,ID,total_sentences_precision,count_ones_precision,count_zeros_precision,precision,total_sentences_recall,count_ones_recall,count_zeros_recall,recall,f1,model,dataset,note_type,prompt
0,0,15,14,1,0.9333333333333332,9,9,0,1.0,0.9655172413793104,llama3,coral,pdac,PROMPT1_entailment
1,1,13,12,1,0.9230769230769232,9,9,0,1.0,0.96,llama3,coral,pdac,PROMPT1_entailment
2,10,21,20,1,0.9523809523809524,11,9,2,0.8181818181818182,0.880195599022005,llama3,coral,pdac,PROMPT1_entailment
3,100,21,15,6,0.7142857142857143,11,10,1,0.9090909090909092,0.8,llama3,coral,pdac,PROMPT1_entailment
4,101,23,19,4,0.8260869565217391,11,10,1,0.9090909090909092,0.8656036446469249,llama3,coral,pdac,PROMPT1_entailment
5,102,24,23,1,0.9583333333333334,27,21,6,0.7777777777777778,0.8586666666666668,llama3,coral,pdac,PROMPT1_entailment
6,103,11,8,3,0.7272727272727273,15,12,3,0.8,0.761904761904762,llama3,coral,pdac,PROMPT1_entailment
7,104,18,16,2,0.8888888888888888,12,10,2,0.8333333333333334,0.8602150537634408,llama3,coral,pdac,PROMPT1_entailment
8,105,30,22,8,0.7333333333333333,33,16,17,0.4848484848484848,0.583747927031509,llama3,coral,pdac,PROMPT1_entailment
9,106,15,13,2,0.8666666666666667,10,10,0,1.0,0.9285714285714286,llama3,coral,pdac,PROMPT1_entailment
10,107,11,11,0,1.0,10,10,0,1.0,1.0,llama3,coral,pdac,PROMPT1_entailment
11,108,17,17,0,1.0,10,10,0,1.0,1.0,llama3,coral,pdac,PROMPT1_entailment
12,109,26,22,4,0.8461538461538461,34,27,7,0.7941176470588235,0.8193103448275861,llama3,coral,pdac,PROMPT1_entailment
13,11,19,15,4,0.7894736842105263,10,9,1,0.9,0.8411214953271027,llama3,coral,pdac,PROMPT1_entailment
14,110,9,9,0,1.0,4,4,0,1.0,1.0,llama3,coral,pdac,PROMPT1_entailment
15,111,12,12,0,1.0,3,3,0,1.0,1.0,llama3,coral,pdac,PROMPT1_entailment
16,112,11,10,1,0.9090909090909092,9,7,2,0.7777777777777778,0.8383233532934132,llama3,coral,pdac,PROMPT1_entailment
17,113,17,11,6,0.6470588235294118,6,4,2,0.6666666666666666,0.6567164179104478,llama3,coral,pdac,PROMPT1_entailment
18,114,13,13,0,1.0,9,9,0,1.0,1.0,llama3,coral,pdac,PROMPT1_entailment
19,115,11,10,1,0.9090909090909092,7,6,1,0.8571428571428571,0.8823529411764706,llama3,coral,pdac,PROMPT1_entailment
20,116,8,7,1,0.875,2,2,0,1.0,0.9333333333333332,llama3,coral,pdac,PROMPT1_entailment
21,117,15,15,0,1.0,8,7,1,0.875,0.9333333333333332,llama3,coral,pdac,PROMPT1_entailment
22,118,15,14,1,0.9333333333333332,9,8,1,0.8888888888888888,0.9105691056910568,llama3,coral,pdac,PROMPT1_entailment
23,119,17,13,4,0.7647058823529411,12,10,2,0.8333333333333334,0.7975460122699386,llama3,coral,pdac,PROMPT1_entailment
24,12,22,22,0,1.0,10,10,0,1.0,1.0,llama3,coral,pdac,PROMPT1_entailment
25,120,17,14,3,0.8235294117647058,13,10,3,0.7692307692307693,0.7954545454545454,llama3,coral,pdac,PROMPT1_entailment
26,121,26,22,4,0.8461538461538461,12,12,0,1.0,0.9166666666666666,llama3,coral,pdac,PROMPT1_entailment
27,122,48,33,15,0.6875,45,35,10,0.7777777777777778,0.7298578199052133,llama3,coral,pdac,PROMPT1_entailment
28,123,12,10,2,0.8333333333333334,10,8,2,0.8,0.816326530612245,llama3,coral,pdac,PROMPT1_entailment
29,124,6,6,0,1.0,3,3,0,1.0,1.0,llama3,coral,pdac,PROMPT1_entailment
30,125,15,12,3,0.8,8,7,1,0.875,0.8358208955223881,llama3,coral,pdac,PROMPT1_entailment
31,126,13,12,1,0.9230769230769232,10,8,2,0.8,0.8571428571428571,llama3,coral,pdac,PROMPT1_entailment
32,127,28,23,5,0.8214285714285714,30,20,10,0.6666666666666666,0.7359999999999999,llama3,coral,pdac,PROMPT1_entailment
33,128,23,18,5,0.782608695652174,35,31,4,0.8857142857142857,0.830975428145942,llama3,coral,pdac,PROMPT1_entailment
34,129,15,12,3,0.8,11,10,1,0.9090909090909092,0.8510638297872342,llama3,coral,pdac,PROMPT1_entailment
35,13,17,15,2,0.8823529411764706,13,9,4,0.6923076923076923,0.7758620689655172,llama3,coral,pdac,PROMPT1_entailment
36,130,22,17,5,0.7727272727272727,12,9,3,0.75,0.7611940298507464,llama3,coral,pdac,PROMPT1_entailment
37,131,14,11,3,0.7857142857142857,12,10,2,0.8333333333333334,0.8088235294117647,llama3,coral,pdac,PROMPT1_entailment
38,132,10,10,0,1.0,10,8,2,0.8,0.888888888888889,llama3,coral,pdac,PROMPT1_entailment
39,133,13,12,1,0.9230769230769232,7,7,0,1.0,0.96,llama3,coral,pdac,PROMPT1_entailment
40,134,15,11,4,0.7333333333333333,15,12,3,0.8,0.7652173913043478,llama3,coral,pdac,PROMPT1_entailment
41,135,13,12,1,0.9230769230769232,9,9,0,1.0,0.96,llama3,coral,pdac,PROMPT1_entailment
42,136,16,13,3,0.8125,7,3,4,0.4285714285714285,0.5611510791366906,llama3,coral,pdac,PROMPT1_entailment
43,137,17,14,3,0.8235294117647058,10,6,4,0.6,0.6942148760330579,llama3,coral,pdac,PROMPT1_entailment
44,138,31,22,9,0.7096774193548387,25,15,10,0.6,0.6502463054187193,llama3,coral,pdac,PROMPT1_entailment
45,139,65,32,33,0.4923076923076923,62,32,30,0.5161290322580645,0.5039370078740157,llama3,coral,pdac,PROMPT1_entailment
46,14,14,13,1,0.9285714285714286,10,10,0,1.0,0.962962962962963,llama3,coral,pdac,PROMPT1_entailment
47,140,14,12,2,0.8571428571428571,8,7,1,0.875,0.8659793814432989,llama3,coral,pdac,PROMPT1_entailment
48,141,18,11,7,0.6111111111111112,11,7,4,0.6363636363636364,0.6234817813765182,llama3,coral,pdac,PROMPT1_entailment
49,142,18,13,5,0.7222222222222222,11,8,3,0.7272727272727273,0.7247386759581883,llama3,coral,pdac,PROMPT1_entailment
50,143,13,12,1,0.9230769230769232,9,8,1,0.8888888888888888,0.9056603773584906,llama3,coral,pdac,PROMPT1_entailment
51,144,15,13,2,0.8666666666666667,12,11,1,0.9166666666666666,0.8909657320872274,llama3,coral,pdac,PROMPT1_entailment
52,145,14,14,0,1.0,10,9,1,0.9,0.9473684210526316,llama3,coral,pdac,PROMPT1_entailment
53,146,9,6,3,0.6666666666666666,7,7,0,1.0,0.8,llama3,coral,pdac,PROMPT1_entailment
54,147,12,11,1,0.9166666666666666,12,10,2,0.8333333333333334,0.8730158730158729,llama3,coral,pdac,PROMPT1_entailment
55,148,30,25,5,0.8333333333333334,25,17,8,0.68,0.748898678414097,llama3,coral,pdac,PROMPT1_entailment
56,149,10,10,0,1.0,7,6,1,0.8571428571428571,0.923076923076923,llama3,coral,pdac,PROMPT1_entailment
57,15,12,12,0,1.0,10,10,0,1.0,1.0,llama3,coral,pdac,PROMPT1_entailment
58,150,14,13,1,0.9285714285714286,8,7,1,0.875,0.900990099009901,llama3,coral,pdac,PROMPT1_entailment
59,151,15,14,1,0.9333333333333332,10,10,0,1.0,0.9655172413793104,llama3,coral,pdac,PROMPT1_entailment
60,152,15,14,1,0.9333333333333332,11,10,1,0.9090909090909092,0.9210526315789476,llama3,coral,pdac,PROMPT1_entailment
61,153,45,18,27,0.4,30,17,13,0.5666666666666667,0.4689655172413793,llama3,coral,pdac,PROMPT1_entailment
62,154,23,21,2,0.9130434782608696,15,15,0,1.0,0.9545454545454544,llama3,coral,pdac,PROMPT1_entailment
63,155,50,43,7,0.86,47,35,12,0.7446808510638298,0.7981967647838769,llama3,coral,pdac,PROMPT1_entailment
64,156,13,12,1,0.9230769230769232,10,9,1,0.9,0.9113924050632912,llama3,coral,pdac,PROMPT1_entailment
65,157,19,18,1,0.9473684210526316,14,13,1,0.9285714285714286,0.937875751503006,llama3,coral,pdac,PROMPT1_entailment
66,158,14,10,4,0.7142857142857143,10,9,1,0.9,0.7964601769911505,llama3,coral,pdac,PROMPT1_entailment
67,159,14,14,0,1.0,4,4,0,1.0,1.0,llama3,coral,pdac,PROMPT1_entailment
68,16,39,34,5,0.8717948717948718,31,24,7,0.7741935483870968,0.8201005025125628,llama3,coral,pdac,PROMPT1_entailment
69,160,10,9,1,0.9,9,9,0,1.0,0.9473684210526316,llama3,coral,pdac,PROMPT1_entailment
70,161,16,16,0,1.0,9,8,1,0.8888888888888888,0.9411764705882352,llama3,coral,pdac,PROMPT1_entailment
71,162,13,13,0,1.0,10,10,0,1.0,1.0,llama3,coral,pdac,PROMPT1_entailment
72,163,17,12,5,0.7058823529411765,13,10,3,0.7692307692307693,0.736196319018405,llama3,coral,pdac,PROMPT1_entailment
73,164,36,27,9,0.75,36,30,6,0.8333333333333334,0.7894736842105262,llama3,coral,pdac,PROMPT1_entailment
74,165,17,13,4,0.7647058823529411,10,8,2,0.8,0.7819548872180452,llama3,coral,pdac,PROMPT1_entailment
75,166,16,14,2,0.875,11,10,1,0.9090909090909092,0.8917197452229298,llama3,coral,pdac,PROMPT1_entailment
76,167,12,10,2,0.8333333333333334,8,7,1,0.875,0.8536585365853658,llama3,coral,pdac,PROMPT1_entailment
77,168,11,9,2,0.8181818181818182,6,5,1,0.8333333333333334,0.8256880733944955,llama3,coral,pdac,PROMPT1_entailment
78,169,9,9,0,1.0,7,6,1,0.8571428571428571,0.923076923076923,llama3,coral,pdac,PROMPT1_entailment
79,17,12,12,0,1.0,5,5,0,1.0,1.0,llama3,coral,pdac,PROMPT1_entailment
80,170,23,19,4,0.8260869565217391,16,10,6,0.625,0.7116104868913856,llama3,coral,pdac,PROMPT1_entailment
81,171,17,13,4,0.7647058823529411,13,13,0,1.0,0.8666666666666666,llama3,coral,pdac,PROMPT1_entailment
82,172,22,17,5,0.7727272727272727,10,10,0,1.0,0.8717948717948718,llama3,coral,pdac,PROMPT1_entailment
83,173,24,22,2,0.9166666666666666,22,16,6,0.7272727272727273,0.8110599078341013,llama3,coral,pdac,PROMPT1_entailment
84,174,15,12,3,0.8,11,7,4,0.6363636363636364,0.7088607594936709,llama3,coral,pdac,PROMPT1_entailment
85,175,38,13,25,0.3421052631578947,28,15,13,0.5357142857142857,0.4175588865096359,llama3,coral,pdac,PROMPT1_entailment
86,176,15,15,0,1.0,10,10,0,1.0,1.0,llama3,coral,pdac,PROMPT1_entailment
87,177,16,16,0,1.0,10,10,0,1.0,1.0,llama3,coral,pdac,PROMPT1_entailment
88,178,30,20,10,0.6666666666666666,36,34,2,0.9444444444444444,0.7816091954022987,llama3,coral,pdac,PROMPT1_entailment
89,179,9,8,1,0.8888888888888888,9,7,2,0.7777777777777778,0.8296296296296296,llama3,coral,pdac,PROMPT1_entailment
90,18,17,17,0,1.0,15,10,5,0.6666666666666666,0.8,llama3,coral,pdac,PROMPT1_entailment
91,180,9,9,0,1.0,5,5,0,1.0,1.0,llama3,coral,pdac,PROMPT1_entailment
92,181,14,12,2,0.8571428571428571,10,8,2,0.8,0.8275862068965518,llama3,coral,pdac,PROMPT1_entailment
93,182,16,14,2,0.875,8,6,2,0.75,0.8076923076923077,llama3,coral,pdac,PROMPT1_entailment
94,183,14,12,2,0.8571428571428571,10,8,2,0.8,0.8275862068965518,llama3,coral,pdac,PROMPT1_entailment
95,184,14,10,4,0.7142857142857143,9,8,1,0.8888888888888888,0.792079207920792,llama3,coral,pdac,PROMPT1_entailment
96,185,28,24,4,0.8571428571428571,22,17,5,0.7727272727272727,0.8127490039840638,llama3,coral,pdac,PROMPT1_entailment
97,186,44,32,12,0.7272727272727273,32,15,17,0.46875,0.5700712589073634,llama3,coral,pdac,PROMPT1_entailment
98,187,38,28,10,0.7368421052631579,34,21,13,0.6176470588235294,0.6719999999999999,llama3,coral,pdac,PROMPT1_entailment
99,188,15,13,2,0.8666666666666667,8,6,2,0.75,0.8041237113402062,llama3,coral,pdac,PROMPT1_entailment
100,189,9,7,2,0.7777777777777778,5,5,0,1.0,0.8750000000000001,llama3,coral,pdac,PROMPT1_entailment
101,19,27,24,3,0.8888888888888888,21,17,4,0.8095238095238095,0.8473520249221184,llama3,coral,pdac,PROMPT1_entailment
102,190,36,31,5,0.8611111111111112,17,11,6,0.6470588235294118,0.7388949079089925,llama3,coral,pdac,PROMPT1_entailment
103,191,29,22,7,0.7586206896551724,15,13,2,0.8666666666666667,0.8090523338048091,llama3,coral,pdac,PROMPT1_entailment
104,192,21,16,5,0.7619047619047619,12,10,2,0.8333333333333334,0.7960199004975124,llama3,coral,pdac,PROMPT1_entailment
105,193,11,10,1,0.9090909090909092,10,8,2,0.8,0.8510638297872342,llama3,coral,pdac,PROMPT1_entailment
106,194,11,8,3,0.7272727272727273,11,9,2,0.8181818181818182,0.770053475935829,llama3,coral,pdac,PROMPT1_entailment
107,195,9,6,3,0.6666666666666666,7,7,0,1.0,0.8,llama3,coral,pdac,PROMPT1_entailment
108,196,14,13,1,0.9285714285714286,8,6,2,0.75,0.8297872340425532,llama3,coral,pdac,PROMPT1_entailment
109,197,17,17,0,1.0,9,7,2,0.7777777777777778,0.8750000000000001,llama3,coral,pdac,PROMPT1_entailment
110,198,15,12,3,0.8,12,10,2,0.8333333333333334,0.816326530612245,llama3,coral,pdac,PROMPT1_entailment
111,199,13,12,1,0.9230769230769232,9,8,1,0.8888888888888888,0.9056603773584906,llama3,coral,pdac,PROMPT1_entailment
112,2,15,9,6,0.6,14,12,2,0.8571428571428571,0.7058823529411764,llama3,coral,pdac,PROMPT1_entailment
113,20,25,15,10,0.6,18,13,5,0.7222222222222222,0.6554621848739496,llama3,coral,pdac,PROMPT1_entailment
114,200,28,24,4,0.8571428571428571,16,15,1,0.9375,0.8955223880597014,llama3,coral,pdac,PROMPT1_entailment
115,201,12,12,0,1.0,10,10,0,1.0,1.0,llama3,coral,pdac,PROMPT1_entailment
116,202,13,13,0,1.0,10,10,0,1.0,1.0,llama3,coral,pdac,PROMPT1_entailment
117,203,35,32,3,0.9142857142857144,31,27,4,0.8709677419354839,0.8921011874032008,llama3,coral,pdac,PROMPT1_entailment
118,204,19,18,1,0.9473684210526316,14,10,4,0.7142857142857143,0.8144796380090498,llama3,coral,pdac,PROMPT1_entailment
119,205,13,9,4,0.6923076923076923,7,5,2,0.7142857142857143,0.7031250000000001,llama3,coral,pdac,PROMPT1_entailment
120,206,12,9,3,0.75,9,8,1,0.8888888888888888,0.8135593220338982,llama3,coral,pdac,PROMPT1_entailment
121,207,16,14,2,0.875,8,8,0,1.0,0.9333333333333332,llama3,coral,pdac,PROMPT1_entailment
122,208,9,7,2,0.7777777777777778,8,8,0,1.0,0.8750000000000001,llama3,coral,pdac,PROMPT1_entailment
123,209,16,14,2,0.875,9,9,0,1.0,0.9333333333333332,llama3,coral,pdac,PROMPT1_entailment
124,21,11,11,0,1.0,10,10,0,1.0,1.0,llama3,coral,pdac,PROMPT1_entailment
125,210,15,12,3,0.8,9,9,0,1.0,0.888888888888889,llama3,coral,pdac,PROMPT1_entailment
126,211,13,11,2,0.8461538461538461,8,8,0,1.0,0.9166666666666666,llama3,coral,pdac,PROMPT1_entailment
127,212,18,18,0,1.0,17,17,0,1.0,1.0,llama3,coral,pdac,PROMPT1_entailment
128,213,13,12,1,0.9230769230769232,11,11,0,1.0,0.96,llama3,coral,pdac,PROMPT1_entailment
129,214,15,12,3,0.8,18,9,9,0.5,0.6153846153846154,llama3,coral,pdac,PROMPT1_entailment
130,215,20,4,16,0.2,12,7,5,0.5833333333333334,0.2978723404255319,llama3,coral,pdac,PROMPT1_entailment
131,216,33,31,2,0.9393939393939394,33,31,2,0.9393939393939394,0.9393939393939394,llama3,coral,pdac,PROMPT1_entailment
132,217,18,16,2,0.8888888888888888,19,15,4,0.7894736842105263,0.8362369337979094,llama3,coral,pdac,PROMPT1_entailment
133,218,18,15,3,0.8333333333333334,11,8,3,0.7272727272727273,0.7766990291262137,llama3,coral,pdac,PROMPT1_entailment
134,219,9,7,2,0.7777777777777778,8,8,0,1.0,0.8750000000000001,llama3,coral,pdac,PROMPT1_entailment
135,22,25,12,13,0.48,17,15,2,0.8823529411764706,0.6217616580310881,llama3,coral,pdac,PROMPT1_entailment
136,220,16,14,2,0.875,11,9,2,0.8181818181818182,0.8456375838926175,llama3,coral,pdac,PROMPT1_entailment
137,221,12,11,1,0.9166666666666666,12,11,1,0.9166666666666666,0.9166666666666666,llama3,coral,pdac,PROMPT1_entailment
138,222,14,13,1,0.9285714285714286,11,10,1,0.9090909090909092,0.9187279151943464,llama3,coral,pdac,PROMPT1_entailment
139,223,35,26,9,0.7428571428571429,37,30,7,0.8108108108108109,0.7753479125248508,llama3,coral,pdac,PROMPT1_entailment
140,224,12,9,3,0.75,8,6,2,0.75,0.75,llama3,coral,pdac,PROMPT1_entailment
141,225,20,17,3,0.85,13,12,1,0.9230769230769232,0.8850325379609545,llama3,coral,pdac,PROMPT1_entailment
142,226,18,17,1,0.9444444444444444,11,9,2,0.8181818181818182,0.8767908309455588,llama3,coral,pdac,PROMPT1_entailment
143,227,11,9,2,0.8181818181818182,10,10,0,1.0,0.9,llama3,coral,pdac,PROMPT1_entailment
144,228,11,11,0,1.0,9,9,0,1.0,1.0,llama3,coral,pdac,PROMPT1_entailment
145,229,13,11,2,0.8461538461538461,9,8,1,0.8888888888888888,0.8669950738916256,llama3,coral,pdac,PROMPT1_entailment
146,23,15,14,1,0.9333333333333332,12,9,3,0.75,0.8316831683168316,llama3,coral,pdac,PROMPT1_entailment
147,230,12,12,0,1.0,8,8,0,1.0,1.0,llama3,coral,pdac,PROMPT1_entailment
148,24,11,10,1,0.9090909090909092,9,7,2,0.7777777777777778,0.8383233532934132,llama3,coral,pdac,PROMPT1_entailment
149,25,15,12,3,0.8,11,9,2,0.8181818181818182,0.8089887640449439,llama3,coral,pdac,PROMPT1_entailment
150,26,15,14,1,0.9333333333333332,11,11,0,1.0,0.9655172413793104,llama3,coral,pdac,PROMPT1_entailment
151,27,14,11,3,0.7857142857142857,12,11,1,0.9166666666666666,0.8461538461538461,llama3,coral,pdac,PROMPT1_entailment
152,28,11,11,0,1.0,13,13,0,1.0,1.0,llama3,coral,pdac,PROMPT1_entailment
153,29,12,10,2,0.8333333333333334,9,8,1,0.8888888888888888,0.8602150537634408,llama3,coral,pdac,PROMPT1_entailment
154,3,14,12,2,0.8571428571428571,8,7,1,0.875,0.8659793814432989,llama3,coral,pdac,PROMPT1_entailment
155,30,17,14,3,0.8235294117647058,11,10,1,0.9090909090909092,0.8641975308641976,llama3,coral,pdac,PROMPT1_entailment
156,31,20,19,1,0.95,11,11,0,1.0,0.9743589743589745,llama3,coral,pdac,PROMPT1_entailment
157,32,26,22,4,0.8461538461538461,11,8,3,0.7272727272727273,0.7822222222222223,llama3,coral,pdac,PROMPT1_entailment
158,33,32,8,24,0.25,24,10,14,0.4166666666666667,0.3125,llama3,coral,pdac,PROMPT1_entailment
159,34,11,10,1,0.9090909090909092,10,10,0,1.0,0.9523809523809524,llama3,coral,pdac,PROMPT1_entailment
160,35,14,14,0,1.0,10,10,0,1.0,1.0,llama3,coral,pdac,PROMPT1_entailment
161,36,34,32,2,0.9411764705882352,44,36,8,0.8181818181818182,0.8753799392097266,llama3,coral,pdac,PROMPT1_entailment
162,37,21,18,3,0.8571428571428571,9,8,1,0.8888888888888888,0.8727272727272727,llama3,coral,pdac,PROMPT1_entailment
163,38,21,18,3,0.8571428571428571,13,12,1,0.9230769230769232,0.888888888888889,llama3,coral,pdac,PROMPT1_entailment
164,39,15,13,2,0.8666666666666667,10,9,1,0.9,0.8830188679245283,llama3,coral,pdac,PROMPT1_entailment
165,4,25,21,4,0.84,15,11,4,0.7333333333333333,0.783050847457627,llama3,coral,pdac,PROMPT1_entailment
166,40,11,9,2,0.8181818181818182,10,5,5,0.5,0.6206896551724137,llama3,coral,pdac,PROMPT1_entailment
167,41,13,11,2,0.8461538461538461,8,6,2,0.75,0.7951807228915662,llama3,coral,pdac,PROMPT1_entailment
168,42,16,15,1,0.9375,11,10,1,0.9090909090909092,0.923076923076923,llama3,coral,pdac,PROMPT1_entailment
169,43,20,18,2,0.9,13,7,6,0.5384615384615384,0.6737967914438503,llama3,coral,pdac,PROMPT1_entailment
170,44,14,12,2,0.8571428571428571,11,11,0,1.0,0.923076923076923,llama3,coral,pdac,PROMPT1_entailment
171,45,19,17,2,0.8947368421052632,10,10,0,1.0,0.9444444444444444,llama3,coral,pdac,PROMPT1_entailment
172,46,26,19,7,0.7307692307692307,11,9,2,0.8181818181818182,0.7720090293453725,llama3,coral,pdac,PROMPT1_entailment
173,47,31,29,2,0.935483870967742,39,33,6,0.8461538461538461,0.8885793871866294,llama3,coral,pdac,PROMPT1_entailment
174,48,12,9,3,0.75,10,10,0,1.0,0.8571428571428571,llama3,coral,pdac,PROMPT1_entailment
175,49,14,13,1,0.9285714285714286,10,8,2,0.8,0.859504132231405,llama3,coral,pdac,PROMPT1_entailment
176,5,18,17,1,0.9444444444444444,10,9,1,0.9,0.9216867469879516,llama3,coral,pdac,PROMPT1_entailment
177,50,11,10,1,0.9090909090909092,10,5,5,0.5,0.6451612903225806,llama3,coral,pdac,PROMPT1_entailment
178,51,16,14,2,0.875,12,11,1,0.9166666666666666,0.8953488372093024,llama3,coral,pdac,PROMPT1_entailment
179,52,12,10,2,0.8333333333333334,10,10,0,1.0,0.9090909090909092,llama3,coral,pdac,PROMPT1_entailment
180,53,11,10,1,0.9090909090909092,8,7,1,0.875,0.8917197452229298,llama3,coral,pdac,PROMPT1_entailment
181,54,6,5,1,0.8333333333333334,2,2,0,1.0,0.9090909090909092,llama3,coral,pdac,PROMPT1_entailment
182,55,13,12,1,0.9230769230769232,10,7,3,0.7,0.7962085308056872,llama3,coral,pdac,PROMPT1_entailment
183,56,14,13,1,0.9285714285714286,8,8,0,1.0,0.962962962962963,llama3,coral,pdac,PROMPT1_entailment
184,57,38,34,4,0.8947368421052632,13,9,4,0.6923076923076923,0.7806122448979592,llama3,coral,pdac,PROMPT1_entailment
185,58,21,18,3,0.8571428571428571,10,10,0,1.0,0.923076923076923,llama3,coral,pdac,PROMPT1_entailment
186,59,33,23,10,0.696969696969697,21,15,6,0.7142857142857143,0.7055214723926381,llama3,coral,pdac,PROMPT1_entailment
187,6,16,15,1,0.9375,12,11,1,0.9166666666666666,0.9269662921348316,llama3,coral,pdac,PROMPT1_entailment
188,60,24,19,5,0.7916666666666666,13,10,3,0.7692307692307693,0.7802874743326489,llama3,coral,pdac,PROMPT1_entailment
189,61,11,10,1,0.9090909090909092,7,7,0,1.0,0.9523809523809524,llama3,coral,pdac,PROMPT1_entailment
190,62,14,13,1,0.9285714285714286,11,7,4,0.6363636363636364,0.7551867219917012,llama3,coral,pdac,PROMPT1_entailment
191,63,12,12,0,1.0,10,10,0,1.0,1.0,llama3,coral,pdac,PROMPT1_entailment
192,64,14,14,0,1.0,12,11,1,0.9166666666666666,0.9565217391304348,llama3,coral,pdac,PROMPT1_entailment
193,65,15,14,1,0.9333333333333332,9,7,2,0.7777777777777778,0.8484848484848485,llama3,coral,pdac,PROMPT1_entailment
194,66,14,11,3,0.7857142857142857,12,9,3,0.75,0.7674418604651163,llama3,coral,pdac,PROMPT1_entailment
195,67,8,8,0,1.0,1,1,0,1.0,1.0,llama3,coral,pdac,PROMPT1_entailment
196,68,11,10,1,0.9090909090909092,11,9,2,0.8181818181818182,0.861244019138756,llama3,coral,pdac,PROMPT1_entailment
197,69,13,11,2,0.8461538461538461,10,9,1,0.9,0.8722466960352422,llama3,coral,pdac,PROMPT1_entailment
198,7,15,13,2,0.8666666666666667,11,11,0,1.0,0.9285714285714286,llama3,coral,pdac,PROMPT1_entailment
199,70,13,11,2,0.8461538461538461,15,14,1,0.9333333333333332,0.8876080691642652,llama3,coral,pdac,PROMPT1_entailment
200,71,23,12,11,0.5217391304347826,9,8,1,0.8888888888888888,0.6575342465753423,llama3,coral,pdac,PROMPT1_entailment
201,72,25,16,9,0.64,13,10,3,0.7692307692307693,0.6986899563318777,llama3,coral,pdac,PROMPT1_entailment
202,73,137,22,115,0.1605839416058394,154,77,77,0.5,0.2430939226519337,llama3,coral,pdac,PROMPT1_entailment
203,74,17,13,4,0.7647058823529411,8,6,2,0.75,0.7572815533980582,llama3,coral,pdac,PROMPT1_entailment
204,75,17,14,3,0.8235294117647058,7,7,0,1.0,0.9032258064516128,llama3,coral,pdac,PROMPT1_entailment
205,76,10,7,3,0.7,7,7,0,1.0,0.8235294117647058,llama3,coral,pdac,PROMPT1_entailment
206,77,17,13,4,0.7647058823529411,8,7,1,0.875,0.8161434977578476,llama3,coral,pdac,PROMPT1_entailment
207,78,10,8,2,0.8,8,8,0,1.0,0.888888888888889,llama3,coral,pdac,PROMPT1_entailment
208,79,14,12,2,0.8571428571428571,11,9,2,0.8181818181818182,0.8372093023255814,llama3,coral,pdac,PROMPT1_entailment
209,8,11,11,0,1.0,2,2,0,1.0,1.0,llama3,coral,pdac,PROMPT1_entailment
210,80,15,15,0,1.0,9,9,0,1.0,1.0,llama3,coral,pdac,PROMPT1_entailment
211,81,11,10,1,0.9090909090909092,6,5,1,0.8333333333333334,0.8695652173913043,llama3,coral,pdac,PROMPT1_entailment
212,82,18,17,1,0.9444444444444444,4,3,1,0.75,0.8360655737704917,llama3,coral,pdac,PROMPT1_entailment
213,83,22,18,4,0.8181818181818182,11,9,2,0.8181818181818182,0.8181818181818182,llama3,coral,pdac,PROMPT1_entailment
214,84,19,13,6,0.6842105263157895,11,8,3,0.7272727272727273,0.7050847457627119,llama3,coral,pdac,PROMPT1_entailment
215,85,34,27,7,0.7941176470588235,35,24,11,0.6857142857142857,0.735945485519591,llama3,coral,pdac,PROMPT1_entailment
216,86,12,11,1,0.9166666666666666,10,8,2,0.8,0.854368932038835,llama3,coral,pdac,PROMPT1_entailment
217,87,18,15,3,0.8333333333333334,7,7,0,1.0,0.9090909090909092,llama3,coral,pdac,PROMPT1_entailment
218,88,12,11,1,0.9166666666666666,8,7,1,0.875,0.8953488372093024,llama3,coral,pdac,PROMPT1_entailment
219,89,14,11,3,0.7857142857142857,10,10,0,1.0,0.88,llama3,coral,pdac,PROMPT1_entailment
220,9,13,13,0,1.0,12,11,1,0.9166666666666666,0.9565217391304348,llama3,coral,pdac,PROMPT1_entailment
221,90,11,6,5,0.5454545454545454,9,6,3,0.6666666666666666,0.6,llama3,coral,pdac,PROMPT1_entailment
222,91,11,9,2,0.8181818181818182,10,10,0,1.0,0.9,llama3,coral,pdac,PROMPT1_entailment
223,92,12,8,4,0.6666666666666666,10,10,0,1.0,0.8,llama3,coral,pdac,PROMPT1_entailment
224,93,10,9,1,0.9,9,9,0,1.0,0.9473684210526316,llama3,coral,pdac,PROMPT1_entailment
225,94,10,7,3,0.7,7,6,1,0.8571428571428571,0.7706422018348624,llama3,coral,pdac,PROMPT1_entailment
226,95,14,10,4,0.7142857142857143,8,6,2,0.75,0.7317073170731706,llama3,coral,pdac,PROMPT1_entailment
227,96,11,10,1,0.9090909090909092,4,4,0,1.0,0.9523809523809524,llama3,coral,pdac,PROMPT1_entailment
228,97,14,11,3,0.7857142857142857,8,6,2,0.75,0.7674418604651163,llama3,coral,pdac,PROMPT1_entailment
229,98,15,11,4,0.7333333333333333,9,9,0,1.0,0.846153846153846,llama3,coral,pdac,PROMPT1_entailment
230,99,15,13,2,0.8666666666666667,9,9,0,1.0,0.9285714285714286,llama3,coral,pdac,PROMPT1_entailment
0,0,24,14,10,0.5833333333333334,9,8,1,0.8888888888888888,0.7044025157232704,llama3,coral,pdac,PROMPT1_ICL_entailment
1,1,23,14,9,0.6086956521739131,9,9,0,1.0,0.7567567567567568,llama3,coral,pdac,PROMPT1_ICL_entailment
2,10,39,26,13,0.6666666666666666,11,10,1,0.9090909090909092,0.7692307692307692,llama3,coral,pdac,PROMPT1_ICL_entailment
3,100,28,12,16,0.4285714285714285,11,9,2,0.8181818181818182,0.5625,llama3,coral,pdac,PROMPT1_ICL_entailment
4,101,30,21,9,0.7,11,7,4,0.6363636363636364,0.6666666666666666,llama3,coral,pdac,PROMPT1_ICL_entailment
5,102,30,25,5,0.8333333333333334,27,13,14,0.4814814814814814,0.6103286384976525,llama3,coral,pdac,PROMPT1_ICL_entailment
6,103,19,7,12,0.3684210526315789,15,4,11,0.2666666666666666,0.3093922651933701,llama3,coral,pdac,PROMPT1_ICL_entailment
7,104,20,10,10,0.5,12,7,5,0.5833333333333334,0.5384615384615384,llama3,coral,pdac,PROMPT1_ICL_entailment
8,105,43,22,21,0.5116279069767442,33,18,15,0.5454545454545454,0.528,llama3,coral,pdac,PROMPT1_ICL_entailment
9,106,21,11,10,0.5238095238095238,10,9,1,0.9,0.6622073578595318,llama3,coral,pdac,PROMPT1_ICL_entailment
10,107,19,10,9,0.5263157894736842,10,9,1,0.9,0.6642066420664207,llama3,coral,pdac,PROMPT1_ICL_entailment
11,108,25,17,8,0.68,10,10,0,1.0,0.8095238095238095,llama3,coral,pdac,PROMPT1_ICL_entailment
12,109,36,24,12,0.6666666666666666,34,26,8,0.7647058823529411,0.7123287671232877,llama3,coral,pdac,PROMPT1_ICL_entailment
13,11,29,16,13,0.5517241379310345,10,9,1,0.9,0.684085510688836,llama3,coral,pdac,PROMPT1_ICL_entailment
14,110,15,7,8,0.4666666666666667,4,2,2,0.5,0.4827586206896552,llama3,coral,pdac,PROMPT1_ICL_entailment
15,111,18,10,8,0.5555555555555556,3,3,0,1.0,0.7142857142857143,llama3,coral,pdac,PROMPT1_ICL_entailment
16,112,21,12,9,0.5714285714285714,9,8,1,0.8888888888888888,0.6956521739130435,llama3,coral,pdac,PROMPT1_ICL_entailment
17,113,24,11,13,0.4583333333333333,6,4,2,0.6666666666666666,0.5432098765432098,llama3,coral,pdac,PROMPT1_ICL_entailment
18,114,22,14,8,0.6363636363636364,9,8,1,0.8888888888888888,0.7417218543046358,llama3,coral,pdac,PROMPT1_ICL_entailment
19,115,21,12,9,0.5714285714285714,7,6,1,0.8571428571428571,0.6857142857142857,llama3,coral,pdac,PROMPT1_ICL_entailment
20,116,14,4,10,0.2857142857142857,2,2,0,1.0,0.4444444444444445,llama3,coral,pdac,PROMPT1_ICL_entailment
21,117,20,12,8,0.6,8,7,1,0.875,0.711864406779661,llama3,coral,pdac,PROMPT1_ICL_entailment
22,118,17,13,4,0.7647058823529411,9,8,1,0.8888888888888888,0.8221343873517786,llama3,coral,pdac,PROMPT1_ICL_entailment
23,119,27,15,12,0.5555555555555556,12,9,3,0.75,0.6382978723404256,llama3,coral,pdac,PROMPT1_ICL_entailment
24,12,28,19,9,0.6785714285714286,10,6,4,0.6,0.6368715083798883,llama3,coral,pdac,PROMPT1_ICL_entailment
25,120,25,11,14,0.44,13,6,7,0.4615384615384615,0.4505119453924914,llama3,coral,pdac,PROMPT1_ICL_entailment
26,121,33,23,10,0.696969696969697,12,9,3,0.75,0.7225130890052356,llama3,coral,pdac,PROMPT1_ICL_entailment
27,122,57,48,9,0.8421052631578947,45,32,13,0.7111111111111111,0.7710843373493975,llama3,coral,pdac,PROMPT1_ICL_entailment
28,123,25,17,8,0.68,10,9,1,0.9,0.7746835443037976,llama3,coral,pdac,PROMPT1_ICL_entailment
29,124,12,4,8,0.3333333333333333,3,3,0,1.0,0.5,llama3,coral,pdac,PROMPT1_ICL_entailment
30,125,19,10,9,0.5263157894736842,8,7,1,0.875,0.6572769953051644,llama3,coral,pdac,PROMPT1_ICL_entailment
31,126,25,17,8,0.68,10,6,4,0.6,0.6375000000000001,llama3,coral,pdac,PROMPT1_ICL_entailment
32,127,46,32,14,0.6956521739130435,30,15,15,0.5,0.5818181818181818,llama3,coral,pdac,PROMPT1_ICL_entailment
33,128,64,50,14,0.78125,35,28,7,0.8,0.7905138339920948,llama3,coral,pdac,PROMPT1_ICL_entailment
34,129,23,13,10,0.5652173913043478,11,9,2,0.8181818181818182,0.6685714285714286,llama3,coral,pdac,PROMPT1_ICL_entailment
35,13,24,14,10,0.5833333333333334,13,7,6,0.5384615384615384,0.5599999999999999,llama3,coral,pdac,PROMPT1_ICL_entailment
36,130,28,15,13,0.5357142857142857,12,9,3,0.75,0.6250000000000001,llama3,coral,pdac,PROMPT1_ICL_entailment
37,131,22,11,11,0.5,12,11,1,0.9166666666666666,0.6470588235294118,llama3,coral,pdac,PROMPT1_ICL_entailment
38,132,18,9,9,0.5,10,8,2,0.8,0.6153846153846154,llama3,coral,pdac,PROMPT1_ICL_entailment
39,133,23,14,9,0.6086956521739131,7,5,2,0.7142857142857143,0.6572769953051643,llama3,coral,pdac,PROMPT1_ICL_entailment
40,134,23,14,9,0.6086956521739131,15,6,9,0.4,0.4827586206896552,llama3,coral,pdac,PROMPT1_ICL_entailment
41,135,26,17,9,0.6538461538461539,9,9,0,1.0,0.7906976744186047,llama3,coral,pdac,PROMPT1_ICL_entailment
42,136,29,15,14,0.5172413793103449,7,6,1,0.8571428571428571,0.6451612903225806,llama3,coral,pdac,PROMPT1_ICL_entailment
43,137,21,10,11,0.4761904761904761,10,8,2,0.8,0.5970149253731344,llama3,coral,pdac,PROMPT1_ICL_entailment
44,138,34,15,19,0.4411764705882353,25,12,13,0.48,0.4597701149425287,llama3,coral,pdac,PROMPT1_ICL_entailment
45,139,25,16,9,0.64,62,34,28,0.5483870967741935,0.5906623235613463,llama3,coral,pdac,PROMPT1_ICL_entailment
46,14,20,11,9,0.55,10,7,3,0.7,0.616,llama3,coral,pdac,PROMPT1_ICL_entailment
47,140,18,13,5,0.7222222222222222,8,6,2,0.75,0.7358490566037735,llama3,coral,pdac,PROMPT1_ICL_entailment
48,141,24,14,10,0.5833333333333334,11,6,5,0.5454545454545454,0.5637583892617449,llama3,coral,pdac,PROMPT1_ICL_entailment
49,142,25,14,11,0.56,11,10,1,0.9090909090909092,0.6930693069306931,llama3,coral,pdac,PROMPT1_ICL_entailment
50,143,22,14,8,0.6363636363636364,9,7,2,0.7777777777777778,0.7000000000000001,llama3,coral,pdac,PROMPT1_ICL_entailment
51,144,25,16,9,0.64,12,9,3,0.75,0.6906474820143884,llama3,coral,pdac,PROMPT1_ICL_entailment
52,145,20,11,9,0.55,10,8,2,0.8,0.6518518518518519,llama3,coral,pdac,PROMPT1_ICL_entailment
53,146,21,7,14,0.3333333333333333,7,5,2,0.7142857142857143,0.4545454545454545,llama3,coral,pdac,PROMPT1_ICL_entailment
54,147,22,12,10,0.5454545454545454,12,12,0,1.0,0.7058823529411764,llama3,coral,pdac,PROMPT1_ICL_entailment
55,148,403,20,383,0.0496277915632754,25,16,9,0.64,0.0921128382268278,llama3,coral,pdac,PROMPT1_ICL_entailment
56,149,22,13,9,0.5909090909090909,7,4,3,0.5714285714285714,0.5810055865921787,llama3,coral,pdac,PROMPT1_ICL_entailment
57,15,19,11,8,0.5789473684210527,10,10,0,1.0,0.7333333333333334,llama3,coral,pdac,PROMPT1_ICL_entailment
58,150,15,15,0,1.0,8,8,0,1.0,1.0,llama3,coral,pdac,PROMPT1_ICL_entailment
59,151,24,15,9,0.625,10,10,0,1.0,0.7692307692307693,llama3,coral,pdac,PROMPT1_ICL_entailment
60,152,19,15,4,0.7894736842105263,11,9,2,0.8181818181818182,0.8035714285714286,llama3,coral,pdac,PROMPT1_ICL_entailment
61,153,46,16,30,0.3478260869565217,30,6,24,0.2,0.253968253968254,llama3,coral,pdac,PROMPT1_ICL_entailment
62,154,28,14,14,0.5,15,9,6,0.6,0.5454545454545454,llama3,coral,pdac,PROMPT1_ICL_entailment
63,155,45,36,9,0.8,47,22,25,0.4680851063829787,0.5906040268456376,llama3,coral,pdac,PROMPT1_ICL_entailment
64,156,24,15,9,0.625,10,10,0,1.0,0.7692307692307693,llama3,coral,pdac,PROMPT1_ICL_entailment
65,157,23,12,11,0.5217391304347826,14,10,4,0.7142857142857143,0.6030150753768844,llama3,coral,pdac,PROMPT1_ICL_entailment
66,158,18,9,9,0.5,10,7,3,0.7,0.5833333333333334,llama3,coral,pdac,PROMPT1_ICL_entailment
67,159,22,13,9,0.5909090909090909,4,1,3,0.25,0.3513513513513513,llama3,coral,pdac,PROMPT1_ICL_entailment
68,16,42,26,16,0.6190476190476191,31,19,12,0.6129032258064516,0.6159600997506235,llama3,coral,pdac,PROMPT1_ICL_entailment
69,160,19,9,10,0.4736842105263157,9,8,1,0.8888888888888888,0.6180257510729614,llama3,coral,pdac,PROMPT1_ICL_entailment
70,161,23,15,8,0.6521739130434783,9,6,3,0.6666666666666666,0.6593406593406593,llama3,coral,pdac,PROMPT1_ICL_entailment
71,162,20,11,9,0.55,10,9,1,0.9,0.6827586206896552,llama3,coral,pdac,PROMPT1_ICL_entailment
72,163,27,16,11,0.5925925925925926,13,9,4,0.6923076923076923,0.6385809312638581,llama3,coral,pdac,PROMPT1_ICL_entailment
73,164,41,33,8,0.8048780487804879,36,16,20,0.4444444444444444,0.5726681127982647,llama3,coral,pdac,PROMPT1_ICL_entailment
74,165,30,19,11,0.6333333333333333,10,9,1,0.9,0.7434782608695653,llama3,coral,pdac,PROMPT1_ICL_entailment
75,166,31,20,11,0.6451612903225806,11,10,1,0.9090909090909092,0.7547169811320754,llama3,coral,pdac,PROMPT1_ICL_entailment
76,167,21,10,11,0.4761904761904761,8,7,1,0.875,0.6167400881057268,llama3,coral,pdac,PROMPT1_ICL_entailment
77,168,17,8,9,0.4705882352941176,6,5,1,0.8333333333333334,0.6015037593984962,llama3,coral,pdac,PROMPT1_ICL_entailment
78,169,20,11,9,0.55,7,5,2,0.7142857142857143,0.6214689265536724,llama3,coral,pdac,PROMPT1_ICL_entailment
79,17,19,10,9,0.5263157894736842,5,4,1,0.8,0.6349206349206348,llama3,coral,pdac,PROMPT1_ICL_entailment
80,170,31,18,13,0.5806451612903226,16,11,5,0.6875,0.6295707472178061,llama3,coral,pdac,PROMPT1_ICL_entailment
81,171,34,21,13,0.6176470588235294,13,9,4,0.6923076923076923,0.6528497409326426,llama3,coral,pdac,PROMPT1_ICL_entailment
82,172,29,14,15,0.4827586206896552,10,8,2,0.8,0.6021505376344086,llama3,coral,pdac,PROMPT1_ICL_entailment
83,173,33,22,11,0.6666666666666666,22,11,11,0.5,0.5714285714285715,llama3,coral,pdac,PROMPT1_ICL_entailment
84,174,24,9,15,0.375,11,8,3,0.7272727272727273,0.4948453608247422,llama3,coral,pdac,PROMPT1_ICL_entailment
85,175,53,18,35,0.3396226415094339,28,21,7,0.75,0.4675324675324676,llama3,coral,pdac,PROMPT1_ICL_entailment
86,176,23,13,10,0.5652173913043478,10,10,0,1.0,0.7222222222222222,llama3,coral,pdac,PROMPT1_ICL_entailment
87,177,17,13,4,0.7647058823529411,10,10,0,1.0,0.8666666666666666,llama3,coral,pdac,PROMPT1_ICL_entailment
88,178,42,23,19,0.5476190476190477,36,28,8,0.7777777777777778,0.6427145708582834,llama3,coral,pdac,PROMPT1_ICL_entailment
89,179,17,7,10,0.4117647058823529,9,6,3,0.6666666666666666,0.509090909090909,llama3,coral,pdac,PROMPT1_ICL_entailment
90,18,20,11,9,0.55,15,5,10,0.3333333333333333,0.4150943396226416,llama3,coral,pdac,PROMPT1_ICL_entailment
91,180,15,6,9,0.4,5,4,1,0.8,0.5333333333333333,llama3,coral,pdac,PROMPT1_ICL_entailment
92,181,21,10,11,0.4761904761904761,10,6,4,0.6,0.5309734513274337,llama3,coral,pdac,PROMPT1_ICL_entailment
93,182,24,14,10,0.5833333333333334,8,7,1,0.875,0.7000000000000001,llama3,coral,pdac,PROMPT1_ICL_entailment
94,183,20,12,8,0.6,10,6,4,0.6,0.6,llama3,coral,pdac,PROMPT1_ICL_entailment
95,184,22,8,14,0.3636363636363636,9,8,1,0.8888888888888888,0.5161290322580644,llama3,coral,pdac,PROMPT1_ICL_entailment
96,185,25,16,9,0.64,22,15,7,0.6818181818181818,0.6602475928473177,llama3,coral,pdac,PROMPT1_ICL_entailment
97,186,45,25,20,0.5555555555555556,32,7,25,0.21875,0.3139013452914798,llama3,coral,pdac,PROMPT1_ICL_entailment
98,187,55,37,18,0.6727272727272727,34,17,17,0.5,0.5736434108527131,llama3,coral,pdac,PROMPT1_ICL_entailment
99,188,28,20,8,0.7142857142857143,8,6,2,0.75,0.7317073170731706,llama3,coral,pdac,PROMPT1_ICL_entailment
100,189,26,15,11,0.5769230769230769,5,5,0,1.0,0.7317073170731707,llama3,coral,pdac,PROMPT1_ICL_entailment
101,19,38,26,12,0.6842105263157895,21,12,9,0.5714285714285714,0.622754491017964,llama3,coral,pdac,PROMPT1_ICL_entailment
102,190,33,21,12,0.6363636363636364,17,8,9,0.4705882352941176,0.5410628019323671,llama3,coral,pdac,PROMPT1_ICL_entailment
103,191,38,30,8,0.7894736842105263,15,12,3,0.8,0.794701986754967,llama3,coral,pdac,PROMPT1_ICL_entailment
104,192,28,19,9,0.6785714285714286,12,9,3,0.75,0.7124999999999999,llama3,coral,pdac,PROMPT1_ICL_entailment
105,193,19,9,10,0.4736842105263157,10,6,4,0.6,0.5294117647058824,llama3,coral,pdac,PROMPT1_ICL_entailment
106,194,22,10,12,0.4545454545454545,11,10,1,0.9090909090909092,0.6060606060606061,llama3,coral,pdac,PROMPT1_ICL_entailment
107,195,20,10,10,0.5,7,6,1,0.8571428571428571,0.631578947368421,llama3,coral,pdac,PROMPT1_ICL_entailment
108,196,22,11,11,0.5,8,8,0,1.0,0.6666666666666666,llama3,coral,pdac,PROMPT1_ICL_entailment
109,197,32,23,9,0.71875,9,4,5,0.4444444444444444,0.5492537313432836,llama3,coral,pdac,PROMPT1_ICL_entailment
110,198,20,11,9,0.55,12,9,3,0.75,0.6346153846153847,llama3,coral,pdac,PROMPT1_ICL_entailment
111,199,26,17,9,0.6538461538461539,9,9,0,1.0,0.7906976744186047,llama3,coral,pdac,PROMPT1_ICL_entailment
112,2,28,17,11,0.6071428571428571,14,11,3,0.7857142857142857,0.684981684981685,llama3,coral,pdac,PROMPT1_ICL_entailment
113,20,35,17,18,0.4857142857142857,18,12,6,0.6666666666666666,0.5619834710743802,llama3,coral,pdac,PROMPT1_ICL_entailment
114,200,34,26,8,0.7647058823529411,16,15,1,0.9375,0.8423326133909286,llama3,coral,pdac,PROMPT1_ICL_entailment
115,201,20,11,9,0.55,10,10,0,1.0,0.7096774193548387,llama3,coral,pdac,PROMPT1_ICL_entailment
116,202,19,11,8,0.5789473684210527,10,10,0,1.0,0.7333333333333334,llama3,coral,pdac,PROMPT1_ICL_entailment
117,203,39,30,9,0.7692307692307693,31,23,8,0.7419354838709677,0.7553366174055829,llama3,coral,pdac,PROMPT1_ICL_entailment
118,204,27,17,10,0.6296296296296297,14,11,3,0.7857142857142857,0.6990654205607476,llama3,coral,pdac,PROMPT1_ICL_entailment
119,205,17,7,10,0.4117647058823529,7,5,2,0.7142857142857143,0.5223880597014926,llama3,coral,pdac,PROMPT1_ICL_entailment
120,206,20,9,11,0.45,9,9,0,1.0,0.6206896551724138,llama3,coral,pdac,PROMPT1_ICL_entailment
121,207,26,14,12,0.5384615384615384,8,5,3,0.625,0.578512396694215,llama3,coral,pdac,PROMPT1_ICL_entailment
122,208,18,9,9,0.5,8,8,0,1.0,0.6666666666666666,llama3,coral,pdac,PROMPT1_ICL_entailment
123,209,29,20,9,0.6896551724137931,9,9,0,1.0,0.8163265306122449,llama3,coral,pdac,PROMPT1_ICL_entailment
124,21,19,11,8,0.5789473684210527,10,9,1,0.9,0.7046263345195731,llama3,coral,pdac,PROMPT1_ICL_entailment
125,210,21,13,8,0.6190476190476191,9,8,1,0.8888888888888888,0.7298245614035087,llama3,coral,pdac,PROMPT1_ICL_entailment
126,211,19,11,8,0.5789473684210527,8,6,2,0.75,0.6534653465346535,llama3,coral,pdac,PROMPT1_ICL_entailment
127,212,33,21,12,0.6363636363636364,17,13,4,0.7647058823529411,0.6946564885496184,llama3,coral,pdac,PROMPT1_ICL_entailment
128,213,24,15,9,0.625,11,7,4,0.6363636363636364,0.6306306306306306,llama3,coral,pdac,PROMPT1_ICL_entailment
129,214,35,23,12,0.6571428571428571,18,8,10,0.4444444444444444,0.5302593659942362,llama3,coral,pdac,PROMPT1_ICL_entailment
130,215,27,12,15,0.4444444444444444,12,5,7,0.4166666666666667,0.4301075268817204,llama3,coral,pdac,PROMPT1_ICL_entailment
131,216,41,29,12,0.7073170731707317,33,25,8,0.7575757575757576,0.7315842583249242,llama3,coral,pdac,PROMPT1_ICL_entailment
132,217,36,28,8,0.7777777777777778,19,13,6,0.6842105263157895,0.728,llama3,coral,pdac,PROMPT1_ICL_entailment
133,218,22,13,9,0.5909090909090909,11,8,3,0.7272727272727273,0.6520376175548589,llama3,coral,pdac,PROMPT1_ICL_entailment
134,219,23,14,9,0.6086956521739131,8,7,1,0.875,0.717948717948718,llama3,coral,pdac,PROMPT1_ICL_entailment
135,22,32,20,12,0.625,17,14,3,0.8235294117647058,0.7106598984771573,llama3,coral,pdac,PROMPT1_ICL_entailment
136,220,26,15,11,0.5769230769230769,11,10,1,0.9090909090909092,0.7058823529411764,llama3,coral,pdac,PROMPT1_ICL_entailment
137,221,19,9,10,0.4736842105263157,12,8,4,0.6666666666666666,0.5538461538461538,llama3,coral,pdac,PROMPT1_ICL_entailment
138,222,21,8,13,0.3809523809523809,11,5,6,0.4545454545454545,0.4145077720207253,llama3,coral,pdac,PROMPT1_ICL_entailment
139,223,54,43,11,0.7962962962962963,37,20,17,0.5405405405405406,0.6439535754399102,llama3,coral,pdac,PROMPT1_ICL_entailment
140,224,34,17,17,0.5,8,7,1,0.875,0.6363636363636364,llama3,coral,pdac,PROMPT1_ICL_entailment
141,225,30,21,9,0.7,13,9,4,0.6923076923076923,0.6961325966850829,llama3,coral,pdac,PROMPT1_ICL_entailment
142,226,24,14,10,0.5833333333333334,11,9,2,0.8181818181818182,0.6810810810810811,llama3,coral,pdac,PROMPT1_ICL_entailment
143,227,19,9,10,0.4736842105263157,10,7,3,0.7,0.5650224215246636,llama3,coral,pdac,PROMPT1_ICL_entailment
144,228,20,11,9,0.55,9,9,0,1.0,0.7096774193548387,llama3,coral,pdac,PROMPT1_ICL_entailment
145,229,24,15,9,0.625,9,6,3,0.6666666666666666,0.6451612903225806,llama3,coral,pdac,PROMPT1_ICL_entailment
146,23,22,14,8,0.6363636363636364,12,12,0,1.0,0.7777777777777778,llama3,coral,pdac,PROMPT1_ICL_entailment
147,230,20,11,9,0.55,8,8,0,1.0,0.7096774193548387,llama3,coral,pdac,PROMPT1_ICL_entailment
148,24,21,12,9,0.5714285714285714,9,5,4,0.5555555555555556,0.5633802816901409,llama3,coral,pdac,PROMPT1_ICL_entailment
149,25,23,14,9,0.6086956521739131,11,10,1,0.9090909090909092,0.7291666666666666,llama3,coral,pdac,PROMPT1_ICL_entailment
150,26,24,16,8,0.6666666666666666,11,11,0,1.0,0.8,llama3,coral,pdac,PROMPT1_ICL_entailment
151,27,23,13,10,0.5652173913043478,12,9,3,0.75,0.6446280991735538,llama3,coral,pdac,PROMPT1_ICL_entailment
152,28,14,11,3,0.7857142857142857,13,13,0,1.0,0.88,llama3,coral,pdac,PROMPT1_ICL_entailment
153,29,35,24,11,0.6857142857142857,9,6,3,0.6666666666666666,0.676056338028169,llama3,coral,pdac,PROMPT1_ICL_entailment
154,3,22,13,9,0.5909090909090909,8,7,1,0.875,0.7054263565891474,llama3,coral,pdac,PROMPT1_ICL_entailment
155,30,31,20,11,0.6451612903225806,11,10,1,0.9090909090909092,0.7547169811320754,llama3,coral,pdac,PROMPT1_ICL_entailment
156,31,39,35,4,0.8974358974358975,11,9,2,0.8181818181818182,0.8559782608695653,llama3,coral,pdac,PROMPT1_ICL_entailment
157,32,33,20,13,0.6060606060606061,11,5,6,0.4545454545454545,0.5194805194805195,llama3,coral,pdac,PROMPT1_ICL_entailment
158,33,27,11,16,0.4074074074074074,24,8,16,0.3333333333333333,0.3666666666666666,llama3,coral,pdac,PROMPT1_ICL_entailment
159,34,19,10,9,0.5263157894736842,10,8,2,0.8,0.6349206349206348,llama3,coral,pdac,PROMPT1_ICL_entailment
160,35,19,11,8,0.5789473684210527,10,10,0,1.0,0.7333333333333334,llama3,coral,pdac,PROMPT1_ICL_entailment
161,36,41,30,11,0.7317073170731707,44,28,16,0.6363636363636364,0.6807131280388978,llama3,coral,pdac,PROMPT1_ICL_entailment
162,37,30,19,11,0.6333333333333333,9,8,1,0.8888888888888888,0.7396593673965937,llama3,coral,pdac,PROMPT1_ICL_entailment
163,38,27,16,11,0.5925925925925926,13,10,3,0.7692307692307693,0.6694560669456068,llama3,coral,pdac,PROMPT1_ICL_entailment
164,39,21,12,9,0.5714285714285714,10,7,3,0.7,0.6292134831460674,llama3,coral,pdac,PROMPT1_ICL_entailment
165,4,29,19,10,0.6551724137931034,15,10,5,0.6666666666666666,0.6608695652173913,llama3,coral,pdac,PROMPT1_ICL_entailment
166,40,20,10,10,0.5,10,8,2,0.8,0.6153846153846154,llama3,coral,pdac,PROMPT1_ICL_entailment
167,41,21,10,11,0.4761904761904761,8,6,2,0.75,0.58252427184466,llama3,coral,pdac,PROMPT1_ICL_entailment
168,42,25,16,9,0.64,11,4,7,0.3636363636363636,0.463768115942029,llama3,coral,pdac,PROMPT1_ICL_entailment
169,43,29,23,6,0.7931034482758621,13,9,4,0.6923076923076923,0.7392857142857143,llama3,coral,pdac,PROMPT1_ICL_entailment
170,44,23,13,10,0.5652173913043478,11,10,1,0.9090909090909092,0.6970509383378015,llama3,coral,pdac,PROMPT1_ICL_entailment
171,45,30,22,8,0.7333333333333333,10,10,0,1.0,0.846153846153846,llama3,coral,pdac,PROMPT1_ICL_entailment
172,46,31,15,16,0.4838709677419355,11,9,2,0.8181818181818182,0.6081081081081081,llama3,coral,pdac,PROMPT1_ICL_entailment
173,47,39,29,10,0.7435897435897436,39,21,18,0.5384615384615384,0.6246153846153847,llama3,coral,pdac,PROMPT1_ICL_entailment
174,48,23,10,13,0.4347826086956521,10,10,0,1.0,0.6060606060606061,llama3,coral,pdac,PROMPT1_ICL_entailment
175,49,25,15,10,0.6,10,9,1,0.9,0.7200000000000001,llama3,coral,pdac,PROMPT1_ICL_entailment
176,5,17,11,6,0.6470588235294118,10,8,2,0.8,0.7154471544715447,llama3,coral,pdac,PROMPT1_ICL_entailment
177,50,21,11,10,0.5238095238095238,10,9,1,0.9,0.6622073578595318,llama3,coral,pdac,PROMPT1_ICL_entailment
178,51,26,12,14,0.4615384615384615,12,11,1,0.9166666666666666,0.6139534883720931,llama3,coral,pdac,PROMPT1_ICL_entailment
179,52,24,11,13,0.4583333333333333,10,10,0,1.0,0.6285714285714286,llama3,coral,pdac,PROMPT1_ICL_entailment
180,53,21,12,9,0.5714285714285714,8,7,1,0.875,0.691358024691358,llama3,coral,pdac,PROMPT1_ICL_entailment
181,54,12,3,9,0.25,2,2,0,1.0,0.4,llama3,coral,pdac,PROMPT1_ICL_entailment
182,55,25,17,8,0.68,10,7,3,0.7,0.6898550724637681,llama3,coral,pdac,PROMPT1_ICL_entailment
183,56,21,17,4,0.8095238095238095,8,6,2,0.75,0.7786259541984734,llama3,coral,pdac,PROMPT1_ICL_entailment
184,57,40,30,10,0.75,13,10,3,0.7692307692307693,0.7594936708860761,llama3,coral,pdac,PROMPT1_ICL_entailment
185,58,29,23,6,0.7931034482758621,10,10,0,1.0,0.8846153846153846,llama3,coral,pdac,PROMPT1_ICL_entailment
186,59,30,20,10,0.6666666666666666,21,15,6,0.7142857142857143,0.689655172413793,llama3,coral,pdac,PROMPT1_ICL_entailment
187,6,18,9,9,0.5,12,7,5,0.5833333333333334,0.5384615384615384,llama3,coral,pdac,PROMPT1_ICL_entailment
188,60,36,23,13,0.6388888888888888,13,9,4,0.6923076923076923,0.6645264847512038,llama3,coral,pdac,PROMPT1_ICL_entailment
189,61,20,11,9,0.55,7,7,0,1.0,0.7096774193548387,llama3,coral,pdac,PROMPT1_ICL_entailment
190,62,22,11,11,0.5,11,8,3,0.7272727272727273,0.5925925925925926,llama3,coral,pdac,PROMPT1_ICL_entailment
191,63,20,11,9,0.55,10,7,3,0.7,0.616,llama3,coral,pdac,PROMPT1_ICL_entailment
192,64,25,15,10,0.6,12,11,1,0.9166666666666666,0.7252747252747253,llama3,coral,pdac,PROMPT1_ICL_entailment
193,65,33,23,10,0.696969696969697,9,9,0,1.0,0.8214285714285715,llama3,coral,pdac,PROMPT1_ICL_entailment
194,66,22,13,9,0.5909090909090909,12,7,5,0.5833333333333334,0.5870967741935484,llama3,coral,pdac,PROMPT1_ICL_entailment
195,67,12,4,8,0.3333333333333333,1,1,0,1.0,0.5,llama3,coral,pdac,PROMPT1_ICL_entailment
196,68,25,14,11,0.56,11,9,2,0.8181818181818182,0.6649076517150395,llama3,coral,pdac,PROMPT1_ICL_entailment
197,69,24,15,9,0.625,10,10,0,1.0,0.7692307692307693,llama3,coral,pdac,PROMPT1_ICL_entailment
198,7,23,13,10,0.5652173913043478,11,7,4,0.6363636363636364,0.5986842105263158,llama3,coral,pdac,PROMPT1_ICL_entailment
199,70,23,14,9,0.6086956521739131,15,9,6,0.6,0.6043165467625898,llama3,coral,pdac,PROMPT1_ICL_entailment
200,71,34,16,18,0.4705882352941176,9,9,0,1.0,0.6399999999999999,llama3,coral,pdac,PROMPT1_ICL_entailment
201,72,29,20,9,0.6896551724137931,13,9,4,0.6923076923076923,0.6909788867562381,llama3,coral,pdac,PROMPT1_ICL_entailment
202,73,114,22,92,0.1929824561403508,154,93,61,0.6038961038961039,0.292494639027877,llama3,coral,pdac,PROMPT1_ICL_entailment
203,74,28,14,14,0.5,8,5,3,0.625,0.5555555555555556,llama3,coral,pdac,PROMPT1_ICL_entailment
204,75,28,17,11,0.6071428571428571,7,6,1,0.8571428571428571,0.7108013937282229,llama3,coral,pdac,PROMPT1_ICL_entailment
205,76,18,9,9,0.5,7,6,1,0.8571428571428571,0.631578947368421,llama3,coral,pdac,PROMPT1_ICL_entailment
206,77,28,17,11,0.6071428571428571,8,8,0,1.0,0.7555555555555554,llama3,coral,pdac,PROMPT1_ICL_entailment
207,78,27,15,12,0.5555555555555556,8,7,1,0.875,0.6796116504854369,llama3,coral,pdac,PROMPT1_ICL_entailment
208,79,22,11,11,0.5,11,6,5,0.5454545454545454,0.5217391304347826,llama3,coral,pdac,PROMPT1_ICL_entailment
209,8,19,11,8,0.5789473684210527,2,2,0,1.0,0.7333333333333334,llama3,coral,pdac,PROMPT1_ICL_entailment
210,80,21,16,5,0.7619047619047619,9,6,3,0.6666666666666666,0.7111111111111111,llama3,coral,pdac,PROMPT1_ICL_entailment
211,81,21,11,10,0.5238095238095238,6,5,1,0.8333333333333334,0.6432748538011697,llama3,coral,pdac,PROMPT1_ICL_entailment
212,82,22,21,1,0.9545454545454546,4,4,0,1.0,0.9767441860465116,llama3,coral,pdac,PROMPT1_ICL_entailment
213,83,37,29,8,0.7837837837837838,11,7,4,0.6363636363636364,0.7024221453287197,llama3,coral,pdac,PROMPT1_ICL_entailment
214,84,24,12,12,0.5,11,8,3,0.7272727272727273,0.5925925925925926,llama3,coral,pdac,PROMPT1_ICL_entailment
215,85,37,28,9,0.7567567567567568,35,28,7,0.8,0.7777777777777778,llama3,coral,pdac,PROMPT1_ICL_entailment
216,86,21,12,9,0.5714285714285714,10,9,1,0.9,0.6990291262135921,llama3,coral,pdac,PROMPT1_ICL_entailment
217,87,26,16,10,0.6153846153846154,7,6,1,0.8571428571428571,0.7164179104477612,llama3,coral,pdac,PROMPT1_ICL_entailment
218,88,23,11,12,0.4782608695652174,8,8,0,1.0,0.6470588235294118,llama3,coral,pdac,PROMPT1_ICL_entailment
219,89,23,13,10,0.5652173913043478,10,10,0,1.0,0.7222222222222222,llama3,coral,pdac,PROMPT1_ICL_entailment
220,9,21,12,9,0.5714285714285714,12,8,4,0.6666666666666666,0.6153846153846153,llama3,coral,pdac,PROMPT1_ICL_entailment
221,90,26,12,14,0.4615384615384615,9,8,1,0.8888888888888888,0.6075949367088607,llama3,coral,pdac,PROMPT1_ICL_entailment
222,91,23,13,10,0.5652173913043478,10,10,0,1.0,0.7222222222222222,llama3,coral,pdac,PROMPT1_ICL_entailment
223,92,28,15,13,0.5357142857142857,10,9,1,0.9,0.6716417910447762,llama3,coral,pdac,PROMPT1_ICL_entailment
224,93,23,13,10,0.5652173913043478,9,7,2,0.7777777777777778,0.6546762589928057,llama3,coral,pdac,PROMPT1_ICL_entailment
225,94,21,11,10,0.5238095238095238,7,7,0,1.0,0.6875000000000001,llama3,coral,pdac,PROMPT1_ICL_entailment
226,95,24,14,10,0.5833333333333334,8,3,5,0.375,0.4565217391304347,llama3,coral,pdac,PROMPT1_ICL_entailment
227,96,18,9,9,0.5,4,4,0,1.0,0.6666666666666666,llama3,coral,pdac,PROMPT1_ICL_entailment
228,97,20,9,11,0.45,8,6,2,0.75,0.5625000000000001,llama3,coral,pdac,PROMPT1_ICL_entailment
229,98,24,13,11,0.5416666666666666,9,9,0,1.0,0.7027027027027027,llama3,coral,pdac,PROMPT1_ICL_entailment
230,99,25,16,9,0.64,9,8,1,0.8888888888888888,0.7441860465116279,llama3,coral,pdac,PROMPT1_ICL_entailment
0,0,19,18,1,0.9473684210526316,9,7,2,0.7777777777777778,0.8542372881355932,llama3,coral,pdac,PROMPT2_ICL_entailment
1,1,16,16,0,1.0,9,9,0,1.0,1.0,llama3,coral,pdac,PROMPT2_ICL_entailment
2,10,32,28,4,0.875,11,10,1,0.9090909090909092,0.8917197452229298,llama3,coral,pdac,PROMPT2_ICL_entailment
3,100,20,14,6,0.7,11,11,0,1.0,0.8235294117647058,llama3,coral,pdac,PROMPT2_ICL_entailment
4,101,23,21,2,0.9130434782608696,11,10,1,0.9090909090909092,0.9110629067245118,llama3,coral,pdac,PROMPT2_ICL_entailment
5,102,27,27,0,1.0,27,18,9,0.6666666666666666,0.8,llama3,coral,pdac,PROMPT2_ICL_entailment
6,103,25,20,5,0.8,15,10,5,0.6666666666666666,0.7272727272727272,llama3,coral,pdac,PROMPT2_ICL_entailment
7,104,31,27,4,0.8709677419354839,12,11,1,0.9166666666666666,0.8932330827067669,llama3,coral,pdac,PROMPT2_ICL_entailment
8,105,32,20,12,0.625,33,15,18,0.4545454545454545,0.5263157894736842,llama3,coral,pdac,PROMPT2_ICL_entailment
9,106,15,13,2,0.8666666666666667,10,10,0,1.0,0.9285714285714286,llama3,coral,pdac,PROMPT2_ICL_entailment
10,107,11,11,0,1.0,10,10,0,1.0,1.0,llama3,coral,pdac,PROMPT2_ICL_entailment
11,108,18,18,0,1.0,10,10,0,1.0,1.0,llama3,coral,pdac,PROMPT2_ICL_entailment
12,109,26,24,2,0.9230769230769232,34,29,5,0.8529411764705882,0.8866242038216561,llama3,coral,pdac,PROMPT2_ICL_entailment
13,11,21,19,2,0.9047619047619048,10,8,2,0.8,0.8491620111731844,llama3,coral,pdac,PROMPT2_ICL_entailment
14,110,13,12,1,0.9230769230769232,4,4,0,1.0,0.96,llama3,coral,pdac,PROMPT2_ICL_entailment
15,111,15,15,0,1.0,3,3,0,1.0,1.0,llama3,coral,pdac,PROMPT2_ICL_entailment
16,112,17,16,1,0.9411764705882352,9,7,2,0.7777777777777778,0.8517110266159694,llama3,coral,pdac,PROMPT2_ICL_entailment
17,113,17,12,5,0.7058823529411765,6,6,0,1.0,0.8275862068965517,llama3,coral,pdac,PROMPT2_ICL_entailment
18,114,15,15,0,1.0,9,9,0,1.0,1.0,llama3,coral,pdac,PROMPT2_ICL_entailment
19,115,16,15,1,0.9375,7,7,0,1.0,0.967741935483871,llama3,coral,pdac,PROMPT2_ICL_entailment
20,116,9,7,2,0.7777777777777778,2,2,0,1.0,0.8750000000000001,llama3,coral,pdac,PROMPT2_ICL_entailment
21,117,21,20,1,0.9523809523809524,8,7,1,0.875,0.9120521172638436,llama3,coral,pdac,PROMPT2_ICL_entailment
22,118,21,19,2,0.9047619047619048,9,9,0,1.0,0.95,llama3,coral,pdac,PROMPT2_ICL_entailment
23,119,21,18,3,0.8571428571428571,12,10,2,0.8333333333333334,0.8450704225352113,llama3,coral,pdac,PROMPT2_ICL_entailment
24,12,21,21,0,1.0,10,10,0,1.0,1.0,llama3,coral,pdac,PROMPT2_ICL_entailment
25,120,20,14,6,0.7,13,11,2,0.8461538461538461,0.7661691542288558,llama3,coral,pdac,PROMPT2_ICL_entailment
26,121,22,19,3,0.8636363636363636,12,9,3,0.75,0.8028169014084506,llama3,coral,pdac,PROMPT2_ICL_entailment
27,122,49,43,6,0.8775510204081632,45,30,15,0.6666666666666666,0.7577092511013216,llama3,coral,pdac,PROMPT2_ICL_entailment
28,123,18,17,1,0.9444444444444444,10,9,1,0.9,0.9216867469879516,llama3,coral,pdac,PROMPT2_ICL_entailment
29,124,7,5,2,0.7142857142857143,3,3,0,1.0,0.8333333333333333,llama3,coral,pdac,PROMPT2_ICL_entailment
30,125,19,18,1,0.9473684210526316,8,8,0,1.0,0.972972972972973,llama3,coral,pdac,PROMPT2_ICL_entailment
31,126,18,18,0,1.0,10,9,1,0.9,0.9473684210526316,llama3,coral,pdac,PROMPT2_ICL_entailment
32,127,18,16,2,0.8888888888888888,30,16,14,0.5333333333333333,0.6666666666666667,llama3,coral,pdac,PROMPT2_ICL_entailment
33,128,41,37,4,0.902439024390244,35,12,23,0.3428571428571428,0.4969222160044767,llama3,coral,pdac,PROMPT2_ICL_entailment
34,129,18,14,4,0.7777777777777778,11,11,0,1.0,0.8750000000000001,llama3,coral,pdac,PROMPT2_ICL_entailment
35,13,17,16,1,0.9411764705882352,13,10,3,0.7692307692307693,0.8465608465608465,llama3,coral,pdac,PROMPT2_ICL_entailment
36,130,21,16,5,0.7619047619047619,12,10,2,0.8333333333333334,0.7960199004975124,llama3,coral,pdac,PROMPT2_ICL_entailment
37,131,19,16,3,0.8421052631578947,12,9,3,0.75,0.7933884297520661,llama3,coral,pdac,PROMPT2_ICL_entailment
38,132,14,14,0,1.0,10,8,2,0.8,0.888888888888889,llama3,coral,pdac,PROMPT2_ICL_entailment
39,133,18,16,2,0.8888888888888888,7,6,1,0.8571428571428571,0.8727272727272727,llama3,coral,pdac,PROMPT2_ICL_entailment
40,134,21,21,0,1.0,15,7,8,0.4666666666666667,0.6363636363636364,llama3,coral,pdac,PROMPT2_ICL_entailment
41,135,18,17,1,0.9444444444444444,9,9,0,1.0,0.9714285714285714,llama3,coral,pdac,PROMPT2_ICL_entailment
42,136,27,19,8,0.7037037037037037,7,3,4,0.4285714285714285,0.5327102803738317,llama3,coral,pdac,PROMPT2_ICL_entailment
43,137,15,12,3,0.8,10,9,1,0.9,0.8470588235294118,llama3,coral,pdac,PROMPT2_ICL_entailment
44,138,32,24,8,0.75,25,17,8,0.68,0.7132867132867132,llama3,coral,pdac,PROMPT2_ICL_entailment
45,139,46,30,16,0.6521739130434783,62,42,20,0.6774193548387096,0.6645569620253163,llama3,coral,pdac,PROMPT2_ICL_entailment
46,14,16,16,0,1.0,10,10,0,1.0,1.0,llama3,coral,pdac,PROMPT2_ICL_entailment
47,140,17,12,5,0.7058823529411765,8,7,1,0.875,0.7813953488372093,llama3,coral,pdac,PROMPT2_ICL_entailment
48,141,19,18,1,0.9473684210526316,11,8,3,0.7272727272727273,0.8228571428571427,llama3,coral,pdac,PROMPT2_ICL_entailment
49,142,26,21,5,0.8076923076923077,11,10,1,0.9090909090909092,0.8553971486761711,llama3,coral,pdac,PROMPT2_ICL_entailment
50,143,17,15,2,0.8823529411764706,9,9,0,1.0,0.9375,llama3,coral,pdac,PROMPT2_ICL_entailment
51,144,22,18,4,0.8181818181818182,12,11,1,0.9166666666666666,0.8646288209606987,llama3,coral,pdac,PROMPT2_ICL_entailment
52,145,18,18,0,1.0,10,10,0,1.0,1.0,llama3,coral,pdac,PROMPT2_ICL_entailment
53,146,24,15,9,0.625,7,6,1,0.8571428571428571,0.7228915662650602,llama3,coral,pdac,PROMPT2_ICL_entailment
54,147,16,14,2,0.875,12,11,1,0.9166666666666666,0.8953488372093024,llama3,coral,pdac,PROMPT2_ICL_entailment
55,148,31,26,5,0.8387096774193549,25,15,10,0.6,0.6995515695067264,llama3,coral,pdac,PROMPT2_ICL_entailment
56,149,14,12,2,0.8571428571428571,7,6,1,0.8571428571428571,0.8571428571428571,llama3,coral,pdac,PROMPT2_ICL_entailment
57,15,12,12,0,1.0,10,10,0,1.0,1.0,llama3,coral,pdac,PROMPT2_ICL_entailment
58,150,19,17,2,0.8947368421052632,8,8,0,1.0,0.9444444444444444,llama3,coral,pdac,PROMPT2_ICL_entailment
59,151,21,20,1,0.9523809523809524,10,9,1,0.9,0.9254498714652956,llama3,coral,pdac,PROMPT2_ICL_entailment
60,152,21,20,1,0.9523809523809524,11,8,3,0.7272727272727273,0.8247422680412371,llama3,coral,pdac,PROMPT2_ICL_entailment
61,153,43,17,26,0.3953488372093023,30,19,11,0.6333333333333333,0.4868123587038432,llama3,coral,pdac,PROMPT2_ICL_entailment
62,154,22,18,4,0.8181818181818182,15,12,3,0.8,0.8089887640449439,llama3,coral,pdac,PROMPT2_ICL_entailment
63,155,38,36,2,0.9473684210526316,47,31,16,0.6595744680851063,0.7777003484320557,llama3,coral,pdac,PROMPT2_ICL_entailment
64,156,19,17,2,0.8947368421052632,10,10,0,1.0,0.9444444444444444,llama3,coral,pdac,PROMPT2_ICL_entailment
65,157,23,23,0,1.0,14,10,4,0.7142857142857143,0.8333333333333333,llama3,coral,pdac,PROMPT2_ICL_entailment
66,158,14,12,2,0.8571428571428571,10,8,2,0.8,0.8275862068965518,llama3,coral,pdac,PROMPT2_ICL_entailment
67,159,19,18,1,0.9473684210526316,4,4,0,1.0,0.972972972972973,llama3,coral,pdac,PROMPT2_ICL_entailment
68,16,26,25,1,0.9615384615384616,31,25,6,0.8064516129032258,0.8771929824561403,llama3,coral,pdac,PROMPT2_ICL_entailment
69,160,12,11,1,0.9166666666666666,9,8,1,0.8888888888888888,0.9025641025641026,llama3,coral,pdac,PROMPT2_ICL_entailment
70,161,18,18,0,1.0,9,8,1,0.8888888888888888,0.9411764705882352,llama3,coral,pdac,PROMPT2_ICL_entailment
71,162,15,15,0,1.0,10,9,1,0.9,0.9473684210526316,llama3,coral,pdac,PROMPT2_ICL_entailment
72,163,20,17,3,0.85,13,11,2,0.8461538461538461,0.8480725623582767,llama3,coral,pdac,PROMPT2_ICL_entailment
73,164,33,27,6,0.8181818181818182,36,23,13,0.6388888888888888,0.7175043327556325,llama3,coral,pdac,PROMPT2_ICL_entailment
74,165,27,22,5,0.8148148148148148,10,7,3,0.7,0.7530562347188264,llama3,coral,pdac,PROMPT2_ICL_entailment
75,166,21,18,3,0.8571428571428571,11,7,4,0.6363636363636364,0.7304347826086957,llama3,coral,pdac,PROMPT2_ICL_entailment
76,167,21,18,3,0.8571428571428571,8,6,2,0.75,0.7999999999999999,llama3,coral,pdac,PROMPT2_ICL_entailment
77,168,14,12,2,0.8571428571428571,6,6,0,1.0,0.923076923076923,llama3,coral,pdac,PROMPT2_ICL_entailment
78,169,14,14,0,1.0,7,7,0,1.0,1.0,llama3,coral,pdac,PROMPT2_ICL_entailment
79,17,14,13,1,0.9285714285714286,5,5,0,1.0,0.962962962962963,llama3,coral,pdac,PROMPT2_ICL_entailment
80,170,24,19,5,0.7916666666666666,16,12,4,0.75,0.7702702702702704,llama3,coral,pdac,PROMPT2_ICL_entailment
81,171,23,15,8,0.6521739130434783,13,12,1,0.9230769230769232,0.7643312101910829,llama3,coral,pdac,PROMPT2_ICL_entailment
82,172,22,17,5,0.7727272727272727,10,9,1,0.9,0.8315217391304347,llama3,coral,pdac,PROMPT2_ICL_entailment
83,173,28,23,5,0.8214285714285714,22,13,9,0.5909090909090909,0.6873563218390804,llama3,coral,pdac,PROMPT2_ICL_entailment
84,174,34,30,4,0.8823529411764706,11,9,2,0.8181818181818182,0.8490566037735848,llama3,coral,pdac,PROMPT2_ICL_entailment
85,175,47,20,27,0.425531914893617,28,14,14,0.5,0.4597701149425288,llama3,coral,pdac,PROMPT2_ICL_entailment
86,176,15,14,1,0.9333333333333332,10,10,0,1.0,0.9655172413793104,llama3,coral,pdac,PROMPT2_ICL_entailment
87,177,16,16,0,1.0,10,10,0,1.0,1.0,llama3,coral,pdac,PROMPT2_ICL_entailment
88,178,42,29,13,0.6904761904761905,36,21,15,0.5833333333333334,0.6323987538940811,llama3,coral,pdac,PROMPT2_ICL_entailment
89,179,11,11,0,1.0,9,5,4,0.5555555555555556,0.7142857142857143,llama3,coral,pdac,PROMPT2_ICL_entailment
90,18,20,20,0,1.0,15,9,6,0.6,0.7499999999999999,llama3,coral,pdac,PROMPT2_ICL_entailment
91,180,13,13,0,1.0,5,5,0,1.0,1.0,llama3,coral,pdac,PROMPT2_ICL_entailment
92,181,15,14,1,0.9333333333333332,10,7,3,0.7,0.8,llama3,coral,pdac,PROMPT2_ICL_entailment
93,182,21,20,1,0.9523809523809524,8,8,0,1.0,0.975609756097561,llama3,coral,pdac,PROMPT2_ICL_entailment
94,183,17,13,4,0.7647058823529411,10,8,2,0.8,0.7819548872180452,llama3,coral,pdac,PROMPT2_ICL_entailment
95,184,15,9,6,0.6,9,8,1,0.8888888888888888,0.7164179104477612,llama3,coral,pdac,PROMPT2_ICL_entailment
96,185,18,16,2,0.8888888888888888,22,14,8,0.6363636363636364,0.7417218543046358,llama3,coral,pdac,PROMPT2_ICL_entailment
97,186,28,25,3,0.8928571428571429,32,11,21,0.34375,0.4963898916967509,llama3,coral,pdac,PROMPT2_ICL_entailment
98,187,58,38,20,0.6551724137931034,34,21,13,0.6176470588235294,0.6358565737051793,llama3,coral,pdac,PROMPT2_ICL_entailment
99,188,19,19,0,1.0,8,7,1,0.875,0.9333333333333332,llama3,coral,pdac,PROMPT2_ICL_entailment
100,189,21,16,5,0.7619047619047619,5,5,0,1.0,0.8648648648648648,llama3,coral,pdac,PROMPT2_ICL_entailment
101,19,29,23,6,0.7931034482758621,21,14,7,0.6666666666666666,0.7244094488188977,llama3,coral,pdac,PROMPT2_ICL_entailment
102,190,33,30,3,0.9090909090909092,17,11,6,0.6470588235294118,0.7560137457044673,llama3,coral,pdac,PROMPT2_ICL_entailment
103,191,22,18,4,0.8181818181818182,15,8,7,0.5333333333333333,0.6457399103139013,llama3,coral,pdac,PROMPT2_ICL_entailment
104,192,40,34,6,0.85,12,9,3,0.75,0.7968749999999999,llama3,coral,pdac,PROMPT2_ICL_entailment
105,193,20,18,2,0.9,10,8,2,0.8,0.8470588235294118,llama3,coral,pdac,PROMPT2_ICL_entailment
106,194,17,15,2,0.8823529411764706,11,10,1,0.9090909090909092,0.8955223880597014,llama3,coral,pdac,PROMPT2_ICL_entailment
107,195,19,17,2,0.8947368421052632,7,6,1,0.8571428571428571,0.8755364806866952,llama3,coral,pdac,PROMPT2_ICL_entailment
108,196,20,14,6,0.7,8,8,0,1.0,0.8235294117647058,llama3,coral,pdac,PROMPT2_ICL_entailment
109,197,16,16,0,1.0,9,6,3,0.6666666666666666,0.8,llama3,coral,pdac,PROMPT2_ICL_entailment
110,198,16,12,4,0.75,12,9,3,0.75,0.75,llama3,coral,pdac,PROMPT2_ICL_entailment
111,199,23,22,1,0.9565217391304348,9,7,2,0.7777777777777778,0.8579387186629527,llama3,coral,pdac,PROMPT2_ICL_entailment
112,2,29,27,2,0.9310344827586208,14,14,0,1.0,0.9642857142857144,llama3,coral,pdac,PROMPT2_ICL_entailment
113,20,31,18,13,0.5806451612903226,18,14,4,0.7777777777777778,0.6649076517150396,llama3,coral,pdac,PROMPT2_ICL_entailment
114,200,33,29,4,0.8787878787878788,16,13,3,0.8125,0.8443449048152295,llama3,coral,pdac,PROMPT2_ICL_entailment
115,201,12,12,0,1.0,10,10,0,1.0,1.0,llama3,coral,pdac,PROMPT2_ICL_entailment
116,202,16,16,0,1.0,10,10,0,1.0,1.0,llama3,coral,pdac,PROMPT2_ICL_entailment
117,203,31,28,3,0.9032258064516128,31,24,7,0.7741935483870968,0.8337468982630273,llama3,coral,pdac,PROMPT2_ICL_entailment
118,204,31,27,4,0.8709677419354839,14,9,5,0.6428571428571429,0.7397260273972603,llama3,coral,pdac,PROMPT2_ICL_entailment
119,205,27,20,7,0.7407407407407407,7,6,1,0.8571428571428571,0.794701986754967,llama3,coral,pdac,PROMPT2_ICL_entailment
120,206,16,14,2,0.875,9,8,1,0.8888888888888888,0.8818897637795274,llama3,coral,pdac,PROMPT2_ICL_entailment
121,207,22,19,3,0.8636363636363636,8,7,1,0.875,0.869281045751634,llama3,coral,pdac,PROMPT2_ICL_entailment
122,208,17,15,2,0.8823529411764706,8,8,0,1.0,0.9375,llama3,coral,pdac,PROMPT2_ICL_entailment
123,209,16,16,0,1.0,9,9,0,1.0,1.0,llama3,coral,pdac,PROMPT2_ICL_entailment
124,21,11,11,0,1.0,10,10,0,1.0,1.0,llama3,coral,pdac,PROMPT2_ICL_entailment
125,210,15,14,1,0.9333333333333332,9,8,1,0.8888888888888888,0.9105691056910568,llama3,coral,pdac,PROMPT2_ICL_entailment
126,211,21,20,1,0.9523809523809524,8,6,2,0.75,0.8391608391608391,llama3,coral,pdac,PROMPT2_ICL_entailment
127,212,17,15,2,0.8823529411764706,17,17,0,1.0,0.9375,llama3,coral,pdac,PROMPT2_ICL_entailment
128,213,24,23,1,0.9583333333333334,11,7,4,0.6363636363636364,0.7648456057007126,llama3,coral,pdac,PROMPT2_ICL_entailment
129,214,25,20,5,0.8,18,10,8,0.5555555555555556,0.6557377049180328,llama3,coral,pdac,PROMPT2_ICL_entailment
130,215,19,7,12,0.3684210526315789,12,7,5,0.5833333333333334,0.4516129032258065,llama3,coral,pdac,PROMPT2_ICL_entailment
131,216,29,24,5,0.8275862068965517,33,27,6,0.8181818181818182,0.8228571428571428,llama3,coral,pdac,PROMPT2_ICL_entailment
132,217,29,28,1,0.9655172413793104,19,16,3,0.8421052631578947,0.8995983935742972,llama3,coral,pdac,PROMPT2_ICL_entailment
133,218,29,27,2,0.9310344827586208,11,9,2,0.8181818181818182,0.8709677419354839,llama3,coral,pdac,PROMPT2_ICL_entailment
134,219,20,18,2,0.9,8,7,1,0.875,0.8873239436619719,llama3,coral,pdac,PROMPT2_ICL_entailment
135,22,30,27,3,0.9,17,16,1,0.9411764705882352,0.9201277955271564,llama3,coral,pdac,PROMPT2_ICL_entailment
136,220,35,28,7,0.8,11,10,1,0.9090909090909092,0.8510638297872342,llama3,coral,pdac,PROMPT2_ICL_entailment
137,221,17,15,2,0.8823529411764706,12,9,3,0.75,0.8108108108108107,llama3,coral,pdac,PROMPT2_ICL_entailment
138,222,26,19,7,0.7307692307692307,11,10,1,0.9090909090909092,0.8102345415778252,llama3,coral,pdac,PROMPT2_ICL_entailment
139,223,45,43,2,0.9555555555555556,37,33,4,0.8918918918918919,0.9226267880364112,llama3,coral,pdac,PROMPT2_ICL_entailment
140,224,28,19,9,0.6785714285714286,8,8,0,1.0,0.8085106382978724,llama3,coral,pdac,PROMPT2_ICL_entailment
141,225,17,16,1,0.9411764705882352,13,8,5,0.6153846153846154,0.744186046511628,llama3,coral,pdac,PROMPT2_ICL_entailment
142,226,25,23,2,0.92,11,10,1,0.9090909090909092,0.9145129224652088,llama3,coral,pdac,PROMPT2_ICL_entailment
143,227,20,15,5,0.75,10,8,2,0.8,0.7741935483870969,llama3,coral,pdac,PROMPT2_ICL_entailment
144,228,19,16,3,0.8421052631578947,9,9,0,1.0,0.9142857142857144,llama3,coral,pdac,PROMPT2_ICL_entailment
145,229,23,20,3,0.8695652173913043,9,6,3,0.6666666666666666,0.7547169811320754,llama3,coral,pdac,PROMPT2_ICL_entailment
146,23,23,21,2,0.9130434782608696,12,10,2,0.8333333333333334,0.871369294605809,llama3,coral,pdac,PROMPT2_ICL_entailment
147,230,16,15,1,0.9375,8,8,0,1.0,0.967741935483871,llama3,coral,pdac,PROMPT2_ICL_entailment
148,24,18,17,1,0.9444444444444444,9,8,1,0.8888888888888888,0.9158249158249158,llama3,coral,pdac,PROMPT2_ICL_entailment
149,25,17,14,3,0.8235294117647058,11,10,1,0.9090909090909092,0.8641975308641976,llama3,coral,pdac,PROMPT2_ICL_entailment
150,26,16,16,0,1.0,11,11,0,1.0,1.0,llama3,coral,pdac,PROMPT2_ICL_entailment
151,27,17,14,3,0.8235294117647058,12,11,1,0.9166666666666666,0.8676056338028169,llama3,coral,pdac,PROMPT2_ICL_entailment
152,28,25,25,0,1.0,13,12,1,0.9230769230769232,0.96,llama3,coral,pdac,PROMPT2_ICL_entailment
153,29,31,27,4,0.8709677419354839,9,7,2,0.7777777777777778,0.8217391304347826,llama3,coral,pdac,PROMPT2_ICL_entailment
154,3,18,15,3,0.8333333333333334,8,7,1,0.875,0.8536585365853658,llama3,coral,pdac,PROMPT2_ICL_entailment
155,30,30,22,8,0.7333333333333333,11,10,1,0.9090909090909092,0.8118081180811808,llama3,coral,pdac,PROMPT2_ICL_entailment
156,31,36,31,5,0.8611111111111112,11,10,1,0.9090909090909092,0.884450784593438,llama3,coral,pdac,PROMPT2_ICL_entailment
157,32,30,28,2,0.9333333333333332,11,8,3,0.7272727272727273,0.8175182481751825,llama3,coral,pdac,PROMPT2_ICL_entailment
158,33,30,7,23,0.2333333333333333,24,13,11,0.5416666666666666,0.3261648745519713,llama3,coral,pdac,PROMPT2_ICL_entailment
159,34,11,11,0,1.0,10,10,0,1.0,1.0,llama3,coral,pdac,PROMPT2_ICL_entailment
160,35,17,17,0,1.0,10,10,0,1.0,1.0,llama3,coral,pdac,PROMPT2_ICL_entailment
161,36,35,33,2,0.9428571428571428,44,37,7,0.8409090909090909,0.8889697852202402,llama3,coral,pdac,PROMPT2_ICL_entailment
162,37,29,25,4,0.8620689655172413,9,8,1,0.8888888888888888,0.87527352297593,llama3,coral,pdac,PROMPT2_ICL_entailment
163,38,28,26,2,0.9285714285714286,13,10,3,0.7692307692307693,0.8414239482200646,llama3,coral,pdac,PROMPT2_ICL_entailment
164,39,22,19,3,0.8636363636363636,10,9,1,0.9,0.8814432989690723,llama3,coral,pdac,PROMPT2_ICL_entailment
165,4,31,25,6,0.8064516129032258,15,11,4,0.7333333333333333,0.7681564245810056,llama3,coral,pdac,PROMPT2_ICL_entailment
166,40,23,15,8,0.6521739130434783,10,8,2,0.8,0.718562874251497,llama3,coral,pdac,PROMPT2_ICL_entailment
167,41,25,20,5,0.8,8,6,2,0.75,0.7741935483870969,llama3,coral,pdac,PROMPT2_ICL_entailment
168,42,33,27,6,0.8181818181818182,11,8,3,0.7272727272727273,0.770053475935829,llama3,coral,pdac,PROMPT2_ICL_entailment
169,43,25,23,2,0.92,13,8,5,0.6153846153846154,0.7374749498997997,llama3,coral,pdac,PROMPT2_ICL_entailment
170,44,21,20,1,0.9523809523809524,11,9,2,0.8181818181818182,0.880195599022005,llama3,coral,pdac,PROMPT2_ICL_entailment
171,45,25,24,1,0.96,10,9,1,0.9,0.9290322580645162,llama3,coral,pdac,PROMPT2_ICL_entailment
172,46,25,15,10,0.6,11,10,1,0.9090909090909092,0.7228915662650602,llama3,coral,pdac,PROMPT2_ICL_entailment
173,47,31,28,3,0.9032258064516128,39,20,19,0.5128205128205128,0.6542056074766354,llama3,coral,pdac,PROMPT2_ICL_entailment
174,48,18,8,10,0.4444444444444444,10,8,2,0.8,0.5714285714285714,llama3,coral,pdac,PROMPT2_ICL_entailment
175,49,20,18,2,0.9,10,8,2,0.8,0.8470588235294118,llama3,coral,pdac,PROMPT2_ICL_entailment
176,5,15,13,2,0.8666666666666667,10,8,2,0.8,0.832,llama3,coral,pdac,PROMPT2_ICL_entailment
177,50,21,19,2,0.9047619047619048,10,9,1,0.9,0.9023746701846964,llama3,coral,pdac,PROMPT2_ICL_entailment
178,51,17,13,4,0.7647058823529411,12,10,2,0.8333333333333334,0.7975460122699386,llama3,coral,pdac,PROMPT2_ICL_entailment
179,52,24,17,7,0.7083333333333334,10,10,0,1.0,0.8292682926829268,llama3,coral,pdac,PROMPT2_ICL_entailment
180,53,18,16,2,0.8888888888888888,8,7,1,0.875,0.8818897637795274,llama3,coral,pdac,PROMPT2_ICL_entailment
181,54,8,6,2,0.75,2,2,0,1.0,0.8571428571428571,llama3,coral,pdac,PROMPT2_ICL_entailment
182,55,22,22,0,1.0,10,7,3,0.7,0.8235294117647058,llama3,coral,pdac,PROMPT2_ICL_entailment
183,56,20,17,3,0.85,8,7,1,0.875,0.8623188405797101,llama3,coral,pdac,PROMPT2_ICL_entailment
184,57,38,29,9,0.7631578947368421,13,9,4,0.6923076923076923,0.7260083449235049,llama3,coral,pdac,PROMPT2_ICL_entailment
185,58,36,34,2,0.9444444444444444,10,10,0,1.0,0.9714285714285714,llama3,coral,pdac,PROMPT2_ICL_entailment
186,59,25,18,7,0.72,21,15,6,0.7142857142857143,0.7171314741035857,llama3,coral,pdac,PROMPT2_ICL_entailment
187,6,21,19,2,0.9047619047619048,12,11,1,0.9166666666666666,0.9106753812636164,llama3,coral,pdac,PROMPT2_ICL_entailment
188,60,35,32,3,0.9142857142857144,13,11,2,0.8461538461538461,0.8789013732833957,llama3,coral,pdac,PROMPT2_ICL_entailment
189,61,17,15,2,0.8823529411764706,7,7,0,1.0,0.9375,llama3,coral,pdac,PROMPT2_ICL_entailment
190,62,28,22,6,0.7857142857142857,11,10,1,0.9090909090909092,0.842911877394636,llama3,coral,pdac,PROMPT2_ICL_entailment
191,63,13,13,0,1.0,10,10,0,1.0,1.0,llama3,coral,pdac,PROMPT2_ICL_entailment
192,64,25,25,0,1.0,12,12,0,1.0,1.0,llama3,coral,pdac,PROMPT2_ICL_entailment
193,65,21,21,0,1.0,9,9,0,1.0,1.0,llama3,coral,pdac,PROMPT2_ICL_entailment
194,66,18,15,3,0.8333333333333334,12,6,6,0.5,0.625,llama3,coral,pdac,PROMPT2_ICL_entailment
195,67,6,6,0,1.0,1,1,0,1.0,1.0,llama3,coral,pdac,PROMPT2_ICL_entailment
196,68,19,16,3,0.8421052631578947,11,10,1,0.9090909090909092,0.8743169398907102,llama3,coral,pdac,PROMPT2_ICL_entailment
197,69,22,21,1,0.9545454545454546,10,10,0,1.0,0.9767441860465116,llama3,coral,pdac,PROMPT2_ICL_entailment
198,7,15,13,2,0.8666666666666667,11,11,0,1.0,0.9285714285714286,llama3,coral,pdac,PROMPT2_ICL_entailment
199,70,23,21,2,0.9130434782608696,15,15,0,1.0,0.9545454545454544,llama3,coral,pdac,PROMPT2_ICL_entailment
200,71,34,31,3,0.9117647058823528,9,9,0,1.0,0.953846153846154,llama3,coral,pdac,PROMPT2_ICL_entailment
201,72,27,18,9,0.6666666666666666,13,8,5,0.6153846153846154,0.64,llama3,coral,pdac,PROMPT2_ICL_entailment
202,73,45,17,28,0.3777777777777777,154,35,119,0.2272727272727272,0.2838063439065108,llama3,coral,pdac,PROMPT2_ICL_entailment
203,74,22,15,7,0.6818181818181818,8,8,0,1.0,0.8108108108108109,llama3,coral,pdac,PROMPT2_ICL_entailment
204,75,24,22,2,0.9166666666666666,7,7,0,1.0,0.9565217391304348,llama3,coral,pdac,PROMPT2_ICL_entailment
205,76,15,14,1,0.9333333333333332,7,6,1,0.8571428571428571,0.8936170212765957,llama3,coral,pdac,PROMPT2_ICL_entailment
206,77,25,25,0,1.0,8,7,1,0.875,0.9333333333333332,llama3,coral,pdac,PROMPT2_ICL_entailment
207,78,19,15,4,0.7894736842105263,8,7,1,0.875,0.8300395256916996,llama3,coral,pdac,PROMPT2_ICL_entailment
208,79,26,23,3,0.8846153846153846,11,11,0,1.0,0.9387755102040816,llama3,coral,pdac,PROMPT2_ICL_entailment
209,8,13,13,0,1.0,2,2,0,1.0,1.0,llama3,coral,pdac,PROMPT2_ICL_entailment
210,80,23,23,0,1.0,9,8,1,0.8888888888888888,0.9411764705882352,llama3,coral,pdac,PROMPT2_ICL_entailment
211,81,13,12,1,0.9230769230769232,6,5,1,0.8333333333333334,0.8759124087591241,llama3,coral,pdac,PROMPT2_ICL_entailment
212,82,25,25,0,1.0,4,4,0,1.0,1.0,llama3,coral,pdac,PROMPT2_ICL_entailment
213,83,25,23,2,0.92,11,5,6,0.4545454545454545,0.6084656084656085,llama3,coral,pdac,PROMPT2_ICL_entailment
214,84,25,19,6,0.76,11,10,1,0.9090909090909092,0.8278867102396515,llama3,coral,pdac,PROMPT2_ICL_entailment
215,85,34,26,8,0.7647058823529411,35,26,9,0.7428571428571429,0.7536231884057971,llama3,coral,pdac,PROMPT2_ICL_entailment
216,86,17,12,5,0.7058823529411765,10,10,0,1.0,0.8275862068965517,llama3,coral,pdac,PROMPT2_ICL_entailment
217,87,18,14,4,0.7777777777777778,7,6,1,0.8571428571428571,0.8155339805825242,llama3,coral,pdac,PROMPT2_ICL_entailment
218,88,21,19,2,0.9047619047619048,8,7,1,0.875,0.8896321070234113,llama3,coral,pdac,PROMPT2_ICL_entailment
219,89,21,16,5,0.7619047619047619,10,8,2,0.8,0.7804878048780488,llama3,coral,pdac,PROMPT2_ICL_entailment
220,9,20,20,0,1.0,12,8,4,0.6666666666666666,0.8,llama3,coral,pdac,PROMPT2_ICL_entailment
221,90,29,22,7,0.7586206896551724,9,8,1,0.8888888888888888,0.8186046511627907,llama3,coral,pdac,PROMPT2_ICL_entailment
222,91,15,14,1,0.9333333333333332,10,10,0,1.0,0.9655172413793104,llama3,coral,pdac,PROMPT2_ICL_entailment
223,92,25,21,4,0.84,10,10,0,1.0,0.9130434782608696,llama3,coral,pdac,PROMPT2_ICL_entailment
224,93,26,25,1,0.9615384615384616,9,6,3,0.6666666666666666,0.7874015748031495,llama3,coral,pdac,PROMPT2_ICL_entailment
225,94,19,16,3,0.8421052631578947,7,5,2,0.7142857142857143,0.7729468599033815,llama3,coral,pdac,PROMPT2_ICL_entailment
226,95,22,19,3,0.8636363636363636,8,5,3,0.625,0.7251908396946565,llama3,coral,pdac,PROMPT2_ICL_entailment
227,96,14,14,0,1.0,4,4,0,1.0,1.0,llama3,coral,pdac,PROMPT2_ICL_entailment
228,97,15,13,2,0.8666666666666667,8,7,1,0.875,0.8708133971291866,llama3,coral,pdac,PROMPT2_ICL_entailment
229,98,26,23,3,0.8846153846153846,9,9,0,1.0,0.9387755102040816,llama3,coral,pdac,PROMPT2_ICL_entailment
230,99,23,22,1,0.9565217391304348,9,8,1,0.8888888888888888,0.9214659685863874,llama3,coral,pdac,PROMPT2_ICL_entailment
0,0,15,14,1,0.9333333333333332,9,8,1,0.8888888888888888,0.9105691056910568,llama3,coral,pdac,PROMPT2_entailment
1,1,14,14,0,1.0,9,9,0,1.0,1.0,llama3,coral,pdac,PROMPT2_entailment
2,10,19,16,3,0.8421052631578947,11,10,1,0.9090909090909092,0.8743169398907102,llama3,coral,pdac,PROMPT2_entailment
3,100,20,13,7,0.65,11,11,0,1.0,0.787878787878788,llama3,coral,pdac,PROMPT2_entailment
4,101,23,23,0,1.0,11,10,1,0.9090909090909092,0.9523809523809524,llama3,coral,pdac,PROMPT2_entailment
5,102,22,19,3,0.8636363636363636,27,18,9,0.6666666666666666,0.7524752475247524,llama3,coral,pdac,PROMPT2_entailment
6,103,11,10,1,0.9090909090909092,15,11,4,0.7333333333333333,0.8118081180811808,llama3,coral,pdac,PROMPT2_entailment
7,104,13,12,1,0.9230769230769232,12,11,1,0.9166666666666666,0.9198606271777002,llama3,coral,pdac,PROMPT2_entailment
8,105,29,19,10,0.6551724137931034,33,17,16,0.5151515151515151,0.5767857142857142,llama3,coral,pdac,PROMPT2_entailment
9,106,15,12,3,0.8,10,10,0,1.0,0.888888888888889,llama3,coral,pdac,PROMPT2_entailment
10,107,11,11,0,1.0,10,10,0,1.0,1.0,llama3,coral,pdac,PROMPT2_entailment
11,108,18,18,0,1.0,10,10,0,1.0,1.0,llama3,coral,pdac,PROMPT2_entailment
12,109,24,19,5,0.7916666666666666,34,30,4,0.8823529411764706,0.8345534407027819,llama3,coral,pdac,PROMPT2_entailment
13,11,20,17,3,0.85,10,8,2,0.8,0.8242424242424243,llama3,coral,pdac,PROMPT2_entailment
14,110,12,12,0,1.0,4,4,0,1.0,1.0,llama3,coral,pdac,PROMPT2_entailment
15,111,11,11,0,1.0,3,3,0,1.0,1.0,llama3,coral,pdac,PROMPT2_entailment
16,112,14,12,2,0.8571428571428571,9,9,0,1.0,0.923076923076923,llama3,coral,pdac,PROMPT2_entailment
17,113,15,14,1,0.9333333333333332,6,6,0,1.0,0.9655172413793104,llama3,coral,pdac,PROMPT2_entailment
18,114,12,12,0,1.0,9,9,0,1.0,1.0,llama3,coral,pdac,PROMPT2_entailment
19,115,14,14,0,1.0,7,7,0,1.0,1.0,llama3,coral,pdac,PROMPT2_entailment
20,116,9,7,2,0.7777777777777778,2,2,0,1.0,0.8750000000000001,llama3,coral,pdac,PROMPT2_entailment
21,117,21,18,3,0.8571428571428571,8,6,2,0.75,0.7999999999999999,llama3,coral,pdac,PROMPT2_entailment
22,118,16,16,0,1.0,9,8,1,0.8888888888888888,0.9411764705882352,llama3,coral,pdac,PROMPT2_entailment
23,119,18,15,3,0.8333333333333334,12,10,2,0.8333333333333334,0.8333333333333334,llama3,coral,pdac,PROMPT2_entailment
24,12,22,18,4,0.8181818181818182,10,9,1,0.9,0.8571428571428572,llama3,coral,pdac,PROMPT2_entailment
25,120,16,13,3,0.8125,13,10,3,0.7692307692307693,0.790273556231003,llama3,coral,pdac,PROMPT2_entailment
26,121,18,16,2,0.8888888888888888,12,11,1,0.9166666666666666,0.9025641025641026,llama3,coral,pdac,PROMPT2_entailment
27,122,46,36,10,0.782608695652174,45,29,16,0.6444444444444445,0.7068381855111714,llama3,coral,pdac,PROMPT2_entailment
28,123,15,15,0,1.0,10,8,2,0.8,0.888888888888889,llama3,coral,pdac,PROMPT2_entailment
29,124,5,5,0,1.0,3,3,0,1.0,1.0,llama3,coral,pdac,PROMPT2_entailment
30,125,15,14,1,0.9333333333333332,8,8,0,1.0,0.9655172413793104,llama3,coral,pdac,PROMPT2_entailment
31,126,15,14,1,0.9333333333333332,10,9,1,0.9,0.9163636363636364,llama3,coral,pdac,PROMPT2_entailment
32,127,31,26,5,0.8387096774193549,30,16,14,0.5333333333333333,0.6520376175548589,llama3,coral,pdac,PROMPT2_entailment
33,128,25,22,3,0.88,35,33,2,0.9428571428571428,0.9103448275862068,llama3,coral,pdac,PROMPT2_entailment
34,129,16,14,2,0.875,11,9,2,0.8181818181818182,0.8456375838926175,llama3,coral,pdac,PROMPT2_entailment
35,13,17,16,1,0.9411764705882352,13,8,5,0.6153846153846154,0.744186046511628,llama3,coral,pdac,PROMPT2_entailment
36,130,19,16,3,0.8421052631578947,12,9,3,0.75,0.7933884297520661,llama3,coral,pdac,PROMPT2_entailment
37,131,18,15,3,0.8333333333333334,12,8,4,0.6666666666666666,0.7407407407407408,llama3,coral,pdac,PROMPT2_entailment
38,132,14,14,0,1.0,10,8,2,0.8,0.888888888888889,llama3,coral,pdac,PROMPT2_entailment
39,133,13,13,0,1.0,7,6,1,0.8571428571428571,0.923076923076923,llama3,coral,pdac,PROMPT2_entailment
40,134,17,17,0,1.0,15,7,8,0.4666666666666667,0.6363636363636364,llama3,coral,pdac,PROMPT2_entailment
41,135,18,17,1,0.9444444444444444,9,9,0,1.0,0.9714285714285714,llama3,coral,pdac,PROMPT2_entailment
42,136,21,16,5,0.7619047619047619,7,6,1,0.8571428571428571,0.8067226890756302,llama3,coral,pdac,PROMPT2_entailment
43,137,13,13,0,1.0,10,8,2,0.8,0.888888888888889,llama3,coral,pdac,PROMPT2_entailment
44,138,25,18,7,0.72,25,17,8,0.68,0.6994285714285715,llama3,coral,pdac,PROMPT2_entailment
45,139,22,17,5,0.7727272727272727,62,29,33,0.4677419354838709,0.5827423167848699,llama3,coral,pdac,PROMPT2_entailment
46,14,14,14,0,1.0,10,10,0,1.0,1.0,llama3,coral,pdac,PROMPT2_entailment
47,140,15,12,3,0.8,8,8,0,1.0,0.888888888888889,llama3,coral,pdac,PROMPT2_entailment
48,141,14,12,2,0.8571428571428571,11,8,3,0.7272727272727273,0.7868852459016394,llama3,coral,pdac,PROMPT2_entailment
49,142,13,12,1,0.9230769230769232,11,10,1,0.9090909090909092,0.9160305343511452,llama3,coral,pdac,PROMPT2_entailment
50,143,15,12,3,0.8,9,8,1,0.8888888888888888,0.8421052631578948,llama3,coral,pdac,PROMPT2_entailment
51,144,15,9,6,0.6,12,9,3,0.75,0.6666666666666665,llama3,coral,pdac,PROMPT2_entailment
52,145,13,13,0,1.0,10,10,0,1.0,1.0,llama3,coral,pdac,PROMPT2_entailment
53,146,9,6,3,0.6666666666666666,7,5,2,0.7142857142857143,0.689655172413793,llama3,coral,pdac,PROMPT2_entailment
54,147,16,16,0,1.0,12,11,1,0.9166666666666666,0.9565217391304348,llama3,coral,pdac,PROMPT2_entailment
55,148,21,17,4,0.8095238095238095,25,16,9,0.64,0.7148488830486204,llama3,coral,pdac,PROMPT2_entailment
56,149,8,8,0,1.0,7,5,2,0.7142857142857143,0.8333333333333333,llama3,coral,pdac,PROMPT2_entailment
57,15,12,12,0,1.0,10,10,0,1.0,1.0,llama3,coral,pdac,PROMPT2_entailment
58,150,16,15,1,0.9375,8,7,1,0.875,0.9051724137931034,llama3,coral,pdac,PROMPT2_entailment
59,151,15,15,0,1.0,10,10,0,1.0,1.0,llama3,coral,pdac,PROMPT2_entailment
60,152,13,13,0,1.0,11,10,1,0.9090909090909092,0.9523809523809524,llama3,coral,pdac,PROMPT2_entailment
61,153,45,17,28,0.3777777777777777,30,18,12,0.6,0.4636363636363636,llama3,coral,pdac,PROMPT2_entailment
62,154,22,18,4,0.8181818181818182,15,11,4,0.7333333333333333,0.7734375,llama3,coral,pdac,PROMPT2_entailment
63,155,41,39,2,0.951219512195122,47,37,10,0.7872340425531915,0.8614925373134329,llama3,coral,pdac,PROMPT2_entailment
64,156,14,14,0,1.0,10,6,4,0.6,0.7499999999999999,llama3,coral,pdac,PROMPT2_entailment
65,157,15,13,2,0.8666666666666667,14,11,3,0.7857142857142857,0.8242074927953891,llama3,coral,pdac,PROMPT2_entailment
66,158,12,10,2,0.8333333333333334,10,9,1,0.9,0.8653846153846153,llama3,coral,pdac,PROMPT2_entailment
67,159,14,14,0,1.0,4,4,0,1.0,1.0,llama3,coral,pdac,PROMPT2_entailment
68,16,29,26,3,0.896551724137931,31,23,8,0.7419354838709677,0.811948404616429,llama3,coral,pdac,PROMPT2_entailment
69,160,12,10,2,0.8333333333333334,9,8,1,0.8888888888888888,0.8602150537634408,llama3,coral,pdac,PROMPT2_entailment
70,161,15,14,1,0.9333333333333332,9,8,1,0.8888888888888888,0.9105691056910568,llama3,coral,pdac,PROMPT2_entailment
71,162,11,10,1,0.9090909090909092,10,10,0,1.0,0.9523809523809524,llama3,coral,pdac,PROMPT2_entailment
72,163,16,13,3,0.8125,13,11,2,0.8461538461538461,0.8289855072463768,llama3,coral,pdac,PROMPT2_entailment
73,164,20,17,3,0.85,36,23,13,0.6388888888888888,0.7294776119402985,llama3,coral,pdac,PROMPT2_entailment
74,165,18,16,2,0.8888888888888888,10,7,3,0.7,0.7832167832167831,llama3,coral,pdac,PROMPT2_entailment
75,166,15,15,0,1.0,11,9,2,0.8181818181818182,0.9,llama3,coral,pdac,PROMPT2_entailment
76,167,14,12,2,0.8571428571428571,8,7,1,0.875,0.8659793814432989,llama3,coral,pdac,PROMPT2_entailment
77,168,13,12,1,0.9230769230769232,6,5,1,0.8333333333333334,0.8759124087591241,llama3,coral,pdac,PROMPT2_entailment
78,169,13,12,1,0.9230769230769232,7,7,0,1.0,0.96,llama3,coral,pdac,PROMPT2_entailment
79,17,13,12,1,0.9230769230769232,5,5,0,1.0,0.96,llama3,coral,pdac,PROMPT2_entailment
80,170,20,17,3,0.85,16,11,5,0.6875,0.7601626016260162,llama3,coral,pdac,PROMPT2_entailment
81,171,15,13,2,0.8666666666666667,13,11,2,0.8461538461538461,0.8562874251497006,llama3,coral,pdac,PROMPT2_entailment
82,172,21,18,3,0.8571428571428571,10,10,0,1.0,0.923076923076923,llama3,coral,pdac,PROMPT2_entailment
83,173,20,18,2,0.9,22,16,6,0.7272727272727273,0.8044692737430167,llama3,coral,pdac,PROMPT2_entailment
84,174,19,12,7,0.631578947368421,11,8,3,0.7272727272727273,0.676056338028169,llama3,coral,pdac,PROMPT2_entailment
85,175,13,3,10,0.2307692307692307,28,14,14,0.5,0.3157894736842105,llama3,coral,pdac,PROMPT2_entailment
86,176,15,12,3,0.8,10,10,0,1.0,0.888888888888889,llama3,coral,pdac,PROMPT2_entailment
87,177,16,16,0,1.0,10,10,0,1.0,1.0,llama3,coral,pdac,PROMPT2_entailment
88,178,30,24,6,0.8,36,26,10,0.7222222222222222,0.759124087591241,llama3,coral,pdac,PROMPT2_entailment
89,179,11,11,0,1.0,9,8,1,0.8888888888888888,0.9411764705882352,llama3,coral,pdac,PROMPT2_entailment
90,18,14,13,1,0.9285714285714286,15,7,8,0.4666666666666667,0.621160409556314,llama3,coral,pdac,PROMPT2_entailment
91,180,9,9,0,1.0,5,5,0,1.0,1.0,llama3,coral,pdac,PROMPT2_entailment
92,181,13,13,0,1.0,10,4,6,0.4,0.5714285714285715,llama3,coral,pdac,PROMPT2_entailment
93,182,18,16,2,0.8888888888888888,8,8,0,1.0,0.9411764705882352,llama3,coral,pdac,PROMPT2_entailment
94,183,18,15,3,0.8333333333333334,10,6,4,0.6,0.6976744186046512,llama3,coral,pdac,PROMPT2_entailment
95,184,15,9,6,0.6,9,7,2,0.7777777777777778,0.6774193548387097,llama3,coral,pdac,PROMPT2_entailment
96,185,23,22,1,0.9565217391304348,22,17,5,0.7727272727272727,0.8548571428571428,llama3,coral,pdac,PROMPT2_entailment
97,186,13,11,2,0.8461538461538461,32,13,19,0.40625,0.5489443378119001,llama3,coral,pdac,PROMPT2_entailment
98,187,48,30,18,0.625,34,27,7,0.7941176470588235,0.6994818652849741,llama3,coral,pdac,PROMPT2_entailment
99,188,17,17,0,1.0,8,6,2,0.75,0.8571428571428571,llama3,coral,pdac,PROMPT2_entailment
100,189,12,9,3,0.75,5,5,0,1.0,0.8571428571428571,llama3,coral,pdac,PROMPT2_entailment
101,19,28,23,5,0.8214285714285714,21,16,5,0.7619047619047619,0.790547798066595,llama3,coral,pdac,PROMPT2_entailment
102,190,30,26,4,0.8666666666666667,17,12,5,0.7058823529411765,0.7780548628428927,llama3,coral,pdac,PROMPT2_entailment
103,191,23,20,3,0.8695652173913043,15,13,2,0.8666666666666667,0.8681135225375627,llama3,coral,pdac,PROMPT2_entailment
104,192,22,17,5,0.7727272727272727,12,11,1,0.9166666666666666,0.8385650224215245,llama3,coral,pdac,PROMPT2_entailment
105,193,15,15,0,1.0,10,8,2,0.8,0.888888888888889,llama3,coral,pdac,PROMPT2_entailment
106,194,14,9,5,0.6428571428571429,11,10,1,0.9090909090909092,0.7531380753138075,llama3,coral,pdac,PROMPT2_entailment
107,195,17,13,4,0.7647058823529411,7,7,0,1.0,0.8666666666666666,llama3,coral,pdac,PROMPT2_entailment
108,196,19,15,4,0.7894736842105263,8,8,0,1.0,0.8823529411764706,llama3,coral,pdac,PROMPT2_entailment
109,197,18,14,4,0.7777777777777778,9,6,3,0.6666666666666666,0.717948717948718,llama3,coral,pdac,PROMPT2_entailment
110,198,13,11,2,0.8461538461538461,12,6,6,0.5,0.6285714285714286,llama3,coral,pdac,PROMPT2_entailment
111,199,17,16,1,0.9411764705882352,9,7,2,0.7777777777777778,0.8517110266159694,llama3,coral,pdac,PROMPT2_entailment
112,2,14,12,2,0.8571428571428571,14,10,4,0.7142857142857143,0.7792207792207793,llama3,coral,pdac,PROMPT2_entailment
113,20,20,13,7,0.65,18,13,5,0.7222222222222222,0.6842105263157895,llama3,coral,pdac,PROMPT2_entailment
114,200,18,17,1,0.9444444444444444,16,14,2,0.875,0.9083969465648856,llama3,coral,pdac,PROMPT2_entailment
115,201,12,12,0,1.0,10,10,0,1.0,1.0,llama3,coral,pdac,PROMPT2_entailment
116,202,13,13,0,1.0,10,10,0,1.0,1.0,llama3,coral,pdac,PROMPT2_entailment
117,203,29,24,5,0.8275862068965517,31,25,6,0.8064516129032258,0.8168822328114362,llama3,coral,pdac,PROMPT2_entailment
118,204,19,17,2,0.8947368421052632,14,12,2,0.8571428571428571,0.8755364806866952,llama3,coral,pdac,PROMPT2_entailment
119,205,15,13,2,0.8666666666666667,7,6,1,0.8571428571428571,0.861878453038674,llama3,coral,pdac,PROMPT2_entailment
120,206,13,11,2,0.8461538461538461,9,8,1,0.8888888888888888,0.8669950738916256,llama3,coral,pdac,PROMPT2_entailment
121,207,14,9,5,0.6428571428571429,8,7,1,0.875,0.7411764705882353,llama3,coral,pdac,PROMPT2_entailment
122,208,11,9,2,0.8181818181818182,8,8,0,1.0,0.9,llama3,coral,pdac,PROMPT2_entailment
123,209,14,12,2,0.8571428571428571,9,9,0,1.0,0.923076923076923,llama3,coral,pdac,PROMPT2_entailment
124,21,11,11,0,1.0,10,9,1,0.9,0.9473684210526316,llama3,coral,pdac,PROMPT2_entailment
125,210,14,13,1,0.9285714285714286,9,9,0,1.0,0.962962962962963,llama3,coral,pdac,PROMPT2_entailment
126,211,14,10,4,0.7142857142857143,8,6,2,0.75,0.7317073170731706,llama3,coral,pdac,PROMPT2_entailment
127,212,24,22,2,0.9166666666666666,17,15,2,0.8823529411764706,0.8991825613079019,llama3,coral,pdac,PROMPT2_entailment
128,213,17,17,0,1.0,11,6,5,0.5454545454545454,0.7058823529411764,llama3,coral,pdac,PROMPT2_entailment
129,214,15,13,2,0.8666666666666667,18,12,6,0.6666666666666666,0.7536231884057971,llama3,coral,pdac,PROMPT2_entailment
130,215,20,4,16,0.2,12,8,4,0.6666666666666666,0.3076923076923076,llama3,coral,pdac,PROMPT2_entailment
131,216,30,25,5,0.8333333333333334,33,27,6,0.8181818181818182,0.8256880733944955,llama3,coral,pdac,PROMPT2_entailment
132,217,14,13,1,0.9285714285714286,19,14,5,0.7368421052631579,0.8216704288939053,llama3,coral,pdac,PROMPT2_entailment
133,218,15,15,0,1.0,11,9,2,0.8181818181818182,0.9,llama3,coral,pdac,PROMPT2_entailment
134,219,10,9,1,0.9,8,8,0,1.0,0.9473684210526316,llama3,coral,pdac,PROMPT2_entailment
135,22,25,20,5,0.8,17,16,1,0.9411764705882352,0.8648648648648648,llama3,coral,pdac,PROMPT2_entailment
136,220,17,15,2,0.8823529411764706,11,10,1,0.9090909090909092,0.8955223880597014,llama3,coral,pdac,PROMPT2_entailment
137,221,11,10,1,0.9090909090909092,12,10,2,0.8333333333333334,0.8695652173913043,llama3,coral,pdac,PROMPT2_entailment
138,222,14,12,2,0.8571428571428571,11,10,1,0.9090909090909092,0.8823529411764706,llama3,coral,pdac,PROMPT2_entailment
139,223,28,25,3,0.8928571428571429,37,33,4,0.8918918918918919,0.8923742563547863,llama3,coral,pdac,PROMPT2_entailment
140,224,20,12,8,0.6,8,8,0,1.0,0.7499999999999999,llama3,coral,pdac,PROMPT2_entailment
141,225,18,16,2,0.8888888888888888,13,9,4,0.6923076923076923,0.7783783783783783,llama3,coral,pdac,PROMPT2_entailment
142,226,16,13,3,0.8125,11,7,4,0.6363636363636364,0.7137254901960786,llama3,coral,pdac,PROMPT2_entailment
143,227,13,11,2,0.8461538461538461,10,10,0,1.0,0.9166666666666666,llama3,coral,pdac,PROMPT2_entailment
144,228,13,12,1,0.9230769230769232,9,9,0,1.0,0.96,llama3,coral,pdac,PROMPT2_entailment
145,229,16,15,1,0.9375,9,7,2,0.7777777777777778,0.8502024291497976,llama3,coral,pdac,PROMPT2_entailment
146,23,17,17,0,1.0,12,10,2,0.8333333333333334,0.9090909090909092,llama3,coral,pdac,PROMPT2_entailment
147,230,11,11,0,1.0,8,7,1,0.875,0.9333333333333332,llama3,coral,pdac,PROMPT2_entailment
148,24,17,16,1,0.9411764705882352,9,8,1,0.8888888888888888,0.9142857142857144,llama3,coral,pdac,PROMPT2_entailment
149,25,18,16,2,0.8888888888888888,11,11,0,1.0,0.9411764705882352,llama3,coral,pdac,PROMPT2_entailment
150,26,16,16,0,1.0,11,11,0,1.0,1.0,llama3,coral,pdac,PROMPT2_entailment
151,27,12,10,2,0.8333333333333334,12,11,1,0.9166666666666666,0.8730158730158729,llama3,coral,pdac,PROMPT2_entailment
152,28,16,15,1,0.9375,13,11,2,0.8461538461538461,0.8894878706199459,llama3,coral,pdac,PROMPT2_entailment
153,29,14,14,0,1.0,9,8,1,0.8888888888888888,0.9411764705882352,llama3,coral,pdac,PROMPT2_entailment
154,3,18,17,1,0.9444444444444444,8,8,0,1.0,0.9714285714285714,llama3,coral,pdac,PROMPT2_entailment
155,30,18,14,4,0.7777777777777778,11,10,1,0.9090909090909092,0.8383233532934132,llama3,coral,pdac,PROMPT2_entailment
156,31,33,30,3,0.9090909090909092,11,10,1,0.9090909090909092,0.9090909090909092,llama3,coral,pdac,PROMPT2_entailment
157,32,28,26,2,0.9285714285714286,11,9,2,0.8181818181818182,0.8698884758364314,llama3,coral,pdac,PROMPT2_entailment
158,33,21,6,15,0.2857142857142857,24,18,6,0.75,0.4137931034482759,llama3,coral,pdac,PROMPT2_entailment
159,34,11,10,1,0.9090909090909092,10,10,0,1.0,0.9523809523809524,llama3,coral,pdac,PROMPT2_entailment
160,35,16,16,0,1.0,10,10,0,1.0,1.0,llama3,coral,pdac,PROMPT2_entailment
161,36,30,28,2,0.9333333333333332,44,35,9,0.7954545454545454,0.8588957055214724,llama3,coral,pdac,PROMPT2_entailment
162,37,22,20,2,0.9090909090909092,9,8,1,0.8888888888888888,0.8988764044943819,llama3,coral,pdac,PROMPT2_entailment
163,38,18,16,2,0.8888888888888888,13,10,3,0.7692307692307693,0.8247422680412372,llama3,coral,pdac,PROMPT2_entailment
164,39,15,14,1,0.9333333333333332,10,9,1,0.9,0.9163636363636364,llama3,coral,pdac,PROMPT2_entailment
165,4,19,19,0,1.0,15,11,4,0.7333333333333333,0.846153846153846,llama3,coral,pdac,PROMPT2_entailment
166,40,11,9,2,0.8181818181818182,10,7,3,0.7,0.7544910179640719,llama3,coral,pdac,PROMPT2_entailment
167,41,15,13,2,0.8666666666666667,8,6,2,0.75,0.8041237113402062,llama3,coral,pdac,PROMPT2_entailment
168,42,16,15,1,0.9375,11,9,2,0.8181818181818182,0.8737864077669902,llama3,coral,pdac,PROMPT2_entailment
169,43,17,17,0,1.0,13,9,4,0.6923076923076923,0.8181818181818181,llama3,coral,pdac,PROMPT2_entailment
170,44,16,15,1,0.9375,11,10,1,0.9090909090909092,0.923076923076923,llama3,coral,pdac,PROMPT2_entailment
171,45,21,21,0,1.0,10,9,1,0.9,0.9473684210526316,llama3,coral,pdac,PROMPT2_entailment
172,46,17,11,6,0.6470588235294118,11,8,3,0.7272727272727273,0.6848249027237354,llama3,coral,pdac,PROMPT2_entailment
173,47,29,26,3,0.896551724137931,39,27,12,0.6923076923076923,0.7813021702838063,llama3,coral,pdac,PROMPT2_entailment
174,48,10,6,4,0.6,10,7,3,0.7,0.6461538461538462,llama3,coral,pdac,PROMPT2_entailment
175,49,18,17,1,0.9444444444444444,10,8,2,0.8,0.8662420382165604,llama3,coral,pdac,PROMPT2_entailment
176,5,12,11,1,0.9166666666666666,10,8,2,0.8,0.854368932038835,llama3,coral,pdac,PROMPT2_entailment
177,50,17,14,3,0.8235294117647058,10,10,0,1.0,0.9032258064516128,llama3,coral,pdac,PROMPT2_entailment
178,51,9,7,2,0.7777777777777778,12,10,2,0.8333333333333334,0.8045977011494253,llama3,coral,pdac,PROMPT2_entailment
179,52,14,12,2,0.8571428571428571,10,10,0,1.0,0.923076923076923,llama3,coral,pdac,PROMPT2_entailment
180,53,14,13,1,0.9285714285714286,8,7,1,0.875,0.900990099009901,llama3,coral,pdac,PROMPT2_entailment
181,54,6,5,1,0.8333333333333334,2,2,0,1.0,0.9090909090909092,llama3,coral,pdac,PROMPT2_entailment
182,55,18,18,0,1.0,10,7,3,0.7,0.8235294117647058,llama3,coral,pdac,PROMPT2_entailment
183,56,18,15,3,0.8333333333333334,8,6,2,0.75,0.7894736842105262,llama3,coral,pdac,PROMPT2_entailment
184,57,35,30,5,0.8571428571428571,13,8,5,0.6153846153846154,0.7164179104477612,llama3,coral,pdac,PROMPT2_entailment
185,58,25,23,2,0.92,10,10,0,1.0,0.9583333333333334,llama3,coral,pdac,PROMPT2_entailment
186,59,34,27,7,0.7941176470588235,21,15,6,0.7142857142857143,0.7520891364902507,llama3,coral,pdac,PROMPT2_entailment
187,6,16,16,0,1.0,12,10,2,0.8333333333333334,0.9090909090909092,llama3,coral,pdac,PROMPT2_entailment
188,60,21,20,1,0.9523809523809524,13,7,6,0.5384615384615384,0.6879606879606879,llama3,coral,pdac,PROMPT2_entailment
189,61,12,12,0,1.0,7,6,1,0.8571428571428571,0.923076923076923,llama3,coral,pdac,PROMPT2_entailment
190,62,13,13,0,1.0,11,7,4,0.6363636363636364,0.7777777777777778,llama3,coral,pdac,PROMPT2_entailment
191,63,14,14,0,1.0,10,10,0,1.0,1.0,llama3,coral,pdac,PROMPT2_entailment
192,64,15,14,1,0.9333333333333332,12,11,1,0.9166666666666666,0.9249249249249248,llama3,coral,pdac,PROMPT2_entailment
193,65,18,16,2,0.8888888888888888,9,9,0,1.0,0.9411764705882352,llama3,coral,pdac,PROMPT2_entailment
194,66,13,11,2,0.8461538461538461,12,10,2,0.8333333333333334,0.8396946564885497,llama3,coral,pdac,PROMPT2_entailment
195,67,7,7,0,1.0,1,1,0,1.0,1.0,llama3,coral,pdac,PROMPT2_entailment
196,68,17,14,3,0.8235294117647058,11,10,1,0.9090909090909092,0.8641975308641976,llama3,coral,pdac,PROMPT2_entailment
197,69,15,15,0,1.0,10,10,0,1.0,1.0,llama3,coral,pdac,PROMPT2_entailment
198,7,14,13,1,0.9285714285714286,11,10,1,0.9090909090909092,0.9187279151943464,llama3,coral,pdac,PROMPT2_entailment
199,70,16,15,1,0.9375,15,14,1,0.9333333333333332,0.935412026726058,llama3,coral,pdac,PROMPT2_entailment
200,71,28,19,9,0.6785714285714286,9,7,2,0.7777777777777778,0.7247956403269754,llama3,coral,pdac,PROMPT2_entailment
201,72,24,16,8,0.6666666666666666,13,9,4,0.6923076923076923,0.6792452830188679,llama3,coral,pdac,PROMPT2_entailment
202,73,19,8,11,0.4210526315789473,154,40,114,0.2597402597402597,0.321285140562249,llama3,coral,pdac,PROMPT2_entailment
203,74,22,17,5,0.7727272727272727,8,7,1,0.875,0.8206896551724138,llama3,coral,pdac,PROMPT2_entailment
204,75,21,19,2,0.9047619047619048,7,5,2,0.7142857142857143,0.7983193277310925,llama3,coral,pdac,PROMPT2_entailment
205,76,15,10,5,0.6666666666666666,7,6,1,0.8571428571428571,0.75,llama3,coral,pdac,PROMPT2_entailment
206,77,21,17,4,0.8095238095238095,8,8,0,1.0,0.8947368421052632,llama3,coral,pdac,PROMPT2_entailment
207,78,17,15,2,0.8823529411764706,8,7,1,0.875,0.8786610878661087,llama3,coral,pdac,PROMPT2_entailment
208,79,17,15,2,0.8823529411764706,11,10,1,0.9090909090909092,0.8955223880597014,llama3,coral,pdac,PROMPT2_entailment
209,8,11,10,1,0.9090909090909092,2,2,0,1.0,0.9523809523809524,llama3,coral,pdac,PROMPT2_entailment
210,80,14,14,0,1.0,9,9,0,1.0,1.0,llama3,coral,pdac,PROMPT2_entailment
211,81,11,10,1,0.9090909090909092,6,5,1,0.8333333333333334,0.8695652173913043,llama3,coral,pdac,PROMPT2_entailment
212,82,13,13,0,1.0,4,4,0,1.0,1.0,llama3,coral,pdac,PROMPT2_entailment
213,83,13,10,3,0.7692307692307693,11,7,4,0.6363636363636364,0.6965174129353234,llama3,coral,pdac,PROMPT2_entailment
214,84,16,10,6,0.625,11,8,3,0.7272727272727273,0.6722689075630253,llama3,coral,pdac,PROMPT2_entailment
215,85,36,27,9,0.75,35,28,7,0.8,0.7741935483870969,llama3,coral,pdac,PROMPT2_entailment
216,86,12,11,1,0.9166666666666666,10,9,1,0.9,0.908256880733945,llama3,coral,pdac,PROMPT2_entailment
217,87,18,17,1,0.9444444444444444,7,7,0,1.0,0.9714285714285714,llama3,coral,pdac,PROMPT2_entailment
218,88,13,11,2,0.8461538461538461,8,7,1,0.875,0.8603351955307262,llama3,coral,pdac,PROMPT2_entailment
219,89,15,13,2,0.8666666666666667,10,9,1,0.9,0.8830188679245283,llama3,coral,pdac,PROMPT2_entailment
220,9,13,13,0,1.0,12,9,3,0.75,0.8571428571428571,llama3,coral,pdac,PROMPT2_entailment
221,90,19,16,3,0.8421052631578947,9,7,2,0.7777777777777778,0.8086642599277979,llama3,coral,pdac,PROMPT2_entailment
222,91,12,11,1,0.9166666666666666,10,9,1,0.9,0.908256880733945,llama3,coral,pdac,PROMPT2_entailment
223,92,21,17,4,0.8095238095238095,10,9,1,0.9,0.8523676880222841,llama3,coral,pdac,PROMPT2_entailment
224,93,14,12,2,0.8571428571428571,9,8,1,0.8888888888888888,0.8727272727272727,llama3,coral,pdac,PROMPT2_entailment
225,94,15,12,3,0.8,7,7,0,1.0,0.888888888888889,llama3,coral,pdac,PROMPT2_entailment
226,95,17,14,3,0.8235294117647058,8,6,2,0.75,0.7850467289719627,llama3,coral,pdac,PROMPT2_entailment
227,96,11,10,1,0.9090909090909092,4,4,0,1.0,0.9523809523809524,llama3,coral,pdac,PROMPT2_entailment
228,97,12,11,1,0.9166666666666666,8,8,0,1.0,0.9565217391304348,llama3,coral,pdac,PROMPT2_entailment
229,98,19,16,3,0.8421052631578947,9,9,0,1.0,0.9142857142857144,llama3,coral,pdac,PROMPT2_entailment
230,99,17,17,0,1.0,9,9,0,1.0,1.0,llama3,coral,pdac,PROMPT2_entailment
0,0,23,23,0,1.0,10,9,1,0.9,0.9473684210526316,llama3,coral,breastca,PROMPT1_entailment
1,1,16,13,3,0.8125,12,10,2,0.8333333333333334,0.8227848101265822,llama3,coral,breastca,PROMPT1_entailment
2,10,13,12,1,0.9230769230769232,10,10,0,1.0,0.96,llama3,coral,breastca,PROMPT1_entailment
3,100,23,17,6,0.7391304347826086,26,11,15,0.4230769230769231,0.5381294964028777,llama3,coral,breastca,PROMPT1_entailment
4,101,29,29,0,1.0,18,13,5,0.7222222222222222,0.8387096774193548,llama3,coral,breastca,PROMPT1_entailment
5,102,14,13,1,0.9285714285714286,7,4,3,0.5714285714285714,0.7074829931972789,llama3,coral,breastca,PROMPT1_entailment
6,103,19,17,2,0.8947368421052632,10,9,1,0.9,0.8973607038123168,llama3,coral,breastca,PROMPT1_entailment
7,104,39,32,7,0.8205128205128205,26,19,7,0.7307692307692307,0.7730451366815003,llama3,coral,breastca,PROMPT1_entailment
8,105,14,12,2,0.8571428571428571,15,15,0,1.0,0.923076923076923,llama3,coral,breastca,PROMPT1_entailment
9,106,14,13,1,0.9285714285714286,9,9,0,1.0,0.962962962962963,llama3,coral,breastca,PROMPT1_entailment
10,107,13,12,1,0.9230769230769232,9,8,1,0.8888888888888888,0.9056603773584906,llama3,coral,breastca,PROMPT1_entailment
11,108,13,12,1,0.9230769230769232,11,11,0,1.0,0.96,llama3,coral,breastca,PROMPT1_entailment
12,109,15,13,2,0.8666666666666667,11,10,1,0.9090909090909092,0.887372013651877,llama3,coral,breastca,PROMPT1_entailment
13,11,12,11,1,0.9166666666666666,3,3,0,1.0,0.9565217391304348,llama3,coral,breastca,PROMPT1_entailment
14,110,14,13,1,0.9285714285714286,11,10,1,0.9090909090909092,0.9187279151943464,llama3,coral,breastca,PROMPT1_entailment
15,111,11,6,5,0.5454545454545454,10,8,2,0.8,0.6486486486486486,llama3,coral,breastca,PROMPT1_entailment
16,112,16,16,0,1.0,10,9,1,0.9,0.9473684210526316,llama3,coral,breastca,PROMPT1_entailment
17,113,27,20,7,0.7407407407407407,49,21,28,0.4285714285714285,0.5429864253393665,llama3,coral,breastca,PROMPT1_entailment
18,114,30,22,8,0.7333333333333333,21,15,6,0.7142857142857143,0.7236842105263158,llama3,coral,breastca,PROMPT1_entailment
19,115,15,12,3,0.8,9,7,2,0.7777777777777778,0.7887323943661971,llama3,coral,breastca,PROMPT1_entailment
20,116,17,17,0,1.0,14,9,5,0.6428571428571429,0.782608695652174,llama3,coral,breastca,PROMPT1_entailment
21,117,8,8,0,1.0,2,1,1,0.5,0.6666666666666666,llama3,coral,breastca,PROMPT1_entailment
22,118,22,22,0,1.0,19,8,11,0.4210526315789473,0.5925925925925926,llama3,coral,breastca,PROMPT1_entailment
23,119,13,10,3,0.7692307692307693,10,9,1,0.9,0.8294930875576038,llama3,coral,breastca,PROMPT1_entailment
24,12,10,10,0,1.0,10,6,4,0.6,0.7499999999999999,llama3,coral,breastca,PROMPT1_entailment
25,120,13,11,2,0.8461538461538461,9,9,0,1.0,0.9166666666666666,llama3,coral,breastca,PROMPT1_entailment
26,121,16,12,4,0.75,10,10,0,1.0,0.8571428571428571,llama3,coral,breastca,PROMPT1_entailment
27,122,12,11,1,0.9166666666666666,9,8,1,0.8888888888888888,0.9025641025641026,llama3,coral,breastca,PROMPT1_entailment
28,123,13,12,1,0.9230769230769232,8,8,0,1.0,0.96,llama3,coral,breastca,PROMPT1_entailment
29,124,15,14,1,0.9333333333333332,10,10,0,1.0,0.9655172413793104,llama3,coral,breastca,PROMPT1_entailment
30,125,18,17,1,0.9444444444444444,11,7,4,0.6363636363636364,0.7603833865814696,llama3,coral,breastca,PROMPT1_entailment
31,126,12,10,2,0.8333333333333334,10,10,0,1.0,0.9090909090909092,llama3,coral,breastca,PROMPT1_entailment
32,127,12,10,2,0.8333333333333334,10,8,2,0.8,0.816326530612245,llama3,coral,breastca,PROMPT1_entailment
33,128,15,14,1,0.9333333333333332,11,10,1,0.9090909090909092,0.9210526315789476,llama3,coral,breastca,PROMPT1_entailment
34,129,14,13,1,0.9285714285714286,11,8,3,0.7272727272727273,0.8156862745098039,llama3,coral,breastca,PROMPT1_entailment
35,13,20,18,2,0.9,10,8,2,0.8,0.8470588235294118,llama3,coral,breastca,PROMPT1_entailment
36,130,13,11,2,0.8461538461538461,7,7,0,1.0,0.9166666666666666,llama3,coral,breastca,PROMPT1_entailment
37,131,23,23,0,1.0,10,10,0,1.0,1.0,llama3,coral,breastca,PROMPT1_entailment
38,132,14,13,1,0.9285714285714286,8,6,2,0.75,0.8297872340425532,llama3,coral,breastca,PROMPT1_entailment
39,133,33,29,4,0.8787878787878788,29,22,7,0.7586206896551724,0.8142948308870454,llama3,coral,breastca,PROMPT1_entailment
40,134,16,9,7,0.5625,11,10,1,0.9090909090909092,0.6949806949806949,llama3,coral,breastca,PROMPT1_entailment
41,135,16,12,4,0.75,16,14,2,0.875,0.8076923076923077,llama3,coral,breastca,PROMPT1_entailment
42,136,16,11,5,0.6875,10,8,2,0.8,0.7394957983193278,llama3,coral,breastca,PROMPT1_entailment
43,137,16,16,0,1.0,10,10,0,1.0,1.0,llama3,coral,breastca,PROMPT1_entailment
44,138,13,13,0,1.0,10,10,0,1.0,1.0,llama3,coral,breastca,PROMPT1_entailment
45,139,20,16,4,0.8,11,10,1,0.9090909090909092,0.8510638297872342,llama3,coral,breastca,PROMPT1_entailment
46,14,50,37,13,0.74,59,25,34,0.423728813559322,0.5388872706087969,llama3,coral,breastca,PROMPT1_entailment
47,140,15,13,2,0.8666666666666667,9,9,0,1.0,0.9285714285714286,llama3,coral,breastca,PROMPT1_entailment
48,141,16,10,6,0.625,11,9,2,0.8181818181818182,0.7086614173228345,llama3,coral,breastca,PROMPT1_entailment
49,142,12,12,0,1.0,10,10,0,1.0,1.0,llama3,coral,breastca,PROMPT1_entailment
50,143,14,12,2,0.8571428571428571,10,9,1,0.9,0.8780487804878048,llama3,coral,breastca,PROMPT1_entailment
51,144,18,16,2,0.8888888888888888,5,2,3,0.4,0.5517241379310346,llama3,coral,breastca,PROMPT1_entailment
52,145,11,10,1,0.9090909090909092,5,5,0,1.0,0.9523809523809524,llama3,coral,breastca,PROMPT1_entailment
53,146,14,13,1,0.9285714285714286,9,9,0,1.0,0.962962962962963,llama3,coral,breastca,PROMPT1_entailment
54,147,20,17,3,0.85,5,5,0,1.0,0.9189189189189187,llama3,coral,breastca,PROMPT1_entailment
55,148,15,8,7,0.5333333333333333,4,2,2,0.5,0.5161290322580646,llama3,coral,breastca,PROMPT1_entailment
56,149,11,11,0,1.0,1,1,0,1.0,1.0,llama3,coral,breastca,PROMPT1_entailment
57,15,35,27,8,0.7714285714285715,16,9,7,0.5625,0.6506024096385543,llama3,coral,breastca,PROMPT1_entailment
58,150,12,8,4,0.6666666666666666,2,2,0,1.0,0.8,llama3,coral,breastca,PROMPT1_entailment
59,151,13,13,0,1.0,9,8,1,0.8888888888888888,0.9411764705882352,llama3,coral,breastca,PROMPT1_entailment
60,152,13,11,2,0.8461538461538461,16,12,4,0.75,0.7951807228915662,llama3,coral,breastca,PROMPT1_entailment
61,153,13,13,0,1.0,1,1,0,1.0,1.0,llama3,coral,breastca,PROMPT1_entailment
62,154,15,14,1,0.9333333333333332,10,9,1,0.9,0.9163636363636364,llama3,coral,breastca,PROMPT1_entailment
63,155,20,19,1,0.95,9,8,1,0.8888888888888888,0.918429003021148,llama3,coral,breastca,PROMPT1_entailment
64,156,19,17,2,0.8947368421052632,8,7,1,0.875,0.8847583643122676,llama3,coral,breastca,PROMPT1_entailment
65,157,16,14,2,0.875,9,9,0,1.0,0.9333333333333332,llama3,coral,breastca,PROMPT1_entailment
66,158,20,15,5,0.75,16,11,5,0.6875,0.717391304347826,llama3,coral,breastca,PROMPT1_entailment
67,159,28,18,10,0.6428571428571429,29,20,9,0.6896551724137931,0.6654343807763402,llama3,coral,breastca,PROMPT1_entailment
68,16,19,19,0,1.0,10,8,2,0.8,0.888888888888889,llama3,coral,breastca,PROMPT1_entailment
69,160,69,23,46,0.3333333333333333,18,14,4,0.7777777777777778,0.4666666666666666,llama3,coral,breastca,PROMPT1_entailment
70,161,32,28,4,0.875,11,9,2,0.8181818181818182,0.8456375838926175,llama3,coral,breastca,PROMPT1_entailment
71,162,19,16,3,0.8421052631578947,16,12,4,0.75,0.7933884297520661,llama3,coral,breastca,PROMPT1_entailment
72,163,13,13,0,1.0,11,11,0,1.0,1.0,llama3,coral,breastca,PROMPT1_entailment
73,164,16,16,0,1.0,8,4,4,0.5,0.6666666666666666,llama3,coral,breastca,PROMPT1_entailment
74,165,16,12,4,0.75,12,11,1,0.9166666666666666,0.8250000000000001,llama3,coral,breastca,PROMPT1_entailment
75,166,15,12,3,0.8,10,9,1,0.9,0.8470588235294118,llama3,coral,breastca,PROMPT1_entailment
76,167,13,10,3,0.7692307692307693,7,6,1,0.8571428571428571,0.8108108108108107,llama3,coral,breastca,PROMPT1_entailment
77,168,9,6,3,0.6666666666666666,7,6,1,0.8571428571428571,0.75,llama3,coral,breastca,PROMPT1_entailment
78,169,12,9,3,0.75,11,7,4,0.6363636363636364,0.6885245901639345,llama3,coral,breastca,PROMPT1_entailment
79,17,8,8,0,1.0,3,3,0,1.0,1.0,llama3,coral,breastca,PROMPT1_entailment
80,170,20,19,1,0.95,10,10,0,1.0,0.9743589743589745,llama3,coral,breastca,PROMPT1_entailment
81,171,17,15,2,0.8823529411764706,9,6,3,0.6666666666666666,0.7594936708860759,llama3,coral,breastca,PROMPT1_entailment
82,172,38,34,4,0.8947368421052632,32,13,19,0.40625,0.5587863463969658,llama3,coral,breastca,PROMPT1_entailment
83,173,15,11,4,0.7333333333333333,11,10,1,0.9090909090909092,0.8118081180811808,llama3,coral,breastca,PROMPT1_entailment
84,174,12,8,4,0.6666666666666666,7,7,0,1.0,0.8,llama3,coral,breastca,PROMPT1_entailment
85,175,10,8,2,0.8,10,10,0,1.0,0.888888888888889,llama3,coral,breastca,PROMPT1_entailment
86,176,14,13,1,0.9285714285714286,10,9,1,0.9,0.9140625,llama3,coral,breastca,PROMPT1_entailment
87,177,15,13,2,0.8666666666666667,9,9,0,1.0,0.9285714285714286,llama3,coral,breastca,PROMPT1_entailment
88,178,16,11,5,0.6875,10,9,1,0.9,0.7795275590551182,llama3,coral,breastca,PROMPT1_entailment
89,179,13,13,0,1.0,9,8,1,0.8888888888888888,0.9411764705882352,llama3,coral,breastca,PROMPT1_entailment
90,18,14,13,1,0.9285714285714286,8,8,0,1.0,0.962962962962963,llama3,coral,breastca,PROMPT1_entailment
91,180,13,12,1,0.9230769230769232,10,8,2,0.8,0.8571428571428571,llama3,coral,breastca,PROMPT1_entailment
92,181,11,9,2,0.8181818181818182,9,8,1,0.8888888888888888,0.8520710059171598,llama3,coral,breastca,PROMPT1_entailment
93,182,12,11,1,0.9166666666666666,9,8,1,0.8888888888888888,0.9025641025641026,llama3,coral,breastca,PROMPT1_entailment
94,183,12,12,0,1.0,10,5,5,0.5,0.6666666666666666,llama3,coral,breastca,PROMPT1_entailment
95,184,16,16,0,1.0,9,8,1,0.8888888888888888,0.9411764705882352,llama3,coral,breastca,PROMPT1_entailment
96,185,19,18,1,0.9473684210526316,10,8,2,0.8,0.8674698795180723,llama3,coral,breastca,PROMPT1_entailment
97,186,13,13,0,1.0,5,5,0,1.0,1.0,llama3,coral,breastca,PROMPT1_entailment
98,187,30,24,6,0.8,26,16,10,0.6153846153846154,0.6956521739130435,llama3,coral,breastca,PROMPT1_entailment
99,188,14,14,0,1.0,9,9,0,1.0,1.0,llama3,coral,breastca,PROMPT1_entailment
100,189,18,17,1,0.9444444444444444,9,9,0,1.0,0.9714285714285714,llama3,coral,breastca,PROMPT1_entailment
101,19,11,11,0,1.0,8,8,0,1.0,1.0,llama3,coral,breastca,PROMPT1_entailment
102,190,37,13,24,0.3513513513513513,34,16,18,0.4705882352941176,0.402321083172147,llama3,coral,breastca,PROMPT1_entailment
103,191,36,19,17,0.5277777777777778,14,13,1,0.9285714285714286,0.6730245231607629,llama3,coral,breastca,PROMPT1_entailment
104,192,18,15,3,0.8333333333333334,12,11,1,0.9166666666666666,0.8730158730158729,llama3,coral,breastca,PROMPT1_entailment
105,193,8,8,0,1.0,2,2,0,1.0,1.0,llama3,coral,breastca,PROMPT1_entailment
106,194,19,19,0,1.0,15,11,4,0.7333333333333333,0.846153846153846,llama3,coral,breastca,PROMPT1_entailment
107,195,14,13,1,0.9285714285714286,13,12,1,0.9230769230769232,0.9258160237388724,llama3,coral,breastca,PROMPT1_entailment
108,196,33,27,6,0.8181818181818182,30,23,7,0.7666666666666667,0.7915869980879541,llama3,coral,breastca,PROMPT1_entailment
109,197,28,24,4,0.8571428571428571,14,11,3,0.7857142857142857,0.8198757763975155,llama3,coral,breastca,PROMPT1_entailment
110,198,14,12,2,0.8571428571428571,11,8,3,0.7272727272727273,0.7868852459016394,llama3,coral,breastca,PROMPT1_entailment
111,199,6,5,1,0.8333333333333334,2,2,0,1.0,0.9090909090909092,llama3,coral,breastca,PROMPT1_entailment
112,2,12,9,3,0.75,10,7,3,0.7,0.7241379310344827,llama3,coral,breastca,PROMPT1_entailment
113,20,18,13,5,0.7222222222222222,17,12,5,0.7058823529411765,0.71395881006865,llama3,coral,breastca,PROMPT1_entailment
114,200,20,18,2,0.9,15,9,6,0.6,0.7200000000000001,llama3,coral,breastca,PROMPT1_entailment
115,201,24,18,6,0.75,26,15,11,0.5769230769230769,0.6521739130434783,llama3,coral,breastca,PROMPT1_entailment
116,202,18,15,3,0.8333333333333334,17,13,4,0.7647058823529411,0.7975460122699386,llama3,coral,breastca,PROMPT1_entailment
117,203,32,23,9,0.71875,27,18,9,0.6666666666666666,0.6917293233082707,llama3,coral,breastca,PROMPT1_entailment
118,204,13,13,0,1.0,11,8,3,0.7272727272727273,0.8421052631578948,llama3,coral,breastca,PROMPT1_entailment
119,205,12,10,2,0.8333333333333334,11,11,0,1.0,0.9090909090909092,llama3,coral,breastca,PROMPT1_entailment
120,206,11,10,1,0.9090909090909092,4,4,0,1.0,0.9523809523809524,llama3,coral,breastca,PROMPT1_entailment
121,207,18,16,2,0.8888888888888888,12,9,3,0.75,0.8135593220338982,llama3,coral,breastca,PROMPT1_entailment
122,208,15,14,1,0.9333333333333332,9,9,0,1.0,0.9655172413793104,llama3,coral,breastca,PROMPT1_entailment
123,209,50,49,1,0.98,11,8,3,0.7272727272727273,0.8349307774227902,llama3,coral,breastca,PROMPT1_entailment
124,21,29,23,6,0.7931034482758621,27,16,11,0.5925925925925926,0.6783410138248848,llama3,coral,breastca,PROMPT1_entailment
125,210,19,17,2,0.8947368421052632,13,12,1,0.9230769230769232,0.9086859688195992,llama3,coral,breastca,PROMPT1_entailment
126,211,18,16,2,0.8888888888888888,11,8,3,0.7272727272727273,0.7999999999999999,llama3,coral,breastca,PROMPT1_entailment
127,212,15,13,2,0.8666666666666667,9,8,1,0.8888888888888888,0.8776371308016878,llama3,coral,breastca,PROMPT1_entailment
128,213,11,9,2,0.8181818181818182,11,11,0,1.0,0.9,llama3,coral,breastca,PROMPT1_entailment
129,214,26,14,12,0.5384615384615384,28,14,14,0.5,0.5185185185185186,llama3,coral,breastca,PROMPT1_entailment
130,215,30,24,6,0.8,37,19,18,0.5135135135135135,0.6255144032921811,llama3,coral,breastca,PROMPT1_entailment
131,216,20,17,3,0.85,15,12,3,0.8,0.8242424242424243,llama3,coral,breastca,PROMPT1_entailment
132,22,12,9,3,0.75,7,7,0,1.0,0.8571428571428571,llama3,coral,breastca,PROMPT1_entailment
133,23,13,12,1,0.9230769230769232,9,7,2,0.7777777777777778,0.8442211055276381,llama3,coral,breastca,PROMPT1_entailment
134,24,17,16,1,0.9411764705882352,10,8,2,0.8,0.8648648648648648,llama3,coral,breastca,PROMPT1_entailment
135,25,14,12,2,0.8571428571428571,8,8,0,1.0,0.923076923076923,llama3,coral,breastca,PROMPT1_entailment
136,26,19,16,3,0.8421052631578947,11,8,3,0.7272727272727273,0.7804878048780488,llama3,coral,breastca,PROMPT1_entailment
137,27,13,11,2,0.8461538461538461,12,8,4,0.6666666666666666,0.7457627118644068,llama3,coral,breastca,PROMPT1_entailment
138,28,19,15,4,0.7894736842105263,18,13,5,0.7222222222222222,0.7543520309477757,llama3,coral,breastca,PROMPT1_entailment
139,29,30,25,5,0.8333333333333334,9,5,4,0.5555555555555556,0.6666666666666667,llama3,coral,breastca,PROMPT1_entailment
140,3,24,18,6,0.75,11,5,6,0.4545454545454545,0.5660377358490566,llama3,coral,breastca,PROMPT1_entailment
141,30,35,13,22,0.3714285714285714,18,12,6,0.6666666666666666,0.4770642201834863,llama3,coral,breastca,PROMPT1_entailment
142,31,16,10,6,0.625,13,10,3,0.7692307692307693,0.6896551724137931,llama3,coral,breastca,PROMPT1_entailment
143,32,10,8,2,0.8,9,8,1,0.8888888888888888,0.8421052631578948,llama3,coral,breastca,PROMPT1_entailment
144,33,14,10,4,0.7142857142857143,8,8,0,1.0,0.8333333333333333,llama3,coral,breastca,PROMPT1_entailment
145,34,10,9,1,0.9,10,8,2,0.8,0.8470588235294118,llama3,coral,breastca,PROMPT1_entailment
146,35,17,16,1,0.9411764705882352,12,9,3,0.75,0.8347826086956521,llama3,coral,breastca,PROMPT1_entailment
147,36,16,15,1,0.9375,11,9,2,0.8181818181818182,0.8737864077669902,llama3,coral,breastca,PROMPT1_entailment
148,37,15,15,0,1.0,11,8,3,0.7272727272727273,0.8421052631578948,llama3,coral,breastca,PROMPT1_entailment
149,38,17,17,0,1.0,11,7,4,0.6363636363636364,0.7777777777777778,llama3,coral,breastca,PROMPT1_entailment
150,39,14,13,1,0.9285714285714286,11,10,1,0.9090909090909092,0.9187279151943464,llama3,coral,breastca,PROMPT1_entailment
151,4,43,25,18,0.5813953488372093,59,21,38,0.3559322033898305,0.441547518923465,llama3,coral,breastca,PROMPT1_entailment
152,40,18,16,2,0.8888888888888888,9,7,2,0.7777777777777778,0.8296296296296296,llama3,coral,breastca,PROMPT1_entailment
153,41,23,20,3,0.8695652173913043,14,11,3,0.7857142857142857,0.8255159474671669,llama3,coral,breastca,PROMPT1_entailment
154,42,16,14,2,0.875,9,5,4,0.5555555555555556,0.6796116504854369,llama3,coral,breastca,PROMPT1_entailment
155,43,14,11,3,0.7857142857142857,9,8,1,0.8888888888888888,0.8341232227488152,llama3,coral,breastca,PROMPT1_entailment
156,44,14,13,1,0.9285714285714286,9,9,0,1.0,0.962962962962963,llama3,coral,breastca,PROMPT1_entailment
157,45,8,8,0,1.0,2,2,0,1.0,1.0,llama3,coral,breastca,PROMPT1_entailment
158,46,13,13,0,1.0,5,5,0,1.0,1.0,llama3,coral,breastca,PROMPT1_entailment
159,47,14,13,1,0.9285714285714286,2,2,0,1.0,0.962962962962963,llama3,coral,breastca,PROMPT1_entailment
160,48,12,12,0,1.0,5,5,0,1.0,1.0,llama3,coral,breastca,PROMPT1_entailment
161,49,28,20,8,0.7142857142857143,16,13,3,0.8125,0.7602339181286549,llama3,coral,breastca,PROMPT1_entailment
162,5,22,20,2,0.9090909090909092,12,11,1,0.9166666666666666,0.9128630705394192,llama3,coral,breastca,PROMPT1_entailment
163,50,21,11,10,0.5238095238095238,16,10,6,0.625,0.5699481865284974,llama3,coral,breastca,PROMPT1_entailment
164,51,40,35,5,0.875,11,9,2,0.8181818181818182,0.8456375838926175,llama3,coral,breastca,PROMPT1_entailment
165,52,16,13,3,0.8125,10,9,1,0.9,0.854014598540146,llama3,coral,breastca,PROMPT1_entailment
166,53,17,17,0,1.0,10,10,0,1.0,1.0,llama3,coral,breastca,PROMPT1_entailment
167,54,20,19,1,0.95,9,8,1,0.8888888888888888,0.918429003021148,llama3,coral,breastca,PROMPT1_entailment
168,55,4,4,0,1.0,1,1,0,1.0,1.0,llama3,coral,breastca,PROMPT1_entailment
169,56,19,15,4,0.7894736842105263,18,6,12,0.3333333333333333,0.46875,llama3,coral,breastca,PROMPT1_entailment
170,57,24,22,2,0.9166666666666666,10,10,0,1.0,0.9565217391304348,llama3,coral,breastca,PROMPT1_entailment
171,58,19,18,1,0.9473684210526316,10,10,0,1.0,0.972972972972973,llama3,coral,breastca,PROMPT1_entailment
172,59,12,11,1,0.9166666666666666,9,9,0,1.0,0.9565217391304348,llama3,coral,breastca,PROMPT1_entailment
173,6,11,10,1,0.9090909090909092,8,6,2,0.75,0.821917808219178,llama3,coral,breastca,PROMPT1_entailment
174,60,17,14,3,0.8235294117647058,10,9,1,0.9,0.8600682593856656,llama3,coral,breastca,PROMPT1_entailment
175,61,16,15,1,0.9375,11,10,1,0.9090909090909092,0.923076923076923,llama3,coral,breastca,PROMPT1_entailment
176,62,15,14,1,0.9333333333333332,10,10,0,1.0,0.9655172413793104,llama3,coral,breastca,PROMPT1_entailment
177,63,12,12,0,1.0,11,9,2,0.8181818181818182,0.9,llama3,coral,breastca,PROMPT1_entailment
178,64,24,13,11,0.5416666666666666,17,11,6,0.6470588235294118,0.5896907216494846,llama3,coral,breastca,PROMPT1_entailment
179,65,11,10,1,0.9090909090909092,6,6,0,1.0,0.9523809523809524,llama3,coral,breastca,PROMPT1_entailment
180,66,15,13,2,0.8666666666666667,10,10,0,1.0,0.9285714285714286,llama3,coral,breastca,PROMPT1_entailment
181,67,43,20,23,0.4651162790697674,49,26,23,0.5306122448979592,0.4957102001906577,llama3,coral,breastca,PROMPT1_entailment
182,68,14,11,3,0.7857142857142857,8,8,0,1.0,0.88,llama3,coral,breastca,PROMPT1_entailment
183,69,21,14,7,0.6666666666666666,12,5,7,0.4166666666666667,0.5128205128205129,llama3,coral,breastca,PROMPT1_entailment
184,7,13,13,0,1.0,11,11,0,1.0,1.0,llama3,coral,breastca,PROMPT1_entailment
185,70,76,61,15,0.8026315789473685,51,25,26,0.4901960784313725,0.6086609459189783,llama3,coral,breastca,PROMPT1_entailment
186,71,8,7,1,0.875,5,5,0,1.0,0.9333333333333332,llama3,coral,breastca,PROMPT1_entailment
187,72,12,11,1,0.9166666666666666,3,2,1,0.6666666666666666,0.7719298245614035,llama3,coral,breastca,PROMPT1_entailment
188,73,11,10,1,0.9090909090909092,1,1,0,1.0,0.9523809523809524,llama3,coral,breastca,PROMPT1_entailment
189,74,11,10,1,0.9090909090909092,2,2,0,1.0,0.9523809523809524,llama3,coral,breastca,PROMPT1_entailment
190,75,16,15,1,0.9375,6,6,0,1.0,0.967741935483871,llama3,coral,breastca,PROMPT1_entailment
191,76,13,12,1,0.9230769230769232,7,7,0,1.0,0.96,llama3,coral,breastca,PROMPT1_entailment
192,77,19,16,3,0.8421052631578947,15,10,5,0.6666666666666666,0.744186046511628,llama3,coral,breastca,PROMPT1_entailment
193,78,13,12,1,0.9230769230769232,8,5,3,0.625,0.7453416149068324,llama3,coral,breastca,PROMPT1_entailment
194,79,13,12,1,0.9230769230769232,8,6,2,0.75,0.8275862068965517,llama3,coral,breastca,PROMPT1_entailment
195,8,12,9,3,0.75,9,9,0,1.0,0.8571428571428571,llama3,coral,breastca,PROMPT1_entailment
196,80,19,18,1,0.9473684210526316,24,14,10,0.5833333333333334,0.7220630372492838,llama3,coral,breastca,PROMPT1_entailment
197,81,11,10,1,0.9090909090909092,11,9,2,0.8181818181818182,0.861244019138756,llama3,coral,breastca,PROMPT1_entailment
198,82,12,10,2,0.8333333333333334,6,5,1,0.8333333333333334,0.8333333333333334,llama3,coral,breastca,PROMPT1_entailment
199,83,13,12,1,0.9230769230769232,6,5,1,0.8333333333333334,0.8759124087591241,llama3,coral,breastca,PROMPT1_entailment
200,84,14,12,2,0.8571428571428571,11,9,2,0.8181818181818182,0.8372093023255814,llama3,coral,breastca,PROMPT1_entailment
201,85,14,11,3,0.7857142857142857,7,7,0,1.0,0.88,llama3,coral,breastca,PROMPT1_entailment
202,86,18,14,4,0.7777777777777778,16,13,3,0.8125,0.7947598253275109,llama3,coral,breastca,PROMPT1_entailment
203,87,10,8,2,0.8,8,8,0,1.0,0.888888888888889,llama3,coral,breastca,PROMPT1_entailment
204,88,11,11,0,1.0,8,8,0,1.0,1.0,llama3,coral,breastca,PROMPT1_entailment
205,89,14,14,0,1.0,11,11,0,1.0,1.0,llama3,coral,breastca,PROMPT1_entailment
206,9,12,10,2,0.8333333333333334,6,5,1,0.8333333333333334,0.8333333333333334,llama3,coral,breastca,PROMPT1_entailment
207,90,35,17,18,0.4857142857142857,17,9,8,0.5294117647058824,0.5066225165562913,llama3,coral,breastca,PROMPT1_entailment
208,91,13,10,3,0.7692307692307693,7,4,3,0.5714285714285714,0.6557377049180327,llama3,coral,breastca,PROMPT1_entailment
209,92,6,6,0,1.0,2,2,0,1.0,1.0,llama3,coral,breastca,PROMPT1_entailment
210,93,17,17,0,1.0,13,12,1,0.9230769230769232,0.96,llama3,coral,breastca,PROMPT1_entailment
211,94,23,19,4,0.8260869565217391,25,18,7,0.72,0.7694038245219348,llama3,coral,breastca,PROMPT1_entailment
212,95,32,26,6,0.8125,13,10,3,0.7692307692307693,0.790273556231003,llama3,coral,breastca,PROMPT1_entailment
213,96,16,13,3,0.8125,10,10,0,1.0,0.896551724137931,llama3,coral,breastca,PROMPT1_entailment
214,97,15,14,1,0.9333333333333332,11,10,1,0.9090909090909092,0.9210526315789476,llama3,coral,breastca,PROMPT1_entailment
215,98,8,7,1,0.875,2,2,0,1.0,0.9333333333333332,llama3,coral,breastca,PROMPT1_entailment
216,99,26,24,2,0.9230769230769232,15,12,3,0.8,0.8571428571428571,llama3,coral,breastca,PROMPT1_entailment
0,0,20,11,9,0.55,10,9,1,0.9,0.6827586206896552,llama3,coral,breastca,PROMPT1_ICL_entailment
1,1,24,17,7,0.7083333333333334,12,10,2,0.8333333333333334,0.7657657657657657,llama3,coral,breastca,PROMPT1_ICL_entailment
2,10,25,17,8,0.68,10,9,1,0.9,0.7746835443037976,llama3,coral,breastca,PROMPT1_ICL_entailment
3,100,35,19,16,0.5428571428571428,26,8,18,0.3076923076923077,0.3927648578811369,llama3,coral,breastca,PROMPT1_ICL_entailment
4,101,33,30,3,0.9090909090909092,18,15,3,0.8333333333333334,0.8695652173913043,llama3,coral,breastca,PROMPT1_ICL_entailment
5,102,22,13,9,0.5909090909090909,7,6,1,0.8571428571428571,0.6995515695067264,llama3,coral,breastca,PROMPT1_ICL_entailment
6,103,27,19,8,0.7037037037037037,10,8,2,0.8,0.7487684729064039,llama3,coral,breastca,PROMPT1_ICL_entailment
7,104,41,28,13,0.6829268292682927,26,9,17,0.3461538461538461,0.4594348222424795,llama3,coral,breastca,PROMPT1_ICL_entailment
8,105,24,15,9,0.625,15,15,0,1.0,0.7692307692307693,llama3,coral,breastca,PROMPT1_ICL_entailment
9,106,23,14,9,0.6086956521739131,9,8,1,0.8888888888888888,0.7225806451612903,llama3,coral,breastca,PROMPT1_ICL_entailment
10,107,21,10,11,0.4761904761904761,9,8,1,0.8888888888888888,0.6201550387596899,llama3,coral,breastca,PROMPT1_ICL_entailment
11,108,21,12,9,0.5714285714285714,11,10,1,0.9090909090909092,0.7017543859649122,llama3,coral,breastca,PROMPT1_ICL_entailment
12,109,19,10,9,0.5263157894736842,11,10,1,0.9090909090909092,0.6666666666666666,llama3,coral,breastca,PROMPT1_ICL_entailment
13,11,18,9,9,0.5,3,3,0,1.0,0.6666666666666666,llama3,coral,breastca,PROMPT1_ICL_entailment
14,110,20,11,9,0.55,11,7,4,0.6363636363636364,0.5900383141762452,llama3,coral,breastca,PROMPT1_ICL_entailment
15,111,25,11,14,0.44,10,8,2,0.8,0.567741935483871,llama3,coral,breastca,PROMPT1_ICL_entailment
16,112,24,14,10,0.5833333333333334,10,8,2,0.8,0.674698795180723,llama3,coral,breastca,PROMPT1_ICL_entailment
17,113,34,24,10,0.7058823529411765,49,25,24,0.5102040816326531,0.5923000987166831,llama3,coral,breastca,PROMPT1_ICL_entailment
18,114,32,19,13,0.59375,21,13,8,0.6190476190476191,0.6061349693251534,llama3,coral,breastca,PROMPT1_ICL_entailment
19,115,20,11,9,0.55,9,5,4,0.5555555555555556,0.5527638190954774,llama3,coral,breastca,PROMPT1_ICL_entailment
20,116,30,17,13,0.5666666666666667,14,11,3,0.7857142857142857,0.658450704225352,llama3,coral,breastca,PROMPT1_ICL_entailment
21,117,15,7,8,0.4666666666666667,2,1,1,0.5,0.4827586206896552,llama3,coral,breastca,PROMPT1_ICL_entailment
22,118,22,13,9,0.5909090909090909,19,5,14,0.2631578947368421,0.3641456582633053,llama3,coral,breastca,PROMPT1_ICL_entailment
23,119,22,11,11,0.5,10,9,1,0.9,0.6428571428571429,llama3,coral,breastca,PROMPT1_ICL_entailment
24,12,22,14,8,0.6363636363636364,10,7,3,0.7,0.6666666666666666,llama3,coral,breastca,PROMPT1_ICL_entailment
25,120,28,19,9,0.6785714285714286,9,9,0,1.0,0.8085106382978724,llama3,coral,breastca,PROMPT1_ICL_entailment
26,121,34,21,13,0.6176470588235294,10,9,1,0.9,0.7325581395348838,llama3,coral,breastca,PROMPT1_ICL_entailment
27,122,28,19,9,0.6785714285714286,9,8,1,0.8888888888888888,0.769620253164557,llama3,coral,breastca,PROMPT1_ICL_entailment
28,123,22,11,11,0.5,8,7,1,0.875,0.6363636363636364,llama3,coral,breastca,PROMPT1_ICL_entailment
29,124,19,14,5,0.7368421052631579,10,9,1,0.9,0.810289389067524,llama3,coral,breastca,PROMPT1_ICL_entailment
30,125,30,21,9,0.7,11,8,3,0.7272727272727273,0.7133757961783439,llama3,coral,breastca,PROMPT1_ICL_entailment
31,126,15,11,4,0.7333333333333333,10,10,0,1.0,0.846153846153846,llama3,coral,breastca,PROMPT1_ICL_entailment
32,127,27,18,9,0.6666666666666666,10,7,3,0.7,0.6829268292682926,llama3,coral,breastca,PROMPT1_ICL_entailment
33,128,32,23,9,0.71875,11,8,3,0.7272727272727273,0.7229862475442043,llama3,coral,breastca,PROMPT1_ICL_entailment
34,129,24,15,9,0.625,11,7,4,0.6363636363636364,0.6306306306306306,llama3,coral,breastca,PROMPT1_ICL_entailment
35,13,30,19,11,0.6333333333333333,10,8,2,0.8,0.7069767441860466,llama3,coral,breastca,PROMPT1_ICL_entailment
36,130,859,849,10,0.9883585564610012,7,4,3,0.5714285714285714,0.7241710203646443,llama3,coral,breastca,PROMPT1_ICL_entailment
37,131,36,26,10,0.7222222222222222,10,8,2,0.8,0.759124087591241,llama3,coral,breastca,PROMPT1_ICL_entailment
38,132,19,15,4,0.7894736842105263,8,8,0,1.0,0.8823529411764706,llama3,coral,breastca,PROMPT1_ICL_entailment
39,133,40,25,15,0.625,29,17,12,0.5862068965517241,0.6049822064056939,llama3,coral,breastca,PROMPT1_ICL_entailment
40,134,24,9,15,0.375,11,8,3,0.7272727272727273,0.4948453608247422,llama3,coral,breastca,PROMPT1_ICL_entailment
41,135,24,13,11,0.5416666666666666,16,8,8,0.5,0.52,llama3,coral,breastca,PROMPT1_ICL_entailment
42,136,25,13,12,0.52,10,6,4,0.6,0.557142857142857,llama3,coral,breastca,PROMPT1_ICL_entailment
43,137,23,14,9,0.6086956521739131,10,9,1,0.9,0.7262247838616716,llama3,coral,breastca,PROMPT1_ICL_entailment
44,138,21,13,8,0.6190476190476191,10,10,0,1.0,0.7647058823529412,llama3,coral,breastca,PROMPT1_ICL_entailment
45,139,26,17,9,0.6538461538461539,11,9,2,0.8181818181818182,0.7268408551068883,llama3,coral,breastca,PROMPT1_ICL_entailment
46,14,70,53,17,0.7571428571428571,59,19,40,0.3220338983050847,0.4518734574826116,llama3,coral,breastca,PROMPT1_ICL_entailment
47,140,26,15,11,0.5769230769230769,9,8,1,0.8888888888888888,0.6997084548104956,llama3,coral,breastca,PROMPT1_ICL_entailment
48,141,24,14,10,0.5833333333333334,11,10,1,0.9090909090909092,0.7106598984771573,llama3,coral,breastca,PROMPT1_ICL_entailment
49,142,19,11,8,0.5789473684210527,10,8,2,0.8,0.6717557251908397,llama3,coral,breastca,PROMPT1_ICL_entailment
50,143,18,7,11,0.3888888888888889,10,5,5,0.5,0.4375,llama3,coral,breastca,PROMPT1_ICL_entailment
51,144,25,16,9,0.64,5,5,0,1.0,0.7804878048780487,llama3,coral,breastca,PROMPT1_ICL_entailment
52,145,20,11,9,0.55,5,5,0,1.0,0.7096774193548387,llama3,coral,breastca,PROMPT1_ICL_entailment
53,146,23,14,9,0.6086956521739131,9,8,1,0.8888888888888888,0.7225806451612903,llama3,coral,breastca,PROMPT1_ICL_entailment
54,147,28,19,9,0.6785714285714286,5,5,0,1.0,0.8085106382978724,llama3,coral,breastca,PROMPT1_ICL_entailment
55,148,21,12,9,0.5714285714285714,4,1,3,0.25,0.3478260869565217,llama3,coral,breastca,PROMPT1_ICL_entailment
56,149,20,12,8,0.6,1,1,0,1.0,0.7499999999999999,llama3,coral,breastca,PROMPT1_ICL_entailment
57,15,47,32,15,0.6808510638297872,16,9,7,0.5625,0.616042780748663,llama3,coral,breastca,PROMPT1_ICL_entailment
58,150,24,12,12,0.5,2,2,0,1.0,0.6666666666666666,llama3,coral,breastca,PROMPT1_ICL_entailment
59,151,19,11,8,0.5789473684210527,9,6,3,0.6666666666666666,0.619718309859155,llama3,coral,breastca,PROMPT1_ICL_entailment
60,152,22,13,9,0.5909090909090909,16,10,6,0.625,0.6074766355140188,llama3,coral,breastca,PROMPT1_ICL_entailment
61,153,22,14,8,0.6363636363636364,1,1,0,1.0,0.7777777777777778,llama3,coral,breastca,PROMPT1_ICL_entailment
62,154,22,13,9,0.5909090909090909,10,9,1,0.9,0.7134146341463415,llama3,coral,breastca,PROMPT1_ICL_entailment
63,155,29,19,10,0.6551724137931034,9,8,1,0.8888888888888888,0.7543424317617865,llama3,coral,breastca,PROMPT1_ICL_entailment
64,156,28,20,8,0.7142857142857143,8,8,0,1.0,0.8333333333333333,llama3,coral,breastca,PROMPT1_ICL_entailment
65,157,25,16,9,0.64,9,9,0,1.0,0.7804878048780487,llama3,coral,breastca,PROMPT1_ICL_entailment
66,158,30,20,10,0.6666666666666666,16,11,5,0.6875,0.676923076923077,llama3,coral,breastca,PROMPT1_ICL_entailment
67,159,42,23,19,0.5476190476190477,29,12,17,0.4137931034482758,0.4713919726729292,llama3,coral,breastca,PROMPT1_ICL_entailment
68,16,25,16,9,0.64,10,6,4,0.6,0.6193548387096774,llama3,coral,breastca,PROMPT1_ICL_entailment
69,160,79,58,21,0.7341772151898734,18,10,8,0.5555555555555556,0.6324972737186477,llama3,coral,breastca,PROMPT1_ICL_entailment
70,161,29,18,11,0.6206896551724138,11,10,1,0.9090909090909092,0.7377049180327868,llama3,coral,breastca,PROMPT1_ICL_entailment
71,162,25,16,9,0.64,16,12,4,0.75,0.6906474820143884,llama3,coral,breastca,PROMPT1_ICL_entailment
72,163,20,12,8,0.6,11,10,1,0.9090909090909092,0.7228915662650602,llama3,coral,breastca,PROMPT1_ICL_entailment
73,164,23,14,9,0.6086956521739131,8,5,3,0.625,0.6167400881057269,llama3,coral,breastca,PROMPT1_ICL_entailment
74,165,24,14,10,0.5833333333333334,12,10,2,0.8333333333333334,0.6862745098039216,llama3,coral,breastca,PROMPT1_ICL_entailment
75,166,23,14,9,0.6086956521739131,10,6,4,0.6,0.6043165467625898,llama3,coral,breastca,PROMPT1_ICL_entailment
76,167,29,20,9,0.6896551724137931,7,6,1,0.8571428571428571,0.7643312101910829,llama3,coral,breastca,PROMPT1_ICL_entailment
77,168,17,6,11,0.3529411764705882,7,5,2,0.7142857142857143,0.4724409448818898,llama3,coral,breastca,PROMPT1_ICL_entailment
78,169,18,8,10,0.4444444444444444,11,4,7,0.3636363636363636,0.3999999999999999,llama3,coral,breastca,PROMPT1_ICL_entailment
79,17,15,6,9,0.4,3,3,0,1.0,0.5714285714285715,llama3,coral,breastca,PROMPT1_ICL_entailment
80,170,27,18,9,0.6666666666666666,10,9,1,0.9,0.7659574468085106,llama3,coral,breastca,PROMPT1_ICL_entailment
81,171,23,15,8,0.6521739130434783,9,9,0,1.0,0.7894736842105263,llama3,coral,breastca,PROMPT1_ICL_entailment
82,172,49,39,10,0.7959183673469388,32,12,20,0.375,0.5098039215686274,llama3,coral,breastca,PROMPT1_ICL_entailment
83,173,20,10,10,0.5,11,9,2,0.8181818181818182,0.6206896551724137,llama3,coral,breastca,PROMPT1_ICL_entailment
84,174,22,12,10,0.5454545454545454,7,7,0,1.0,0.7058823529411764,llama3,coral,breastca,PROMPT1_ICL_entailment
85,175,22,11,11,0.5,10,7,3,0.7,0.5833333333333334,llama3,coral,breastca,PROMPT1_ICL_entailment
86,176,16,7,9,0.4375,10,4,6,0.4,0.417910447761194,llama3,coral,breastca,PROMPT1_ICL_entailment
87,177,26,16,10,0.6153846153846154,9,9,0,1.0,0.761904761904762,llama3,coral,breastca,PROMPT1_ICL_entailment
88,178,25,14,11,0.56,10,6,4,0.6,0.5793103448275861,llama3,coral,breastca,PROMPT1_ICL_entailment
89,179,20,10,10,0.5,9,9,0,1.0,0.6666666666666666,llama3,coral,breastca,PROMPT1_ICL_entailment
90,18,24,17,7,0.7083333333333334,8,7,1,0.875,0.7828947368421053,llama3,coral,breastca,PROMPT1_ICL_entailment
91,180,22,13,9,0.5909090909090909,10,7,3,0.7,0.6408450704225351,llama3,coral,breastca,PROMPT1_ICL_entailment
92,181,19,11,8,0.5789473684210527,9,7,2,0.7777777777777778,0.6637931034482759,llama3,coral,breastca,PROMPT1_ICL_entailment
93,182,22,13,9,0.5909090909090909,9,5,4,0.5555555555555556,0.5726872246696034,llama3,coral,breastca,PROMPT1_ICL_entailment
94,183,20,11,9,0.55,10,8,2,0.8,0.6518518518518519,llama3,coral,breastca,PROMPT1_ICL_entailment
95,184,26,16,10,0.6153846153846154,9,8,1,0.8888888888888888,0.7272727272727274,llama3,coral,breastca,PROMPT1_ICL_entailment
96,185,25,16,9,0.64,10,5,5,0.5,0.5614035087719298,llama3,coral,breastca,PROMPT1_ICL_entailment
97,186,17,9,8,0.5294117647058824,5,4,1,0.8,0.6371681415929203,llama3,coral,breastca,PROMPT1_ICL_entailment
98,187,25,19,6,0.76,26,15,11,0.5769230769230769,0.6559263521288837,llama3,coral,breastca,PROMPT1_ICL_entailment
99,188,23,14,9,0.6086956521739131,9,9,0,1.0,0.7567567567567568,llama3,coral,breastca,PROMPT1_ICL_entailment
100,189,19,15,4,0.7894736842105263,9,9,0,1.0,0.8823529411764706,llama3,coral,breastca,PROMPT1_ICL_entailment
101,19,20,12,8,0.6,8,7,1,0.875,0.711864406779661,llama3,coral,breastca,PROMPT1_ICL_entailment
102,190,44,12,32,0.2727272727272727,34,17,17,0.5,0.3529411764705882,llama3,coral,breastca,PROMPT1_ICL_entailment
103,191,51,30,21,0.5882352941176471,14,7,7,0.5,0.5405405405405405,llama3,coral,breastca,PROMPT1_ICL_entailment
104,192,24,12,12,0.5,12,9,3,0.75,0.6,llama3,coral,breastca,PROMPT1_ICL_entailment
105,193,16,8,8,0.5,2,1,1,0.5,0.5,llama3,coral,breastca,PROMPT1_ICL_entailment
106,194,19,18,1,0.9473684210526316,15,12,3,0.8,0.8674698795180723,llama3,coral,breastca,PROMPT1_ICL_entailment
107,195,25,14,11,0.56,13,13,0,1.0,0.717948717948718,llama3,coral,breastca,PROMPT1_ICL_entailment
108,196,44,31,13,0.7045454545454546,30,13,17,0.4333333333333333,0.5366178428761652,llama3,coral,breastca,PROMPT1_ICL_entailment
109,197,62,50,12,0.8064516129032258,14,10,4,0.7142857142857143,0.7575757575757576,llama3,coral,breastca,PROMPT1_ICL_entailment
110,198,33,24,9,0.7272727272727273,11,7,4,0.6363636363636364,0.6787878787878787,llama3,coral,breastca,PROMPT1_ICL_entailment
111,199,13,4,9,0.3076923076923077,2,2,0,1.0,0.4705882352941176,llama3,coral,breastca,PROMPT1_ICL_entailment
112,2,33,22,11,0.6666666666666666,10,6,4,0.6,0.631578947368421,llama3,coral,breastca,PROMPT1_ICL_entailment
113,20,23,10,13,0.4347826086956521,17,8,9,0.4705882352941176,0.4519774011299435,llama3,coral,breastca,PROMPT1_ICL_entailment
114,200,23,12,11,0.5217391304347826,15,8,7,0.5333333333333333,0.5274725274725275,llama3,coral,breastca,PROMPT1_ICL_entailment
115,201,33,21,12,0.6363636363636364,26,15,11,0.5769230769230769,0.6051873198847261,llama3,coral,breastca,PROMPT1_ICL_entailment
116,202,28,18,10,0.6428571428571429,17,10,7,0.5882352941176471,0.6143344709897611,llama3,coral,breastca,PROMPT1_ICL_entailment
117,203,41,32,9,0.7804878048780488,27,13,14,0.4814814814814814,0.5955619183965641,llama3,coral,breastca,PROMPT1_ICL_entailment
118,204,15,6,9,0.4,11,5,6,0.4545454545454545,0.4255319148936171,llama3,coral,breastca,PROMPT1_ICL_entailment
119,205,26,17,9,0.6538461538461539,11,9,2,0.8181818181818182,0.7268408551068883,llama3,coral,breastca,PROMPT1_ICL_entailment
120,206,20,12,8,0.6,4,4,0,1.0,0.7499999999999999,llama3,coral,breastca,PROMPT1_ICL_entailment
121,207,26,14,12,0.5384615384615384,12,6,6,0.5,0.5185185185185186,llama3,coral,breastca,PROMPT1_ICL_entailment
122,208,22,18,4,0.8181818181818182,9,9,0,1.0,0.9,llama3,coral,breastca,PROMPT1_ICL_entailment
123,209,53,49,4,0.9245283018867924,11,7,4,0.6363636363636364,0.7538461538461539,llama3,coral,breastca,PROMPT1_ICL_entailment
124,21,46,26,20,0.5652173913043478,27,8,19,0.2962962962962963,0.3887850467289719,llama3,coral,breastca,PROMPT1_ICL_entailment
125,210,30,17,13,0.5666666666666667,13,7,6,0.5384615384615384,0.5522041763341067,llama3,coral,breastca,PROMPT1_ICL_entailment
126,211,31,23,8,0.7419354838709677,11,9,2,0.8181818181818182,0.7781954887218046,llama3,coral,breastca,PROMPT1_ICL_entailment
127,212,30,17,13,0.5666666666666667,9,5,4,0.5555555555555556,0.5610561056105611,llama3,coral,breastca,PROMPT1_ICL_entailment
128,213,38,24,14,0.631578947368421,11,7,4,0.6363636363636364,0.6339622641509434,llama3,coral,breastca,PROMPT1_ICL_entailment
129,214,26,9,17,0.3461538461538461,28,7,21,0.25,0.2903225806451613,llama3,coral,breastca,PROMPT1_ICL_entailment
130,215,40,24,16,0.6,37,19,18,0.5135135135135135,0.5533980582524272,llama3,coral,breastca,PROMPT1_ICL_entailment
131,216,39,28,11,0.717948717948718,15,12,3,0.8,0.7567567567567569,llama3,coral,breastca,PROMPT1_ICL_entailment
132,22,20,7,13,0.35,7,6,1,0.8571428571428571,0.4970414201183432,llama3,coral,breastca,PROMPT1_ICL_entailment
133,23,19,11,8,0.5789473684210527,9,7,2,0.7777777777777778,0.6637931034482759,llama3,coral,breastca,PROMPT1_ICL_entailment
134,24,22,13,9,0.5909090909090909,10,6,4,0.6,0.5954198473282443,llama3,coral,breastca,PROMPT1_ICL_entailment
135,25,31,21,10,0.6774193548387096,8,8,0,1.0,0.8076923076923077,llama3,coral,breastca,PROMPT1_ICL_entailment
136,26,26,16,10,0.6153846153846154,11,10,1,0.9090909090909092,0.7339449541284404,llama3,coral,breastca,PROMPT1_ICL_entailment
137,27,20,10,10,0.5,12,9,3,0.75,0.6,llama3,coral,breastca,PROMPT1_ICL_entailment
138,28,31,18,13,0.5806451612903226,18,13,5,0.7222222222222222,0.6437414030261348,llama3,coral,breastca,PROMPT1_ICL_entailment
139,29,20,10,10,0.5,9,5,4,0.5555555555555556,0.5263157894736842,llama3,coral,breastca,PROMPT1_ICL_entailment
140,3,23,12,11,0.5217391304347826,11,4,7,0.3636363636363636,0.4285714285714285,llama3,coral,breastca,PROMPT1_ICL_entailment
141,30,33,16,17,0.4848484848484848,18,9,9,0.5,0.4923076923076923,llama3,coral,breastca,PROMPT1_ICL_entailment
142,31,26,13,13,0.5,13,9,4,0.6923076923076923,0.5806451612903226,llama3,coral,breastca,PROMPT1_ICL_entailment
143,32,20,9,11,0.45,9,8,1,0.8888888888888888,0.5975103734439834,llama3,coral,breastca,PROMPT1_ICL_entailment
144,33,23,11,12,0.4782608695652174,8,6,2,0.75,0.5840707964601771,llama3,coral,breastca,PROMPT1_ICL_entailment
145,34,15,6,9,0.4,10,4,6,0.4,0.4000000000000001,llama3,coral,breastca,PROMPT1_ICL_entailment
146,35,31,19,12,0.6129032258064516,12,8,4,0.6666666666666666,0.6386554621848739,llama3,coral,breastca,PROMPT1_ICL_entailment
147,36,26,16,10,0.6153846153846154,11,11,0,1.0,0.761904761904762,llama3,coral,breastca,PROMPT1_ICL_entailment
148,37,25,17,8,0.68,11,7,4,0.6363636363636364,0.6574585635359116,llama3,coral,breastca,PROMPT1_ICL_entailment
149,38,21,13,8,0.6190476190476191,11,7,4,0.6363636363636364,0.6275862068965518,llama3,coral,breastca,PROMPT1_ICL_entailment
150,39,23,14,9,0.6086956521739131,11,10,1,0.9090909090909092,0.7291666666666666,llama3,coral,breastca,PROMPT1_ICL_entailment
151,4,51,22,29,0.4313725490196078,59,19,40,0.3220338983050847,0.368769298632554,llama3,coral,breastca,PROMPT1_ICL_entailment
152,40,24,16,8,0.6666666666666666,9,8,1,0.8888888888888888,0.761904761904762,llama3,coral,breastca,PROMPT1_ICL_entailment
153,41,18,9,9,0.5,14,2,12,0.1428571428571428,0.2222222222222222,llama3,coral,breastca,PROMPT1_ICL_entailment
154,42,23,12,11,0.5217391304347826,9,4,5,0.4444444444444444,0.48,llama3,coral,breastca,PROMPT1_ICL_entailment
155,43,20,10,10,0.5,9,6,3,0.6666666666666666,0.5714285714285715,llama3,coral,breastca,PROMPT1_ICL_entailment
156,44,23,14,9,0.6086956521739131,9,8,1,0.8888888888888888,0.7225806451612903,llama3,coral,breastca,PROMPT1_ICL_entailment
157,45,11,2,9,0.1818181818181818,2,2,0,1.0,0.3076923076923077,llama3,coral,breastca,PROMPT1_ICL_entailment
158,46,19,13,6,0.6842105263157895,5,4,1,0.8,0.7375886524822695,llama3,coral,breastca,PROMPT1_ICL_entailment
159,47,20,13,7,0.65,2,1,1,0.5,0.5652173913043479,llama3,coral,breastca,PROMPT1_ICL_entailment
160,48,17,9,8,0.5294117647058824,5,3,2,0.6,0.5625,llama3,coral,breastca,PROMPT1_ICL_entailment
161,49,43,24,19,0.5581395348837209,16,12,4,0.75,0.6399999999999999,llama3,coral,breastca,PROMPT1_ICL_entailment
162,5,38,25,13,0.6578947368421053,12,7,5,0.5833333333333334,0.6183745583038869,llama3,coral,breastca,PROMPT1_ICL_entailment
163,50,23,11,12,0.4782608695652174,16,11,5,0.6875,0.5641025641025642,llama3,coral,breastca,PROMPT1_ICL_entailment
164,51,48,33,15,0.6875,11,8,3,0.7272727272727273,0.7068273092369478,llama3,coral,breastca,PROMPT1_ICL_entailment
165,52,24,12,12,0.5,10,9,1,0.9,0.6428571428571429,llama3,coral,breastca,PROMPT1_ICL_entailment
166,53,17,11,6,0.6470588235294118,10,10,0,1.0,0.7857142857142858,llama3,coral,breastca,PROMPT1_ICL_entailment
167,54,29,15,14,0.5172413793103449,9,7,2,0.7777777777777778,0.621301775147929,llama3,coral,breastca,PROMPT1_ICL_entailment
168,55,10,2,8,0.2,1,1,0,1.0,0.3333333333333333,llama3,coral,breastca,PROMPT1_ICL_entailment
169,56,21,14,7,0.6666666666666666,18,7,11,0.3888888888888889,0.4912280701754385,llama3,coral,breastca,PROMPT1_ICL_entailment
170,57,29,19,10,0.6551724137931034,10,9,1,0.9,0.7583148558758314,llama3,coral,breastca,PROMPT1_ICL_entailment
171,58,28,19,9,0.6785714285714286,10,9,1,0.9,0.7737556561085973,llama3,coral,breastca,PROMPT1_ICL_entailment
172,59,22,13,9,0.5909090909090909,9,8,1,0.8888888888888888,0.7098976109215018,llama3,coral,breastca,PROMPT1_ICL_entailment
173,6,23,12,11,0.5217391304347826,8,8,0,1.0,0.6857142857142856,llama3,coral,breastca,PROMPT1_ICL_entailment
174,60,23,19,4,0.8260869565217391,10,7,3,0.7,0.7578347578347578,llama3,coral,breastca,PROMPT1_ICL_entailment
175,61,23,14,9,0.6086956521739131,11,10,1,0.9090909090909092,0.7291666666666666,llama3,coral,breastca,PROMPT1_ICL_entailment
176,62,28,18,10,0.6428571428571429,10,9,1,0.9,0.75,llama3,coral,breastca,PROMPT1_ICL_entailment
177,63,19,11,8,0.5789473684210527,11,10,1,0.9090909090909092,0.7073954983922829,llama3,coral,breastca,PROMPT1_ICL_entailment
178,64,101,7,94,0.0693069306930693,17,7,10,0.4117647058823529,0.1186440677966101,llama3,coral,breastca,PROMPT1_ICL_entailment
179,65,26,17,9,0.6538461538461539,6,6,0,1.0,0.7906976744186047,llama3,coral,breastca,PROMPT1_ICL_entailment
180,66,27,18,9,0.6666666666666666,10,10,0,1.0,0.8,llama3,coral,breastca,PROMPT1_ICL_entailment
181,67,49,27,22,0.5510204081632653,49,20,29,0.4081632653061224,0.4689535388623534,llama3,coral,breastca,PROMPT1_ICL_entailment
182,68,22,10,12,0.4545454545454545,8,7,1,0.875,0.5982905982905983,llama3,coral,breastca,PROMPT1_ICL_entailment
183,69,42,12,30,0.2857142857142857,12,2,10,0.1666666666666666,0.2105263157894737,llama3,coral,breastca,PROMPT1_ICL_entailment
184,7,24,16,8,0.6666666666666666,11,11,0,1.0,0.8,llama3,coral,breastca,PROMPT1_ICL_entailment
185,70,105,89,16,0.8476190476190476,51,11,40,0.2156862745098039,0.3438707411310151,llama3,coral,breastca,PROMPT1_ICL_entailment
186,71,19,9,10,0.4736842105263157,5,3,2,0.6,0.5294117647058824,llama3,coral,breastca,PROMPT1_ICL_entailment
187,72,19,11,8,0.5789473684210527,3,1,2,0.3333333333333333,0.4230769230769231,llama3,coral,breastca,PROMPT1_ICL_entailment
188,73,19,10,9,0.5263157894736842,1,1,0,1.0,0.6896551724137931,llama3,coral,breastca,PROMPT1_ICL_entailment
189,74,23,14,9,0.6086956521739131,2,2,0,1.0,0.7567567567567568,llama3,coral,breastca,PROMPT1_ICL_entailment
190,75,26,16,10,0.6153846153846154,6,6,0,1.0,0.761904761904762,llama3,coral,breastca,PROMPT1_ICL_entailment
191,76,20,12,8,0.6,7,7,0,1.0,0.7499999999999999,llama3,coral,breastca,PROMPT1_ICL_entailment
192,77,26,17,9,0.6538461538461539,15,12,3,0.8,0.7195767195767195,llama3,coral,breastca,PROMPT1_ICL_entailment
193,78,24,14,10,0.5833333333333334,8,5,3,0.625,0.603448275862069,llama3,coral,breastca,PROMPT1_ICL_entailment
194,79,16,7,9,0.4375,8,5,3,0.625,0.5147058823529411,llama3,coral,breastca,PROMPT1_ICL_entailment
195,8,18,8,10,0.4444444444444444,9,6,3,0.6666666666666666,0.5333333333333333,llama3,coral,breastca,PROMPT1_ICL_entailment
196,80,30,28,2,0.9333333333333332,24,19,5,0.7916666666666666,0.8566827697262479,llama3,coral,breastca,PROMPT1_ICL_entailment
197,81,18,9,9,0.5,11,6,5,0.5454545454545454,0.5217391304347826,llama3,coral,breastca,PROMPT1_ICL_entailment
198,82,17,9,8,0.5294117647058824,6,4,2,0.6666666666666666,0.5901639344262295,llama3,coral,breastca,PROMPT1_ICL_entailment
199,83,21,12,9,0.5714285714285714,6,5,1,0.8333333333333334,0.6779661016949152,llama3,coral,breastca,PROMPT1_ICL_entailment
200,84,23,15,8,0.6521739130434783,11,9,2,0.8181818181818182,0.7258064516129032,llama3,coral,breastca,PROMPT1_ICL_entailment
201,85,23,12,11,0.5217391304347826,7,6,1,0.8571428571428571,0.6486486486486486,llama3,coral,breastca,PROMPT1_ICL_entailment
202,86,30,17,13,0.5666666666666667,16,12,4,0.75,0.6455696202531646,llama3,coral,breastca,PROMPT1_ICL_entailment
203,87,17,7,10,0.4117647058823529,8,5,3,0.625,0.4964539007092198,llama3,coral,breastca,PROMPT1_ICL_entailment
204,88,18,10,8,0.5555555555555556,8,7,1,0.875,0.6796116504854369,llama3,coral,breastca,PROMPT1_ICL_entailment
205,89,21,11,10,0.5238095238095238,11,7,4,0.6363636363636364,0.5746268656716419,llama3,coral,breastca,PROMPT1_ICL_entailment
206,9,20,10,10,0.5,6,6,0,1.0,0.6666666666666666,llama3,coral,breastca,PROMPT1_ICL_entailment
207,90,54,25,29,0.4629629629629629,17,8,9,0.4705882352941176,0.4667444574095682,llama3,coral,breastca,PROMPT1_ICL_entailment
208,91,23,14,9,0.6086956521739131,7,5,2,0.7142857142857143,0.6572769953051643,llama3,coral,breastca,PROMPT1_ICL_entailment
209,92,13,4,9,0.3076923076923077,2,2,0,1.0,0.4705882352941176,llama3,coral,breastca,PROMPT1_ICL_entailment
210,93,19,19,0,1.0,13,11,2,0.8461538461538461,0.9166666666666666,llama3,coral,breastca,PROMPT1_ICL_entailment
211,94,29,17,12,0.5862068965517241,25,13,12,0.52,0.5511221945137157,llama3,coral,breastca,PROMPT1_ICL_entailment
212,95,35,26,9,0.7428571428571429,13,8,5,0.6153846153846154,0.6731391585760518,llama3,coral,breastca,PROMPT1_ICL_entailment
213,96,26,17,9,0.6538461538461539,10,10,0,1.0,0.7906976744186047,llama3,coral,breastca,PROMPT1_ICL_entailment
214,97,35,22,13,0.6285714285714286,11,9,2,0.8181818181818182,0.710951526032316,llama3,coral,breastca,PROMPT1_ICL_entailment
215,98,15,6,9,0.4,2,2,0,1.0,0.5714285714285715,llama3,coral,breastca,PROMPT1_ICL_entailment
216,99,19,10,9,0.5263157894736842,15,9,6,0.6,0.5607476635514018,llama3,coral,breastca,PROMPT1_ICL_entailment
0,0,19,19,0,1.0,10,9,1,0.9,0.9473684210526316,llama3,coral,breastca,PROMPT2_ICL_entailment
1,1,63,43,20,0.6825396825396826,12,10,2,0.8333333333333334,0.7504363001745201,llama3,coral,breastca,PROMPT2_ICL_entailment
2,10,23,19,4,0.8260869565217391,10,10,0,1.0,0.9047619047619048,llama3,coral,breastca,PROMPT2_ICL_entailment
3,100,32,21,11,0.65625,26,10,16,0.3846153846153846,0.4849884526558891,llama3,coral,breastca,PROMPT2_ICL_entailment
4,101,29,29,0,1.0,18,15,3,0.8333333333333334,0.9090909090909092,llama3,coral,breastca,PROMPT2_ICL_entailment
5,102,15,14,1,0.9333333333333332,7,4,3,0.5714285714285714,0.7088607594936709,llama3,coral,breastca,PROMPT2_ICL_entailment
6,103,27,26,1,0.9629629629629628,10,9,1,0.9,0.930417495029821,llama3,coral,breastca,PROMPT2_ICL_entailment
7,104,32,24,8,0.75,26,13,13,0.5,0.6,llama3,coral,breastca,PROMPT2_ICL_entailment
8,105,26,25,1,0.9615384615384616,15,13,2,0.8666666666666667,0.91164095371669,llama3,coral,breastca,PROMPT2_ICL_entailment
9,106,19,18,1,0.9473684210526316,9,8,1,0.8888888888888888,0.9171974522292994,llama3,coral,breastca,PROMPT2_ICL_entailment
10,107,23,17,6,0.7391304347826086,9,6,3,0.6666666666666666,0.7010309278350515,llama3,coral,breastca,PROMPT2_ICL_entailment
11,108,23,20,3,0.8695652173913043,11,10,1,0.9090909090909092,0.888888888888889,llama3,coral,breastca,PROMPT2_ICL_entailment
12,109,21,19,2,0.9047619047619048,11,11,0,1.0,0.95,llama3,coral,breastca,PROMPT2_ICL_entailment
13,11,13,13,0,1.0,3,3,0,1.0,1.0,llama3,coral,breastca,PROMPT2_ICL_entailment
14,110,17,12,5,0.7058823529411765,11,10,1,0.9090909090909092,0.794701986754967,llama3,coral,breastca,PROMPT2_ICL_entailment
15,111,17,10,7,0.5882352941176471,10,8,2,0.8,0.6779661016949153,llama3,coral,breastca,PROMPT2_ICL_entailment
16,112,17,16,1,0.9411764705882352,10,10,0,1.0,0.9696969696969696,llama3,coral,breastca,PROMPT2_ICL_entailment
17,113,27,26,1,0.9629629629629628,49,23,26,0.4693877551020408,0.6311345646437996,llama3,coral,breastca,PROMPT2_ICL_entailment
18,114,24,21,3,0.875,21,15,6,0.7142857142857143,0.7865168539325842,llama3,coral,breastca,PROMPT2_ICL_entailment
19,115,17,15,2,0.8823529411764706,9,9,0,1.0,0.9375,llama3,coral,breastca,PROMPT2_ICL_entailment
20,116,16,16,0,1.0,14,9,5,0.6428571428571429,0.782608695652174,llama3,coral,breastca,PROMPT2_ICL_entailment
21,117,10,9,1,0.9,2,1,1,0.5,0.6428571428571429,llama3,coral,breastca,PROMPT2_ICL_entailment
22,118,15,14,1,0.9333333333333332,19,3,16,0.1578947368421052,0.270096463022508,llama3,coral,breastca,PROMPT2_ICL_entailment
23,119,23,20,3,0.8695652173913043,10,9,1,0.9,0.8845208845208845,llama3,coral,breastca,PROMPT2_ICL_entailment
24,12,20,20,0,1.0,10,9,1,0.9,0.9473684210526316,llama3,coral,breastca,PROMPT2_ICL_entailment
25,120,26,25,1,0.9615384615384616,9,9,0,1.0,0.9803921568627452,llama3,coral,breastca,PROMPT2_ICL_entailment
26,121,32,27,5,0.84375,10,8,2,0.8,0.8212927756653993,llama3,coral,breastca,PROMPT2_ICL_entailment
27,122,28,23,5,0.8214285714285714,9,9,0,1.0,0.9019607843137256,llama3,coral,breastca,PROMPT2_ICL_entailment
28,123,30,26,4,0.8666666666666667,8,8,0,1.0,0.9285714285714286,llama3,coral,breastca,PROMPT2_ICL_entailment
29,124,23,22,1,0.9565217391304348,10,10,0,1.0,0.9777777777777776,llama3,coral,breastca,PROMPT2_ICL_entailment
30,125,30,27,3,0.9,11,9,2,0.8181818181818182,0.8571428571428572,llama3,coral,breastca,PROMPT2_ICL_entailment
31,126,18,18,0,1.0,10,9,1,0.9,0.9473684210526316,llama3,coral,breastca,PROMPT2_ICL_entailment
32,127,20,20,0,1.0,10,9,1,0.9,0.9473684210526316,llama3,coral,breastca,PROMPT2_ICL_entailment
33,128,34,30,4,0.8823529411764706,11,6,5,0.5454545454545454,0.6741573033707865,llama3,coral,breastca,PROMPT2_ICL_entailment
34,129,20,19,1,0.95,11,8,3,0.7272727272727273,0.8238482384823849,llama3,coral,breastca,PROMPT2_ICL_entailment
35,13,21,19,2,0.9047619047619048,10,9,1,0.9,0.9023746701846964,llama3,coral,breastca,PROMPT2_ICL_entailment
36,130,9,7,2,0.7777777777777778,7,7,0,1.0,0.8750000000000001,llama3,coral,breastca,PROMPT2_ICL_entailment
37,131,30,29,1,0.9666666666666668,10,10,0,1.0,0.983050847457627,llama3,coral,breastca,PROMPT2_ICL_entailment
38,132,18,17,1,0.9444444444444444,8,8,0,1.0,0.9714285714285714,llama3,coral,breastca,PROMPT2_ICL_entailment
39,133,32,27,5,0.84375,29,19,10,0.6551724137931034,0.7375988497483825,llama3,coral,breastca,PROMPT2_ICL_entailment
40,134,29,17,12,0.5862068965517241,11,8,3,0.7272727272727273,0.649164677804296,llama3,coral,breastca,PROMPT2_ICL_entailment
41,135,26,22,4,0.8461538461538461,16,14,2,0.875,0.8603351955307262,llama3,coral,breastca,PROMPT2_ICL_entailment
42,136,31,24,7,0.7741935483870968,10,10,0,1.0,0.8727272727272727,llama3,coral,breastca,PROMPT2_ICL_entailment
43,137,16,16,0,1.0,10,10,0,1.0,1.0,llama3,coral,breastca,PROMPT2_ICL_entailment
44,138,13,13,0,1.0,10,10,0,1.0,1.0,llama3,coral,breastca,PROMPT2_ICL_entailment
45,139,21,17,4,0.8095238095238095,11,10,1,0.9090909090909092,0.8564231738035265,llama3,coral,breastca,PROMPT2_ICL_entailment
46,14,21,20,1,0.9523809523809524,59,16,43,0.2711864406779661,0.4221635883905013,llama3,coral,breastca,PROMPT2_ICL_entailment
47,140,30,27,3,0.9,9,9,0,1.0,0.9473684210526316,llama3,coral,breastca,PROMPT2_ICL_entailment
48,141,38,35,3,0.9210526315789472,11,11,0,1.0,0.958904109589041,llama3,coral,breastca,PROMPT2_ICL_entailment
49,142,15,13,2,0.8666666666666667,10,9,1,0.9,0.8830188679245283,llama3,coral,breastca,PROMPT2_ICL_entailment
50,143,20,14,6,0.7,10,9,1,0.9,0.7875,llama3,coral,breastca,PROMPT2_ICL_entailment
51,144,23,21,2,0.9130434782608696,5,4,1,0.8,0.852791878172589,llama3,coral,breastca,PROMPT2_ICL_entailment
52,145,15,13,2,0.8666666666666667,5,3,2,0.6,0.7090909090909091,llama3,coral,breastca,PROMPT2_ICL_entailment
53,146,19,18,1,0.9473684210526316,9,9,0,1.0,0.972972972972973,llama3,coral,breastca,PROMPT2_ICL_entailment
54,147,20,18,2,0.9,5,5,0,1.0,0.9473684210526316,llama3,coral,breastca,PROMPT2_ICL_entailment
55,148,24,21,3,0.875,4,1,3,0.25,0.3888888888888889,llama3,coral,breastca,PROMPT2_ICL_entailment
56,149,14,13,1,0.9285714285714286,1,1,0,1.0,0.962962962962963,llama3,coral,breastca,PROMPT2_ICL_entailment
57,15,45,35,10,0.7777777777777778,16,4,12,0.25,0.3783783783783784,llama3,coral,breastca,PROMPT2_ICL_entailment
58,150,20,17,3,0.85,2,2,0,1.0,0.9189189189189187,llama3,coral,breastca,PROMPT2_ICL_entailment
59,151,14,14,0,1.0,9,7,2,0.7777777777777778,0.8750000000000001,llama3,coral,breastca,PROMPT2_ICL_entailment
60,152,23,21,2,0.9130434782608696,16,15,1,0.9375,0.9251101321585904,llama3,coral,breastca,PROMPT2_ICL_entailment
61,153,16,16,0,1.0,1,1,0,1.0,1.0,llama3,coral,breastca,PROMPT2_ICL_entailment
62,154,16,15,1,0.9375,10,10,0,1.0,0.967741935483871,llama3,coral,breastca,PROMPT2_ICL_entailment
63,155,28,26,2,0.9285714285714286,9,9,0,1.0,0.962962962962963,llama3,coral,breastca,PROMPT2_ICL_entailment
64,156,16,15,1,0.9375,8,7,1,0.875,0.9051724137931034,llama3,coral,breastca,PROMPT2_ICL_entailment
65,157,26,24,2,0.9230769230769232,9,8,1,0.8888888888888888,0.9056603773584906,llama3,coral,breastca,PROMPT2_ICL_entailment
66,158,40,27,13,0.675,16,11,5,0.6875,0.6811926605504588,llama3,coral,breastca,PROMPT2_ICL_entailment
67,159,29,23,6,0.7931034482758621,29,18,11,0.6206896551724138,0.6963835155592936,llama3,coral,breastca,PROMPT2_ICL_entailment
68,16,19,14,5,0.7368421052631579,10,8,2,0.8,0.7671232876712328,llama3,coral,breastca,PROMPT2_ICL_entailment
69,160,66,55,11,0.8333333333333334,18,10,8,0.5555555555555556,0.6666666666666667,llama3,coral,breastca,PROMPT2_ICL_entailment
70,161,31,31,0,1.0,11,8,3,0.7272727272727273,0.8421052631578948,llama3,coral,breastca,PROMPT2_ICL_entailment
71,162,22,19,3,0.8636363636363636,16,10,6,0.625,0.7251908396946565,llama3,coral,breastca,PROMPT2_ICL_entailment
72,163,17,17,0,1.0,11,10,1,0.9090909090909092,0.9523809523809524,llama3,coral,breastca,PROMPT2_ICL_entailment
73,164,15,15,0,1.0,8,4,4,0.5,0.6666666666666666,llama3,coral,breastca,PROMPT2_ICL_entailment
74,165,19,17,2,0.8947368421052632,12,10,2,0.8333333333333334,0.8629441624365481,llama3,coral,breastca,PROMPT2_ICL_entailment
75,166,20,19,1,0.95,10,7,3,0.7,0.806060606060606,llama3,coral,breastca,PROMPT2_ICL_entailment
76,167,27,20,7,0.7407407407407407,7,7,0,1.0,0.851063829787234,llama3,coral,breastca,PROMPT2_ICL_entailment
77,168,16,12,4,0.75,7,5,2,0.7142857142857143,0.7317073170731706,llama3,coral,breastca,PROMPT2_ICL_entailment
78,169,15,14,1,0.9333333333333332,11,8,3,0.7272727272727273,0.8175182481751825,llama3,coral,breastca,PROMPT2_ICL_entailment
79,17,13,13,0,1.0,3,3,0,1.0,1.0,llama3,coral,breastca,PROMPT2_ICL_entailment
80,170,21,20,1,0.9523809523809524,10,10,0,1.0,0.975609756097561,llama3,coral,breastca,PROMPT2_ICL_entailment
81,171,23,22,1,0.9565217391304348,9,8,1,0.8888888888888888,0.9214659685863874,llama3,coral,breastca,PROMPT2_ICL_entailment
82,172,38,36,2,0.9473684210526316,32,14,18,0.4375,0.5985748218527316,llama3,coral,breastca,PROMPT2_ICL_entailment
83,173,14,14,0,1.0,11,10,1,0.9090909090909092,0.9523809523809524,llama3,coral,breastca,PROMPT2_ICL_entailment
84,174,23,15,8,0.6521739130434783,7,4,3,0.5714285714285714,0.6091370558375634,llama3,coral,breastca,PROMPT2_ICL_entailment
85,175,15,13,2,0.8666666666666667,10,10,0,1.0,0.9285714285714286,llama3,coral,breastca,PROMPT2_ICL_entailment
86,176,12,12,0,1.0,10,9,1,0.9,0.9473684210526316,llama3,coral,breastca,PROMPT2_ICL_entailment
87,177,20,19,1,0.95,9,9,0,1.0,0.9743589743589745,llama3,coral,breastca,PROMPT2_ICL_entailment
88,178,19,16,3,0.8421052631578947,10,8,2,0.8,0.8205128205128205,llama3,coral,breastca,PROMPT2_ICL_entailment
89,179,21,20,1,0.9523809523809524,9,9,0,1.0,0.975609756097561,llama3,coral,breastca,PROMPT2_ICL_entailment
90,18,24,24,0,1.0,8,7,1,0.875,0.9333333333333332,llama3,coral,breastca,PROMPT2_ICL_entailment
91,180,21,21,0,1.0,10,8,2,0.8,0.888888888888889,llama3,coral,breastca,PROMPT2_ICL_entailment
92,181,13,13,0,1.0,9,7,2,0.7777777777777778,0.8750000000000001,llama3,coral,breastca,PROMPT2_ICL_entailment
93,182,18,17,1,0.9444444444444444,9,8,1,0.8888888888888888,0.9158249158249158,llama3,coral,breastca,PROMPT2_ICL_entailment
94,183,20,20,0,1.0,10,8,2,0.8,0.888888888888889,llama3,coral,breastca,PROMPT2_ICL_entailment
95,184,19,18,1,0.9473684210526316,9,6,3,0.6666666666666666,0.782608695652174,llama3,coral,breastca,PROMPT2_ICL_entailment
96,185,30,30,0,1.0,10,8,2,0.8,0.888888888888889,llama3,coral,breastca,PROMPT2_ICL_entailment
97,186,13,13,0,1.0,5,5,0,1.0,1.0,llama3,coral,breastca,PROMPT2_ICL_entailment
98,187,29,25,4,0.8620689655172413,26,22,4,0.8461538461538461,0.8540372670807455,llama3,coral,breastca,PROMPT2_ICL_entailment
99,188,19,19,0,1.0,9,8,1,0.8888888888888888,0.9411764705882352,llama3,coral,breastca,PROMPT2_ICL_entailment
100,189,18,17,1,0.9444444444444444,9,8,1,0.8888888888888888,0.9158249158249158,llama3,coral,breastca,PROMPT2_ICL_entailment
101,19,23,22,1,0.9565217391304348,8,7,1,0.875,0.913946587537092,llama3,coral,breastca,PROMPT2_ICL_entailment
102,190,35,10,25,0.2857142857142857,34,20,14,0.5882352941176471,0.3846153846153846,llama3,coral,breastca,PROMPT2_ICL_entailment
103,191,25,17,8,0.68,14,6,8,0.4285714285714285,0.5257731958762887,llama3,coral,breastca,PROMPT2_ICL_entailment
104,192,26,23,3,0.8846153846153846,12,11,1,0.9166666666666666,0.900355871886121,llama3,coral,breastca,PROMPT2_ICL_entailment
105,193,14,13,1,0.9285714285714286,2,2,0,1.0,0.962962962962963,llama3,coral,breastca,PROMPT2_ICL_entailment
106,194,27,26,1,0.9629629629629628,15,13,2,0.8666666666666667,0.912280701754386,llama3,coral,breastca,PROMPT2_ICL_entailment
107,195,29,26,3,0.896551724137931,13,12,1,0.9230769230769232,0.9096209912536444,llama3,coral,breastca,PROMPT2_ICL_entailment
108,196,33,27,6,0.8181818181818182,30,23,7,0.7666666666666667,0.7915869980879541,llama3,coral,breastca,PROMPT2_ICL_entailment
109,197,21,21,0,1.0,14,11,3,0.7857142857142857,0.88,llama3,coral,breastca,PROMPT2_ICL_entailment
110,198,20,18,2,0.9,11,9,2,0.8181818181818182,0.8571428571428572,llama3,coral,breastca,PROMPT2_ICL_entailment
111,199,6,5,1,0.8333333333333334,2,2,0,1.0,0.9090909090909092,llama3,coral,breastca,PROMPT2_ICL_entailment
112,2,27,23,4,0.8518518518518519,10,8,2,0.8,0.8251121076233184,llama3,coral,breastca,PROMPT2_ICL_entailment
113,20,27,19,8,0.7037037037037037,17,7,10,0.4117647058823529,0.5195312500000001,llama3,coral,breastca,PROMPT2_ICL_entailment
114,200,15,13,2,0.8666666666666667,15,10,5,0.6666666666666666,0.7536231884057971,llama3,coral,breastca,PROMPT2_ICL_entailment
115,201,32,25,7,0.78125,26,17,9,0.6538461538461539,0.711892797319933,llama3,coral,breastca,PROMPT2_ICL_entailment
116,202,21,18,3,0.8571428571428571,17,17,0,1.0,0.923076923076923,llama3,coral,breastca,PROMPT2_ICL_entailment
117,203,21,19,2,0.9047619047619048,27,17,10,0.6296296296296297,0.7425287356321839,llama3,coral,breastca,PROMPT2_ICL_entailment
118,204,18,18,0,1.0,11,8,3,0.7272727272727273,0.8421052631578948,llama3,coral,breastca,PROMPT2_ICL_entailment
119,205,14,13,1,0.9285714285714286,11,11,0,1.0,0.962962962962963,llama3,coral,breastca,PROMPT2_ICL_entailment
120,206,19,18,1,0.9473684210526316,4,4,0,1.0,0.972972972972973,llama3,coral,breastca,PROMPT2_ICL_entailment
121,207,24,21,3,0.875,12,7,5,0.5833333333333334,0.7000000000000001,llama3,coral,breastca,PROMPT2_ICL_entailment
122,208,23,22,1,0.9565217391304348,9,9,0,1.0,0.9777777777777776,llama3,coral,breastca,PROMPT2_ICL_entailment
123,209,51,50,1,0.9803921568627452,11,6,5,0.5454545454545454,0.7009345794392522,llama3,coral,breastca,PROMPT2_ICL_entailment
124,21,37,30,7,0.8108108108108109,27,8,19,0.2962962962962963,0.4339963833634719,llama3,coral,breastca,PROMPT2_ICL_entailment
125,210,19,18,1,0.9473684210526316,13,11,2,0.8461538461538461,0.8939051918735891,llama3,coral,breastca,PROMPT2_ICL_entailment
126,211,51,47,4,0.9215686274509804,11,11,0,1.0,0.9591836734693878,llama3,coral,breastca,PROMPT2_ICL_entailment
127,212,25,21,4,0.84,9,4,5,0.4444444444444444,0.5813148788927335,llama3,coral,breastca,PROMPT2_ICL_entailment
128,213,48,40,8,0.8333333333333334,11,9,2,0.8181818181818182,0.8256880733944955,llama3,coral,breastca,PROMPT2_ICL_entailment
129,214,21,6,15,0.2857142857142857,28,14,14,0.5,0.3636363636363636,llama3,coral,breastca,PROMPT2_ICL_entailment
130,215,30,20,10,0.6666666666666666,37,21,16,0.5675675675675675,0.6131386861313869,llama3,coral,breastca,PROMPT2_ICL_entailment
131,216,29,23,6,0.7931034482758621,15,12,3,0.8,0.7965367965367965,llama3,coral,breastca,PROMPT2_ICL_entailment
132,22,24,18,6,0.75,7,7,0,1.0,0.8571428571428571,llama3,coral,breastca,PROMPT2_ICL_entailment
133,23,14,13,1,0.9285714285714286,9,8,1,0.8888888888888888,0.9082969432314412,llama3,coral,breastca,PROMPT2_ICL_entailment
134,24,14,12,2,0.8571428571428571,10,8,2,0.8,0.8275862068965518,llama3,coral,breastca,PROMPT2_ICL_entailment
135,25,31,30,1,0.967741935483871,8,8,0,1.0,0.9836065573770492,llama3,coral,breastca,PROMPT2_ICL_entailment
136,26,22,20,2,0.9090909090909092,11,11,0,1.0,0.9523809523809524,llama3,coral,breastca,PROMPT2_ICL_entailment
137,27,28,25,3,0.8928571428571429,12,10,2,0.8333333333333334,0.8620689655172413,llama3,coral,breastca,PROMPT2_ICL_entailment
138,28,21,19,2,0.9047619047619048,18,17,1,0.9444444444444444,0.9241773962804004,llama3,coral,breastca,PROMPT2_ICL_entailment
139,29,14,11,3,0.7857142857142857,9,5,4,0.5555555555555556,0.650887573964497,llama3,coral,breastca,PROMPT2_ICL_entailment
140,3,27,21,6,0.7777777777777778,11,10,1,0.9090909090909092,0.8383233532934132,llama3,coral,breastca,PROMPT2_ICL_entailment
141,30,31,14,17,0.4516129032258064,18,8,10,0.4444444444444444,0.4479999999999999,llama3,coral,breastca,PROMPT2_ICL_entailment
142,31,21,13,8,0.6190476190476191,13,11,2,0.8461538461538461,0.715,llama3,coral,breastca,PROMPT2_ICL_entailment
143,32,15,12,3,0.8,9,9,0,1.0,0.888888888888889,llama3,coral,breastca,PROMPT2_ICL_entailment
144,33,28,25,3,0.8928571428571429,8,8,0,1.0,0.9433962264150944,llama3,coral,breastca,PROMPT2_ICL_entailment
145,34,11,10,1,0.9090909090909092,10,10,0,1.0,0.9523809523809524,llama3,coral,breastca,PROMPT2_ICL_entailment
146,35,21,19,2,0.9047619047619048,12,9,3,0.75,0.8201438848920864,llama3,coral,breastca,PROMPT2_ICL_entailment
147,36,22,21,1,0.9545454545454546,11,11,0,1.0,0.9767441860465116,llama3,coral,breastca,PROMPT2_ICL_entailment
148,37,20,19,1,0.95,11,10,1,0.9090909090909092,0.9290953545232272,llama3,coral,breastca,PROMPT2_ICL_entailment
149,38,19,19,0,1.0,11,6,5,0.5454545454545454,0.7058823529411764,llama3,coral,breastca,PROMPT2_ICL_entailment
150,39,19,18,1,0.9473684210526316,11,11,0,1.0,0.972972972972973,llama3,coral,breastca,PROMPT2_ICL_entailment
151,4,35,17,18,0.4857142857142857,59,23,36,0.3898305084745763,0.4325221238938053,llama3,coral,breastca,PROMPT2_ICL_entailment
152,40,16,16,0,1.0,9,7,2,0.7777777777777778,0.8750000000000001,llama3,coral,breastca,PROMPT2_ICL_entailment
153,41,16,16,0,1.0,14,12,2,0.8571428571428571,0.923076923076923,llama3,coral,breastca,PROMPT2_ICL_entailment
154,42,22,19,3,0.8636363636363636,9,6,3,0.6666666666666666,0.7524752475247524,llama3,coral,breastca,PROMPT2_ICL_entailment
155,43,15,12,3,0.8,9,7,2,0.7777777777777778,0.7887323943661971,llama3,coral,breastca,PROMPT2_ICL_entailment
156,44,19,18,1,0.9473684210526316,9,9,0,1.0,0.972972972972973,llama3,coral,breastca,PROMPT2_ICL_entailment
157,45,5,5,0,1.0,2,2,0,1.0,1.0,llama3,coral,breastca,PROMPT2_ICL_entailment
158,46,12,12,0,1.0,5,5,0,1.0,1.0,llama3,coral,breastca,PROMPT2_ICL_entailment
159,47,17,16,1,0.9411764705882352,2,2,0,1.0,0.9696969696969696,llama3,coral,breastca,PROMPT2_ICL_entailment
160,48,18,17,1,0.9444444444444444,5,5,0,1.0,0.9714285714285714,llama3,coral,breastca,PROMPT2_ICL_entailment
161,49,35,25,10,0.7142857142857143,16,11,5,0.6875,0.7006369426751592,llama3,coral,breastca,PROMPT2_ICL_entailment
162,5,52,47,5,0.903846153846154,12,9,3,0.75,0.8197674418604652,llama3,coral,breastca,PROMPT2_ICL_entailment
163,50,51,27,24,0.5294117647058824,16,14,2,0.875,0.6596858638743456,llama3,coral,breastca,PROMPT2_ICL_entailment
164,51,40,33,7,0.825,11,7,4,0.6363636363636364,0.7185069984447899,llama3,coral,breastca,PROMPT2_ICL_entailment
165,52,24,21,3,0.875,10,8,2,0.8,0.8358208955223881,llama3,coral,breastca,PROMPT2_ICL_entailment
166,53,24,23,1,0.9583333333333334,10,10,0,1.0,0.9787234042553192,llama3,coral,breastca,PROMPT2_ICL_entailment
167,54,18,12,6,0.6666666666666666,9,6,3,0.6666666666666666,0.6666666666666666,llama3,coral,breastca,PROMPT2_ICL_entailment
168,55,1,0,1,0.0,1,0,1,0.0,,llama3,coral,breastca,PROMPT2_ICL_entailment
169,56,11,10,1,0.9090909090909092,18,6,12,0.3333333333333333,0.4878048780487804,llama3,coral,breastca,PROMPT2_ICL_entailment
170,57,39,37,2,0.9487179487179488,10,10,0,1.0,0.9736842105263158,llama3,coral,breastca,PROMPT2_ICL_entailment
171,58,27,26,1,0.9629629629629628,10,9,1,0.9,0.930417495029821,llama3,coral,breastca,PROMPT2_ICL_entailment
172,59,21,21,0,1.0,9,9,0,1.0,1.0,llama3,coral,breastca,PROMPT2_ICL_entailment
173,6,18,17,1,0.9444444444444444,8,7,1,0.875,0.9083969465648856,llama3,coral,breastca,PROMPT2_ICL_entailment
174,60,20,19,1,0.95,10,10,0,1.0,0.9743589743589745,llama3,coral,breastca,PROMPT2_ICL_entailment
175,61,21,21,0,1.0,11,10,1,0.9090909090909092,0.9523809523809524,llama3,coral,breastca,PROMPT2_ICL_entailment
176,62,33,27,6,0.8181818181818182,10,9,1,0.9,0.8571428571428572,llama3,coral,breastca,PROMPT2_ICL_entailment
177,63,13,13,0,1.0,11,8,3,0.7272727272727273,0.8421052631578948,llama3,coral,breastca,PROMPT2_ICL_entailment
178,64,20,18,2,0.9,17,15,2,0.8823529411764706,0.8910891089108911,llama3,coral,breastca,PROMPT2_ICL_entailment
179,65,29,28,1,0.9655172413793104,6,6,0,1.0,0.9824561403508772,llama3,coral,breastca,PROMPT2_ICL_entailment
180,66,30,30,0,1.0,10,8,2,0.8,0.888888888888889,llama3,coral,breastca,PROMPT2_ICL_entailment
181,67,23,12,11,0.5217391304347826,49,22,27,0.4489795918367347,0.4826325411334552,llama3,coral,breastca,PROMPT2_ICL_entailment
182,68,20,16,4,0.8,8,7,1,0.875,0.8358208955223881,llama3,coral,breastca,PROMPT2_ICL_entailment
183,69,36,22,14,0.6111111111111112,12,6,6,0.5,0.55,llama3,coral,breastca,PROMPT2_ICL_entailment
184,7,26,25,1,0.9615384615384616,11,9,2,0.8181818181818182,0.8840864440078586,llama3,coral,breastca,PROMPT2_ICL_entailment
185,70,17,8,9,0.4705882352941176,51,34,17,0.6666666666666666,0.5517241379310345,llama3,coral,breastca,PROMPT2_ICL_entailment
186,71,20,16,4,0.8,5,4,1,0.8,0.8000000000000002,llama3,coral,breastca,PROMPT2_ICL_entailment
187,72,10,8,2,0.8,3,2,1,0.6666666666666666,0.7272727272727272,llama3,coral,breastca,PROMPT2_ICL_entailment
188,73,16,14,2,0.875,1,1,0,1.0,0.9333333333333332,llama3,coral,breastca,PROMPT2_ICL_entailment
189,74,20,17,3,0.85,2,2,0,1.0,0.9189189189189187,llama3,coral,breastca,PROMPT2_ICL_entailment
190,75,26,25,1,0.9615384615384616,6,6,0,1.0,0.9803921568627452,llama3,coral,breastca,PROMPT2_ICL_entailment
191,76,15,14,1,0.9333333333333332,7,7,0,1.0,0.9655172413793104,llama3,coral,breastca,PROMPT2_ICL_entailment
192,77,22,21,1,0.9545454545454546,15,8,7,0.5333333333333333,0.684317718940937,llama3,coral,breastca,PROMPT2_ICL_entailment
193,78,21,18,3,0.8571428571428571,8,7,1,0.875,0.8659793814432989,llama3,coral,breastca,PROMPT2_ICL_entailment
194,79,16,14,2,0.875,8,6,2,0.75,0.8076923076923077,llama3,coral,breastca,PROMPT2_ICL_entailment
195,8,22,17,5,0.7727272727272727,9,6,3,0.6666666666666666,0.7157894736842105,llama3,coral,breastca,PROMPT2_ICL_entailment
196,80,21,21,0,1.0,24,16,8,0.6666666666666666,0.8,llama3,coral,breastca,PROMPT2_ICL_entailment
197,81,31,28,3,0.9032258064516128,11,7,4,0.6363636363636364,0.7466666666666666,llama3,coral,breastca,PROMPT2_ICL_entailment
198,82,13,11,2,0.8461538461538461,6,4,2,0.6666666666666666,0.7457627118644068,llama3,coral,breastca,PROMPT2_ICL_entailment
199,83,16,16,0,1.0,6,6,0,1.0,1.0,llama3,coral,breastca,PROMPT2_ICL_entailment
200,84,38,32,6,0.8421052631578947,11,8,3,0.7272727272727273,0.7804878048780488,llama3,coral,breastca,PROMPT2_ICL_entailment
201,85,26,25,1,0.9615384615384616,7,6,1,0.8571428571428571,0.9063444108761328,llama3,coral,breastca,PROMPT2_ICL_entailment
202,86,26,21,5,0.8076923076923077,16,14,2,0.875,0.8400000000000001,llama3,coral,breastca,PROMPT2_ICL_entailment
203,87,18,16,2,0.8888888888888888,8,7,1,0.875,0.8818897637795274,llama3,coral,breastca,PROMPT2_ICL_entailment
204,88,13,12,1,0.9230769230769232,8,8,0,1.0,0.96,llama3,coral,breastca,PROMPT2_ICL_entailment
205,89,17,16,1,0.9411764705882352,11,10,1,0.9090909090909092,0.92485549132948,llama3,coral,breastca,PROMPT2_ICL_entailment
206,9,23,22,1,0.9565217391304348,6,6,0,1.0,0.9777777777777776,llama3,coral,breastca,PROMPT2_ICL_entailment
207,90,19,12,7,0.631578947368421,17,9,8,0.5294117647058824,0.576,llama3,coral,breastca,PROMPT2_ICL_entailment
208,91,19,19,0,1.0,7,6,1,0.8571428571428571,0.923076923076923,llama3,coral,breastca,PROMPT2_ICL_entailment
209,92,10,10,0,1.0,2,2,0,1.0,1.0,llama3,coral,breastca,PROMPT2_ICL_entailment
210,93,18,18,0,1.0,13,12,1,0.9230769230769232,0.96,llama3,coral,breastca,PROMPT2_ICL_entailment
211,94,32,22,10,0.6875,25,17,8,0.68,0.6837294332723949,llama3,coral,breastca,PROMPT2_ICL_entailment
212,95,23,22,1,0.9565217391304348,13,6,7,0.4615384615384615,0.6226415094339623,llama3,coral,breastca,PROMPT2_ICL_entailment
213,96,26,19,7,0.7307692307692307,10,9,1,0.9,0.8066037735849056,llama3,coral,breastca,PROMPT2_ICL_entailment
214,97,31,28,3,0.9032258064516128,11,10,1,0.9090909090909092,0.906148867313916,llama3,coral,breastca,PROMPT2_ICL_entailment
215,98,18,17,1,0.9444444444444444,2,2,0,1.0,0.9714285714285714,llama3,coral,breastca,PROMPT2_ICL_entailment
216,99,22,20,2,0.9090909090909092,15,13,2,0.8666666666666667,0.887372013651877,llama3,coral,breastca,PROMPT2_ICL_entailment
0,0,12,12,0,1.0,10,8,2,0.8,0.888888888888889,llama3,coral,breastca,PROMPT2_entailment
1,1,16,15,1,0.9375,12,9,3,0.75,0.8333333333333334,llama3,coral,breastca,PROMPT2_entailment
2,10,15,14,1,0.9333333333333332,10,10,0,1.0,0.9655172413793104,llama3,coral,breastca,PROMPT2_entailment
3,100,16,13,3,0.8125,26,9,17,0.3461538461538461,0.4854771784232364,llama3,coral,breastca,PROMPT2_entailment
4,101,26,26,0,1.0,18,15,3,0.8333333333333334,0.9090909090909092,llama3,coral,breastca,PROMPT2_entailment
5,102,15,14,1,0.9333333333333332,7,4,3,0.5714285714285714,0.7088607594936709,llama3,coral,breastca,PROMPT2_entailment
6,103,25,25,0,1.0,10,8,2,0.8,0.888888888888889,llama3,coral,breastca,PROMPT2_entailment
7,104,16,12,4,0.75,26,14,12,0.5384615384615384,0.6268656716417911,llama3,coral,breastca,PROMPT2_entailment
8,105,19,18,1,0.9473684210526316,15,15,0,1.0,0.972972972972973,llama3,coral,breastca,PROMPT2_entailment
9,106,15,15,0,1.0,9,9,0,1.0,1.0,llama3,coral,breastca,PROMPT2_entailment
10,107,13,11,2,0.8461538461538461,9,8,1,0.8888888888888888,0.8669950738916256,llama3,coral,breastca,PROMPT2_entailment
11,108,17,17,0,1.0,11,10,1,0.9090909090909092,0.9523809523809524,llama3,coral,breastca,PROMPT2_entailment
12,109,16,16,0,1.0,11,10,1,0.9090909090909092,0.9523809523809524,llama3,coral,breastca,PROMPT2_entailment
13,11,13,11,2,0.8461538461538461,3,3,0,1.0,0.9166666666666666,llama3,coral,breastca,PROMPT2_entailment
14,110,11,10,1,0.9090909090909092,11,5,6,0.4545454545454545,0.6060606060606061,llama3,coral,breastca,PROMPT2_entailment
15,111,13,9,4,0.6923076923076923,10,9,1,0.9,0.7826086956521738,llama3,coral,breastca,PROMPT2_entailment
16,112,17,17,0,1.0,10,9,1,0.9,0.9473684210526316,llama3,coral,breastca,PROMPT2_entailment
17,113,21,18,3,0.8571428571428571,49,21,28,0.4285714285714285,0.5714285714285714,llama3,coral,breastca,PROMPT2_entailment
18,114,22,20,2,0.9090909090909092,21,14,7,0.6666666666666666,0.7692307692307692,llama3,coral,breastca,PROMPT2_entailment
19,115,17,15,2,0.8823529411764706,9,8,1,0.8888888888888888,0.8856088560885608,llama3,coral,breastca,PROMPT2_entailment
20,116,17,16,1,0.9411764705882352,14,10,4,0.7142857142857143,0.8121827411167514,llama3,coral,breastca,PROMPT2_entailment
21,117,8,8,0,1.0,2,2,0,1.0,1.0,llama3,coral,breastca,PROMPT2_entailment
22,118,16,16,0,1.0,19,3,16,0.1578947368421052,0.2727272727272727,llama3,coral,breastca,PROMPT2_entailment
23,119,14,12,2,0.8571428571428571,10,9,1,0.9,0.8780487804878048,llama3,coral,breastca,PROMPT2_entailment
24,12,12,12,0,1.0,10,8,2,0.8,0.888888888888889,llama3,coral,breastca,PROMPT2_entailment
25,120,22,21,1,0.9545454545454546,9,9,0,1.0,0.9767441860465116,llama3,coral,breastca,PROMPT2_entailment
26,121,18,16,2,0.8888888888888888,10,9,1,0.9,0.8944099378881988,llama3,coral,breastca,PROMPT2_entailment
27,122,17,17,0,1.0,9,9,0,1.0,1.0,llama3,coral,breastca,PROMPT2_entailment
28,123,16,15,1,0.9375,8,7,1,0.875,0.9051724137931034,llama3,coral,breastca,PROMPT2_entailment
29,124,15,12,3,0.8,10,10,0,1.0,0.888888888888889,llama3,coral,breastca,PROMPT2_entailment
30,125,20,18,2,0.9,11,8,3,0.7272727272727273,0.8044692737430167,llama3,coral,breastca,PROMPT2_entailment
31,126,14,13,1,0.9285714285714286,10,10,0,1.0,0.962962962962963,llama3,coral,breastca,PROMPT2_entailment
32,127,15,15,0,1.0,10,8,2,0.8,0.888888888888889,llama3,coral,breastca,PROMPT2_entailment
33,128,18,18,0,1.0,11,7,4,0.6363636363636364,0.7777777777777778,llama3,coral,breastca,PROMPT2_entailment
34,129,19,19,0,1.0,11,8,3,0.7272727272727273,0.8421052631578948,llama3,coral,breastca,PROMPT2_entailment
35,13,21,18,3,0.8571428571428571,10,9,1,0.9,0.8780487804878048,llama3,coral,breastca,PROMPT2_entailment
36,130,101,99,2,0.9801980198019802,7,2,5,0.2857142857142857,0.4424581005586592,llama3,coral,breastca,PROMPT2_entailment
37,131,26,25,1,0.9615384615384616,10,10,0,1.0,0.9803921568627452,llama3,coral,breastca,PROMPT2_entailment
38,132,17,16,1,0.9411764705882352,8,7,1,0.875,0.9068825910931174,llama3,coral,breastca,PROMPT2_entailment
39,133,24,19,5,0.7916666666666666,29,19,10,0.6551724137931034,0.7169811320754716,llama3,coral,breastca,PROMPT2_entailment
40,134,34,12,22,0.3529411764705882,11,8,3,0.7272727272727273,0.4752475247524753,llama3,coral,breastca,PROMPT2_entailment
41,135,16,11,5,0.6875,16,13,3,0.8125,0.7447916666666666,llama3,coral,breastca,PROMPT2_entailment
42,136,19,14,5,0.7368421052631579,10,9,1,0.9,0.810289389067524,llama3,coral,breastca,PROMPT2_entailment
43,137,16,16,0,1.0,10,9,1,0.9,0.9473684210526316,llama3,coral,breastca,PROMPT2_entailment
44,138,13,13,0,1.0,10,10,0,1.0,1.0,llama3,coral,breastca,PROMPT2_entailment
45,139,23,19,4,0.8260869565217391,11,9,2,0.8181818181818182,0.8221153846153847,llama3,coral,breastca,PROMPT2_entailment
46,14,19,17,2,0.8947368421052632,59,26,33,0.4406779661016949,0.5905143620574482,llama3,coral,breastca,PROMPT2_entailment
47,140,26,24,2,0.9230769230769232,9,8,1,0.8888888888888888,0.9056603773584906,llama3,coral,breastca,PROMPT2_entailment
48,141,17,15,2,0.8823529411764706,11,9,2,0.8181818181818182,0.8490566037735848,llama3,coral,breastca,PROMPT2_entailment
49,142,16,15,1,0.9375,10,10,0,1.0,0.967741935483871,llama3,coral,breastca,PROMPT2_entailment
50,143,14,10,4,0.7142857142857143,10,9,1,0.9,0.7964601769911505,llama3,coral,breastca,PROMPT2_entailment
51,144,18,17,1,0.9444444444444444,5,5,0,1.0,0.9714285714285714,llama3,coral,breastca,PROMPT2_entailment
52,145,13,12,1,0.9230769230769232,5,5,0,1.0,0.96,llama3,coral,breastca,PROMPT2_entailment
53,146,18,18,0,1.0,9,8,1,0.8888888888888888,0.9411764705882352,llama3,coral,breastca,PROMPT2_entailment
54,147,18,10,8,0.5555555555555556,5,5,0,1.0,0.7142857142857143,llama3,coral,breastca,PROMPT2_entailment
55,148,13,11,2,0.8461538461538461,4,1,3,0.25,0.3859649122807017,llama3,coral,breastca,PROMPT2_entailment
56,149,10,9,1,0.9,1,1,0,1.0,0.9473684210526316,llama3,coral,breastca,PROMPT2_entailment
57,15,36,29,7,0.8055555555555556,16,7,9,0.4375,0.5670391061452514,llama3,coral,breastca,PROMPT2_entailment
58,150,15,13,2,0.8666666666666667,2,2,0,1.0,0.9285714285714286,llama3,coral,breastca,PROMPT2_entailment
59,151,12,10,2,0.8333333333333334,9,9,0,1.0,0.9090909090909092,llama3,coral,breastca,PROMPT2_entailment
60,152,17,16,1,0.9411764705882352,16,13,3,0.8125,0.8721174004192872,llama3,coral,breastca,PROMPT2_entailment
61,153,13,11,2,0.8461538461538461,1,1,0,1.0,0.9166666666666666,llama3,coral,breastca,PROMPT2_entailment
62,154,17,17,0,1.0,10,9,1,0.9,0.9473684210526316,llama3,coral,breastca,PROMPT2_entailment
63,155,23,22,1,0.9565217391304348,9,9,0,1.0,0.9777777777777776,llama3,coral,breastca,PROMPT2_entailment
64,156,13,13,0,1.0,8,7,1,0.875,0.9333333333333332,llama3,coral,breastca,PROMPT2_entailment
65,157,18,18,0,1.0,9,9,0,1.0,1.0,llama3,coral,breastca,PROMPT2_entailment
66,158,16,11,5,0.6875,16,10,6,0.625,0.6547619047619048,llama3,coral,breastca,PROMPT2_entailment
67,159,18,15,3,0.8333333333333334,29,18,11,0.6206896551724138,0.7114624505928854,llama3,coral,breastca,PROMPT2_entailment
68,16,17,17,0,1.0,10,10,0,1.0,1.0,llama3,coral,breastca,PROMPT2_entailment
69,160,26,21,5,0.8076923076923077,18,12,6,0.6666666666666666,0.7304347826086955,llama3,coral,breastca,PROMPT2_entailment
70,161,27,27,0,1.0,11,10,1,0.9090909090909092,0.9523809523809524,llama3,coral,breastca,PROMPT2_entailment
71,162,17,16,1,0.9411764705882352,16,10,6,0.625,0.7511737089201879,llama3,coral,breastca,PROMPT2_entailment
72,163,13,13,0,1.0,11,10,1,0.9090909090909092,0.9523809523809524,llama3,coral,breastca,PROMPT2_entailment
73,164,11,10,1,0.9090909090909092,8,5,3,0.625,0.7407407407407406,llama3,coral,breastca,PROMPT2_entailment
74,165,17,15,2,0.8823529411764706,12,12,0,1.0,0.9375,llama3,coral,breastca,PROMPT2_entailment
75,166,18,18,0,1.0,10,7,3,0.7,0.8235294117647058,llama3,coral,breastca,PROMPT2_entailment
76,167,18,15,3,0.8333333333333334,7,6,1,0.8571428571428571,0.8450704225352113,llama3,coral,breastca,PROMPT2_entailment
77,168,12,9,3,0.75,7,5,2,0.7142857142857143,0.7317073170731706,llama3,coral,breastca,PROMPT2_entailment
78,169,14,13,1,0.9285714285714286,11,4,7,0.3636363636363636,0.5226130653266332,llama3,coral,breastca,PROMPT2_entailment
79,17,7,7,0,1.0,3,3,0,1.0,1.0,llama3,coral,breastca,PROMPT2_entailment
80,170,15,13,2,0.8666666666666667,10,10,0,1.0,0.9285714285714286,llama3,coral,breastca,PROMPT2_entailment
81,171,17,16,1,0.9411764705882352,9,8,1,0.8888888888888888,0.9142857142857144,llama3,coral,breastca,PROMPT2_entailment
82,172,14,13,1,0.9285714285714286,32,13,19,0.40625,0.5652173913043478,llama3,coral,breastca,PROMPT2_entailment
83,173,11,11,0,1.0,11,11,0,1.0,1.0,llama3,coral,breastca,PROMPT2_entailment
84,174,12,10,2,0.8333333333333334,7,5,2,0.7142857142857143,0.7692307692307692,llama3,coral,breastca,PROMPT2_entailment
85,175,13,11,2,0.8461538461538461,10,8,2,0.8,0.8224299065420562,llama3,coral,breastca,PROMPT2_entailment
86,176,9,9,0,1.0,10,9,1,0.9,0.9473684210526316,llama3,coral,breastca,PROMPT2_entailment
87,177,18,17,1,0.9444444444444444,9,9,0,1.0,0.9714285714285714,llama3,coral,breastca,PROMPT2_entailment
88,178,15,12,3,0.8,10,6,4,0.6,0.6857142857142857,llama3,coral,breastca,PROMPT2_entailment
89,179,20,20,0,1.0,9,8,1,0.8888888888888888,0.9411764705882352,llama3,coral,breastca,PROMPT2_entailment
90,18,18,18,0,1.0,8,8,0,1.0,1.0,llama3,coral,breastca,PROMPT2_entailment
91,180,15,15,0,1.0,10,9,1,0.9,0.9473684210526316,llama3,coral,breastca,PROMPT2_entailment
92,181,12,11,1,0.9166666666666666,9,9,0,1.0,0.9565217391304348,llama3,coral,breastca,PROMPT2_entailment
93,182,11,11,0,1.0,9,7,2,0.7777777777777778,0.8750000000000001,llama3,coral,breastca,PROMPT2_entailment
94,183,15,15,0,1.0,10,8,2,0.8,0.888888888888889,llama3,coral,breastca,PROMPT2_entailment
95,184,18,18,0,1.0,9,6,3,0.6666666666666666,0.8,llama3,coral,breastca,PROMPT2_entailment
96,185,16,16,0,1.0,10,9,1,0.9,0.9473684210526316,llama3,coral,breastca,PROMPT2_entailment
97,186,11,11,0,1.0,5,5,0,1.0,1.0,llama3,coral,breastca,PROMPT2_entailment
98,187,20,17,3,0.85,26,17,9,0.6538461538461539,0.7391304347826088,llama3,coral,breastca,PROMPT2_entailment
99,188,15,15,0,1.0,9,9,0,1.0,1.0,llama3,coral,breastca,PROMPT2_entailment
100,189,14,13,1,0.9285714285714286,9,9,0,1.0,0.962962962962963,llama3,coral,breastca,PROMPT2_entailment
101,19,17,17,0,1.0,8,8,0,1.0,1.0,llama3,coral,breastca,PROMPT2_entailment
102,190,17,7,10,0.4117647058823529,34,13,21,0.3823529411764705,0.3965141612200435,llama3,coral,breastca,PROMPT2_entailment
103,191,16,13,3,0.8125,14,7,7,0.5,0.6190476190476191,llama3,coral,breastca,PROMPT2_entailment
104,192,14,13,1,0.9285714285714286,12,11,1,0.9166666666666666,0.9225806451612902,llama3,coral,breastca,PROMPT2_entailment
105,193,8,8,0,1.0,2,2,0,1.0,1.0,llama3,coral,breastca,PROMPT2_entailment
106,194,20,19,1,0.95,15,13,2,0.8666666666666667,0.906422018348624,llama3,coral,breastca,PROMPT2_entailment
107,195,17,15,2,0.8823529411764706,13,12,1,0.9230769230769232,0.9022556390977444,llama3,coral,breastca,PROMPT2_entailment
108,196,29,25,4,0.8620689655172413,30,23,7,0.7666666666666667,0.8115737473535638,llama3,coral,breastca,PROMPT2_entailment
109,197,20,20,0,1.0,14,9,5,0.6428571428571429,0.782608695652174,llama3,coral,breastca,PROMPT2_entailment
110,198,21,19,2,0.9047619047619048,11,8,3,0.7272727272727273,0.806366047745358,llama3,coral,breastca,PROMPT2_entailment
111,199,6,5,1,0.8333333333333334,2,2,0,1.0,0.9090909090909092,llama3,coral,breastca,PROMPT2_entailment
112,2,26,22,4,0.8461538461538461,10,9,1,0.9,0.8722466960352422,llama3,coral,breastca,PROMPT2_entailment
113,20,19,15,4,0.7894736842105263,17,9,8,0.5294117647058824,0.6338028169014084,llama3,coral,breastca,PROMPT2_entailment
114,200,21,20,1,0.9523809523809524,15,8,7,0.5333333333333333,0.6837606837606837,llama3,coral,breastca,PROMPT2_entailment
115,201,25,23,2,0.92,26,17,9,0.6538461538461539,0.7644183773216031,llama3,coral,breastca,PROMPT2_entailment
116,202,20,17,3,0.85,17,12,5,0.7058823529411765,0.771266540642722,llama3,coral,breastca,PROMPT2_entailment
117,203,21,18,3,0.8571428571428571,27,12,15,0.4444444444444444,0.5853658536585367,llama3,coral,breastca,PROMPT2_entailment
118,204,13,13,0,1.0,11,10,1,0.9090909090909092,0.9523809523809524,llama3,coral,breastca,PROMPT2_entailment
119,205,13,12,1,0.9230769230769232,11,11,0,1.0,0.96,llama3,coral,breastca,PROMPT2_entailment
120,206,10,10,0,1.0,4,4,0,1.0,1.0,llama3,coral,breastca,PROMPT2_entailment
121,207,17,17,0,1.0,12,7,5,0.5833333333333334,0.7368421052631579,llama3,coral,breastca,PROMPT2_entailment
122,208,20,20,0,1.0,9,9,0,1.0,1.0,llama3,coral,breastca,PROMPT2_entailment
123,209,50,50,0,1.0,11,9,2,0.8181818181818182,0.9,llama3,coral,breastca,PROMPT2_entailment
124,21,24,19,5,0.7916666666666666,27,8,19,0.2962962962962963,0.4312056737588653,llama3,coral,breastca,PROMPT2_entailment
125,210,21,20,1,0.9523809523809524,13,11,2,0.8461538461538461,0.8961303462321792,llama3,coral,breastca,PROMPT2_entailment
126,211,19,17,2,0.8947368421052632,11,5,6,0.4545454545454545,0.6028368794326242,llama3,coral,breastca,PROMPT2_entailment
127,212,20,17,3,0.85,9,9,0,1.0,0.9189189189189187,llama3,coral,breastca,PROMPT2_entailment
128,213,24,11,13,0.4583333333333333,11,10,1,0.9090909090909092,0.6094182825484764,llama3,coral,breastca,PROMPT2_entailment
129,214,20,6,14,0.3,28,10,18,0.3571428571428571,0.3260869565217391,llama3,coral,breastca,PROMPT2_entailment
130,215,17,12,5,0.7058823529411765,37,30,7,0.8108108108108109,0.7547169811320755,llama3,coral,breastca,PROMPT2_entailment
131,216,20,18,2,0.9,15,13,2,0.8666666666666667,0.8830188679245283,llama3,coral,breastca,PROMPT2_entailment
132,22,22,18,4,0.8181818181818182,7,6,1,0.8571428571428571,0.8372093023255814,llama3,coral,breastca,PROMPT2_entailment
133,23,13,12,1,0.9230769230769232,9,8,1,0.8888888888888888,0.9056603773584906,llama3,coral,breastca,PROMPT2_entailment
134,24,16,14,2,0.875,10,8,2,0.8,0.8358208955223881,llama3,coral,breastca,PROMPT2_entailment
135,25,24,24,0,1.0,8,8,0,1.0,1.0,llama3,coral,breastca,PROMPT2_entailment
136,26,18,18,0,1.0,11,8,3,0.7272727272727273,0.8421052631578948,llama3,coral,breastca,PROMPT2_entailment
137,27,13,13,0,1.0,12,9,3,0.75,0.8571428571428571,llama3,coral,breastca,PROMPT2_entailment
138,28,17,15,2,0.8823529411764706,18,13,5,0.7222222222222222,0.7942973523421588,llama3,coral,breastca,PROMPT2_entailment
139,29,16,14,2,0.875,9,6,3,0.6666666666666666,0.7567567567567567,llama3,coral,breastca,PROMPT2_entailment
140,3,24,14,10,0.5833333333333334,11,7,4,0.6363636363636364,0.6086956521739131,llama3,coral,breastca,PROMPT2_entailment
141,30,25,10,15,0.4,18,9,9,0.5,0.4444444444444445,llama3,coral,breastca,PROMPT2_entailment
142,31,16,10,6,0.625,13,11,2,0.8461538461538461,0.7189542483660131,llama3,coral,breastca,PROMPT2_entailment
143,32,11,10,1,0.9090909090909092,9,8,1,0.8888888888888888,0.8988764044943819,llama3,coral,breastca,PROMPT2_entailment
144,33,17,12,5,0.7058823529411765,8,6,2,0.75,0.7272727272727272,llama3,coral,breastca,PROMPT2_entailment
145,34,11,10,1,0.9090909090909092,10,7,3,0.7,0.7909604519774012,llama3,coral,breastca,PROMPT2_entailment
146,35,17,17,0,1.0,12,10,2,0.8333333333333334,0.9090909090909092,llama3,coral,breastca,PROMPT2_entailment
147,36,12,12,0,1.0,11,7,4,0.6363636363636364,0.7777777777777778,llama3,coral,breastca,PROMPT2_entailment
148,37,18,17,1,0.9444444444444444,11,11,0,1.0,0.9714285714285714,llama3,coral,breastca,PROMPT2_entailment
149,38,11,11,0,1.0,11,9,2,0.8181818181818182,0.9,llama3,coral,breastca,PROMPT2_entailment
150,39,19,19,0,1.0,11,11,0,1.0,1.0,llama3,coral,breastca,PROMPT2_entailment
151,4,35,18,17,0.5142857142857142,59,26,33,0.4406779661016949,0.4746450304259635,llama3,coral,breastca,PROMPT2_entailment
152,40,12,12,0,1.0,9,7,2,0.7777777777777778,0.8750000000000001,llama3,coral,breastca,PROMPT2_entailment
153,41,17,17,0,1.0,14,13,1,0.9285714285714286,0.962962962962963,llama3,coral,breastca,PROMPT2_entailment
154,42,20,14,6,0.7,9,2,7,0.2222222222222222,0.3373493975903614,llama3,coral,breastca,PROMPT2_entailment
155,43,13,11,2,0.8461538461538461,9,8,1,0.8888888888888888,0.8669950738916256,llama3,coral,breastca,PROMPT2_entailment
156,44,14,14,0,1.0,9,9,0,1.0,1.0,llama3,coral,breastca,PROMPT2_entailment
157,45,6,6,0,1.0,2,2,0,1.0,1.0,llama3,coral,breastca,PROMPT2_entailment
158,46,14,14,0,1.0,5,5,0,1.0,1.0,llama3,coral,breastca,PROMPT2_entailment
159,47,13,10,3,0.7692307692307693,2,2,0,1.0,0.8695652173913044,llama3,coral,breastca,PROMPT2_entailment
160,48,12,12,0,1.0,5,5,0,1.0,1.0,llama3,coral,breastca,PROMPT2_entailment
161,49,17,15,2,0.8823529411764706,16,12,4,0.75,0.8108108108108107,llama3,coral,breastca,PROMPT2_entailment
162,5,19,18,1,0.9473684210526316,12,10,2,0.8333333333333334,0.8866995073891626,llama3,coral,breastca,PROMPT2_entailment
163,50,14,14,0,1.0,16,12,4,0.75,0.8571428571428571,llama3,coral,breastca,PROMPT2_entailment
164,51,36,28,8,0.7777777777777778,11,9,2,0.8181818181818182,0.7974683544303799,llama3,coral,breastca,PROMPT2_entailment
165,52,20,18,2,0.9,10,10,0,1.0,0.9473684210526316,llama3,coral,breastca,PROMPT2_entailment
166,53,18,18,0,1.0,10,9,1,0.9,0.9473684210526316,llama3,coral,breastca,PROMPT2_entailment
167,54,16,12,4,0.75,9,6,3,0.6666666666666666,0.7058823529411765,llama3,coral,breastca,PROMPT2_entailment
168,55,6,6,0,1.0,1,1,0,1.0,1.0,llama3,coral,breastca,PROMPT2_entailment
169,56,10,9,1,0.9,18,7,11,0.3888888888888889,0.5431034482758621,llama3,coral,breastca,PROMPT2_entailment
170,57,21,20,1,0.9523809523809524,10,10,0,1.0,0.975609756097561,llama3,coral,breastca,PROMPT2_entailment
171,58,18,18,0,1.0,10,7,3,0.7,0.8235294117647058,llama3,coral,breastca,PROMPT2_entailment
172,59,18,18,0,1.0,9,9,0,1.0,1.0,llama3,coral,breastca,PROMPT2_entailment
173,6,14,13,1,0.9285714285714286,8,6,2,0.75,0.8297872340425532,llama3,coral,breastca,PROMPT2_entailment
174,60,20,18,2,0.9,10,9,1,0.9,0.9,llama3,coral,breastca,PROMPT2_entailment
175,61,21,20,1,0.9523809523809524,11,10,1,0.9090909090909092,0.9302325581395348,llama3,coral,breastca,PROMPT2_entailment
176,62,14,13,1,0.9285714285714286,10,10,0,1.0,0.962962962962963,llama3,coral,breastca,PROMPT2_entailment
177,63,12,12,0,1.0,11,11,0,1.0,1.0,llama3,coral,breastca,PROMPT2_entailment
178,64,16,15,1,0.9375,17,14,3,0.8235294117647058,0.8768267223382046,llama3,coral,breastca,PROMPT2_entailment
179,65,21,21,0,1.0,6,6,0,1.0,1.0,llama3,coral,breastca,PROMPT2_entailment
180,66,23,23,0,1.0,10,9,1,0.9,0.9473684210526316,llama3,coral,breastca,PROMPT2_entailment
181,67,21,13,8,0.6190476190476191,49,24,25,0.4897959183673469,0.5468886941279579,llama3,coral,breastca,PROMPT2_entailment
182,68,20,16,4,0.8,8,7,1,0.875,0.8358208955223881,llama3,coral,breastca,PROMPT2_entailment
183,69,20,16,4,0.8,12,5,7,0.4166666666666667,0.547945205479452,llama3,coral,breastca,PROMPT2_entailment
184,7,17,17,0,1.0,11,10,1,0.9090909090909092,0.9523809523809524,llama3,coral,breastca,PROMPT2_entailment
185,70,74,50,24,0.6756756756756757,51,23,28,0.4509803921568627,0.5409219190968956,llama3,coral,breastca,PROMPT2_entailment
186,71,18,13,5,0.7222222222222222,5,4,1,0.8,0.759124087591241,llama3,coral,breastca,PROMPT2_entailment
187,72,11,10,1,0.9090909090909092,3,2,1,0.6666666666666666,0.7692307692307692,llama3,coral,breastca,PROMPT2_entailment
188,73,11,11,0,1.0,1,1,0,1.0,1.0,llama3,coral,breastca,PROMPT2_entailment
189,74,11,11,0,1.0,2,2,0,1.0,1.0,llama3,coral,breastca,PROMPT2_entailment
190,75,13,12,1,0.9230769230769232,6,6,0,1.0,0.96,llama3,coral,breastca,PROMPT2_entailment
191,76,13,13,0,1.0,7,7,0,1.0,1.0,llama3,coral,breastca,PROMPT2_entailment
192,77,16,14,2,0.875,15,9,6,0.6,0.711864406779661,llama3,coral,breastca,PROMPT2_entailment
193,78,17,15,2,0.8823529411764706,8,6,2,0.75,0.8108108108108107,llama3,coral,breastca,PROMPT2_entailment
194,79,10,7,3,0.7,8,8,0,1.0,0.8235294117647058,llama3,coral,breastca,PROMPT2_entailment
195,8,17,14,3,0.8235294117647058,9,7,2,0.7777777777777778,0.7999999999999999,llama3,coral,breastca,PROMPT2_entailment
196,80,14,13,1,0.9285714285714286,24,16,8,0.6666666666666666,0.7761194029850746,llama3,coral,breastca,PROMPT2_entailment
197,81,14,13,1,0.9285714285714286,11,10,1,0.9090909090909092,0.9187279151943464,llama3,coral,breastca,PROMPT2_entailment
198,82,14,11,3,0.7857142857142857,6,6,0,1.0,0.88,llama3,coral,breastca,PROMPT2_entailment
199,83,15,15,0,1.0,6,6,0,1.0,1.0,llama3,coral,breastca,PROMPT2_entailment
200,84,16,14,2,0.875,11,11,0,1.0,0.9333333333333332,llama3,coral,breastca,PROMPT2_entailment
201,85,12,10,2,0.8333333333333334,7,7,0,1.0,0.9090909090909092,llama3,coral,breastca,PROMPT2_entailment
202,86,19,15,4,0.7894736842105263,16,14,2,0.875,0.8300395256916996,llama3,coral,breastca,PROMPT2_entailment
203,87,14,14,0,1.0,8,7,1,0.875,0.9333333333333332,llama3,coral,breastca,PROMPT2_entailment
204,88,12,12,0,1.0,8,7,1,0.875,0.9333333333333332,llama3,coral,breastca,PROMPT2_entailment
205,89,16,16,0,1.0,11,10,1,0.9090909090909092,0.9523809523809524,llama3,coral,breastca,PROMPT2_entailment
206,9,15,13,2,0.8666666666666667,6,6,0,1.0,0.9285714285714286,llama3,coral,breastca,PROMPT2_entailment
207,90,48,30,18,0.625,17,12,5,0.7058823529411765,0.6629834254143646,llama3,coral,breastca,PROMPT2_entailment
208,91,13,11,2,0.8461538461538461,7,6,1,0.8571428571428571,0.8516129032258064,llama3,coral,breastca,PROMPT2_entailment
209,92,8,7,1,0.875,2,2,0,1.0,0.9333333333333332,llama3,coral,breastca,PROMPT2_entailment
210,93,17,17,0,1.0,13,13,0,1.0,1.0,llama3,coral,breastca,PROMPT2_entailment
211,94,17,15,2,0.8823529411764706,25,15,10,0.6,0.7142857142857143,llama3,coral,breastca,PROMPT2_entailment
212,95,21,20,1,0.9523809523809524,13,8,5,0.6153846153846154,0.7476635514018692,llama3,coral,breastca,PROMPT2_entailment
213,96,16,14,2,0.875,10,10,0,1.0,0.9333333333333332,llama3,coral,breastca,PROMPT2_entailment
214,97,19,14,5,0.7368421052631579,11,10,1,0.9090909090909092,0.813953488372093,llama3,coral,breastca,PROMPT2_entailment
215,98,9,9,0,1.0,2,2,0,1.0,1.0,llama3,coral,breastca,PROMPT2_entailment
216,99,28,27,1,0.9642857142857144,15,11,4,0.7333333333333333,0.8330995792426367,llama3,coral,breastca,PROMPT2_entailment
0,0,12,11,1,0.9166666666666666,11,10,1,0.9090909090909092,0.9128630705394192,llama3,mimiciii,nursing_note,PROMPT1_entailment
1,1,30,18,12,0.6,31,22,9,0.7096774193548387,0.6502463054187193,llama3,mimiciii,nursing_note,PROMPT1_entailment
2,10,21,18,3,0.8571428571428571,18,14,4,0.7777777777777778,0.8155339805825242,llama3,mimiciii,nursing_note,PROMPT1_entailment
3,100,11,11,0,1.0,6,6,0,1.0,1.0,llama3,mimiciii,nursing_note,PROMPT1_entailment
4,101,27,25,2,0.925925925925926,27,23,4,0.8518518518518519,0.8873456790123457,llama3,mimiciii,nursing_note,PROMPT1_entailment
5,102,27,25,2,0.925925925925926,26,20,6,0.7692307692307693,0.8403361344537816,llama3,mimiciii,nursing_note,PROMPT1_entailment
6,103,22,22,0,1.0,22,17,5,0.7727272727272727,0.8717948717948718,llama3,mimiciii,nursing_note,PROMPT1_entailment
7,104,22,21,1,0.9545454545454546,20,19,1,0.95,0.9522673031026252,llama3,mimiciii,nursing_note,PROMPT1_entailment
8,105,19,18,1,0.9473684210526316,20,19,1,0.95,0.9486823855755894,llama3,mimiciii,nursing_note,PROMPT1_entailment
9,106,8,8,0,1.0,4,4,0,1.0,1.0,llama3,mimiciii,nursing_note,PROMPT1_entailment
10,107,47,44,3,0.9361702127659576,49,44,5,0.8979591836734694,0.9166666666666666,llama3,mimiciii,nursing_note,PROMPT1_entailment
11,108,32,31,1,0.96875,28,24,4,0.8571428571428571,0.9095354523227382,llama3,mimiciii,nursing_note,PROMPT1_entailment
12,109,5,5,0,1.0,4,4,0,1.0,1.0,llama3,mimiciii,nursing_note,PROMPT1_entailment
13,11,3,3,0,1.0,2,2,0,1.0,1.0,llama3,mimiciii,nursing_note,PROMPT1_entailment
14,110,14,13,1,0.9285714285714286,13,13,0,1.0,0.962962962962963,llama3,mimiciii,nursing_note,PROMPT1_entailment
15,111,27,22,5,0.8148148148148148,32,28,4,0.875,0.843835616438356,llama3,mimiciii,nursing_note,PROMPT1_entailment
16,112,31,26,5,0.8387096774193549,37,31,6,0.8378378378378378,0.8382735309412377,llama3,mimiciii,nursing_note,PROMPT1_entailment
17,113,7,7,0,1.0,5,5,0,1.0,1.0,llama3,mimiciii,nursing_note,PROMPT1_entailment
18,114,16,15,1,0.9375,19,15,4,0.7894736842105263,0.8571428571428572,llama3,mimiciii,nursing_note,PROMPT1_entailment
19,115,11,11,0,1.0,7,7,0,1.0,1.0,llama3,mimiciii,nursing_note,PROMPT1_entailment
20,116,34,33,1,0.9705882352941176,31,28,3,0.9032258064516128,0.9356962025316456,llama3,mimiciii,nursing_note,PROMPT1_entailment
21,117,36,30,6,0.8333333333333334,18,15,3,0.8333333333333334,0.8333333333333334,llama3,mimiciii,nursing_note,PROMPT1_entailment
22,118,27,25,2,0.925925925925926,25,22,3,0.88,0.9023789991796554,llama3,mimiciii,nursing_note,PROMPT1_entailment
23,119,23,21,2,0.9130434782608696,26,22,4,0.8461538461538461,0.8783269961977186,llama3,mimiciii,nursing_note,PROMPT1_entailment
24,12,19,18,1,0.9473684210526316,18,14,4,0.7777777777777778,0.8542372881355932,llama3,mimiciii,nursing_note,PROMPT1_entailment
25,120,16,15,1,0.9375,18,17,1,0.9444444444444444,0.940959409594096,llama3,mimiciii,nursing_note,PROMPT1_entailment
26,121,24,23,1,0.9583333333333334,37,27,10,0.7297297297297297,0.828552368245497,llama3,mimiciii,nursing_note,PROMPT1_entailment
27,122,19,15,4,0.7894736842105263,11,9,2,0.8181818181818182,0.8035714285714286,llama3,mimiciii,nursing_note,PROMPT1_entailment
28,123,8,8,0,1.0,6,6,0,1.0,1.0,llama3,mimiciii,nursing_note,PROMPT1_entailment
29,124,9,9,0,1.0,5,3,2,0.6,0.7499999999999999,llama3,mimiciii,nursing_note,PROMPT1_entailment
30,125,29,27,2,0.9310344827586208,43,29,14,0.6744186046511628,0.7822177822177823,llama3,mimiciii,nursing_note,PROMPT1_entailment
31,126,22,21,1,0.9545454545454546,28,26,2,0.9285714285714286,0.9413793103448276,llama3,mimiciii,nursing_note,PROMPT1_entailment
32,127,16,14,2,0.875,10,9,1,0.9,0.8873239436619719,llama3,mimiciii,nursing_note,PROMPT1_entailment
33,128,19,19,0,1.0,17,15,2,0.8823529411764706,0.9375,llama3,mimiciii,nursing_note,PROMPT1_entailment
34,129,27,26,1,0.9629629629629628,29,24,5,0.8275862068965517,0.8901569186875892,llama3,mimiciii,nursing_note,PROMPT1_entailment
35,13,24,23,1,0.9583333333333334,34,21,13,0.6176470588235294,0.7511664074650077,llama3,mimiciii,nursing_note,PROMPT1_entailment
36,130,38,33,5,0.868421052631579,33,25,8,0.7575757575757576,0.8092202059833252,llama3,mimiciii,nursing_note,PROMPT1_entailment
37,131,28,27,1,0.9642857142857144,31,26,5,0.8387096774193549,0.8971246006389776,llama3,mimiciii,nursing_note,PROMPT1_entailment
38,132,26,24,2,0.9230769230769232,17,16,1,0.9411764705882352,0.9320388349514565,llama3,mimiciii,nursing_note,PROMPT1_entailment
39,133,15,14,1,0.9333333333333332,10,10,0,1.0,0.9655172413793104,llama3,mimiciii,nursing_note,PROMPT1_entailment
40,134,30,15,15,0.5,30,18,12,0.6,0.5454545454545454,llama3,mimiciii,nursing_note,PROMPT1_entailment
41,135,42,39,3,0.9285714285714286,42,37,5,0.8809523809523809,0.9041353383458646,llama3,mimiciii,nursing_note,PROMPT1_entailment
42,136,30,27,3,0.9,41,33,8,0.8048780487804879,0.8497854077253219,llama3,mimiciii,nursing_note,PROMPT1_entailment
43,137,4,4,0,1.0,2,1,1,0.5,0.6666666666666666,llama3,mimiciii,nursing_note,PROMPT1_entailment
44,138,5,5,0,1.0,5,4,1,0.8,0.888888888888889,llama3,mimiciii,nursing_note,PROMPT1_entailment
45,139,7,6,1,0.8571428571428571,4,3,1,0.75,0.7999999999999999,llama3,mimiciii,nursing_note,PROMPT1_entailment
46,14,29,28,1,0.9655172413793104,25,22,3,0.88,0.9207772795216742,llama3,mimiciii,nursing_note,PROMPT1_entailment
47,140,12,11,1,0.9166666666666666,24,22,2,0.9166666666666666,0.9166666666666666,llama3,mimiciii,nursing_note,PROMPT1_entailment
48,141,18,18,0,1.0,11,11,0,1.0,1.0,llama3,mimiciii,nursing_note,PROMPT1_entailment
49,142,27,26,1,0.9629629629629628,8,6,2,0.75,0.8432432432432433,llama3,mimiciii,nursing_note,PROMPT1_entailment
50,143,11,10,1,0.9090909090909092,2,1,1,0.5,0.6451612903225806,llama3,mimiciii,nursing_note,PROMPT1_entailment
51,144,12,9,3,0.75,5,5,0,1.0,0.8571428571428571,llama3,mimiciii,nursing_note,PROMPT1_entailment
52,145,14,14,0,1.0,19,17,2,0.8947368421052632,0.9444444444444444,llama3,mimiciii,nursing_note,PROMPT1_entailment
53,146,10,10,0,1.0,6,6,0,1.0,1.0,llama3,mimiciii,nursing_note,PROMPT1_entailment
54,147,10,8,2,0.8,26,17,9,0.6538461538461539,0.7195767195767195,llama3,mimiciii,nursing_note,PROMPT1_entailment
55,148,9,9,0,1.0,7,7,0,1.0,1.0,llama3,mimiciii,nursing_note,PROMPT1_entailment
56,149,30,26,4,0.8666666666666667,36,28,8,0.7777777777777778,0.81981981981982,llama3,mimiciii,nursing_note,PROMPT1_entailment
57,15,25,20,5,0.8,33,30,3,0.9090909090909092,0.8510638297872342,llama3,mimiciii,nursing_note,PROMPT1_entailment
58,150,12,12,0,1.0,8,7,1,0.875,0.9333333333333332,llama3,mimiciii,nursing_note,PROMPT1_entailment
59,151,28,26,2,0.9285714285714286,26,24,2,0.9230769230769232,0.9258160237388724,llama3,mimiciii,nursing_note,PROMPT1_entailment
60,152,35,30,5,0.8571428571428571,44,33,11,0.75,0.7999999999999999,llama3,mimiciii,nursing_note,PROMPT1_entailment
61,153,6,6,0,1.0,4,3,1,0.75,0.8571428571428571,llama3,mimiciii,nursing_note,PROMPT1_entailment
62,154,38,34,4,0.8947368421052632,34,29,5,0.8529411764705882,0.8733392382639503,llama3,mimiciii,nursing_note,PROMPT1_entailment
63,155,33,28,5,0.8484848484848485,51,42,9,0.8235294117647058,0.8358208955223881,llama3,mimiciii,nursing_note,PROMPT1_entailment
64,156,22,21,1,0.9545454545454546,26,18,8,0.6923076923076923,0.8025477707006369,llama3,mimiciii,nursing_note,PROMPT1_entailment
65,157,7,7,0,1.0,5,3,2,0.6,0.7499999999999999,llama3,mimiciii,nursing_note,PROMPT1_entailment
66,158,29,29,0,1.0,22,19,3,0.8636363636363636,0.9268292682926828,llama3,mimiciii,nursing_note,PROMPT1_entailment
67,159,12,12,0,1.0,8,7,1,0.875,0.9333333333333332,llama3,mimiciii,nursing_note,PROMPT1_entailment
68,16,26,21,5,0.8076923076923077,30,24,6,0.8,0.8038277511961722,llama3,mimiciii,nursing_note,PROMPT1_entailment
69,160,20,18,2,0.9,21,16,5,0.7619047619047619,0.8252148997134672,llama3,mimiciii,nursing_note,PROMPT1_entailment
70,161,7,7,0,1.0,6,5,1,0.8333333333333334,0.9090909090909092,llama3,mimiciii,nursing_note,PROMPT1_entailment
71,162,27,23,4,0.8518518518518519,31,27,4,0.8709677419354839,0.8613037447988905,llama3,mimiciii,nursing_note,PROMPT1_entailment
72,163,10,10,0,1.0,4,3,1,0.75,0.8571428571428571,llama3,mimiciii,nursing_note,PROMPT1_entailment
73,164,15,14,1,0.9333333333333332,13,12,1,0.9230769230769232,0.9281767955801106,llama3,mimiciii,nursing_note,PROMPT1_entailment
74,165,30,29,1,0.9666666666666668,24,19,5,0.7916666666666666,0.8704581358609794,llama3,mimiciii,nursing_note,PROMPT1_entailment
75,166,13,12,1,0.9230769230769232,3,3,0,1.0,0.96,llama3,mimiciii,nursing_note,PROMPT1_entailment
76,167,24,23,1,0.9583333333333334,16,15,1,0.9375,0.9478021978021978,llama3,mimiciii,nursing_note,PROMPT1_entailment
77,168,15,11,4,0.7333333333333333,25,17,8,0.68,0.7056603773584905,llama3,mimiciii,nursing_note,PROMPT1_entailment
78,169,18,18,0,1.0,12,12,0,1.0,1.0,llama3,mimiciii,nursing_note,PROMPT1_entailment
79,17,30,28,2,0.9333333333333332,39,32,7,0.8205128205128205,0.8732943469785575,llama3,mimiciii,nursing_note,PROMPT1_entailment
80,170,24,22,2,0.9166666666666666,21,20,1,0.9523809523809524,0.9341825902335456,llama3,mimiciii,nursing_note,PROMPT1_entailment
81,171,7,5,2,0.7142857142857143,8,8,0,1.0,0.8333333333333333,llama3,mimiciii,nursing_note,PROMPT1_entailment
82,172,34,33,1,0.9705882352941176,38,30,8,0.7894736842105263,0.870712401055409,llama3,mimiciii,nursing_note,PROMPT1_entailment
83,173,20,19,1,0.95,19,18,1,0.9473684210526316,0.9486823855755894,llama3,mimiciii,nursing_note,PROMPT1_entailment
84,174,9,9,0,1.0,8,7,1,0.875,0.9333333333333332,llama3,mimiciii,nursing_note,PROMPT1_entailment
85,175,5,4,1,0.8,4,4,0,1.0,0.888888888888889,llama3,mimiciii,nursing_note,PROMPT1_entailment
86,176,19,18,1,0.9473684210526316,13,10,3,0.7692307692307693,0.8490566037735849,llama3,mimiciii,nursing_note,PROMPT1_entailment
87,177,38,35,3,0.9210526315789472,38,33,5,0.868421052631579,0.8939628482972136,llama3,mimiciii,nursing_note,PROMPT1_entailment
88,178,26,25,1,0.9615384615384616,25,21,4,0.84,0.89666951323655,llama3,mimiciii,nursing_note,PROMPT1_entailment
89,179,21,21,0,1.0,22,16,6,0.7272727272727273,0.8421052631578948,llama3,mimiciii,nursing_note,PROMPT1_entailment
90,18,20,19,1,0.95,25,22,3,0.88,0.9136612021857924,llama3,mimiciii,nursing_note,PROMPT1_entailment
91,180,24,20,4,0.8333333333333334,27,19,8,0.7037037037037037,0.7630522088353413,llama3,mimiciii,nursing_note,PROMPT1_entailment
92,181,24,20,4,0.8333333333333334,25,25,0,1.0,0.9090909090909092,llama3,mimiciii,nursing_note,PROMPT1_entailment
93,182,11,10,1,0.9090909090909092,10,8,2,0.8,0.8510638297872342,llama3,mimiciii,nursing_note,PROMPT1_entailment
94,183,8,8,0,1.0,5,3,2,0.6,0.7499999999999999,llama3,mimiciii,nursing_note,PROMPT1_entailment
95,184,18,17,1,0.9444444444444444,1,1,0,1.0,0.9714285714285714,llama3,mimiciii,nursing_note,PROMPT1_entailment
96,185,26,23,3,0.8846153846153846,30,27,3,0.9,0.8922413793103449,llama3,mimiciii,nursing_note,PROMPT1_entailment
97,186,6,6,0,1.0,4,2,2,0.5,0.6666666666666666,llama3,mimiciii,nursing_note,PROMPT1_entailment
98,187,38,38,0,1.0,37,33,4,0.8918918918918919,0.9428571428571428,llama3,mimiciii,nursing_note,PROMPT1_entailment
99,188,6,6,0,1.0,2,1,1,0.5,0.6666666666666666,llama3,mimiciii,nursing_note,PROMPT1_entailment
100,189,28,27,1,0.9642857142857144,21,19,2,0.9047619047619048,0.9335759781619656,llama3,mimiciii,nursing_note,PROMPT1_entailment
101,19,49,39,10,0.7959183673469388,45,33,12,0.7333333333333333,0.7633451957295374,llama3,mimiciii,nursing_note,PROMPT1_entailment
102,190,29,27,2,0.9310344827586208,24,21,3,0.875,0.9021479713603818,llama3,mimiciii,nursing_note,PROMPT1_entailment
103,191,27,25,2,0.925925925925926,29,23,6,0.7931034482758621,0.8543833580980683,llama3,mimiciii,nursing_note,PROMPT1_entailment
104,192,14,14,0,1.0,15,14,1,0.9333333333333332,0.9655172413793104,llama3,mimiciii,nursing_note,PROMPT1_entailment
105,193,28,26,2,0.9285714285714286,36,33,3,0.9166666666666666,0.9225806451612902,llama3,mimiciii,nursing_note,PROMPT1_entailment
106,194,12,12,0,1.0,11,10,1,0.9090909090909092,0.9523809523809524,llama3,mimiciii,nursing_note,PROMPT1_entailment
107,195,7,7,0,1.0,7,7,0,1.0,1.0,llama3,mimiciii,nursing_note,PROMPT1_entailment
108,196,35,33,2,0.9428571428571428,34,31,3,0.9117647058823528,0.9270502945174444,llama3,mimiciii,nursing_note,PROMPT1_entailment
109,197,27,21,6,0.7777777777777778,27,25,2,0.925925925925926,0.8454106280193238,llama3,mimiciii,nursing_note,PROMPT1_entailment
110,198,27,26,1,0.9629629629629628,38,32,6,0.8421052631578947,0.898488120950324,llama3,mimiciii,nursing_note,PROMPT1_entailment
111,199,14,14,0,1.0,14,13,1,0.9285714285714286,0.962962962962963,llama3,mimiciii,nursing_note,PROMPT1_entailment
112,2,43,32,11,0.7441860465116279,43,35,8,0.813953488372093,0.777507809788268,llama3,mimiciii,nursing_note,PROMPT1_entailment
113,20,21,15,6,0.7142857142857143,46,32,14,0.6956521739130435,0.7048458149779735,llama3,mimiciii,nursing_note,PROMPT1_entailment
114,200,48,31,17,0.6458333333333334,44,33,11,0.75,0.6940298507462686,llama3,mimiciii,nursing_note,PROMPT1_entailment
115,201,24,22,2,0.9166666666666666,29,22,7,0.7586206896551724,0.830188679245283,llama3,mimiciii,nursing_note,PROMPT1_entailment
116,202,11,10,1,0.9090909090909092,9,9,0,1.0,0.9523809523809524,llama3,mimiciii,nursing_note,PROMPT1_entailment
117,203,12,12,0,1.0,7,7,0,1.0,1.0,llama3,mimiciii,nursing_note,PROMPT1_entailment
118,204,26,23,3,0.8846153846153846,24,19,5,0.7916666666666666,0.8355640535372849,llama3,mimiciii,nursing_note,PROMPT1_entailment
119,205,35,34,1,0.9714285714285714,47,39,8,0.8297872340425532,0.8950388120148499,llama3,mimiciii,nursing_note,PROMPT1_entailment
120,206,6,5,1,0.8333333333333334,6,4,2,0.6666666666666666,0.7407407407407408,llama3,mimiciii,nursing_note,PROMPT1_entailment
121,207,35,31,4,0.8857142857142857,29,27,2,0.9310344827586208,0.9078091106290672,llama3,mimiciii,nursing_note,PROMPT1_entailment
122,208,12,11,1,0.9166666666666666,7,7,0,1.0,0.9565217391304348,llama3,mimiciii,nursing_note,PROMPT1_entailment
123,209,5,5,0,1.0,2,2,0,1.0,1.0,llama3,mimiciii,nursing_note,PROMPT1_entailment
124,21,7,7,0,1.0,6,5,1,0.8333333333333334,0.9090909090909092,llama3,mimiciii,nursing_note,PROMPT1_entailment
125,210,21,20,1,0.9523809523809524,22,17,5,0.7727272727272727,0.8531994981179423,llama3,mimiciii,nursing_note,PROMPT1_entailment
126,211,5,5,0,1.0,4,4,0,1.0,1.0,llama3,mimiciii,nursing_note,PROMPT1_entailment
127,212,22,20,2,0.9090909090909092,37,35,2,0.945945945945946,0.9271523178807948,llama3,mimiciii,nursing_note,PROMPT1_entailment
128,213,15,14,1,0.9333333333333332,18,16,2,0.8888888888888888,0.9105691056910568,llama3,mimiciii,nursing_note,PROMPT1_entailment
129,214,9,7,2,0.7777777777777778,3,3,0,1.0,0.8750000000000001,llama3,mimiciii,nursing_note,PROMPT1_entailment
130,215,8,7,1,0.875,7,6,1,0.8571428571428571,0.8659793814432989,llama3,mimiciii,nursing_note,PROMPT1_entailment
131,216,19,17,2,0.8947368421052632,13,10,3,0.7692307692307693,0.8272506082725061,llama3,mimiciii,nursing_note,PROMPT1_entailment
132,217,28,26,2,0.9285714285714286,25,21,4,0.84,0.8820678513731826,llama3,mimiciii,nursing_note,PROMPT1_entailment
133,218,16,15,1,0.9375,18,15,3,0.8333333333333334,0.8823529411764706,llama3,mimiciii,nursing_note,PROMPT1_entailment
134,219,38,28,10,0.7368421052631579,14,12,2,0.8571428571428571,0.7924528301886793,llama3,mimiciii,nursing_note,PROMPT1_entailment
135,22,23,21,2,0.9130434782608696,26,23,3,0.8846153846153846,0.8986046511627905,llama3,mimiciii,nursing_note,PROMPT1_entailment
136,220,11,9,2,0.8181818181818182,5,5,0,1.0,0.9,llama3,mimiciii,nursing_note,PROMPT1_entailment
137,221,27,24,3,0.8888888888888888,35,24,11,0.6857142857142857,0.7741935483870968,llama3,mimiciii,nursing_note,PROMPT1_entailment
138,222,7,7,0,1.0,3,2,1,0.6666666666666666,0.8,llama3,mimiciii,nursing_note,PROMPT1_entailment
139,223,26,19,7,0.7307692307692307,30,24,6,0.8,0.763819095477387,llama3,mimiciii,nursing_note,PROMPT1_entailment
140,224,9,9,0,1.0,6,5,1,0.8333333333333334,0.9090909090909092,llama3,mimiciii,nursing_note,PROMPT1_entailment
141,225,35,25,10,0.7142857142857143,45,36,9,0.8,0.7547169811320756,llama3,mimiciii,nursing_note,PROMPT1_entailment
142,226,20,19,1,0.95,20,17,3,0.85,0.8972222222222223,llama3,mimiciii,nursing_note,PROMPT1_entailment
143,227,18,16,2,0.8888888888888888,15,14,1,0.9333333333333332,0.9105691056910568,llama3,mimiciii,nursing_note,PROMPT1_entailment
144,228,35,32,3,0.9142857142857144,38,34,4,0.8947368421052632,0.9044056525353285,llama3,mimiciii,nursing_note,PROMPT1_entailment
145,229,24,23,1,0.9583333333333334,22,19,3,0.8636363636363636,0.9085239085239084,llama3,mimiciii,nursing_note,PROMPT1_entailment
146,23,39,36,3,0.9230769230769232,35,31,4,0.8857142857142857,0.9040097205346294,llama3,mimiciii,nursing_note,PROMPT1_entailment
147,230,13,12,1,0.9230769230769232,7,6,1,0.8571428571428571,0.888888888888889,llama3,mimiciii,nursing_note,PROMPT1_entailment
148,231,39,39,0,1.0,15,12,3,0.8,0.888888888888889,llama3,mimiciii,nursing_note,PROMPT1_entailment
149,232,9,6,3,0.6666666666666666,2,2,0,1.0,0.8,llama3,mimiciii,nursing_note,PROMPT1_entailment
150,233,24,20,4,0.8333333333333334,33,24,9,0.7272727272727273,0.7766990291262137,llama3,mimiciii,nursing_note,PROMPT1_entailment
151,234,25,25,0,1.0,32,29,3,0.90625,0.9508196721311476,llama3,mimiciii,nursing_note,PROMPT1_entailment
152,235,12,12,0,1.0,10,10,0,1.0,1.0,llama3,mimiciii,nursing_note,PROMPT1_entailment
153,236,13,12,1,0.9230769230769232,7,4,3,0.5714285714285714,0.7058823529411765,llama3,mimiciii,nursing_note,PROMPT1_entailment
154,237,29,26,3,0.896551724137931,35,29,6,0.8285714285714286,0.8612221587664192,llama3,mimiciii,nursing_note,PROMPT1_entailment
155,238,37,27,10,0.7297297297297297,42,36,6,0.8571428571428571,0.7883211678832117,llama3,mimiciii,nursing_note,PROMPT1_entailment
156,239,20,20,0,1.0,21,19,2,0.9047619047619048,0.95,llama3,mimiciii,nursing_note,PROMPT1_entailment
157,24,9,9,0,1.0,5,5,0,1.0,1.0,llama3,mimiciii,nursing_note,PROMPT1_entailment
158,240,32,28,4,0.875,42,30,12,0.7142857142857143,0.7865168539325842,llama3,mimiciii,nursing_note,PROMPT1_entailment
159,241,19,16,3,0.8421052631578947,21,17,4,0.8095238095238095,0.8254931714719271,llama3,mimiciii,nursing_note,PROMPT1_entailment
160,242,18,15,3,0.8333333333333334,16,13,3,0.8125,0.8227848101265822,llama3,mimiciii,nursing_note,PROMPT1_entailment
161,243,10,8,2,0.8,5,3,2,0.6,0.6857142857142857,llama3,mimiciii,nursing_note,PROMPT1_entailment
162,244,21,18,3,0.8571428571428571,16,12,4,0.75,0.7999999999999999,llama3,mimiciii,nursing_note,PROMPT1_entailment
163,245,31,26,5,0.8387096774193549,37,28,9,0.7567567567567568,0.7956284153005465,llama3,mimiciii,nursing_note,PROMPT1_entailment
164,246,18,17,1,0.9444444444444444,10,8,2,0.8,0.8662420382165604,llama3,mimiciii,nursing_note,PROMPT1_entailment
165,247,10,10,0,1.0,6,5,1,0.8333333333333334,0.9090909090909092,llama3,mimiciii,nursing_note,PROMPT1_entailment
166,248,36,34,2,0.9444444444444444,42,36,6,0.8571428571428571,0.8986784140969163,llama3,mimiciii,nursing_note,PROMPT1_entailment
167,249,29,23,6,0.7931034482758621,39,32,7,0.8205128205128205,0.8065753424657535,llama3,mimiciii,nursing_note,PROMPT1_entailment
168,25,23,21,2,0.9130434782608696,23,15,8,0.6521739130434783,0.7608695652173915,llama3,mimiciii,nursing_note,PROMPT1_entailment
169,26,36,33,3,0.9166666666666666,35,28,7,0.8,0.854368932038835,llama3,mimiciii,nursing_note,PROMPT1_entailment
170,27,4,4,0,1.0,3,2,1,0.6666666666666666,0.8,llama3,mimiciii,nursing_note,PROMPT1_entailment
171,28,33,31,2,0.9393939393939394,16,13,3,0.8125,0.8713513513513513,llama3,mimiciii,nursing_note,PROMPT1_entailment
172,29,30,25,5,0.8333333333333334,33,24,9,0.7272727272727273,0.7766990291262137,llama3,mimiciii,nursing_note,PROMPT1_entailment
173,3,11,8,3,0.7272727272727273,6,5,1,0.8333333333333334,0.7766990291262137,llama3,mimiciii,nursing_note,PROMPT1_entailment
174,30,17,16,1,0.9411764705882352,13,13,0,1.0,0.9696969696969696,llama3,mimiciii,nursing_note,PROMPT1_entailment
175,31,22,21,1,0.9545454545454546,19,17,2,0.8947368421052632,0.923673997412678,llama3,mimiciii,nursing_note,PROMPT1_entailment
176,32,36,35,1,0.9722222222222222,44,41,3,0.9318181818181818,0.9515915119363396,llama3,mimiciii,nursing_note,PROMPT1_entailment
177,33,9,9,0,1.0,5,5,0,1.0,1.0,llama3,mimiciii,nursing_note,PROMPT1_entailment
178,34,6,6,0,1.0,3,3,0,1.0,1.0,llama3,mimiciii,nursing_note,PROMPT1_entailment
179,35,12,11,1,0.9166666666666666,7,7,0,1.0,0.9565217391304348,llama3,mimiciii,nursing_note,PROMPT1_entailment
180,36,32,29,3,0.90625,62,33,29,0.532258064516129,0.6706377014716187,llama3,mimiciii,nursing_note,PROMPT1_entailment
181,37,22,20,2,0.9090909090909092,38,28,10,0.7368421052631579,0.813953488372093,llama3,mimiciii,nursing_note,PROMPT1_entailment
182,38,22,17,5,0.7727272727272727,26,24,2,0.9230769230769232,0.8412371134020619,llama3,mimiciii,nursing_note,PROMPT1_entailment
183,39,15,15,0,1.0,3,2,1,0.6666666666666666,0.8,llama3,mimiciii,nursing_note,PROMPT1_entailment
184,4,20,19,1,0.95,26,24,2,0.9230769230769232,0.9363449691991786,llama3,mimiciii,nursing_note,PROMPT1_entailment
185,40,10,10,0,1.0,3,2,1,0.6666666666666666,0.8,llama3,mimiciii,nursing_note,PROMPT1_entailment
186,41,35,34,1,0.9714285714285714,50,39,11,0.78,0.8652528548123982,llama3,mimiciii,nursing_note,PROMPT1_entailment
187,42,21,19,2,0.9047619047619048,7,6,1,0.8571428571428571,0.8803088803088803,llama3,mimiciii,nursing_note,PROMPT1_entailment
188,43,28,23,5,0.8214285714285714,14,13,1,0.9285714285714286,0.8717201166180758,llama3,mimiciii,nursing_note,PROMPT1_entailment
189,44,6,6,0,1.0,3,3,0,1.0,1.0,llama3,mimiciii,nursing_note,PROMPT1_entailment
190,45,25,23,2,0.92,34,26,8,0.7647058823529411,0.835195530726257,llama3,mimiciii,nursing_note,PROMPT1_entailment
191,46,37,35,2,0.945945945945946,31,27,4,0.8709677419354839,0.9069097888675623,llama3,mimiciii,nursing_note,PROMPT1_entailment
192,47,16,15,1,0.9375,14,13,1,0.9285714285714286,0.9330143540669856,llama3,mimiciii,nursing_note,PROMPT1_entailment
193,48,16,16,0,1.0,9,9,0,1.0,1.0,llama3,mimiciii,nursing_note,PROMPT1_entailment
194,49,7,7,0,1.0,3,2,1,0.6666666666666666,0.8,llama3,mimiciii,nursing_note,PROMPT1_entailment
195,5,35,25,10,0.7142857142857143,15,14,1,0.9333333333333332,0.809248554913295,llama3,mimiciii,nursing_note,PROMPT1_entailment
196,50,19,19,0,1.0,16,12,4,0.75,0.8571428571428571,llama3,mimiciii,nursing_note,PROMPT1_entailment
197,51,9,9,0,1.0,6,5,1,0.8333333333333334,0.9090909090909092,llama3,mimiciii,nursing_note,PROMPT1_entailment
198,52,38,31,7,0.8157894736842105,38,29,9,0.7631578947368421,0.7885964912280702,llama3,mimiciii,nursing_note,PROMPT1_entailment
199,53,8,7,1,0.875,6,5,1,0.8333333333333334,0.8536585365853658,llama3,mimiciii,nursing_note,PROMPT1_entailment
200,54,16,15,1,0.9375,37,28,9,0.7567567567567568,0.8374875373878365,llama3,mimiciii,nursing_note,PROMPT1_entailment
201,55,35,28,7,0.8,35,18,17,0.5142857142857142,0.6260869565217391,llama3,mimiciii,nursing_note,PROMPT1_entailment
202,56,13,13,0,1.0,2,2,0,1.0,1.0,llama3,mimiciii,nursing_note,PROMPT1_entailment
203,57,20,19,1,0.95,17,12,5,0.7058823529411765,0.8099467140319717,llama3,mimiciii,nursing_note,PROMPT1_entailment
204,58,32,30,2,0.9375,25,21,4,0.84,0.8860759493670887,llama3,mimiciii,nursing_note,PROMPT1_entailment
205,59,11,10,1,0.9090909090909092,8,7,1,0.875,0.8917197452229298,llama3,mimiciii,nursing_note,PROMPT1_entailment
206,6,10,9,1,0.9,8,7,1,0.875,0.8873239436619719,llama3,mimiciii,nursing_note,PROMPT1_entailment
207,60,21,19,2,0.9047619047619048,27,22,5,0.8148148148148148,0.8574358974358974,llama3,mimiciii,nursing_note,PROMPT1_entailment
208,61,19,19,0,1.0,20,15,5,0.75,0.8571428571428571,llama3,mimiciii,nursing_note,PROMPT1_entailment
209,62,27,23,4,0.8518518518518519,37,26,11,0.7027027027027027,0.7701223438506117,llama3,mimiciii,nursing_note,PROMPT1_entailment
210,63,7,7,0,1.0,5,4,1,0.8,0.888888888888889,llama3,mimiciii,nursing_note,PROMPT1_entailment
211,64,36,35,1,0.9722222222222222,27,22,5,0.8148148148148148,0.8865860679332181,llama3,mimiciii,nursing_note,PROMPT1_entailment
212,65,16,15,1,0.9375,19,15,4,0.7894736842105263,0.8571428571428572,llama3,mimiciii,nursing_note,PROMPT1_entailment
213,66,13,12,1,0.9230769230769232,1,1,0,1.0,0.96,llama3,mimiciii,nursing_note,PROMPT1_entailment
214,67,11,11,0,1.0,7,4,3,0.5714285714285714,0.7272727272727273,llama3,mimiciii,nursing_note,PROMPT1_entailment
215,68,17,17,0,1.0,18,15,3,0.8333333333333334,0.9090909090909092,llama3,mimiciii,nursing_note,PROMPT1_entailment
216,69,25,21,4,0.84,25,23,2,0.92,0.8781818181818182,llama3,mimiciii,nursing_note,PROMPT1_entailment
217,7,6,6,0,1.0,2,2,0,1.0,1.0,llama3,mimiciii,nursing_note,PROMPT1_entailment
218,70,33,32,1,0.9696969696969696,45,33,12,0.7333333333333333,0.8351126927639382,llama3,mimiciii,nursing_note,PROMPT1_entailment
219,71,26,15,11,0.5769230769230769,51,25,26,0.4901960784313725,0.5300353356890458,llama3,mimiciii,nursing_note,PROMPT1_entailment
220,72,13,13,0,1.0,12,9,3,0.75,0.8571428571428571,llama3,mimiciii,nursing_note,PROMPT1_entailment
221,73,33,27,6,0.8181818181818182,38,32,6,0.8421052631578947,0.829971181556196,llama3,mimiciii,nursing_note,PROMPT1_entailment
222,74,7,6,1,0.8571428571428571,7,5,2,0.7142857142857143,0.7792207792207793,llama3,mimiciii,nursing_note,PROMPT1_entailment
223,75,30,28,2,0.9333333333333332,27,25,2,0.925925925925926,0.9296148738379816,llama3,mimiciii,nursing_note,PROMPT1_entailment
224,76,4,4,0,1.0,1,1,0,1.0,1.0,llama3,mimiciii,nursing_note,PROMPT1_entailment
225,77,66,46,20,0.696969696969697,59,53,6,0.8983050847457628,0.784932388924662,llama3,mimiciii,nursing_note,PROMPT1_entailment
226,78,26,22,4,0.8461538461538461,20,18,2,0.9,0.8722466960352422,llama3,mimiciii,nursing_note,PROMPT1_entailment
227,79,27,25,2,0.925925925925926,30,28,2,0.9333333333333332,0.9296148738379816,llama3,mimiciii,nursing_note,PROMPT1_entailment
228,8,10,10,0,1.0,11,10,1,0.9090909090909092,0.9523809523809524,llama3,mimiciii,nursing_note,PROMPT1_entailment
229,80,21,19,2,0.9047619047619048,22,18,4,0.8181818181818182,0.8592964824120602,llama3,mimiciii,nursing_note,PROMPT1_entailment
230,81,20,16,4,0.8,22,18,4,0.8181818181818182,0.8089887640449439,llama3,mimiciii,nursing_note,PROMPT1_entailment
231,82,20,15,5,0.75,17,13,4,0.7647058823529411,0.7572815533980582,llama3,mimiciii,nursing_note,PROMPT1_entailment
232,83,17,15,2,0.8823529411764706,28,20,8,0.7142857142857143,0.7894736842105262,llama3,mimiciii,nursing_note,PROMPT1_entailment
233,84,7,7,0,1.0,6,5,1,0.8333333333333334,0.9090909090909092,llama3,mimiciii,nursing_note,PROMPT1_entailment
234,85,21,19,2,0.9047619047619048,24,18,6,0.75,0.8201438848920864,llama3,mimiciii,nursing_note,PROMPT1_entailment
235,86,23,23,0,1.0,40,26,14,0.65,0.787878787878788,llama3,mimiciii,nursing_note,PROMPT1_entailment
236,87,18,17,1,0.9444444444444444,15,13,2,0.8666666666666667,0.9038854805725972,llama3,mimiciii,nursing_note,PROMPT1_entailment
237,88,22,20,2,0.9090909090909092,15,13,2,0.8666666666666667,0.887372013651877,llama3,mimiciii,nursing_note,PROMPT1_entailment
238,89,15,15,0,1.0,29,28,1,0.9655172413793104,0.9824561403508772,llama3,mimiciii,nursing_note,PROMPT1_entailment
239,9,27,25,2,0.925925925925926,17,15,2,0.8823529411764706,0.9036144578313252,llama3,mimiciii,nursing_note,PROMPT1_entailment
240,90,28,27,1,0.9642857142857144,14,13,1,0.9285714285714286,0.9460916442048518,llama3,mimiciii,nursing_note,PROMPT1_entailment
241,91,24,24,0,1.0,24,23,1,0.9583333333333334,0.9787234042553192,llama3,mimiciii,nursing_note,PROMPT1_entailment
242,92,26,23,3,0.8846153846153846,28,26,2,0.9285714285714286,0.906060606060606,llama3,mimiciii,nursing_note,PROMPT1_entailment
243,93,21,18,3,0.8571428571428571,23,23,0,1.0,0.923076923076923,llama3,mimiciii,nursing_note,PROMPT1_entailment
244,94,8,8,0,1.0,5,4,1,0.8,0.888888888888889,llama3,mimiciii,nursing_note,PROMPT1_entailment
245,95,18,16,2,0.8888888888888888,14,13,1,0.9285714285714286,0.9082969432314412,llama3,mimiciii,nursing_note,PROMPT1_entailment
246,96,8,6,2,0.75,6,5,1,0.8333333333333334,0.7894736842105262,llama3,mimiciii,nursing_note,PROMPT1_entailment
247,97,10,10,0,1.0,10,9,1,0.9,0.9473684210526316,llama3,mimiciii,nursing_note,PROMPT1_entailment
248,98,34,31,3,0.9117647058823528,13,10,3,0.7692307692307693,0.8344549125168238,llama3,mimiciii,nursing_note,PROMPT1_entailment
249,99,47,43,4,0.9148936170212766,44,41,3,0.9318181818181818,0.9232783451165226,llama3,mimiciii,nursing_note,PROMPT1_entailment
0,0,23,14,9,0.6086956521739131,11,10,1,0.9090909090909092,0.7291666666666666,llama3,mimiciii,nursing_note,PROMPT1_ICL_entailment
1,1,40,19,21,0.475,31,17,14,0.5483870967741935,0.5090622537431047,llama3,mimiciii,nursing_note,PROMPT1_ICL_entailment
2,10,26,16,10,0.6153846153846154,18,10,8,0.5555555555555556,0.583941605839416,llama3,mimiciii,nursing_note,PROMPT1_ICL_entailment
3,100,19,12,7,0.631578947368421,6,6,0,1.0,0.7741935483870968,llama3,mimiciii,nursing_note,PROMPT1_ICL_entailment
4,101,35,24,11,0.6857142857142857,27,23,4,0.8518518518518519,0.7598072952512045,llama3,mimiciii,nursing_note,PROMPT1_ICL_entailment
5,102,32,23,9,0.71875,26,20,6,0.7692307692307693,0.7431340872374799,llama3,mimiciii,nursing_note,PROMPT1_ICL_entailment
6,103,33,25,8,0.7575757575757576,22,16,6,0.7272727272727273,0.7421150278293136,llama3,mimiciii,nursing_note,PROMPT1_ICL_entailment
7,104,34,27,7,0.7941176470588235,20,17,3,0.85,0.8211091234347048,llama3,mimiciii,nursing_note,PROMPT1_ICL_entailment
8,105,29,19,10,0.6551724137931034,20,17,3,0.85,0.7399770904925544,llama3,mimiciii,nursing_note,PROMPT1_ICL_entailment
9,106,16,8,8,0.5,4,3,1,0.75,0.6,llama3,mimiciii,nursing_note,PROMPT1_ICL_entailment
10,107,58,47,11,0.8103448275862069,49,35,14,0.7142857142857143,0.7592891760904685,llama3,mimiciii,nursing_note,PROMPT1_ICL_entailment
11,108,41,36,5,0.8780487804878049,28,26,2,0.9285714285714286,0.9026036644165863,llama3,mimiciii,nursing_note,PROMPT1_ICL_entailment
12,109,13,5,8,0.3846153846153846,4,3,1,0.75,0.5084745762711865,llama3,mimiciii,nursing_note,PROMPT1_ICL_entailment
13,11,10,3,7,0.3,2,1,1,0.5,0.3749999999999999,llama3,mimiciii,nursing_note,PROMPT1_ICL_entailment
14,110,23,14,9,0.6086956521739131,13,12,1,0.9230769230769232,0.7336244541484717,llama3,mimiciii,nursing_note,PROMPT1_ICL_entailment
15,111,39,27,12,0.6923076923076923,32,24,8,0.75,0.7199999999999999,llama3,mimiciii,nursing_note,PROMPT1_ICL_entailment
16,112,47,38,9,0.8085106382978723,37,23,14,0.6216216216216216,0.7028548451950141,llama3,mimiciii,nursing_note,PROMPT1_ICL_entailment
17,113,14,6,8,0.4285714285714285,5,3,2,0.6,0.5,llama3,mimiciii,nursing_note,PROMPT1_ICL_entailment
18,114,29,19,10,0.6551724137931034,19,16,3,0.8421052631578947,0.7369696969696969,llama3,mimiciii,nursing_note,PROMPT1_ICL_entailment
19,115,22,15,7,0.6818181818181818,7,6,1,0.8571428571428571,0.759493670886076,llama3,mimiciii,nursing_note,PROMPT1_ICL_entailment
20,116,43,33,10,0.7674418604651163,31,25,6,0.8064516129032258,0.7864632983794089,llama3,mimiciii,nursing_note,PROMPT1_ICL_entailment
21,117,28,22,6,0.7857142857142857,18,13,5,0.7222222222222222,0.7526315789473684,llama3,mimiciii,nursing_note,PROMPT1_ICL_entailment
22,118,38,28,10,0.7368421052631579,25,18,7,0.72,0.7283236994219653,llama3,mimiciii,nursing_note,PROMPT1_ICL_entailment
23,119,31,28,3,0.9032258064516128,26,21,5,0.8076923076923077,0.852791878172589,llama3,mimiciii,nursing_note,PROMPT1_ICL_entailment
24,12,28,20,8,0.7142857142857143,18,14,4,0.7777777777777778,0.7446808510638298,llama3,mimiciii,nursing_note,PROMPT1_ICL_entailment
25,120,27,19,8,0.7037037037037037,18,15,3,0.8333333333333334,0.7630522088353413,llama3,mimiciii,nursing_note,PROMPT1_ICL_entailment
26,121,35,26,9,0.7428571428571429,37,19,18,0.5135135135135135,0.6072526121696373,llama3,mimiciii,nursing_note,PROMPT1_ICL_entailment
27,122,38,29,9,0.7631578947368421,11,6,5,0.5454545454545454,0.6361974405850092,llama3,mimiciii,nursing_note,PROMPT1_ICL_entailment
28,123,14,7,7,0.5,6,5,1,0.8333333333333334,0.625,llama3,mimiciii,nursing_note,PROMPT1_ICL_entailment
29,124,16,9,7,0.5625,5,3,2,0.6,0.5806451612903225,llama3,mimiciii,nursing_note,PROMPT1_ICL_entailment
30,125,31,29,2,0.935483870967742,43,30,13,0.6976744186046512,0.7992650436380341,llama3,mimiciii,nursing_note,PROMPT1_ICL_entailment
31,126,35,23,12,0.6571428571428571,28,16,12,0.5714285714285714,0.6112956810631228,llama3,mimiciii,nursing_note,PROMPT1_ICL_entailment
32,127,27,22,5,0.8148148148148148,10,9,1,0.9,0.855291576673866,llama3,mimiciii,nursing_note,PROMPT1_ICL_entailment
33,128,22,22,0,1.0,17,14,3,0.8235294117647058,0.9032258064516128,llama3,mimiciii,nursing_note,PROMPT1_ICL_entailment
34,129,35,26,9,0.7428571428571429,29,21,8,0.7241379310344828,0.7333781061114844,llama3,mimiciii,nursing_note,PROMPT1_ICL_entailment
35,13,47,43,4,0.9148936170212766,34,28,6,0.8235294117647058,0.8668106551475881,llama3,mimiciii,nursing_note,PROMPT1_ICL_entailment
36,130,38,31,7,0.8157894736842105,33,26,7,0.7878787878787878,0.8015912481352561,llama3,mimiciii,nursing_note,PROMPT1_ICL_entailment
37,131,30,25,5,0.8333333333333334,31,23,8,0.7419354838709677,0.7849829351535836,llama3,mimiciii,nursing_note,PROMPT1_ICL_entailment
38,132,42,31,11,0.7380952380952381,17,14,3,0.8235294117647058,0.77847533632287,llama3,mimiciii,nursing_note,PROMPT1_ICL_entailment
39,133,24,13,11,0.5416666666666666,10,6,4,0.6,0.5693430656934306,llama3,mimiciii,nursing_note,PROMPT1_ICL_entailment
40,134,39,18,21,0.4615384615384615,30,23,7,0.7666666666666667,0.5762004175365344,llama3,mimiciii,nursing_note,PROMPT1_ICL_entailment
41,135,46,38,8,0.8260869565217391,42,30,12,0.7142857142857143,0.7661290322580645,llama3,mimiciii,nursing_note,PROMPT1_ICL_entailment
42,136,48,44,4,0.9166666666666666,41,38,3,0.926829268292683,0.9217199558985668,llama3,mimiciii,nursing_note,PROMPT1_ICL_entailment
43,137,11,4,7,0.3636363636363636,2,1,1,0.5,0.4210526315789474,llama3,mimiciii,nursing_note,PROMPT1_ICL_entailment
44,138,13,5,8,0.3846153846153846,5,2,3,0.4,0.392156862745098,llama3,mimiciii,nursing_note,PROMPT1_ICL_entailment
45,139,15,6,9,0.4,4,3,1,0.75,0.5217391304347827,llama3,mimiciii,nursing_note,PROMPT1_ICL_entailment
46,14,38,28,10,0.7368421052631579,25,23,2,0.92,0.8182973316391359,llama3,mimiciii,nursing_note,PROMPT1_ICL_entailment
47,140,35,30,5,0.8571428571428571,24,21,3,0.875,0.8659793814432989,llama3,mimiciii,nursing_note,PROMPT1_ICL_entailment
48,141,22,15,7,0.6818181818181818,11,11,0,1.0,0.8108108108108109,llama3,mimiciii,nursing_note,PROMPT1_ICL_entailment
49,142,33,28,5,0.8484848484848485,8,7,1,0.875,0.8615384615384615,llama3,mimiciii,nursing_note,PROMPT1_ICL_entailment
50,143,18,12,6,0.6666666666666666,2,0,2,0.0,0.0,llama3,mimiciii,nursing_note,PROMPT1_ICL_entailment
51,144,17,8,9,0.4705882352941176,5,5,0,1.0,0.6399999999999999,llama3,mimiciii,nursing_note,PROMPT1_ICL_entailment
52,145,38,29,9,0.7631578947368421,19,16,3,0.8421052631578947,0.8006902502157032,llama3,mimiciii,nursing_note,PROMPT1_ICL_entailment
53,146,17,9,8,0.5294117647058824,6,5,1,0.8333333333333334,0.6474820143884893,llama3,mimiciii,nursing_note,PROMPT1_ICL_entailment
54,147,30,17,13,0.5666666666666667,26,16,10,0.6153846153846154,0.5900216919739697,llama3,mimiciii,nursing_note,PROMPT1_ICL_entailment
55,148,17,8,9,0.4705882352941176,7,6,1,0.8571428571428571,0.6075949367088607,llama3,mimiciii,nursing_note,PROMPT1_ICL_entailment
56,149,45,33,12,0.7333333333333333,36,26,10,0.7222222222222222,0.727735368956743,llama3,mimiciii,nursing_note,PROMPT1_ICL_entailment
57,15,32,18,14,0.5625,33,22,11,0.6666666666666666,0.6101694915254238,llama3,mimiciii,nursing_note,PROMPT1_ICL_entailment
58,150,19,11,8,0.5789473684210527,8,5,3,0.625,0.6010928961748634,llama3,mimiciii,nursing_note,PROMPT1_ICL_entailment
59,151,35,24,11,0.6857142857142857,26,21,5,0.8076923076923077,0.7417218543046358,llama3,mimiciii,nursing_note,PROMPT1_ICL_entailment
60,152,52,43,9,0.8269230769230769,44,33,11,0.75,0.7865853658536586,llama3,mimiciii,nursing_note,PROMPT1_ICL_entailment
61,153,12,4,8,0.3333333333333333,4,3,1,0.75,0.4615384615384615,llama3,mimiciii,nursing_note,PROMPT1_ICL_entailment
62,154,36,25,11,0.6944444444444444,34,21,13,0.6176470588235294,0.6537982565379826,llama3,mimiciii,nursing_note,PROMPT1_ICL_entailment
63,155,55,48,7,0.8727272727272727,51,46,5,0.9019607843137256,0.8871032543190036,llama3,mimiciii,nursing_note,PROMPT1_ICL_entailment
64,156,25,25,0,1.0,26,19,7,0.7307692307692307,0.8444444444444443,llama3,mimiciii,nursing_note,PROMPT1_ICL_entailment
65,157,14,7,7,0.5,5,4,1,0.8,0.6153846153846154,llama3,mimiciii,nursing_note,PROMPT1_ICL_entailment
66,158,35,30,5,0.8571428571428571,22,19,3,0.8636363636363636,0.860377358490566,llama3,mimiciii,nursing_note,PROMPT1_ICL_entailment
67,159,17,8,9,0.4705882352941176,8,2,6,0.25,0.3265306122448979,llama3,mimiciii,nursing_note,PROMPT1_ICL_entailment
68,16,46,34,12,0.7391304347826086,30,23,7,0.7666666666666667,0.7526467757459094,llama3,mimiciii,nursing_note,PROMPT1_ICL_entailment
69,160,39,32,7,0.8205128205128205,21,19,2,0.9047619047619048,0.8605803255484784,llama3,mimiciii,nursing_note,PROMPT1_ICL_entailment
70,161,14,6,8,0.4285714285714285,6,4,2,0.6666666666666666,0.5217391304347826,llama3,mimiciii,nursing_note,PROMPT1_ICL_entailment
71,162,37,24,13,0.6486486486486487,31,20,11,0.6451612903225806,0.646900269541779,llama3,mimiciii,nursing_note,PROMPT1_ICL_entailment
72,163,18,10,8,0.5555555555555556,4,4,0,1.0,0.7142857142857143,llama3,mimiciii,nursing_note,PROMPT1_ICL_entailment
73,164,26,17,9,0.6538461538461539,13,11,2,0.8461538461538461,0.7376725838264301,llama3,mimiciii,nursing_note,PROMPT1_ICL_entailment
74,165,46,33,13,0.717391304347826,24,17,7,0.7083333333333334,0.712833545108005,llama3,mimiciii,nursing_note,PROMPT1_ICL_entailment
75,166,21,15,6,0.7142857142857143,3,3,0,1.0,0.8333333333333333,llama3,mimiciii,nursing_note,PROMPT1_ICL_entailment
76,167,30,26,4,0.8666666666666667,16,16,0,1.0,0.9285714285714286,llama3,mimiciii,nursing_note,PROMPT1_ICL_entailment
77,168,33,20,13,0.6060606060606061,25,14,11,0.56,0.5821205821205822,llama3,mimiciii,nursing_note,PROMPT1_ICL_entailment
78,169,29,25,4,0.8620689655172413,12,12,0,1.0,0.925925925925926,llama3,mimiciii,nursing_note,PROMPT1_ICL_entailment
79,17,39,31,8,0.7948717948717948,39,28,11,0.717948717948718,0.7544545849630595,llama3,mimiciii,nursing_note,PROMPT1_ICL_entailment
80,170,34,30,4,0.8823529411764706,21,19,2,0.9047619047619048,0.8934169278996865,llama3,mimiciii,nursing_note,PROMPT1_ICL_entailment
81,171,15,9,6,0.6,8,5,3,0.625,0.6122448979591836,llama3,mimiciii,nursing_note,PROMPT1_ICL_entailment
82,172,34,34,0,1.0,38,30,8,0.7894736842105263,0.8823529411764706,llama3,mimiciii,nursing_note,PROMPT1_ICL_entailment
83,173,28,25,3,0.8928571428571429,19,15,4,0.7894736842105263,0.8379888268156424,llama3,mimiciii,nursing_note,PROMPT1_ICL_entailment
84,174,18,11,7,0.6111111111111112,8,4,4,0.5,0.55,llama3,mimiciii,nursing_note,PROMPT1_ICL_entailment
85,175,12,3,9,0.25,4,3,1,0.75,0.375,llama3,mimiciii,nursing_note,PROMPT1_ICL_entailment
86,176,31,21,10,0.6774193548387096,13,11,2,0.8461538461538461,0.752442996742671,llama3,mimiciii,nursing_note,PROMPT1_ICL_entailment
87,177,48,37,11,0.7708333333333334,38,35,3,0.9210526315789472,0.8392741412832144,llama3,mimiciii,nursing_note,PROMPT1_ICL_entailment
88,178,31,27,4,0.8709677419354839,25,20,5,0.8,0.833976833976834,llama3,mimiciii,nursing_note,PROMPT1_ICL_entailment
89,179,32,26,6,0.8125,22,17,5,0.7727272727272727,0.7921146953405017,llama3,mimiciii,nursing_note,PROMPT1_ICL_entailment
90,18,30,18,12,0.6,25,16,9,0.64,0.6193548387096774,llama3,mimiciii,nursing_note,PROMPT1_ICL_entailment
91,180,30,22,8,0.7333333333333333,27,17,10,0.6296296296296297,0.677536231884058,llama3,mimiciii,nursing_note,PROMPT1_ICL_entailment
92,181,30,21,9,0.7,25,21,4,0.84,0.7636363636363636,llama3,mimiciii,nursing_note,PROMPT1_ICL_entailment
93,182,19,9,10,0.4736842105263157,10,6,4,0.6,0.5294117647058824,llama3,mimiciii,nursing_note,PROMPT1_ICL_entailment
94,183,15,6,9,0.4,5,2,3,0.4,0.4000000000000001,llama3,mimiciii,nursing_note,PROMPT1_ICL_entailment
95,184,20,11,9,0.55,1,0,1,0.0,0.0,llama3,mimiciii,nursing_note,PROMPT1_ICL_entailment
96,185,25,15,10,0.6,30,19,11,0.6333333333333333,0.6162162162162161,llama3,mimiciii,nursing_note,PROMPT1_ICL_entailment
97,186,14,6,8,0.4285714285714285,4,3,1,0.75,0.5454545454545454,llama3,mimiciii,nursing_note,PROMPT1_ICL_entailment
98,187,33,32,1,0.9696969696969696,37,32,5,0.8648648648648649,0.9142857142857144,llama3,mimiciii,nursing_note,PROMPT1_ICL_entailment
99,188,12,4,8,0.3333333333333333,2,1,1,0.5,0.4,llama3,mimiciii,nursing_note,PROMPT1_ICL_entailment
100,189,36,24,12,0.6666666666666666,21,15,6,0.7142857142857143,0.689655172413793,llama3,mimiciii,nursing_note,PROMPT1_ICL_entailment
101,19,50,39,11,0.78,45,31,14,0.6888888888888889,0.7316187594553706,llama3,mimiciii,nursing_note,PROMPT1_ICL_entailment
102,190,30,23,7,0.7666666666666667,24,15,9,0.625,0.6886227544910181,llama3,mimiciii,nursing_note,PROMPT1_ICL_entailment
103,191,35,25,10,0.7142857142857143,29,21,8,0.7241379310344828,0.7191780821917808,llama3,mimiciii,nursing_note,PROMPT1_ICL_entailment
104,192,21,13,8,0.6190476190476191,15,13,2,0.8666666666666667,0.7222222222222222,llama3,mimiciii,nursing_note,PROMPT1_ICL_entailment
105,193,28,26,2,0.9285714285714286,36,33,3,0.9166666666666666,0.9225806451612902,llama3,mimiciii,nursing_note,PROMPT1_ICL_entailment
106,194,20,12,8,0.6,11,10,1,0.9090909090909092,0.7228915662650602,llama3,mimiciii,nursing_note,PROMPT1_ICL_entailment
107,195,15,8,7,0.5333333333333333,7,5,2,0.7142857142857143,0.6106870229007633,llama3,mimiciii,nursing_note,PROMPT1_ICL_entailment
108,196,38,35,3,0.9210526315789472,34,30,4,0.8823529411764706,0.9012875536480688,llama3,mimiciii,nursing_note,PROMPT1_ICL_entailment
109,197,21,13,8,0.6190476190476191,27,26,1,0.9629629629629628,0.7536231884057971,llama3,mimiciii,nursing_note,PROMPT1_ICL_entailment
110,198,27,21,6,0.7777777777777778,38,29,9,0.7631578947368421,0.7703984819734345,llama3,mimiciii,nursing_note,PROMPT1_ICL_entailment
111,199,20,18,2,0.9,14,13,1,0.9285714285714286,0.9140625,llama3,mimiciii,nursing_note,PROMPT1_ICL_entailment
112,2,35,17,18,0.4857142857142857,43,21,22,0.4883720930232558,0.4870395634379262,llama3,mimiciii,nursing_note,PROMPT1_ICL_entailment
113,20,41,30,11,0.7317073170731707,46,34,12,0.7391304347826086,0.7354001441961067,llama3,mimiciii,nursing_note,PROMPT1_ICL_entailment
114,200,45,40,5,0.8888888888888888,44,32,12,0.7272727272727273,0.7999999999999999,llama3,mimiciii,nursing_note,PROMPT1_ICL_entailment
115,201,28,23,5,0.8214285714285714,29,23,6,0.7931034482758621,0.8070175438596492,llama3,mimiciii,nursing_note,PROMPT1_ICL_entailment
116,202,19,10,9,0.5263157894736842,9,8,1,0.8888888888888888,0.6611570247933884,llama3,mimiciii,nursing_note,PROMPT1_ICL_entailment
117,203,17,9,8,0.5294117647058824,7,6,1,0.8571428571428571,0.6545454545454545,llama3,mimiciii,nursing_note,PROMPT1_ICL_entailment
118,204,27,24,3,0.8888888888888888,24,21,3,0.875,0.8818897637795274,llama3,mimiciii,nursing_note,PROMPT1_ICL_entailment
119,205,51,50,1,0.9803921568627452,47,38,9,0.8085106382978723,0.8861940298507462,llama3,mimiciii,nursing_note,PROMPT1_ICL_entailment
120,206,12,4,8,0.3333333333333333,6,4,2,0.6666666666666666,0.4444444444444444,llama3,mimiciii,nursing_note,PROMPT1_ICL_entailment
121,207,44,34,10,0.7727272727272727,29,16,13,0.5517241379310345,0.6437869822485207,llama3,mimiciii,nursing_note,PROMPT1_ICL_entailment
122,208,20,13,7,0.65,7,7,0,1.0,0.787878787878788,llama3,mimiciii,nursing_note,PROMPT1_ICL_entailment
123,209,11,4,7,0.3636363636363636,2,1,1,0.5,0.4210526315789474,llama3,mimiciii,nursing_note,PROMPT1_ICL_entailment
124,21,15,9,6,0.6,6,4,2,0.6666666666666666,0.631578947368421,llama3,mimiciii,nursing_note,PROMPT1_ICL_entailment
125,210,32,19,13,0.59375,22,19,3,0.8636363636363636,0.7037037037037037,llama3,mimiciii,nursing_note,PROMPT1_ICL_entailment
126,211,12,4,8,0.3333333333333333,4,2,2,0.5,0.4,llama3,mimiciii,nursing_note,PROMPT1_ICL_entailment
127,212,39,34,5,0.8717948717948718,37,34,3,0.918918918918919,0.8947368421052632,llama3,mimiciii,nursing_note,PROMPT1_ICL_entailment
128,213,27,20,7,0.7407407407407407,18,16,2,0.8888888888888888,0.808080808080808,llama3,mimiciii,nursing_note,PROMPT1_ICL_entailment
129,214,14,6,8,0.4285714285714285,3,3,0,1.0,0.6,llama3,mimiciii,nursing_note,PROMPT1_ICL_entailment
130,215,15,7,8,0.4666666666666667,7,6,1,0.8571428571428571,0.60431654676259,llama3,mimiciii,nursing_note,PROMPT1_ICL_entailment
131,216,33,21,12,0.6363636363636364,13,10,3,0.7692307692307693,0.6965174129353234,llama3,mimiciii,nursing_note,PROMPT1_ICL_entailment
132,217,35,25,10,0.7142857142857143,25,19,6,0.76,0.7364341085271319,llama3,mimiciii,nursing_note,PROMPT1_ICL_entailment
133,218,20,12,8,0.6,18,10,8,0.5555555555555556,0.576923076923077,llama3,mimiciii,nursing_note,PROMPT1_ICL_entailment
134,219,30,16,14,0.5333333333333333,14,9,5,0.6428571428571429,0.582995951417004,llama3,mimiciii,nursing_note,PROMPT1_ICL_entailment
135,22,44,35,9,0.7954545454545454,26,22,4,0.8461538461538461,0.8200212992545259,llama3,mimiciii,nursing_note,PROMPT1_ICL_entailment
136,220,19,10,9,0.5263157894736842,5,3,2,0.6,0.5607476635514018,llama3,mimiciii,nursing_note,PROMPT1_ICL_entailment
137,221,27,23,4,0.8518518518518519,35,23,12,0.6571428571428571,0.7419354838709677,llama3,mimiciii,nursing_note,PROMPT1_ICL_entailment
138,222,12,5,7,0.4166666666666667,3,2,1,0.6666666666666666,0.5128205128205129,llama3,mimiciii,nursing_note,PROMPT1_ICL_entailment
139,223,38,26,12,0.6842105263157895,30,25,5,0.8333333333333334,0.7514450867052023,llama3,mimiciii,nursing_note,PROMPT1_ICL_entailment
140,224,17,9,8,0.5294117647058824,6,5,1,0.8333333333333334,0.6474820143884893,llama3,mimiciii,nursing_note,PROMPT1_ICL_entailment
141,225,35,25,10,0.7142857142857143,45,31,14,0.6888888888888889,0.7013574660633485,llama3,mimiciii,nursing_note,PROMPT1_ICL_entailment
142,226,24,18,6,0.75,20,15,5,0.75,0.75,llama3,mimiciii,nursing_note,PROMPT1_ICL_entailment
143,227,26,19,7,0.7307692307692307,15,14,1,0.9333333333333332,0.8197226502311249,llama3,mimiciii,nursing_note,PROMPT1_ICL_entailment
144,228,49,36,13,0.7346938775510204,38,30,8,0.7894736842105263,0.7610993657505284,llama3,mimiciii,nursing_note,PROMPT1_ICL_entailment
145,229,36,26,10,0.7222222222222222,22,15,7,0.6818181818181818,0.7014388489208633,llama3,mimiciii,nursing_note,PROMPT1_ICL_entailment
146,23,43,37,6,0.8604651162790697,35,24,11,0.6857142857142857,0.7632144391920929,llama3,mimiciii,nursing_note,PROMPT1_ICL_entailment
147,230,21,13,8,0.6190476190476191,7,6,1,0.8571428571428571,0.7188940092165899,llama3,mimiciii,nursing_note,PROMPT1_ICL_entailment
148,231,46,46,0,1.0,15,13,2,0.8666666666666667,0.9285714285714286,llama3,mimiciii,nursing_note,PROMPT1_ICL_entailment
149,232,16,8,8,0.5,2,2,0,1.0,0.6666666666666666,llama3,mimiciii,nursing_note,PROMPT1_ICL_entailment
150,233,24,16,8,0.6666666666666666,33,27,6,0.8181818181818182,0.7346938775510203,llama3,mimiciii,nursing_note,PROMPT1_ICL_entailment
151,234,28,27,1,0.9642857142857144,32,21,11,0.65625,0.78099173553719,llama3,mimiciii,nursing_note,PROMPT1_ICL_entailment
152,235,23,17,6,0.7391304347826086,10,9,1,0.9,0.8116710875331564,llama3,mimiciii,nursing_note,PROMPT1_ICL_entailment
153,236,18,9,9,0.5,7,6,1,0.8571428571428571,0.631578947368421,llama3,mimiciii,nursing_note,PROMPT1_ICL_entailment
154,237,41,31,10,0.7560975609756098,35,20,15,0.5714285714285714,0.6509186351706037,llama3,mimiciii,nursing_note,PROMPT1_ICL_entailment
155,238,38,32,6,0.8421052631578947,42,25,17,0.5952380952380952,0.6974716652136006,llama3,mimiciii,nursing_note,PROMPT1_ICL_entailment
156,239,27,26,1,0.9629629629629628,21,20,1,0.9523809523809524,0.9576427255985268,llama3,mimiciii,nursing_note,PROMPT1_ICL_entailment
157,24,15,9,6,0.6,5,4,1,0.8,0.6857142857142857,llama3,mimiciii,nursing_note,PROMPT1_ICL_entailment
158,240,35,25,10,0.7142857142857143,42,24,18,0.5714285714285714,0.634920634920635,llama3,mimiciii,nursing_note,PROMPT1_ICL_entailment
159,241,22,19,3,0.8636363636363636,21,21,0,1.0,0.9268292682926828,llama3,mimiciii,nursing_note,PROMPT1_ICL_entailment
160,242,39,29,10,0.7435897435897436,16,12,4,0.75,0.7467811158798283,llama3,mimiciii,nursing_note,PROMPT1_ICL_entailment
161,243,15,6,9,0.4,5,3,2,0.6,0.48,llama3,mimiciii,nursing_note,PROMPT1_ICL_entailment
162,244,38,23,15,0.6052631578947368,16,10,6,0.625,0.6149732620320856,llama3,mimiciii,nursing_note,PROMPT1_ICL_entailment
163,245,35,27,8,0.7714285714285715,37,20,17,0.5405405405405406,0.6356680400235433,llama3,mimiciii,nursing_note,PROMPT1_ICL_entailment
164,246,28,25,3,0.8928571428571429,10,9,1,0.9,0.896414342629482,llama3,mimiciii,nursing_note,PROMPT1_ICL_entailment
165,247,16,8,8,0.5,6,4,2,0.6666666666666666,0.5714285714285715,llama3,mimiciii,nursing_note,PROMPT1_ICL_entailment
166,248,47,45,2,0.9574468085106383,42,40,2,0.9523809523809524,0.9549071618037136,llama3,mimiciii,nursing_note,PROMPT1_ICL_entailment
167,249,36,24,12,0.6666666666666666,39,25,14,0.6410256410256411,0.6535947712418301,llama3,mimiciii,nursing_note,PROMPT1_ICL_entailment
168,25,31,25,6,0.8064516129032258,23,16,7,0.6956521739130435,0.7469654528478058,llama3,mimiciii,nursing_note,PROMPT1_ICL_entailment
169,26,32,31,1,0.96875,35,24,11,0.6857142857142857,0.8030221262817053,llama3,mimiciii,nursing_note,PROMPT1_ICL_entailment
170,27,12,4,8,0.3333333333333333,3,2,1,0.6666666666666666,0.4444444444444444,llama3,mimiciii,nursing_note,PROMPT1_ICL_entailment
171,28,33,30,3,0.9090909090909092,16,11,5,0.6875,0.7829181494661921,llama3,mimiciii,nursing_note,PROMPT1_ICL_entailment
172,29,24,17,7,0.7083333333333334,33,14,19,0.4242424242424242,0.5306577480490525,llama3,mimiciii,nursing_note,PROMPT1_ICL_entailment
173,3,12,10,2,0.8333333333333334,6,5,1,0.8333333333333334,0.8333333333333334,llama3,mimiciii,nursing_note,PROMPT1_ICL_entailment
174,30,27,18,9,0.6666666666666666,13,12,1,0.9230769230769232,0.7741935483870968,llama3,mimiciii,nursing_note,PROMPT1_ICL_entailment
175,31,26,16,10,0.6153846153846154,19,13,6,0.6842105263157895,0.64797507788162,llama3,mimiciii,nursing_note,PROMPT1_ICL_entailment
176,32,40,38,2,0.95,44,41,3,0.9318181818181818,0.9408212560386472,llama3,mimiciii,nursing_note,PROMPT1_ICL_entailment
177,33,16,8,8,0.5,5,4,1,0.8,0.6153846153846154,llama3,mimiciii,nursing_note,PROMPT1_ICL_entailment
178,34,12,4,8,0.3333333333333333,3,2,1,0.6666666666666666,0.4444444444444444,llama3,mimiciii,nursing_note,PROMPT1_ICL_entailment
179,35,13,9,4,0.6923076923076923,7,7,0,1.0,0.8181818181818181,llama3,mimiciii,nursing_note,PROMPT1_ICL_entailment
180,36,35,29,6,0.8285714285714286,62,37,25,0.5967741935483871,0.6938247655997414,llama3,mimiciii,nursing_note,PROMPT1_ICL_entailment
181,37,34,18,16,0.5294117647058824,38,20,18,0.5263157894736842,0.5278592375366569,llama3,mimiciii,nursing_note,PROMPT1_ICL_entailment
182,38,34,21,13,0.6176470588235294,26,15,11,0.5769230769230769,0.5965909090909092,llama3,mimiciii,nursing_note,PROMPT1_ICL_entailment
183,39,23,15,8,0.6521739130434783,3,1,2,0.3333333333333333,0.4411764705882353,llama3,mimiciii,nursing_note,PROMPT1_ICL_entailment
184,4,26,16,10,0.6153846153846154,26,20,6,0.7692307692307693,0.6837606837606838,llama3,mimiciii,nursing_note,PROMPT1_ICL_entailment
185,40,17,10,7,0.5882352941176471,3,2,1,0.6666666666666666,0.625,llama3,mimiciii,nursing_note,PROMPT1_ICL_entailment
186,41,40,36,4,0.9,50,36,14,0.72,0.7999999999999999,llama3,mimiciii,nursing_note,PROMPT1_ICL_entailment
187,42,34,20,14,0.5882352941176471,7,6,1,0.8571428571428571,0.6976744186046512,llama3,mimiciii,nursing_note,PROMPT1_ICL_entailment
188,43,26,18,8,0.6923076923076923,14,9,5,0.6428571428571429,0.6666666666666666,llama3,mimiciii,nursing_note,PROMPT1_ICL_entailment
189,44,14,6,8,0.4285714285714285,3,2,1,0.6666666666666666,0.5217391304347826,llama3,mimiciii,nursing_note,PROMPT1_ICL_entailment
190,45,33,31,2,0.9393939393939394,34,25,9,0.7352941176470589,0.8249068653539117,llama3,mimiciii,nursing_note,PROMPT1_ICL_entailment
191,46,46,37,9,0.8043478260869565,31,28,3,0.9032258064516128,0.8509240246406571,llama3,mimiciii,nursing_note,PROMPT1_ICL_entailment
192,47,33,25,8,0.7575757575757576,14,12,2,0.8571428571428571,0.804289544235925,llama3,mimiciii,nursing_note,PROMPT1_ICL_entailment
193,48,25,17,8,0.68,9,8,1,0.8888888888888888,0.7705382436260623,llama3,mimiciii,nursing_note,PROMPT1_ICL_entailment
194,49,15,7,8,0.4666666666666667,3,2,1,0.6666666666666666,0.5490196078431373,llama3,mimiciii,nursing_note,PROMPT1_ICL_entailment
195,5,34,21,13,0.6176470588235294,15,9,6,0.6,0.608695652173913,llama3,mimiciii,nursing_note,PROMPT1_ICL_entailment
196,50,23,15,8,0.6521739130434783,16,12,4,0.75,0.6976744186046512,llama3,mimiciii,nursing_note,PROMPT1_ICL_entailment
197,51,16,10,6,0.625,6,5,1,0.8333333333333334,0.7142857142857143,llama3,mimiciii,nursing_note,PROMPT1_ICL_entailment
198,52,38,21,17,0.5526315789473685,38,18,20,0.4736842105263157,0.5101214574898785,llama3,mimiciii,nursing_note,PROMPT1_ICL_entailment
199,53,16,8,8,0.5,6,5,1,0.8333333333333334,0.625,llama3,mimiciii,nursing_note,PROMPT1_ICL_entailment
200,54,35,30,5,0.8571428571428571,37,29,8,0.7837837837837838,0.8188235294117646,llama3,mimiciii,nursing_note,PROMPT1_ICL_entailment
201,55,40,30,10,0.75,35,20,15,0.5714285714285714,0.6486486486486486,llama3,mimiciii,nursing_note,PROMPT1_ICL_entailment
202,56,17,10,7,0.5882352941176471,2,2,0,1.0,0.7407407407407407,llama3,mimiciii,nursing_note,PROMPT1_ICL_entailment
203,57,31,24,7,0.7741935483870968,17,12,5,0.7058823529411765,0.7384615384615385,llama3,mimiciii,nursing_note,PROMPT1_ICL_entailment
204,58,33,31,2,0.9393939393939394,25,22,3,0.88,0.9087275149900068,llama3,mimiciii,nursing_note,PROMPT1_ICL_entailment
205,59,23,13,10,0.5652173913043478,8,6,2,0.75,0.6446280991735538,llama3,mimiciii,nursing_note,PROMPT1_ICL_entailment
206,6,18,10,8,0.5555555555555556,8,8,0,1.0,0.7142857142857143,llama3,mimiciii,nursing_note,PROMPT1_ICL_entailment
207,60,26,22,4,0.8461538461538461,27,22,5,0.8148148148148148,0.830188679245283,llama3,mimiciii,nursing_note,PROMPT1_ICL_entailment
208,61,24,18,6,0.75,20,16,4,0.8,0.7741935483870969,llama3,mimiciii,nursing_note,PROMPT1_ICL_entailment
209,62,22,20,2,0.9090909090909092,37,25,12,0.6756756756756757,0.7751937984496124,llama3,mimiciii,nursing_note,PROMPT1_ICL_entailment
210,63,13,6,7,0.4615384615384615,5,4,1,0.8,0.5853658536585367,llama3,mimiciii,nursing_note,PROMPT1_ICL_entailment
211,64,39,35,4,0.8974358974358975,27,22,5,0.8148148148148148,0.8541320022185247,llama3,mimiciii,nursing_note,PROMPT1_ICL_entailment
212,65,20,18,2,0.9,19,14,5,0.7368421052631579,0.810289389067524,llama3,mimiciii,nursing_note,PROMPT1_ICL_entailment
213,66,16,10,6,0.625,1,1,0,1.0,0.7692307692307693,llama3,mimiciii,nursing_note,PROMPT1_ICL_entailment
214,67,19,10,9,0.5263157894736842,7,4,3,0.5714285714285714,0.547945205479452,llama3,mimiciii,nursing_note,PROMPT1_ICL_entailment
215,68,32,30,2,0.9375,18,16,2,0.8888888888888888,0.9125475285171102,llama3,mimiciii,nursing_note,PROMPT1_ICL_entailment
216,69,33,17,16,0.5151515151515151,25,20,5,0.8,0.6267281105990783,llama3,mimiciii,nursing_note,PROMPT1_ICL_entailment
217,7,13,6,7,0.4615384615384615,2,1,1,0.5,0.48,llama3,mimiciii,nursing_note,PROMPT1_ICL_entailment
218,70,37,33,4,0.8918918918918919,41,30,11,0.7317073170731707,0.8038976857490865,llama3,mimiciii,nursing_note,PROMPT1_ICL_entailment
219,72,19,19,0,1.0,3,2,1,0.6666666666666666,0.8,llama3,mimiciii,nursing_note,PROMPT1_ICL_entailment
220,73,36,26,10,0.7222222222222222,38,24,14,0.631578947368421,0.6738660907127431,llama3,mimiciii,nursing_note,PROMPT1_ICL_entailment
221,74,15,8,7,0.5333333333333333,7,5,2,0.7142857142857143,0.6106870229007633,llama3,mimiciii,nursing_note,PROMPT1_ICL_entailment
222,75,47,33,14,0.7021276595744681,27,18,9,0.6666666666666666,0.6839378238341969,llama3,mimiciii,nursing_note,PROMPT1_ICL_entailment
223,76,11,3,8,0.2727272727272727,1,1,0,1.0,0.4285714285714285,llama3,mimiciii,nursing_note,PROMPT1_ICL_entailment
224,77,46,32,14,0.6956521739130435,59,34,25,0.576271186440678,0.630359212050985,llama3,mimiciii,nursing_note,PROMPT1_ICL_entailment
225,78,29,16,13,0.5517241379310345,20,10,10,0.5,0.5245901639344263,llama3,mimiciii,nursing_note,PROMPT1_ICL_entailment
226,79,33,28,5,0.8484848484848485,30,25,5,0.8333333333333334,0.8408408408408408,llama3,mimiciii,nursing_note,PROMPT1_ICL_entailment
227,8,19,11,8,0.5789473684210527,11,9,2,0.8181818181818182,0.6780821917808219,llama3,mimiciii,nursing_note,PROMPT1_ICL_entailment
228,80,33,27,6,0.8181818181818182,22,20,2,0.9090909090909092,0.861244019138756,llama3,mimiciii,nursing_note,PROMPT1_ICL_entailment
229,81,35,23,12,0.6571428571428571,22,18,4,0.8181818181818182,0.7288732394366197,llama3,mimiciii,nursing_note,PROMPT1_ICL_entailment
230,82,29,20,9,0.6896551724137931,17,12,5,0.7058823529411765,0.6976744186046512,llama3,mimiciii,nursing_note,PROMPT1_ICL_entailment
231,83,27,18,9,0.6666666666666666,28,18,10,0.6428571428571429,0.6545454545454545,llama3,mimiciii,nursing_note,PROMPT1_ICL_entailment
232,84,16,9,7,0.5625,6,5,1,0.8333333333333334,0.6716417910447761,llama3,mimiciii,nursing_note,PROMPT1_ICL_entailment
233,85,37,27,10,0.7297297297297297,24,16,8,0.6666666666666666,0.6967741935483871,llama3,mimiciii,nursing_note,PROMPT1_ICL_entailment
234,86,41,35,6,0.8536585365853658,40,23,17,0.575,0.6871532223644898,llama3,mimiciii,nursing_note,PROMPT1_ICL_entailment
235,87,31,21,10,0.6774193548387096,15,13,2,0.8666666666666667,0.7604456824512534,llama3,mimiciii,nursing_note,PROMPT1_ICL_entailment
236,88,47,36,11,0.7659574468085106,15,11,4,0.7333333333333333,0.7492904446546831,llama3,mimiciii,nursing_note,PROMPT1_ICL_entailment
237,89,28,21,7,0.75,29,22,7,0.7586206896551724,0.7542857142857142,llama3,mimiciii,nursing_note,PROMPT1_ICL_entailment
238,9,35,32,3,0.9142857142857144,17,14,3,0.8235294117647058,0.8665377176015474,llama3,mimiciii,nursing_note,PROMPT1_ICL_entailment
239,90,29,19,10,0.6551724137931034,14,9,5,0.6428571428571429,0.6489563567362429,llama3,mimiciii,nursing_note,PROMPT1_ICL_entailment
240,91,20,15,5,0.75,24,19,5,0.7916666666666666,0.7702702702702704,llama3,mimiciii,nursing_note,PROMPT1_ICL_entailment
241,92,30,22,8,0.7333333333333333,28,17,11,0.6071428571428571,0.6642984014209591,llama3,mimiciii,nursing_note,PROMPT1_ICL_entailment
242,93,41,30,11,0.7317073170731707,23,19,4,0.8260869565217391,0.7760381211708647,llama3,mimiciii,nursing_note,PROMPT1_ICL_entailment
243,94,14,8,6,0.5714285714285714,5,4,1,0.8,0.6666666666666666,llama3,mimiciii,nursing_note,PROMPT1_ICL_entailment
244,95,34,23,11,0.6764705882352942,14,13,1,0.9285714285714286,0.7827225130890053,llama3,mimiciii,nursing_note,PROMPT1_ICL_entailment
245,96,16,7,9,0.4375,6,5,1,0.8333333333333334,0.5737704918032787,llama3,mimiciii,nursing_note,PROMPT1_ICL_entailment
246,97,18,11,7,0.6111111111111112,10,9,1,0.9,0.7279411764705883,llama3,mimiciii,nursing_note,PROMPT1_ICL_entailment
247,98,27,22,5,0.8148148148148148,13,10,3,0.7692307692307693,0.7913669064748201,llama3,mimiciii,nursing_note,PROMPT1_ICL_entailment
248,99,58,45,13,0.7758620689655172,44,36,8,0.8181818181818182,0.7964601769911505,llama3,mimiciii,nursing_note,PROMPT1_ICL_entailment
0,0,18,16,2,0.8888888888888888,11,11,0,1.0,0.9411764705882352,llama3,mimiciii,nursing_note,PROMPT2_ICL_entailment
1,1,31,18,13,0.5806451612903226,31,20,11,0.6451612903225806,0.6112054329371817,llama3,mimiciii,nursing_note,PROMPT2_ICL_entailment
2,10,25,22,3,0.88,18,15,3,0.8333333333333334,0.8560311284046693,llama3,mimiciii,nursing_note,PROMPT2_ICL_entailment
3,100,14,14,0,1.0,6,5,1,0.8333333333333334,0.9090909090909092,llama3,mimiciii,nursing_note,PROMPT2_ICL_entailment
4,101,28,24,4,0.8571428571428571,27,24,3,0.8888888888888888,0.8727272727272727,llama3,mimiciii,nursing_note,PROMPT2_ICL_entailment
5,102,28,26,2,0.9285714285714286,26,23,3,0.8846153846153846,0.906060606060606,llama3,mimiciii,nursing_note,PROMPT2_ICL_entailment
6,103,29,25,4,0.8620689655172413,22,19,3,0.8636363636363636,0.8628519527702089,llama3,mimiciii,nursing_note,PROMPT2_ICL_entailment
7,104,28,26,2,0.9285714285714286,20,19,1,0.95,0.9391634980988592,llama3,mimiciii,nursing_note,PROMPT2_ICL_entailment
8,105,22,21,1,0.9545454545454546,20,18,2,0.9,0.9264705882352942,llama3,mimiciii,nursing_note,PROMPT2_ICL_entailment
9,106,9,9,0,1.0,4,3,1,0.75,0.8571428571428571,llama3,mimiciii,nursing_note,PROMPT2_ICL_entailment
10,107,51,45,6,0.8823529411764706,49,34,15,0.6938775510204082,0.7768469154607769,llama3,mimiciii,nursing_note,PROMPT2_ICL_entailment
11,108,35,33,2,0.9428571428571428,28,22,6,0.7857142857142857,0.8571428571428571,llama3,mimiciii,nursing_note,PROMPT2_ICL_entailment
12,109,6,6,0,1.0,4,4,0,1.0,1.0,llama3,mimiciii,nursing_note,PROMPT2_ICL_entailment
13,11,2,2,0,1.0,2,1,1,0.5,0.6666666666666666,llama3,mimiciii,nursing_note,PROMPT2_ICL_entailment
14,110,21,20,1,0.9523809523809524,13,13,0,1.0,0.975609756097561,llama3,mimiciii,nursing_note,PROMPT2_ICL_entailment
15,111,34,27,7,0.7941176470588235,32,21,11,0.65625,0.7186311787072244,llama3,mimiciii,nursing_note,PROMPT2_ICL_entailment
16,112,53,44,9,0.8301886792452831,37,30,7,0.8108108108108109,0.8203853325046614,llama3,mimiciii,nursing_note,PROMPT2_ICL_entailment
17,113,8,8,0,1.0,5,5,0,1.0,1.0,llama3,mimiciii,nursing_note,PROMPT2_ICL_entailment
18,114,21,18,3,0.8571428571428571,19,16,3,0.8421052631578947,0.8495575221238938,llama3,mimiciii,nursing_note,PROMPT2_ICL_entailment
19,115,15,15,0,1.0,7,6,1,0.8571428571428571,0.923076923076923,llama3,mimiciii,nursing_note,PROMPT2_ICL_entailment
20,116,32,30,2,0.9375,31,29,2,0.935483870967742,0.9364908503767492,llama3,mimiciii,nursing_note,PROMPT2_ICL_entailment
21,117,49,42,7,0.8571428571428571,18,15,3,0.8333333333333334,0.8450704225352113,llama3,mimiciii,nursing_note,PROMPT2_ICL_entailment
22,118,34,28,6,0.8235294117647058,25,16,9,0.64,0.7202572347266882,llama3,mimiciii,nursing_note,PROMPT2_ICL_entailment
23,119,33,31,2,0.9393939393939394,26,23,3,0.8846153846153846,0.911182108626198,llama3,mimiciii,nursing_note,PROMPT2_ICL_entailment
24,12,27,25,2,0.925925925925926,18,14,4,0.7777777777777778,0.8454106280193238,llama3,mimiciii,nursing_note,PROMPT2_ICL_entailment
25,120,21,21,0,1.0,18,18,0,1.0,1.0,llama3,mimiciii,nursing_note,PROMPT2_ICL_entailment
26,121,38,36,2,0.9473684210526316,37,27,10,0.7297297297297297,0.8244274809160306,llama3,mimiciii,nursing_note,PROMPT2_ICL_entailment
27,122,39,38,1,0.9743589743589745,11,7,4,0.6363636363636364,0.7698986975397973,llama3,mimiciii,nursing_note,PROMPT2_ICL_entailment
28,123,8,8,0,1.0,6,6,0,1.0,1.0,llama3,mimiciii,nursing_note,PROMPT2_ICL_entailment
29,124,9,9,0,1.0,5,4,1,0.8,0.888888888888889,llama3,mimiciii,nursing_note,PROMPT2_ICL_entailment
30,125,24,22,2,0.9166666666666666,43,29,14,0.6744186046511628,0.7771010962241169,llama3,mimiciii,nursing_note,PROMPT2_ICL_entailment
31,126,24,22,2,0.9166666666666666,28,22,6,0.7857142857142857,0.8461538461538461,llama3,mimiciii,nursing_note,PROMPT2_ICL_entailment
32,127,23,21,2,0.9130434782608696,10,9,1,0.9,0.9064748201438848,llama3,mimiciii,nursing_note,PROMPT2_ICL_entailment
33,128,25,24,1,0.96,17,16,1,0.9411764705882352,0.9504950495049505,llama3,mimiciii,nursing_note,PROMPT2_ICL_entailment
34,129,33,31,2,0.9393939393939394,29,26,3,0.896551724137931,0.9174729652817304,llama3,mimiciii,nursing_note,PROMPT2_ICL_entailment
35,13,21,21,0,1.0,34,22,12,0.6470588235294118,0.7857142857142858,llama3,mimiciii,nursing_note,PROMPT2_ICL_entailment
36,130,33,26,7,0.7878787878787878,33,26,7,0.7878787878787878,0.7878787878787878,llama3,mimiciii,nursing_note,PROMPT2_ICL_entailment
37,131,39,35,4,0.8974358974358975,31,26,5,0.8387096774193549,0.8670795616960458,llama3,mimiciii,nursing_note,PROMPT2_ICL_entailment
38,132,35,33,2,0.9428571428571428,17,16,1,0.9411764705882352,0.9420160570918822,llama3,mimiciii,nursing_note,PROMPT2_ICL_entailment
39,133,21,18,3,0.8571428571428571,10,9,1,0.9,0.8780487804878048,llama3,mimiciii,nursing_note,PROMPT2_ICL_entailment
40,134,31,18,13,0.5806451612903226,30,23,7,0.7666666666666667,0.6608140462889067,llama3,mimiciii,nursing_note,PROMPT2_ICL_entailment
41,135,31,31,0,1.0,42,31,11,0.7380952380952381,0.8493150684931507,llama3,mimiciii,nursing_note,PROMPT2_ICL_entailment
42,136,50,48,2,0.96,41,37,4,0.902439024390244,0.9303300157150342,llama3,mimiciii,nursing_note,PROMPT2_ICL_entailment
43,137,6,6,0,1.0,2,1,1,0.5,0.6666666666666666,llama3,mimiciii,nursing_note,PROMPT2_ICL_entailment
44,138,8,8,0,1.0,5,4,1,0.8,0.888888888888889,llama3,mimiciii,nursing_note,PROMPT2_ICL_entailment
45,139,8,7,1,0.875,4,3,1,0.75,0.8076923076923077,llama3,mimiciii,nursing_note,PROMPT2_ICL_entailment
46,14,33,32,1,0.9696969696969696,25,23,2,0.92,0.944194996792816,llama3,mimiciii,nursing_note,PROMPT2_ICL_entailment
47,140,40,31,9,0.775,24,22,2,0.9166666666666666,0.8399014778325123,llama3,mimiciii,nursing_note,PROMPT2_ICL_entailment
48,141,18,18,0,1.0,11,11,0,1.0,1.0,llama3,mimiciii,nursing_note,PROMPT2_ICL_entailment
49,142,25,25,0,1.0,8,6,2,0.75,0.8571428571428571,llama3,mimiciii,nursing_note,PROMPT2_ICL_entailment
50,143,16,14,2,0.875,2,1,1,0.5,0.6363636363636364,llama3,mimiciii,nursing_note,PROMPT2_ICL_entailment
51,144,11,11,0,1.0,5,5,0,1.0,1.0,llama3,mimiciii,nursing_note,PROMPT2_ICL_entailment
52,145,36,32,4,0.8888888888888888,19,15,4,0.7894736842105263,0.8362369337979094,llama3,mimiciii,nursing_note,PROMPT2_ICL_entailment
53,146,9,9,0,1.0,6,6,0,1.0,1.0,llama3,mimiciii,nursing_note,PROMPT2_ICL_entailment
54,147,25,18,7,0.72,26,22,4,0.8461538461538461,0.7779960707269156,llama3,mimiciii,nursing_note,PROMPT2_ICL_entailment
55,148,15,14,1,0.9333333333333332,7,7,0,1.0,0.9655172413793104,llama3,mimiciii,nursing_note,PROMPT2_ICL_entailment
56,149,37,30,7,0.8108108108108109,36,27,9,0.75,0.7792207792207791,llama3,mimiciii,nursing_note,PROMPT2_ICL_entailment
57,15,28,26,2,0.9285714285714286,33,27,6,0.8181818181818182,0.8698884758364314,llama3,mimiciii,nursing_note,PROMPT2_ICL_entailment
58,150,19,19,0,1.0,8,5,3,0.625,0.7692307692307693,llama3,mimiciii,nursing_note,PROMPT2_ICL_entailment
59,151,30,27,3,0.9,26,23,3,0.8846153846153846,0.8922413793103449,llama3,mimiciii,nursing_note,PROMPT2_ICL_entailment
60,152,27,27,0,1.0,44,35,9,0.7954545454545454,0.8860759493670886,llama3,mimiciii,nursing_note,PROMPT2_ICL_entailment
61,153,7,7,0,1.0,4,4,0,1.0,1.0,llama3,mimiciii,nursing_note,PROMPT2_ICL_entailment
62,154,17,16,1,0.9411764705882352,34,30,4,0.8823529411764706,0.9108159392789372,llama3,mimiciii,nursing_note,PROMPT2_ICL_entailment
63,155,48,44,4,0.9166666666666666,51,43,8,0.8431372549019608,0.8783658310120704,llama3,mimiciii,nursing_note,PROMPT2_ICL_entailment
64,156,26,26,0,1.0,26,18,8,0.6923076923076923,0.8181818181818181,llama3,mimiciii,nursing_note,PROMPT2_ICL_entailment
65,157,7,7,0,1.0,5,4,1,0.8,0.888888888888889,llama3,mimiciii,nursing_note,PROMPT2_ICL_entailment
66,158,33,31,2,0.9393939393939394,22,19,3,0.8636363636363636,0.8999236058059586,llama3,mimiciii,nursing_note,PROMPT2_ICL_entailment
67,159,15,15,0,1.0,8,7,1,0.875,0.9333333333333332,llama3,mimiciii,nursing_note,PROMPT2_ICL_entailment
68,16,40,38,2,0.95,30,23,7,0.7666666666666667,0.8485436893203884,llama3,mimiciii,nursing_note,PROMPT2_ICL_entailment
69,160,36,34,2,0.9444444444444444,21,20,1,0.9523809523809524,0.9483960948396096,llama3,mimiciii,nursing_note,PROMPT2_ICL_entailment
70,161,7,7,0,1.0,6,5,1,0.8333333333333334,0.9090909090909092,llama3,mimiciii,nursing_note,PROMPT2_ICL_entailment
71,162,35,29,6,0.8285714285714286,31,18,13,0.5806451612903226,0.682799215173316,llama3,mimiciii,nursing_note,PROMPT2_ICL_entailment
72,163,11,11,0,1.0,4,4,0,1.0,1.0,llama3,mimiciii,nursing_note,PROMPT2_ICL_entailment
73,164,23,23,0,1.0,13,10,3,0.7692307692307693,0.8695652173913044,llama3,mimiciii,nursing_note,PROMPT2_ICL_entailment
74,165,40,35,5,0.875,24,19,5,0.7916666666666666,0.8312499999999999,llama3,mimiciii,nursing_note,PROMPT2_ICL_entailment
75,166,15,15,0,1.0,3,3,0,1.0,1.0,llama3,mimiciii,nursing_note,PROMPT2_ICL_entailment
76,167,36,35,1,0.9722222222222222,16,16,0,1.0,0.9859154929577464,llama3,mimiciii,nursing_note,PROMPT2_ICL_entailment
77,168,34,27,7,0.7941176470588235,25,17,8,0.68,0.7326416600159618,llama3,mimiciii,nursing_note,PROMPT2_ICL_entailment
78,169,25,25,0,1.0,12,12,0,1.0,1.0,llama3,mimiciii,nursing_note,PROMPT2_ICL_entailment
79,17,32,27,5,0.84375,39,31,8,0.7948717948717948,0.8185819070904645,llama3,mimiciii,nursing_note,PROMPT2_ICL_entailment
80,170,38,37,1,0.9736842105263158,21,20,1,0.9523809523809524,0.962914769030579,llama3,mimiciii,nursing_note,PROMPT2_ICL_entailment
81,171,11,9,2,0.8181818181818182,8,5,3,0.625,0.7086614173228345,llama3,mimiciii,nursing_note,PROMPT2_ICL_entailment
82,172,37,37,0,1.0,38,28,10,0.7368421052631579,0.8484848484848484,llama3,mimiciii,nursing_note,PROMPT2_ICL_entailment
83,173,22,20,2,0.9090909090909092,19,16,3,0.8421052631578947,0.8743169398907102,llama3,mimiciii,nursing_note,PROMPT2_ICL_entailment
84,174,11,11,0,1.0,8,6,2,0.75,0.8571428571428571,llama3,mimiciii,nursing_note,PROMPT2_ICL_entailment
85,175,5,5,0,1.0,4,4,0,1.0,1.0,llama3,mimiciii,nursing_note,PROMPT2_ICL_entailment
86,176,26,23,3,0.8846153846153846,13,8,5,0.6153846153846154,0.7258382642998028,llama3,mimiciii,nursing_note,PROMPT2_ICL_entailment
87,177,36,35,1,0.9722222222222222,38,34,4,0.8947368421052632,0.9318715740015662,llama3,mimiciii,nursing_note,PROMPT2_ICL_entailment
88,178,44,42,2,0.9545454545454546,25,18,7,0.72,0.8208469055374592,llama3,mimiciii,nursing_note,PROMPT2_ICL_entailment
89,179,32,31,1,0.96875,22,18,4,0.8181818181818182,0.8871224165341812,llama3,mimiciii,nursing_note,PROMPT2_ICL_entailment
90,18,45,41,4,0.9111111111111112,25,17,8,0.68,0.7787709497206705,llama3,mimiciii,nursing_note,PROMPT2_ICL_entailment
91,180,27,22,5,0.8148148148148148,27,21,6,0.7777777777777778,0.7958656330749354,llama3,mimiciii,nursing_note,PROMPT2_ICL_entailment
92,181,28,23,5,0.8214285714285714,25,19,6,0.76,0.7895212285456187,llama3,mimiciii,nursing_note,PROMPT2_ICL_entailment
93,182,24,22,2,0.9166666666666666,10,5,5,0.5,0.6470588235294118,llama3,mimiciii,nursing_note,PROMPT2_ICL_entailment
94,183,9,9,0,1.0,5,4,1,0.8,0.888888888888889,llama3,mimiciii,nursing_note,PROMPT2_ICL_entailment
95,184,17,17,0,1.0,1,1,0,1.0,1.0,llama3,mimiciii,nursing_note,PROMPT2_ICL_entailment
96,185,33,30,3,0.9090909090909092,30,25,5,0.8333333333333334,0.8695652173913043,llama3,mimiciii,nursing_note,PROMPT2_ICL_entailment
97,186,6,5,1,0.8333333333333334,4,3,1,0.75,0.7894736842105262,llama3,mimiciii,nursing_note,PROMPT2_ICL_entailment
98,187,39,37,2,0.9487179487179488,37,30,7,0.8108108108108109,0.8743599842457661,llama3,mimiciii,nursing_note,PROMPT2_ICL_entailment
99,188,6,6,0,1.0,2,1,1,0.5,0.6666666666666666,llama3,mimiciii,nursing_note,PROMPT2_ICL_entailment
100,189,34,31,3,0.9117647058823528,21,18,3,0.8571428571428571,0.8836104513064132,llama3,mimiciii,nursing_note,PROMPT2_ICL_entailment
101,19,23,20,3,0.8695652173913043,45,32,13,0.7111111111111111,0.7823960880195598,llama3,mimiciii,nursing_note,PROMPT2_ICL_entailment
102,190,29,28,1,0.9655172413793104,24,17,7,0.7083333333333334,0.817167381974249,llama3,mimiciii,nursing_note,PROMPT2_ICL_entailment
103,191,29,27,2,0.9310344827586208,29,27,2,0.9310344827586208,0.9310344827586208,llama3,mimiciii,nursing_note,PROMPT2_ICL_entailment
104,192,15,15,0,1.0,15,14,1,0.9333333333333332,0.9655172413793104,llama3,mimiciii,nursing_note,PROMPT2_ICL_entailment
105,193,39,35,4,0.8974358974358975,36,31,5,0.8611111111111112,0.8788983394086676,llama3,mimiciii,nursing_note,PROMPT2_ICL_entailment
106,194,14,13,1,0.9285714285714286,11,11,0,1.0,0.962962962962963,llama3,mimiciii,nursing_note,PROMPT2_ICL_entailment
107,195,10,9,1,0.9,7,5,2,0.7142857142857143,0.7964601769911505,llama3,mimiciii,nursing_note,PROMPT2_ICL_entailment
108,196,35,33,2,0.9428571428571428,34,33,1,0.9705882352941176,0.9565217391304348,llama3,mimiciii,nursing_note,PROMPT2_ICL_entailment
109,197,28,22,6,0.7857142857142857,27,26,1,0.9629629629629628,0.8653555219364598,llama3,mimiciii,nursing_note,PROMPT2_ICL_entailment
110,198,34,30,4,0.8823529411764706,38,32,6,0.8421052631578947,0.8617594254937163,llama3,mimiciii,nursing_note,PROMPT2_ICL_entailment
111,199,19,18,1,0.9473684210526316,14,13,1,0.9285714285714286,0.937875751503006,llama3,mimiciii,nursing_note,PROMPT2_ICL_entailment
112,2,40,27,13,0.675,43,36,7,0.8372093023255814,0.7474048442906575,llama3,mimiciii,nursing_note,PROMPT2_ICL_entailment
113,20,30,23,7,0.7666666666666667,46,26,20,0.5652173913043478,0.6507072905331883,llama3,mimiciii,nursing_note,PROMPT2_ICL_entailment
114,200,37,26,11,0.7027027027027027,44,29,15,0.6590909090909091,0.6801984663960307,llama3,mimiciii,nursing_note,PROMPT2_ICL_entailment
115,201,25,23,2,0.92,29,23,6,0.7931034482758621,0.851851851851852,llama3,mimiciii,nursing_note,PROMPT2_ICL_entailment
116,202,12,12,0,1.0,9,7,2,0.7777777777777778,0.8750000000000001,llama3,mimiciii,nursing_note,PROMPT2_ICL_entailment
117,203,14,14,0,1.0,7,7,0,1.0,1.0,llama3,mimiciii,nursing_note,PROMPT2_ICL_entailment
118,204,26,24,2,0.9230769230769232,24,20,4,0.8333333333333334,0.8759124087591241,llama3,mimiciii,nursing_note,PROMPT2_ICL_entailment
119,205,52,52,0,1.0,47,41,6,0.8723404255319149,0.931818181818182,llama3,mimiciii,nursing_note,PROMPT2_ICL_entailment
120,206,7,7,0,1.0,6,5,1,0.8333333333333334,0.9090909090909092,llama3,mimiciii,nursing_note,PROMPT2_ICL_entailment
121,207,41,34,7,0.8292682926829268,29,22,7,0.7586206896551724,0.7923728813559322,llama3,mimiciii,nursing_note,PROMPT2_ICL_entailment
122,208,13,13,0,1.0,7,7,0,1.0,1.0,llama3,mimiciii,nursing_note,PROMPT2_ICL_entailment
123,209,4,4,0,1.0,2,2,0,1.0,1.0,llama3,mimiciii,nursing_note,PROMPT2_ICL_entailment
124,21,8,8,0,1.0,6,4,2,0.6666666666666666,0.8,llama3,mimiciii,nursing_note,PROMPT2_ICL_entailment
125,210,26,24,2,0.9230769230769232,22,18,4,0.8181818181818182,0.8674698795180724,llama3,mimiciii,nursing_note,PROMPT2_ICL_entailment
126,211,8,8,0,1.0,4,4,0,1.0,1.0,llama3,mimiciii,nursing_note,PROMPT2_ICL_entailment
127,212,38,35,3,0.9210526315789472,37,32,5,0.8648648648648649,0.8920748705694942,llama3,mimiciii,nursing_note,PROMPT2_ICL_entailment
128,213,28,24,4,0.8571428571428571,18,16,2,0.8888888888888888,0.8727272727272727,llama3,mimiciii,nursing_note,PROMPT2_ICL_entailment
129,214,12,9,3,0.75,3,3,0,1.0,0.8571428571428571,llama3,mimiciii,nursing_note,PROMPT2_ICL_entailment
130,215,9,8,1,0.8888888888888888,7,6,1,0.8571428571428571,0.8727272727272727,llama3,mimiciii,nursing_note,PROMPT2_ICL_entailment
131,216,22,18,4,0.8181818181818182,13,9,4,0.6923076923076923,0.7500000000000001,llama3,mimiciii,nursing_note,PROMPT2_ICL_entailment
132,217,41,32,9,0.7804878048780488,25,21,4,0.84,0.8091511137868753,llama3,mimiciii,nursing_note,PROMPT2_ICL_entailment
133,218,19,19,0,1.0,18,14,4,0.7777777777777778,0.8750000000000001,llama3,mimiciii,nursing_note,PROMPT2_ICL_entailment
134,219,24,17,7,0.7083333333333334,14,13,1,0.9285714285714286,0.8036363636363638,llama3,mimiciii,nursing_note,PROMPT2_ICL_entailment
135,22,38,36,2,0.9473684210526316,26,23,3,0.8846153846153846,0.9149171270718232,llama3,mimiciii,nursing_note,PROMPT2_ICL_entailment
136,220,12,10,2,0.8333333333333334,5,4,1,0.8,0.816326530612245,llama3,mimiciii,nursing_note,PROMPT2_ICL_entailment
137,221,31,25,6,0.8064516129032258,35,26,9,0.7428571428571429,0.7733491969066032,llama3,mimiciii,nursing_note,PROMPT2_ICL_entailment
138,222,7,7,0,1.0,3,3,0,1.0,1.0,llama3,mimiciii,nursing_note,PROMPT2_ICL_entailment
139,223,26,20,6,0.7692307692307693,30,25,5,0.8333333333333334,0.8,llama3,mimiciii,nursing_note,PROMPT2_ICL_entailment
140,224,13,13,0,1.0,6,5,1,0.8333333333333334,0.9090909090909092,llama3,mimiciii,nursing_note,PROMPT2_ICL_entailment
141,225,28,19,9,0.6785714285714286,45,27,18,0.6,0.6368715083798883,llama3,mimiciii,nursing_note,PROMPT2_ICL_entailment
142,226,24,23,1,0.9583333333333334,20,14,6,0.7,0.8090452261306532,llama3,mimiciii,nursing_note,PROMPT2_ICL_entailment
143,227,19,19,0,1.0,15,14,1,0.9333333333333332,0.9655172413793104,llama3,mimiciii,nursing_note,PROMPT2_ICL_entailment
144,228,41,31,10,0.7560975609756098,38,26,12,0.6842105263157895,0.7183600713012477,llama3,mimiciii,nursing_note,PROMPT2_ICL_entailment
145,229,27,26,1,0.9629629629629628,22,19,3,0.8636363636363636,0.9105990783410138,llama3,mimiciii,nursing_note,PROMPT2_ICL_entailment
146,23,35,33,2,0.9428571428571428,35,29,6,0.8285714285714286,0.8820276497695854,llama3,mimiciii,nursing_note,PROMPT2_ICL_entailment
147,230,14,14,0,1.0,7,6,1,0.8571428571428571,0.923076923076923,llama3,mimiciii,nursing_note,PROMPT2_ICL_entailment
148,231,51,50,1,0.9803921568627452,15,12,3,0.8,0.881057268722467,llama3,mimiciii,nursing_note,PROMPT2_ICL_entailment
149,232,9,7,2,0.7777777777777778,2,2,0,1.0,0.8750000000000001,llama3,mimiciii,nursing_note,PROMPT2_ICL_entailment
150,233,35,25,10,0.7142857142857143,33,20,13,0.6060606060606061,0.6557377049180327,llama3,mimiciii,nursing_note,PROMPT2_ICL_entailment
151,234,34,34,0,1.0,32,23,9,0.71875,0.8363636363636363,llama3,mimiciii,nursing_note,PROMPT2_ICL_entailment
152,235,18,18,0,1.0,10,8,2,0.8,0.888888888888889,llama3,mimiciii,nursing_note,PROMPT2_ICL_entailment
153,236,16,16,0,1.0,7,5,2,0.7142857142857143,0.8333333333333333,llama3,mimiciii,nursing_note,PROMPT2_ICL_entailment
154,237,31,27,4,0.8709677419354839,35,27,8,0.7714285714285715,0.8181818181818182,llama3,mimiciii,nursing_note,PROMPT2_ICL_entailment
155,238,38,30,8,0.7894736842105263,42,32,10,0.7619047619047619,0.7754442649434572,llama3,mimiciii,nursing_note,PROMPT2_ICL_entailment
156,239,42,35,7,0.8333333333333334,21,18,3,0.8571428571428571,0.8450704225352113,llama3,mimiciii,nursing_note,PROMPT2_ICL_entailment
157,24,11,11,0,1.0,5,5,0,1.0,1.0,llama3,mimiciii,nursing_note,PROMPT2_ICL_entailment
158,240,33,29,4,0.8787878787878788,42,28,14,0.6666666666666666,0.7581699346405228,llama3,mimiciii,nursing_note,PROMPT2_ICL_entailment
159,241,26,24,2,0.9230769230769232,21,21,0,1.0,0.96,llama3,mimiciii,nursing_note,PROMPT2_ICL_entailment
160,242,25,24,1,0.96,16,11,5,0.6875,0.8012139605462821,llama3,mimiciii,nursing_note,PROMPT2_ICL_entailment
161,243,11,10,1,0.9090909090909092,5,4,1,0.8,0.8510638297872342,llama3,mimiciii,nursing_note,PROMPT2_ICL_entailment
162,244,39,30,9,0.7692307692307693,16,11,5,0.6875,0.7260726072607261,llama3,mimiciii,nursing_note,PROMPT2_ICL_entailment
163,245,31,28,3,0.9032258064516128,37,27,10,0.7297297297297297,0.807261078483716,llama3,mimiciii,nursing_note,PROMPT2_ICL_entailment
164,246,30,29,1,0.9666666666666668,10,9,1,0.9,0.9321428571428572,llama3,mimiciii,nursing_note,PROMPT2_ICL_entailment
165,247,8,8,0,1.0,6,5,1,0.8333333333333334,0.9090909090909092,llama3,mimiciii,nursing_note,PROMPT2_ICL_entailment
166,248,30,27,3,0.9,42,33,9,0.7857142857142857,0.8389830508474577,llama3,mimiciii,nursing_note,PROMPT2_ICL_entailment
167,249,44,37,7,0.8409090909090909,39,30,9,0.7692307692307693,0.8034744842562432,llama3,mimiciii,nursing_note,PROMPT2_ICL_entailment
168,25,30,27,3,0.9,23,20,3,0.8695652173913043,0.8845208845208845,llama3,mimiciii,nursing_note,PROMPT2_ICL_entailment
169,26,41,35,6,0.8536585365853658,35,27,8,0.7714285714285715,0.8104631217838766,llama3,mimiciii,nursing_note,PROMPT2_ICL_entailment
170,27,6,6,0,1.0,3,2,1,0.6666666666666666,0.8,llama3,mimiciii,nursing_note,PROMPT2_ICL_entailment
171,28,36,31,5,0.8611111111111112,16,14,2,0.875,0.8680000000000001,llama3,mimiciii,nursing_note,PROMPT2_ICL_entailment
172,29,34,22,12,0.6470588235294118,33,19,14,0.5757575757575758,0.60932944606414,llama3,mimiciii,nursing_note,PROMPT2_ICL_entailment
173,3,12,10,2,0.8333333333333334,6,5,1,0.8333333333333334,0.8333333333333334,llama3,mimiciii,nursing_note,PROMPT2_ICL_entailment
174,30,20,20,0,1.0,13,11,2,0.8461538461538461,0.9166666666666666,llama3,mimiciii,nursing_note,PROMPT2_ICL_entailment
175,31,24,21,3,0.875,19,15,4,0.7894736842105263,0.8300395256916996,llama3,mimiciii,nursing_note,PROMPT2_ICL_entailment
176,32,39,39,0,1.0,44,42,2,0.9545454545454546,0.9767441860465116,llama3,mimiciii,nursing_note,PROMPT2_ICL_entailment
177,33,11,11,0,1.0,5,5,0,1.0,1.0,llama3,mimiciii,nursing_note,PROMPT2_ICL_entailment
178,34,6,6,0,1.0,3,2,1,0.6666666666666666,0.8,llama3,mimiciii,nursing_note,PROMPT2_ICL_entailment
179,35,15,14,1,0.9333333333333332,7,6,1,0.8571428571428571,0.8936170212765957,llama3,mimiciii,nursing_note,PROMPT2_ICL_entailment
180,36,26,24,2,0.9230769230769232,62,34,28,0.5483870967741935,0.688026981450253,llama3,mimiciii,nursing_note,PROMPT2_ICL_entailment
181,37,29,23,6,0.7931034482758621,38,30,8,0.7894736842105263,0.7912844036697249,llama3,mimiciii,nursing_note,PROMPT2_ICL_entailment
182,38,33,25,8,0.7575757575757576,26,24,2,0.9230769230769232,0.8321775312066575,llama3,mimiciii,nursing_note,PROMPT2_ICL_entailment
183,39,16,14,2,0.875,3,2,1,0.6666666666666666,0.7567567567567567,llama3,mimiciii,nursing_note,PROMPT2_ICL_entailment
184,4,27,23,4,0.8518518518518519,26,24,2,0.9230769230769232,0.8860353130016052,llama3,mimiciii,nursing_note,PROMPT2_ICL_entailment
185,40,11,11,0,1.0,3,2,1,0.6666666666666666,0.8,llama3,mimiciii,nursing_note,PROMPT2_ICL_entailment
186,41,46,42,4,0.9130434782608696,50,41,9,0.82,0.8640240842950326,llama3,mimiciii,nursing_note,PROMPT2_ICL_entailment
187,42,32,27,5,0.84375,7,6,1,0.8571428571428571,0.8503937007874015,llama3,mimiciii,nursing_note,PROMPT2_ICL_entailment
188,43,31,24,7,0.7741935483870968,14,12,2,0.8571428571428571,0.8135593220338982,llama3,mimiciii,nursing_note,PROMPT2_ICL_entailment
189,44,8,8,0,1.0,3,3,0,1.0,1.0,llama3,mimiciii,nursing_note,PROMPT2_ICL_entailment
190,45,25,24,1,0.96,34,29,5,0.8529411764705882,0.9033095392602204,llama3,mimiciii,nursing_note,PROMPT2_ICL_entailment
191,46,51,46,5,0.9019607843137256,31,22,9,0.7096774193548387,0.7943485086342229,llama3,mimiciii,nursing_note,PROMPT2_ICL_entailment
192,47,27,21,6,0.7777777777777778,14,14,0,1.0,0.8750000000000001,llama3,mimiciii,nursing_note,PROMPT2_ICL_entailment
193,48,21,21,0,1.0,9,8,1,0.8888888888888888,0.9411764705882352,llama3,mimiciii,nursing_note,PROMPT2_ICL_entailment
194,49,9,8,1,0.8888888888888888,3,2,1,0.6666666666666666,0.761904761904762,llama3,mimiciii,nursing_note,PROMPT2_ICL_entailment
195,5,35,29,6,0.8285714285714286,15,13,2,0.8666666666666667,0.847191011235955,llama3,mimiciii,nursing_note,PROMPT2_ICL_entailment
196,50,20,20,0,1.0,16,12,4,0.75,0.8571428571428571,llama3,mimiciii,nursing_note,PROMPT2_ICL_entailment
197,51,12,11,1,0.9166666666666666,6,5,1,0.8333333333333334,0.8730158730158729,llama3,mimiciii,nursing_note,PROMPT2_ICL_entailment
198,52,39,30,9,0.7692307692307693,38,31,7,0.8157894736842105,0.7918263090676884,llama3,mimiciii,nursing_note,PROMPT2_ICL_entailment
199,53,8,7,1,0.875,6,5,1,0.8333333333333334,0.8536585365853658,llama3,mimiciii,nursing_note,PROMPT2_ICL_entailment
200,54,38,35,3,0.9210526315789472,37,28,9,0.7567567567567568,0.8308605341246291,llama3,mimiciii,nursing_note,PROMPT2_ICL_entailment
201,55,32,25,7,0.78125,35,22,13,0.6285714285714286,0.6966434452184926,llama3,mimiciii,nursing_note,PROMPT2_ICL_entailment
202,56,15,15,0,1.0,2,2,0,1.0,1.0,llama3,mimiciii,nursing_note,PROMPT2_ICL_entailment
203,57,30,29,1,0.9666666666666668,17,14,3,0.8235294117647058,0.8893756845564075,llama3,mimiciii,nursing_note,PROMPT2_ICL_entailment
204,58,46,42,4,0.9130434782608696,25,23,2,0.92,0.9165085388994308,llama3,mimiciii,nursing_note,PROMPT2_ICL_entailment
205,59,11,11,0,1.0,8,7,1,0.875,0.9333333333333332,llama3,mimiciii,nursing_note,PROMPT2_ICL_entailment
206,6,11,11,0,1.0,8,7,1,0.875,0.9333333333333332,llama3,mimiciii,nursing_note,PROMPT2_ICL_entailment
207,60,29,26,3,0.896551724137931,27,22,5,0.8148148148148148,0.853731343283582,llama3,mimiciii,nursing_note,PROMPT2_ICL_entailment
208,61,29,26,3,0.896551724137931,20,18,2,0.9,0.8982725527831095,llama3,mimiciii,nursing_note,PROMPT2_ICL_entailment
209,62,24,21,3,0.875,37,26,11,0.7027027027027027,0.7794432548179873,llama3,mimiciii,nursing_note,PROMPT2_ICL_entailment
210,63,9,9,0,1.0,5,4,1,0.8,0.888888888888889,llama3,mimiciii,nursing_note,PROMPT2_ICL_entailment
211,64,39,37,2,0.9487179487179488,27,24,3,0.8888888888888888,0.9178294573643412,llama3,mimiciii,nursing_note,PROMPT2_ICL_entailment
212,65,21,20,1,0.9523809523809524,19,17,2,0.8947368421052632,0.9226594301221168,llama3,mimiciii,nursing_note,PROMPT2_ICL_entailment
213,66,12,12,0,1.0,1,1,0,1.0,1.0,llama3,mimiciii,nursing_note,PROMPT2_ICL_entailment
214,67,14,12,2,0.8571428571428571,7,6,1,0.8571428571428571,0.8571428571428571,llama3,mimiciii,nursing_note,PROMPT2_ICL_entailment
215,68,30,29,1,0.9666666666666668,18,15,3,0.8333333333333334,0.8950617283950617,llama3,mimiciii,nursing_note,PROMPT2_ICL_entailment
216,69,28,23,5,0.8214285714285714,25,24,1,0.96,0.8853247794707296,llama3,mimiciii,nursing_note,PROMPT2_ICL_entailment
217,7,7,7,0,1.0,2,2,0,1.0,1.0,llama3,mimiciii,nursing_note,PROMPT2_ICL_entailment
218,70,34,32,2,0.9411764705882352,45,30,15,0.6666666666666666,0.7804878048780487,llama3,mimiciii,nursing_note,PROMPT2_ICL_entailment
219,71,31,20,11,0.6451612903225806,51,30,21,0.5882352941176471,0.6153846153846154,llama3,mimiciii,nursing_note,PROMPT2_ICL_entailment
220,72,28,26,2,0.9285714285714286,12,10,2,0.8333333333333334,0.8783783783783784,llama3,mimiciii,nursing_note,PROMPT2_ICL_entailment
221,73,35,31,4,0.8857142857142857,38,31,7,0.8157894736842105,0.8493150684931505,llama3,mimiciii,nursing_note,PROMPT2_ICL_entailment
222,74,11,11,0,1.0,7,6,1,0.8571428571428571,0.923076923076923,llama3,mimiciii,nursing_note,PROMPT2_ICL_entailment
223,75,34,32,2,0.9411764705882352,27,23,4,0.8518518518518519,0.8942891859052248,llama3,mimiciii,nursing_note,PROMPT2_ICL_entailment
224,76,6,6,0,1.0,1,1,0,1.0,1.0,llama3,mimiciii,nursing_note,PROMPT2_ICL_entailment
225,77,32,29,3,0.90625,59,29,30,0.4915254237288136,0.6373626373626373,llama3,mimiciii,nursing_note,PROMPT2_ICL_entailment
226,78,33,25,8,0.7575757575757576,20,15,5,0.75,0.7537688442211055,llama3,mimiciii,nursing_note,PROMPT2_ICL_entailment
227,79,36,35,1,0.9722222222222222,30,27,3,0.9,0.9347181008902076,llama3,mimiciii,nursing_note,PROMPT2_ICL_entailment
228,8,13,12,1,0.9230769230769232,11,10,1,0.9090909090909092,0.9160305343511452,llama3,mimiciii,nursing_note,PROMPT2_ICL_entailment
229,80,29,27,2,0.9310344827586208,22,21,1,0.9545454545454546,0.9426433915211972,llama3,mimiciii,nursing_note,PROMPT2_ICL_entailment
230,81,33,27,6,0.8181818181818182,22,18,4,0.8181818181818182,0.8181818181818182,llama3,mimiciii,nursing_note,PROMPT2_ICL_entailment
231,82,34,30,4,0.8823529411764706,17,14,3,0.8235294117647058,0.8519269776876267,llama3,mimiciii,nursing_note,PROMPT2_ICL_entailment
232,83,16,14,2,0.875,28,22,6,0.7857142857142857,0.8279569892473119,llama3,mimiciii,nursing_note,PROMPT2_ICL_entailment
233,84,13,11,2,0.8461538461538461,6,4,2,0.6666666666666666,0.7457627118644068,llama3,mimiciii,nursing_note,PROMPT2_ICL_entailment
234,85,17,17,0,1.0,24,19,5,0.7916666666666666,0.8837209302325582,llama3,mimiciii,nursing_note,PROMPT2_ICL_entailment
235,86,27,25,2,0.925925925925926,40,20,20,0.5,0.6493506493506493,llama3,mimiciii,nursing_note,PROMPT2_ICL_entailment
236,87,22,20,2,0.9090909090909092,15,11,4,0.7333333333333333,0.8118081180811808,llama3,mimiciii,nursing_note,PROMPT2_ICL_entailment
237,88,39,30,9,0.7692307692307693,15,14,1,0.9333333333333332,0.8433734939759036,llama3,mimiciii,nursing_note,PROMPT2_ICL_entailment
238,89,30,29,1,0.9666666666666668,29,25,4,0.8620689655172413,0.9113764927718416,llama3,mimiciii,nursing_note,PROMPT2_ICL_entailment
239,9,36,34,2,0.9444444444444444,17,15,2,0.8823529411764706,0.9123434704830052,llama3,mimiciii,nursing_note,PROMPT2_ICL_entailment
240,90,31,28,3,0.9032258064516128,14,12,2,0.8571428571428571,0.8795811518324608,llama3,mimiciii,nursing_note,PROMPT2_ICL_entailment
241,91,25,24,1,0.96,24,22,2,0.9166666666666666,0.9378330373001776,llama3,mimiciii,nursing_note,PROMPT2_ICL_entailment
242,92,38,36,2,0.9473684210526316,28,24,4,0.8571428571428571,0.9,llama3,mimiciii,nursing_note,PROMPT2_ICL_entailment
243,93,27,26,1,0.9629629629629628,23,22,1,0.9565217391304348,0.959731543624161,llama3,mimiciii,nursing_note,PROMPT2_ICL_entailment
244,94,9,8,1,0.8888888888888888,5,4,1,0.8,0.8421052631578948,llama3,mimiciii,nursing_note,PROMPT2_ICL_entailment
245,95,25,20,5,0.8,14,13,1,0.9285714285714286,0.859504132231405,llama3,mimiciii,nursing_note,PROMPT2_ICL_entailment
246,96,11,10,1,0.9090909090909092,6,6,0,1.0,0.9523809523809524,llama3,mimiciii,nursing_note,PROMPT2_ICL_entailment
247,97,21,21,0,1.0,10,9,1,0.9,0.9473684210526316,llama3,mimiciii,nursing_note,PROMPT2_ICL_entailment
248,98,42,36,6,0.8571428571428571,13,10,3,0.7692307692307693,0.8108108108108107,llama3,mimiciii,nursing_note,PROMPT2_ICL_entailment
249,99,47,42,5,0.8936170212765957,44,38,6,0.8636363636363636,0.8783709411117228,llama3,mimiciii,nursing_note,PROMPT2_ICL_entailment
0,0,11,9,2,0.8181818181818182,11,9,2,0.8181818181818182,0.8181818181818182,llama3,mimiciii,nursing_note,PROMPT2_entailment
1,1,29,16,13,0.5517241379310345,31,24,7,0.7741935483870968,0.6442953020134228,llama3,mimiciii,nursing_note,PROMPT2_entailment
2,10,19,17,2,0.8947368421052632,18,15,3,0.8333333333333334,0.8629441624365481,llama3,mimiciii,nursing_note,PROMPT2_entailment
3,100,11,11,0,1.0,6,6,0,1.0,1.0,llama3,mimiciii,nursing_note,PROMPT2_entailment
4,101,29,27,2,0.9310344827586208,27,24,3,0.8888888888888888,0.9094736842105264,llama3,mimiciii,nursing_note,PROMPT2_entailment
5,102,14,14,0,1.0,26,19,7,0.7307692307692307,0.8444444444444443,llama3,mimiciii,nursing_note,PROMPT2_entailment
6,103,25,22,3,0.88,22,20,2,0.9090909090909092,0.8943089430894309,llama3,mimiciii,nursing_note,PROMPT2_entailment
7,104,22,22,0,1.0,20,19,1,0.95,0.9743589743589745,llama3,mimiciii,nursing_note,PROMPT2_entailment
8,105,17,17,0,1.0,20,18,2,0.9,0.9473684210526316,llama3,mimiciii,nursing_note,PROMPT2_entailment
9,106,9,9,0,1.0,4,3,1,0.75,0.8571428571428571,llama3,mimiciii,nursing_note,PROMPT2_entailment
10,107,36,33,3,0.9166666666666666,49,38,11,0.7755102040816326,0.8402010050251256,llama3,mimiciii,nursing_note,PROMPT2_entailment
11,108,35,34,1,0.9714285714285714,28,24,4,0.8571428571428571,0.9107142857142856,llama3,mimiciii,nursing_note,PROMPT2_entailment
12,109,6,6,0,1.0,4,4,0,1.0,1.0,llama3,mimiciii,nursing_note,PROMPT2_entailment
13,11,4,4,0,1.0,2,2,0,1.0,1.0,llama3,mimiciii,nursing_note,PROMPT2_entailment
14,110,16,16,0,1.0,13,12,1,0.9230769230769232,0.96,llama3,mimiciii,nursing_note,PROMPT2_entailment
15,111,20,20,0,1.0,32,22,10,0.6875,0.8148148148148148,llama3,mimiciii,nursing_note,PROMPT2_entailment
16,112,33,25,8,0.7575757575757576,37,29,8,0.7837837837837838,0.7704569606801275,llama3,mimiciii,nursing_note,PROMPT2_entailment
17,113,8,8,0,1.0,5,5,0,1.0,1.0,llama3,mimiciii,nursing_note,PROMPT2_entailment
18,114,21,17,4,0.8095238095238095,19,15,4,0.7894736842105263,0.7993730407523512,llama3,mimiciii,nursing_note,PROMPT2_entailment
19,115,14,14,0,1.0,7,7,0,1.0,1.0,llama3,mimiciii,nursing_note,PROMPT2_entailment
20,116,27,27,0,1.0,31,27,4,0.8709677419354839,0.9310344827586208,llama3,mimiciii,nursing_note,PROMPT2_entailment
21,117,38,32,6,0.8421052631578947,18,14,4,0.7777777777777778,0.8086642599277979,llama3,mimiciii,nursing_note,PROMPT2_entailment
22,118,30,27,3,0.9,25,18,7,0.72,0.7999999999999999,llama3,mimiciii,nursing_note,PROMPT2_entailment
23,119,21,20,1,0.9523809523809524,26,22,4,0.8461538461538461,0.8961303462321792,llama3,mimiciii,nursing_note,PROMPT2_entailment
24,12,20,18,2,0.9,18,14,4,0.7777777777777778,0.8344370860927153,llama3,mimiciii,nursing_note,PROMPT2_entailment
25,120,18,18,0,1.0,18,15,3,0.8333333333333334,0.9090909090909092,llama3,mimiciii,nursing_note,PROMPT2_entailment
26,121,24,21,3,0.875,37,27,10,0.7297297297297297,0.7957894736842105,llama3,mimiciii,nursing_note,PROMPT2_entailment
27,122,32,30,2,0.9375,11,9,2,0.8181818181818182,0.8737864077669902,llama3,mimiciii,nursing_note,PROMPT2_entailment
28,123,7,7,0,1.0,6,6,0,1.0,1.0,llama3,mimiciii,nursing_note,PROMPT2_entailment
29,124,9,9,0,1.0,5,4,1,0.8,0.888888888888889,llama3,mimiciii,nursing_note,PROMPT2_entailment
30,125,28,25,3,0.8928571428571429,43,32,11,0.7441860465116279,0.8117706747843735,llama3,mimiciii,nursing_note,PROMPT2_entailment
31,126,22,22,0,1.0,28,22,6,0.7857142857142857,0.88,llama3,mimiciii,nursing_note,PROMPT2_entailment
32,127,16,13,3,0.8125,10,9,1,0.9,0.854014598540146,llama3,mimiciii,nursing_note,PROMPT2_entailment
33,128,20,20,0,1.0,17,11,6,0.6470588235294118,0.7857142857142858,llama3,mimiciii,nursing_note,PROMPT2_entailment
34,129,30,30,0,1.0,29,23,6,0.7931034482758621,0.8846153846153846,llama3,mimiciii,nursing_note,PROMPT2_entailment
35,13,28,28,0,1.0,34,24,10,0.7058823529411765,0.8275862068965517,llama3,mimiciii,nursing_note,PROMPT2_entailment
36,130,27,22,5,0.8148148148148148,33,22,11,0.6666666666666666,0.7333333333333333,llama3,mimiciii,nursing_note,PROMPT2_entailment
37,131,20,19,1,0.95,31,24,7,0.7741935483870968,0.8531337698783911,llama3,mimiciii,nursing_note,PROMPT2_entailment
38,132,30,28,2,0.9333333333333332,17,16,1,0.9411764705882352,0.9372384937238494,llama3,mimiciii,nursing_note,PROMPT2_entailment
39,133,17,16,1,0.9411764705882352,10,9,1,0.9,0.9201277955271564,llama3,mimiciii,nursing_note,PROMPT2_entailment
40,134,32,15,17,0.46875,30,11,19,0.3666666666666666,0.4114713216957605,llama3,mimiciii,nursing_note,PROMPT2_entailment
41,135,38,34,4,0.8947368421052632,42,27,15,0.6428571428571429,0.7481662591687042,llama3,mimiciii,nursing_note,PROMPT2_entailment
42,136,28,27,1,0.9642857142857144,41,38,3,0.926829268292683,0.9451865499769692,llama3,mimiciii,nursing_note,PROMPT2_entailment
43,137,5,4,1,0.8,2,1,1,0.5,0.6153846153846154,llama3,mimiciii,nursing_note,PROMPT2_entailment
44,138,6,6,0,1.0,5,4,1,0.8,0.888888888888889,llama3,mimiciii,nursing_note,PROMPT2_entailment
45,139,7,7,0,1.0,4,2,2,0.5,0.6666666666666666,llama3,mimiciii,nursing_note,PROMPT2_entailment
46,14,19,19,0,1.0,25,22,3,0.88,0.9361702127659576,llama3,mimiciii,nursing_note,PROMPT2_entailment
47,140,18,15,3,0.8333333333333334,24,23,1,0.9583333333333334,0.8914728682170543,llama3,mimiciii,nursing_note,PROMPT2_entailment
48,141,15,15,0,1.0,11,11,0,1.0,1.0,llama3,mimiciii,nursing_note,PROMPT2_entailment
49,142,27,27,0,1.0,8,5,3,0.625,0.7692307692307693,llama3,mimiciii,nursing_note,PROMPT2_entailment
50,143,14,13,1,0.9285714285714286,2,1,1,0.5,0.65,llama3,mimiciii,nursing_note,PROMPT2_entailment
51,144,11,10,1,0.9090909090909092,5,5,0,1.0,0.9523809523809524,llama3,mimiciii,nursing_note,PROMPT2_entailment
52,145,23,22,1,0.9565217391304348,19,18,1,0.9473684210526316,0.9519230769230768,llama3,mimiciii,nursing_note,PROMPT2_entailment
53,146,9,8,1,0.8888888888888888,6,5,1,0.8333333333333334,0.8602150537634408,llama3,mimiciii,nursing_note,PROMPT2_entailment
54,147,17,14,3,0.8235294117647058,26,16,10,0.6153846153846154,0.7044025157232704,llama3,mimiciii,nursing_note,PROMPT2_entailment
55,148,10,9,1,0.9,7,7,0,1.0,0.9473684210526316,llama3,mimiciii,nursing_note,PROMPT2_entailment
56,149,25,23,2,0.92,36,28,8,0.7777777777777778,0.8429319371727749,llama3,mimiciii,nursing_note,PROMPT2_entailment
57,15,24,20,4,0.8333333333333334,33,28,5,0.8484848484848485,0.8408408408408408,llama3,mimiciii,nursing_note,PROMPT2_entailment
58,150,12,12,0,1.0,8,7,1,0.875,0.9333333333333332,llama3,mimiciii,nursing_note,PROMPT2_entailment
59,151,24,23,1,0.9583333333333334,26,23,3,0.8846153846153846,0.92,llama3,mimiciii,nursing_note,PROMPT2_entailment
60,152,37,33,4,0.8918918918918919,44,33,11,0.75,0.8148148148148148,llama3,mimiciii,nursing_note,PROMPT2_entailment
61,153,7,7,0,1.0,4,3,1,0.75,0.8571428571428571,llama3,mimiciii,nursing_note,PROMPT2_entailment
62,154,28,27,1,0.9642857142857144,34,26,8,0.7647058823529411,0.8529769137302551,llama3,mimiciii,nursing_note,PROMPT2_entailment
63,155,30,26,4,0.8666666666666667,51,39,12,0.7647058823529411,0.8125,llama3,mimiciii,nursing_note,PROMPT2_entailment
64,156,21,21,0,1.0,26,18,8,0.6923076923076923,0.8181818181818181,llama3,mimiciii,nursing_note,PROMPT2_entailment
65,157,7,7,0,1.0,5,4,1,0.8,0.888888888888889,llama3,mimiciii,nursing_note,PROMPT2_entailment
66,158,31,30,1,0.967741935483871,22,20,2,0.9090909090909092,0.9375,llama3,mimiciii,nursing_note,PROMPT2_entailment
67,159,10,10,0,1.0,8,5,3,0.625,0.7692307692307693,llama3,mimiciii,nursing_note,PROMPT2_entailment
68,16,21,19,2,0.9047619047619048,30,25,5,0.8333333333333334,0.867579908675799,llama3,mimiciii,nursing_note,PROMPT2_entailment
69,160,27,26,1,0.9629629629629628,21,18,3,0.8571428571428571,0.9069767441860463,llama3,mimiciii,nursing_note,PROMPT2_entailment
70,161,7,7,0,1.0,6,5,1,0.8333333333333334,0.9090909090909092,llama3,mimiciii,nursing_note,PROMPT2_entailment
71,162,24,20,4,0.8333333333333334,31,25,6,0.8064516129032258,0.819672131147541,llama3,mimiciii,nursing_note,PROMPT2_entailment
72,163,10,10,0,1.0,4,4,0,1.0,1.0,llama3,mimiciii,nursing_note,PROMPT2_entailment
73,164,17,17,0,1.0,13,12,1,0.9230769230769232,0.96,llama3,mimiciii,nursing_note,PROMPT2_entailment
74,165,27,26,1,0.9629629629629628,24,19,5,0.7916666666666666,0.8689533861037818,llama3,mimiciii,nursing_note,PROMPT2_entailment
75,166,14,14,0,1.0,3,3,0,1.0,1.0,llama3,mimiciii,nursing_note,PROMPT2_entailment
76,167,33,33,0,1.0,16,16,0,1.0,1.0,llama3,mimiciii,nursing_note,PROMPT2_entailment
77,168,15,13,2,0.8666666666666667,25,15,10,0.6,0.7090909090909091,llama3,mimiciii,nursing_note,PROMPT2_entailment
78,169,24,24,0,1.0,12,11,1,0.9166666666666666,0.9565217391304348,llama3,mimiciii,nursing_note,PROMPT2_entailment
79,17,29,28,1,0.9655172413793104,39,29,10,0.7435897435897436,0.8401448525607863,llama3,mimiciii,nursing_note,PROMPT2_entailment
80,170,30,29,1,0.9666666666666668,21,20,1,0.9523809523809524,0.9594706368899918,llama3,mimiciii,nursing_note,PROMPT2_entailment
81,171,9,7,2,0.7777777777777778,8,8,0,1.0,0.8750000000000001,llama3,mimiciii,nursing_note,PROMPT2_entailment
82,172,36,36,0,1.0,38,32,6,0.8421052631578947,0.9142857142857144,llama3,mimiciii,nursing_note,PROMPT2_entailment
83,173,19,18,1,0.9473684210526316,19,17,2,0.8947368421052632,0.9203007518796992,llama3,mimiciii,nursing_note,PROMPT2_entailment
84,174,10,9,1,0.9,8,7,1,0.875,0.8873239436619719,llama3,mimiciii,nursing_note,PROMPT2_entailment
85,175,4,4,0,1.0,4,3,1,0.75,0.8571428571428571,llama3,mimiciii,nursing_note,PROMPT2_entailment
86,176,19,18,1,0.9473684210526316,13,11,2,0.8461538461538461,0.8939051918735891,llama3,mimiciii,nursing_note,PROMPT2_entailment
87,177,26,25,1,0.9615384615384616,38,34,4,0.8947368421052632,0.9269356597600872,llama3,mimiciii,nursing_note,PROMPT2_entailment
88,178,23,22,1,0.9565217391304348,25,23,2,0.92,0.93790546802595,llama3,mimiciii,nursing_note,PROMPT2_entailment
89,179,21,21,0,1.0,22,15,7,0.6818181818181818,0.8108108108108109,llama3,mimiciii,nursing_note,PROMPT2_entailment
90,18,21,20,1,0.9523809523809524,25,20,5,0.8,0.8695652173913043,llama3,mimiciii,nursing_note,PROMPT2_entailment
91,180,19,18,1,0.9473684210526316,27,19,8,0.7037037037037037,0.807556080283353,llama3,mimiciii,nursing_note,PROMPT2_entailment
92,181,24,21,3,0.875,25,23,2,0.92,0.8969359331476324,llama3,mimiciii,nursing_note,PROMPT2_entailment
93,182,15,15,0,1.0,10,7,3,0.7,0.8235294117647058,llama3,mimiciii,nursing_note,PROMPT2_entailment
94,183,8,8,0,1.0,5,4,1,0.8,0.888888888888889,llama3,mimiciii,nursing_note,PROMPT2_entailment
95,184,15,15,0,1.0,1,1,0,1.0,1.0,llama3,mimiciii,nursing_note,PROMPT2_entailment
96,185,29,27,2,0.9310344827586208,30,25,5,0.8333333333333334,0.8794788273615635,llama3,mimiciii,nursing_note,PROMPT2_entailment
97,186,6,6,0,1.0,4,2,2,0.5,0.6666666666666666,llama3,mimiciii,nursing_note,PROMPT2_entailment
98,187,39,39,0,1.0,37,31,6,0.8378378378378378,0.911764705882353,llama3,mimiciii,nursing_note,PROMPT2_entailment
99,188,5,5,0,1.0,2,0,2,0.0,0.0,llama3,mimiciii,nursing_note,PROMPT2_entailment
100,189,25,24,1,0.96,21,17,4,0.8095238095238095,0.8783638320775027,llama3,mimiciii,nursing_note,PROMPT2_entailment
101,19,22,20,2,0.9090909090909092,45,32,13,0.7111111111111111,0.7980049875311721,llama3,mimiciii,nursing_note,PROMPT2_entailment
102,190,29,29,0,1.0,24,18,6,0.75,0.8571428571428571,llama3,mimiciii,nursing_note,PROMPT2_entailment
103,191,21,19,2,0.9047619047619048,29,21,8,0.7241379310344828,0.8044354838709677,llama3,mimiciii,nursing_note,PROMPT2_entailment
104,192,14,14,0,1.0,15,14,1,0.9333333333333332,0.9655172413793104,llama3,mimiciii,nursing_note,PROMPT2_entailment
105,193,44,42,2,0.9545454545454546,36,31,5,0.8611111111111112,0.9054242002781642,llama3,mimiciii,nursing_note,PROMPT2_entailment
106,194,12,12,0,1.0,11,11,0,1.0,1.0,llama3,mimiciii,nursing_note,PROMPT2_entailment
107,195,10,10,0,1.0,7,7,0,1.0,1.0,llama3,mimiciii,nursing_note,PROMPT2_entailment
108,196,31,31,0,1.0,34,31,3,0.9117647058823528,0.953846153846154,llama3,mimiciii,nursing_note,PROMPT2_entailment
109,197,26,22,4,0.8461538461538461,27,25,2,0.925925925925926,0.8842443729903537,llama3,mimiciii,nursing_note,PROMPT2_entailment
110,198,24,22,2,0.9166666666666666,38,30,8,0.7894736842105263,0.8483290488431876,llama3,mimiciii,nursing_note,PROMPT2_entailment
111,199,17,17,0,1.0,14,13,1,0.9285714285714286,0.962962962962963,llama3,mimiciii,nursing_note,PROMPT2_entailment
112,2,40,29,11,0.725,43,33,10,0.7674418604651163,0.7456174522789247,llama3,mimiciii,nursing_note,PROMPT2_entailment
113,20,21,14,7,0.6666666666666666,46,28,18,0.6086956521739131,0.6363636363636365,llama3,mimiciii,nursing_note,PROMPT2_entailment
114,200,38,24,14,0.631578947368421,44,31,13,0.7045454545454546,0.666069829901522,llama3,mimiciii,nursing_note,PROMPT2_entailment
115,201,22,19,3,0.8636363636363636,29,28,1,0.9655172413793104,0.9117395029991432,llama3,mimiciii,nursing_note,PROMPT2_entailment
116,202,12,11,1,0.9166666666666666,9,8,1,0.8888888888888888,0.9025641025641026,llama3,mimiciii,nursing_note,PROMPT2_entailment
117,203,10,10,0,1.0,7,7,0,1.0,1.0,llama3,mimiciii,nursing_note,PROMPT2_entailment
118,204,24,20,4,0.8333333333333334,24,19,5,0.7916666666666666,0.811965811965812,llama3,mimiciii,nursing_note,PROMPT2_entailment
119,205,32,32,0,1.0,47,35,12,0.7446808510638298,0.8536585365853657,llama3,mimiciii,nursing_note,PROMPT2_entailment
120,206,10,10,0,1.0,6,5,1,0.8333333333333334,0.9090909090909092,llama3,mimiciii,nursing_note,PROMPT2_entailment
121,207,23,20,3,0.8695652173913043,29,23,6,0.7931034482758621,0.8295761947700633,llama3,mimiciii,nursing_note,PROMPT2_entailment
122,208,11,11,0,1.0,7,7,0,1.0,1.0,llama3,mimiciii,nursing_note,PROMPT2_entailment
123,209,4,4,0,1.0,2,2,0,1.0,1.0,llama3,mimiciii,nursing_note,PROMPT2_entailment
124,21,8,8,0,1.0,6,5,1,0.8333333333333334,0.9090909090909092,llama3,mimiciii,nursing_note,PROMPT2_entailment
125,210,23,18,5,0.782608695652174,22,19,3,0.8636363636363636,0.8211284513805521,llama3,mimiciii,nursing_note,PROMPT2_entailment
126,211,8,8,0,1.0,4,4,0,1.0,1.0,llama3,mimiciii,nursing_note,PROMPT2_entailment
127,212,34,33,1,0.9705882352941176,37,29,8,0.7837837837837838,0.8672405980969642,llama3,mimiciii,nursing_note,PROMPT2_entailment
128,213,19,18,1,0.9473684210526316,18,15,3,0.8333333333333334,0.8866995073891626,llama3,mimiciii,nursing_note,PROMPT2_entailment
129,214,8,8,0,1.0,3,3,0,1.0,1.0,llama3,mimiciii,nursing_note,PROMPT2_entailment
130,215,8,7,1,0.875,7,6,1,0.8571428571428571,0.8659793814432989,llama3,mimiciii,nursing_note,PROMPT2_entailment
131,216,18,15,3,0.8333333333333334,13,9,4,0.6923076923076923,0.7563025210084034,llama3,mimiciii,nursing_note,PROMPT2_entailment
132,217,21,20,1,0.9523809523809524,25,21,4,0.84,0.8926673751328373,llama3,mimiciii,nursing_note,PROMPT2_entailment
133,218,19,19,0,1.0,18,15,3,0.8333333333333334,0.9090909090909092,llama3,mimiciii,nursing_note,PROMPT2_entailment
134,219,39,26,13,0.6666666666666666,14,12,2,0.8571428571428571,0.75,llama3,mimiciii,nursing_note,PROMPT2_entailment
135,22,23,21,2,0.9130434782608696,26,22,4,0.8461538461538461,0.8783269961977186,llama3,mimiciii,nursing_note,PROMPT2_entailment
136,220,12,10,2,0.8333333333333334,5,4,1,0.8,0.816326530612245,llama3,mimiciii,nursing_note,PROMPT2_entailment
137,221,26,21,5,0.8076923076923077,35,25,10,0.7142857142857143,0.7581227436823106,llama3,mimiciii,nursing_note,PROMPT2_entailment
138,222,7,6,1,0.8571428571428571,3,3,0,1.0,0.923076923076923,llama3,mimiciii,nursing_note,PROMPT2_entailment
139,223,29,26,3,0.896551724137931,30,26,4,0.8666666666666667,0.8813559322033899,llama3,mimiciii,nursing_note,PROMPT2_entailment
140,224,8,8,0,1.0,6,5,1,0.8333333333333334,0.9090909090909092,llama3,mimiciii,nursing_note,PROMPT2_entailment
141,225,37,29,8,0.7837837837837838,45,31,14,0.6888888888888889,0.733278955954323,llama3,mimiciii,nursing_note,PROMPT2_entailment
142,226,17,17,0,1.0,20,14,6,0.7,0.8235294117647058,llama3,mimiciii,nursing_note,PROMPT2_entailment
143,227,18,18,0,1.0,15,15,0,1.0,1.0,llama3,mimiciii,nursing_note,PROMPT2_entailment
144,228,31,31,0,1.0,38,33,5,0.868421052631579,0.9295774647887324,llama3,mimiciii,nursing_note,PROMPT2_entailment
145,229,26,23,3,0.8846153846153846,22,18,4,0.8181818181818182,0.8501026694045174,llama3,mimiciii,nursing_note,PROMPT2_entailment
146,23,15,15,0,1.0,35,29,6,0.8285714285714286,0.90625,llama3,mimiciii,nursing_note,PROMPT2_entailment
147,230,12,12,0,1.0,7,6,1,0.8571428571428571,0.923076923076923,llama3,mimiciii,nursing_note,PROMPT2_entailment
148,231,21,20,1,0.9523809523809524,15,12,3,0.8,0.8695652173913043,llama3,mimiciii,nursing_note,PROMPT2_entailment
149,232,9,9,0,1.0,2,2,0,1.0,1.0,llama3,mimiciii,nursing_note,PROMPT2_entailment
150,233,24,19,5,0.7916666666666666,33,25,8,0.7575757575757576,0.7742461287693561,llama3,mimiciii,nursing_note,PROMPT2_entailment
151,234,27,27,0,1.0,32,27,5,0.84375,0.9152542372881356,llama3,mimiciii,nursing_note,PROMPT2_entailment
152,235,13,13,0,1.0,10,9,1,0.9,0.9473684210526316,llama3,mimiciii,nursing_note,PROMPT2_entailment
153,236,15,14,1,0.9333333333333332,7,6,1,0.8571428571428571,0.8936170212765957,llama3,mimiciii,nursing_note,PROMPT2_entailment
154,237,27,25,2,0.925925925925926,35,28,7,0.8,0.8583690987124465,llama3,mimiciii,nursing_note,PROMPT2_entailment
155,238,30,19,11,0.6333333333333333,42,24,18,0.5714285714285714,0.6007905138339921,llama3,mimiciii,nursing_note,PROMPT2_entailment
156,239,20,20,0,1.0,21,19,2,0.9047619047619048,0.95,llama3,mimiciii,nursing_note,PROMPT2_entailment
157,24,9,9,0,1.0,5,5,0,1.0,1.0,llama3,mimiciii,nursing_note,PROMPT2_entailment
158,240,27,26,1,0.9629629629629628,42,27,15,0.6428571428571429,0.771004942339374,llama3,mimiciii,nursing_note,PROMPT2_entailment
159,241,17,14,3,0.8235294117647058,21,14,7,0.6666666666666666,0.7368421052631577,llama3,mimiciii,nursing_note,PROMPT2_entailment
160,242,22,21,1,0.9545454545454546,16,13,3,0.8125,0.8778135048231511,llama3,mimiciii,nursing_note,PROMPT2_entailment
161,243,10,9,1,0.9,5,3,2,0.6,0.7200000000000001,llama3,mimiciii,nursing_note,PROMPT2_entailment
162,244,24,21,3,0.875,16,13,3,0.8125,0.8425925925925926,llama3,mimiciii,nursing_note,PROMPT2_entailment
163,245,21,17,4,0.8095238095238095,37,20,17,0.5405405405405406,0.6482364156339372,llama3,mimiciii,nursing_note,PROMPT2_entailment
164,246,26,22,4,0.8461538461538461,10,9,1,0.9,0.8722466960352422,llama3,mimiciii,nursing_note,PROMPT2_entailment
165,247,7,7,0,1.0,6,3,3,0.5,0.6666666666666666,llama3,mimiciii,nursing_note,PROMPT2_entailment
166,248,28,24,4,0.8571428571428571,42,34,8,0.8095238095238095,0.8326530612244899,llama3,mimiciii,nursing_note,PROMPT2_entailment
167,249,26,20,6,0.7692307692307693,39,28,11,0.717948717948718,0.7427055702917772,llama3,mimiciii,nursing_note,PROMPT2_entailment
168,25,22,21,1,0.9545454545454546,23,18,5,0.782608695652174,0.8600682593856656,llama3,mimiciii,nursing_note,PROMPT2_entailment
169,26,38,36,2,0.9473684210526316,35,27,8,0.7714285714285715,0.8503937007874016,llama3,mimiciii,nursing_note,PROMPT2_entailment
170,27,5,5,0,1.0,3,2,1,0.6666666666666666,0.8,llama3,mimiciii,nursing_note,PROMPT2_entailment
171,28,25,22,3,0.88,16,14,2,0.875,0.8774928774928775,llama3,mimiciii,nursing_note,PROMPT2_entailment
172,29,23,20,3,0.8695652173913043,33,23,10,0.696969696969697,0.7737594617325483,llama3,mimiciii,nursing_note,PROMPT2_entailment
173,3,11,9,2,0.8181818181818182,6,6,0,1.0,0.9,llama3,mimiciii,nursing_note,PROMPT2_entailment
174,30,16,16,0,1.0,13,13,0,1.0,1.0,llama3,mimiciii,nursing_note,PROMPT2_entailment
175,31,20,19,1,0.95,19,16,3,0.8421052631578947,0.8928046989720998,llama3,mimiciii,nursing_note,PROMPT2_entailment
176,32,31,30,1,0.967741935483871,44,43,1,0.9772727272727272,0.9724839803995478,llama3,mimiciii,nursing_note,PROMPT2_entailment
177,33,11,11,0,1.0,5,5,0,1.0,1.0,llama3,mimiciii,nursing_note,PROMPT2_entailment
178,34,5,5,0,1.0,3,3,0,1.0,1.0,llama3,mimiciii,nursing_note,PROMPT2_entailment
179,35,11,10,1,0.9090909090909092,7,7,0,1.0,0.9523809523809524,llama3,mimiciii,nursing_note,PROMPT2_entailment
180,36,27,27,0,1.0,62,36,26,0.5806451612903226,0.7346938775510204,llama3,mimiciii,nursing_note,PROMPT2_entailment
181,37,23,18,5,0.782608695652174,38,25,13,0.6578947368421053,0.7148530579825259,llama3,mimiciii,nursing_note,PROMPT2_entailment
182,38,24,22,2,0.9166666666666666,26,18,8,0.6923076923076923,0.7888446215139442,llama3,mimiciii,nursing_note,PROMPT2_entailment
183,39,16,13,3,0.8125,3,1,2,0.3333333333333333,0.4727272727272727,llama3,mimiciii,nursing_note,PROMPT2_entailment
184,4,24,23,1,0.9583333333333334,26,24,2,0.9230769230769232,0.940374787052811,llama3,mimiciii,nursing_note,PROMPT2_entailment
185,40,12,12,0,1.0,3,2,1,0.6666666666666666,0.8,llama3,mimiciii,nursing_note,PROMPT2_entailment
186,41,37,34,3,0.918918918918919,50,38,12,0.76,0.8319381841596909,llama3,mimiciii,nursing_note,PROMPT2_entailment
187,42,18,16,2,0.8888888888888888,7,6,1,0.8571428571428571,0.8727272727272727,llama3,mimiciii,nursing_note,PROMPT2_entailment
188,43,23,21,2,0.9130434782608696,14,11,3,0.7857142857142857,0.8446069469835467,llama3,mimiciii,nursing_note,PROMPT2_entailment
189,44,7,7,0,1.0,3,3,0,1.0,1.0,llama3,mimiciii,nursing_note,PROMPT2_entailment
190,45,24,22,2,0.9166666666666666,34,29,5,0.8529411764705882,0.8836565096952907,llama3,mimiciii,nursing_note,PROMPT2_entailment
191,46,25,25,0,1.0,31,21,10,0.6774193548387096,0.8076923076923077,llama3,mimiciii,nursing_note,PROMPT2_entailment
192,47,25,25,0,1.0,14,13,1,0.9285714285714286,0.962962962962963,llama3,mimiciii,nursing_note,PROMPT2_entailment
193,48,15,15,0,1.0,9,8,1,0.8888888888888888,0.9411764705882352,llama3,mimiciii,nursing_note,PROMPT2_entailment
194,49,8,8,0,1.0,3,2,1,0.6666666666666666,0.8,llama3,mimiciii,nursing_note,PROMPT2_entailment
195,5,43,29,14,0.6744186046511628,15,14,1,0.9333333333333332,0.7830279652844744,llama3,mimiciii,nursing_note,PROMPT2_entailment
196,50,18,17,1,0.9444444444444444,16,13,3,0.8125,0.8735177865612648,llama3,mimiciii,nursing_note,PROMPT2_entailment
197,51,12,12,0,1.0,6,5,1,0.8333333333333334,0.9090909090909092,llama3,mimiciii,nursing_note,PROMPT2_entailment
198,52,39,33,6,0.8461538461538461,38,34,4,0.8947368421052632,0.8697674418604652,llama3,mimiciii,nursing_note,PROMPT2_entailment
199,53,8,7,1,0.875,6,5,1,0.8333333333333334,0.8536585365853658,llama3,mimiciii,nursing_note,PROMPT2_entailment
200,54,31,30,1,0.967741935483871,37,26,11,0.7027027027027027,0.8141962421711901,llama3,mimiciii,nursing_note,PROMPT2_entailment
201,55,35,30,5,0.8571428571428571,35,22,13,0.6285714285714286,0.7252747252747251,llama3,mimiciii,nursing_note,PROMPT2_entailment
202,56,9,9,0,1.0,2,2,0,1.0,1.0,llama3,mimiciii,nursing_note,PROMPT2_entailment
203,57,21,20,1,0.9523809523809524,17,13,4,0.7647058823529411,0.8482871125611744,llama3,mimiciii,nursing_note,PROMPT2_entailment
204,58,30,29,1,0.9666666666666668,25,20,5,0.8,0.8754716981132077,llama3,mimiciii,nursing_note,PROMPT2_entailment
205,59,11,11,0,1.0,8,7,1,0.875,0.9333333333333332,llama3,mimiciii,nursing_note,PROMPT2_entailment
206,6,11,11,0,1.0,8,8,0,1.0,1.0,llama3,mimiciii,nursing_note,PROMPT2_entailment
207,60,21,19,2,0.9047619047619048,27,23,4,0.8518518518518519,0.8775100401606425,llama3,mimiciii,nursing_note,PROMPT2_entailment
208,61,21,20,1,0.9523809523809524,20,15,5,0.75,0.8391608391608391,llama3,mimiciii,nursing_note,PROMPT2_entailment
209,62,19,17,2,0.8947368421052632,37,23,14,0.6216216216216216,0.7335834896810507,llama3,mimiciii,nursing_note,PROMPT2_entailment
210,63,7,7,0,1.0,5,5,0,1.0,1.0,llama3,mimiciii,nursing_note,PROMPT2_entailment
211,64,30,28,2,0.9333333333333332,27,21,6,0.7777777777777778,0.8484848484848485,llama3,mimiciii,nursing_note,PROMPT2_entailment
212,65,19,19,0,1.0,19,17,2,0.8947368421052632,0.9444444444444444,llama3,mimiciii,nursing_note,PROMPT2_entailment
213,66,13,13,0,1.0,1,1,0,1.0,1.0,llama3,mimiciii,nursing_note,PROMPT2_entailment
214,67,11,10,1,0.9090909090909092,7,5,2,0.7142857142857143,0.8,llama3,mimiciii,nursing_note,PROMPT2_entailment
215,68,20,20,0,1.0,18,17,1,0.9444444444444444,0.9714285714285714,llama3,mimiciii,nursing_note,PROMPT2_entailment
216,69,27,24,3,0.8888888888888888,25,24,1,0.96,0.923076923076923,llama3,mimiciii,nursing_note,PROMPT2_entailment
217,7,6,6,0,1.0,2,2,0,1.0,1.0,llama3,mimiciii,nursing_note,PROMPT2_entailment
218,70,27,25,2,0.925925925925926,45,32,13,0.7111111111111111,0.8044243338360986,llama3,mimiciii,nursing_note,PROMPT2_entailment
219,71,29,20,9,0.6896551724137931,51,35,16,0.6862745098039216,0.687960687960688,llama3,mimiciii,nursing_note,PROMPT2_entailment
220,72,19,18,1,0.9473684210526316,12,10,2,0.8333333333333334,0.8866995073891626,llama3,mimiciii,nursing_note,PROMPT2_entailment
221,73,35,33,2,0.9428571428571428,38,30,8,0.7894736842105263,0.859375,llama3,mimiciii,nursing_note,PROMPT2_entailment
222,74,8,8,0,1.0,7,6,1,0.8571428571428571,0.923076923076923,llama3,mimiciii,nursing_note,PROMPT2_entailment
223,75,25,23,2,0.92,27,18,9,0.6666666666666666,0.7731092436974789,llama3,mimiciii,nursing_note,PROMPT2_entailment
224,76,4,4,0,1.0,1,1,0,1.0,1.0,llama3,mimiciii,nursing_note,PROMPT2_entailment
225,77,39,35,4,0.8974358974358975,59,42,17,0.711864406779661,0.7939508506616257,llama3,mimiciii,nursing_note,PROMPT2_entailment
226,78,13,10,3,0.7692307692307693,20,15,5,0.75,0.7594936708860761,llama3,mimiciii,nursing_note,PROMPT2_entailment
227,79,28,27,1,0.9642857142857144,30,27,3,0.9,0.9310344827586208,llama3,mimiciii,nursing_note,PROMPT2_entailment
228,8,11,11,0,1.0,11,10,1,0.9090909090909092,0.9523809523809524,llama3,mimiciii,nursing_note,PROMPT2_entailment
229,80,26,24,2,0.9230769230769232,22,19,3,0.8636363636363636,0.8923679060665364,llama3,mimiciii,nursing_note,PROMPT2_entailment
230,81,23,20,3,0.8695652173913043,22,18,4,0.8181818181818182,0.8430913348946135,llama3,mimiciii,nursing_note,PROMPT2_entailment
231,82,20,17,3,0.85,17,14,3,0.8235294117647058,0.8365553602811951,llama3,mimiciii,nursing_note,PROMPT2_entailment
232,83,18,17,1,0.9444444444444444,28,21,7,0.75,0.8360655737704917,llama3,mimiciii,nursing_note,PROMPT2_entailment
233,84,12,10,2,0.8333333333333334,6,4,2,0.6666666666666666,0.7407407407407408,llama3,mimiciii,nursing_note,PROMPT2_entailment
234,85,17,17,0,1.0,24,21,3,0.875,0.9333333333333332,llama3,mimiciii,nursing_note,PROMPT2_entailment
235,86,24,24,0,1.0,40,25,15,0.625,0.7692307692307693,llama3,mimiciii,nursing_note,PROMPT2_entailment
236,87,20,19,1,0.95,15,14,1,0.9333333333333332,0.9415929203539822,llama3,mimiciii,nursing_note,PROMPT2_entailment
237,88,25,23,2,0.92,15,12,3,0.8,0.8558139534883721,llama3,mimiciii,nursing_note,PROMPT2_entailment
238,89,16,16,0,1.0,29,22,7,0.7586206896551724,0.8627450980392156,llama3,mimiciii,nursing_note,PROMPT2_entailment
239,9,29,28,1,0.9655172413793104,17,16,1,0.9411764705882352,0.9531914893617022,llama3,mimiciii,nursing_note,PROMPT2_entailment
240,90,17,16,1,0.9411764705882352,14,11,3,0.7857142857142857,0.8564476885644767,llama3,mimiciii,nursing_note,PROMPT2_entailment
241,91,22,22,0,1.0,24,20,4,0.8333333333333334,0.9090909090909092,llama3,mimiciii,nursing_note,PROMPT2_entailment
242,92,28,26,2,0.9285714285714286,28,23,5,0.8214285714285714,0.8717201166180758,llama3,mimiciii,nursing_note,PROMPT2_entailment
243,93,22,21,1,0.9545454545454546,23,20,3,0.8695652173913043,0.9100758396533044,llama3,mimiciii,nursing_note,PROMPT2_entailment
244,94,8,8,0,1.0,5,4,1,0.8,0.888888888888889,llama3,mimiciii,nursing_note,PROMPT2_entailment
245,95,15,15,0,1.0,14,12,2,0.8571428571428571,0.923076923076923,llama3,mimiciii,nursing_note,PROMPT2_entailment
246,96,9,8,1,0.8888888888888888,6,6,0,1.0,0.9411764705882352,llama3,mimiciii,nursing_note,PROMPT2_entailment
247,97,11,11,0,1.0,10,10,0,1.0,1.0,llama3,mimiciii,nursing_note,PROMPT2_entailment
248,98,29,27,2,0.9310344827586208,13,10,3,0.7692307692307693,0.8424336973478939,llama3,mimiciii,nursing_note,PROMPT2_entailment
249,99,36,26,10,0.7222222222222222,44,37,7,0.8409090909090909,0.7770597738287561,llama3,mimiciii,nursing_note,PROMPT2_entailment
0,0,15,13,2,0.8666666666666667,21,15,6,0.7142857142857143,0.7831325301204819,llama3,mimiciii,radiology_report,PROMPT1_entailment
1,1,17,14,3,0.8235294117647058,15,11,4,0.7333333333333333,0.7758186397984888,llama3,mimiciii,radiology_report,PROMPT1_entailment
2,10,11,9,2,0.8181818181818182,18,15,3,0.8333333333333334,0.8256880733944955,llama3,mimiciii,radiology_report,PROMPT1_entailment
3,100,10,10,0,1.0,9,9,0,1.0,1.0,llama3,mimiciii,radiology_report,PROMPT1_entailment
4,101,14,12,2,0.8571428571428571,15,9,6,0.6,0.7058823529411764,llama3,mimiciii,radiology_report,PROMPT1_entailment
5,102,11,10,1,0.9090909090909092,16,13,3,0.8125,0.858085808580858,llama3,mimiciii,radiology_report,PROMPT1_entailment
6,103,12,11,1,0.9166666666666666,19,16,3,0.8421052631578947,0.8778054862842893,llama3,mimiciii,radiology_report,PROMPT1_entailment
7,104,13,13,0,1.0,17,15,2,0.8823529411764706,0.9375,llama3,mimiciii,radiology_report,PROMPT1_entailment
8,105,7,6,1,0.8571428571428571,8,6,2,0.75,0.7999999999999999,llama3,mimiciii,radiology_report,PROMPT1_entailment
9,106,13,13,0,1.0,12,9,3,0.75,0.8571428571428571,llama3,mimiciii,radiology_report,PROMPT1_entailment
10,107,13,11,2,0.8461538461538461,19,14,5,0.7368421052631579,0.7877237851662404,llama3,mimiciii,radiology_report,PROMPT1_entailment
11,108,12,12,0,1.0,13,11,2,0.8461538461538461,0.9166666666666666,llama3,mimiciii,radiology_report,PROMPT1_entailment
12,109,14,11,3,0.7857142857142857,20,17,3,0.85,0.8165938864628821,llama3,mimiciii,radiology_report,PROMPT1_entailment
13,11,16,16,0,1.0,20,14,6,0.7,0.8235294117647058,llama3,mimiciii,radiology_report,PROMPT1_entailment
14,110,9,9,0,1.0,17,17,0,1.0,1.0,llama3,mimiciii,radiology_report,PROMPT1_entailment
15,111,12,12,0,1.0,20,15,5,0.75,0.8571428571428571,llama3,mimiciii,radiology_report,PROMPT1_entailment
16,112,10,9,1,0.9,14,12,2,0.8571428571428571,0.8780487804878048,llama3,mimiciii,radiology_report,PROMPT1_entailment
17,113,15,11,4,0.7333333333333333,20,16,4,0.8,0.7652173913043478,llama3,mimiciii,radiology_report,PROMPT1_entailment
18,114,13,11,2,0.8461538461538461,23,19,4,0.8260869565217391,0.836,llama3,mimiciii,radiology_report,PROMPT1_entailment
19,115,15,14,1,0.9333333333333332,20,17,3,0.85,0.8897196261682243,llama3,mimiciii,radiology_report,PROMPT1_entailment
20,116,12,11,1,0.9166666666666666,13,11,2,0.8461538461538461,0.8799999999999999,llama3,mimiciii,radiology_report,PROMPT1_entailment
21,117,12,12,0,1.0,16,13,3,0.8125,0.896551724137931,llama3,mimiciii,radiology_report,PROMPT1_entailment
22,118,16,13,3,0.8125,24,19,5,0.7916666666666666,0.801948051948052,llama3,mimiciii,radiology_report,PROMPT1_entailment
23,119,14,14,0,1.0,17,12,5,0.7058823529411765,0.8275862068965517,llama3,mimiciii,radiology_report,PROMPT1_entailment
24,12,13,13,0,1.0,17,14,3,0.8235294117647058,0.9032258064516128,llama3,mimiciii,radiology_report,PROMPT1_entailment
25,120,14,13,1,0.9285714285714286,16,11,5,0.6875,0.7900552486187846,llama3,mimiciii,radiology_report,PROMPT1_entailment
26,121,16,13,3,0.8125,26,23,3,0.8846153846153846,0.8470254957507082,llama3,mimiciii,radiology_report,PROMPT1_entailment
27,122,16,15,1,0.9375,20,17,3,0.85,0.8916083916083916,llama3,mimiciii,radiology_report,PROMPT1_entailment
28,123,13,12,1,0.9230769230769232,13,10,3,0.7692307692307693,0.8391608391608392,llama3,mimiciii,radiology_report,PROMPT1_entailment
29,124,9,9,0,1.0,12,8,4,0.6666666666666666,0.8,llama3,mimiciii,radiology_report,PROMPT1_entailment
30,125,17,15,2,0.8823529411764706,23,18,5,0.782608695652174,0.8294930875576038,llama3,mimiciii,radiology_report,PROMPT1_entailment
31,126,8,7,1,0.875,9,7,2,0.7777777777777778,0.823529411764706,llama3,mimiciii,radiology_report,PROMPT1_entailment
32,127,19,18,1,0.9473684210526316,43,29,14,0.6744186046511628,0.7879245283018869,llama3,mimiciii,radiology_report,PROMPT1_entailment
33,128,10,10,0,1.0,14,10,4,0.7142857142857143,0.8333333333333333,llama3,mimiciii,radiology_report,PROMPT1_entailment
34,129,12,12,0,1.0,16,12,4,0.75,0.8571428571428571,llama3,mimiciii,radiology_report,PROMPT1_entailment
35,13,12,11,1,0.9166666666666666,17,15,2,0.8823529411764706,0.8991825613079019,llama3,mimiciii,radiology_report,PROMPT1_entailment
36,130,13,13,0,1.0,25,16,9,0.64,0.7804878048780487,llama3,mimiciii,radiology_report,PROMPT1_entailment
37,131,11,10,1,0.9090909090909092,32,24,8,0.75,0.821917808219178,llama3,mimiciii,radiology_report,PROMPT1_entailment
38,132,13,12,1,0.9230769230769232,23,16,7,0.6956521739130435,0.7933884297520661,llama3,mimiciii,radiology_report,PROMPT1_entailment
39,133,16,15,1,0.9375,21,16,5,0.7619047619047619,0.8406304728546409,llama3,mimiciii,radiology_report,PROMPT1_entailment
40,134,15,13,2,0.8666666666666667,23,21,2,0.9130434782608696,0.8892508143322475,llama3,mimiciii,radiology_report,PROMPT1_entailment
41,135,14,14,0,1.0,20,18,2,0.9,0.9473684210526316,llama3,mimiciii,radiology_report,PROMPT1_entailment
42,136,9,7,2,0.7777777777777778,14,11,3,0.7857142857142857,0.7817258883248731,llama3,mimiciii,radiology_report,PROMPT1_entailment
43,137,9,8,1,0.8888888888888888,10,8,2,0.8,0.8421052631578948,llama3,mimiciii,radiology_report,PROMPT1_entailment
44,138,13,13,0,1.0,14,11,3,0.7857142857142857,0.88,llama3,mimiciii,radiology_report,PROMPT1_entailment
45,139,10,10,0,1.0,13,10,3,0.7692307692307693,0.8695652173913044,llama3,mimiciii,radiology_report,PROMPT1_entailment
46,14,9,8,1,0.8888888888888888,12,10,2,0.8333333333333334,0.8602150537634408,llama3,mimiciii,radiology_report,PROMPT1_entailment
47,140,13,12,1,0.9230769230769232,18,14,4,0.7777777777777778,0.8442211055276381,llama3,mimiciii,radiology_report,PROMPT1_entailment
48,141,12,11,1,0.9166666666666666,16,12,4,0.75,0.8250000000000001,llama3,mimiciii,radiology_report,PROMPT1_entailment
49,142,10,9,1,0.9,14,13,1,0.9285714285714286,0.9140625,llama3,mimiciii,radiology_report,PROMPT1_entailment
50,143,16,15,1,0.9375,28,20,8,0.7142857142857143,0.8108108108108109,llama3,mimiciii,radiology_report,PROMPT1_entailment
51,144,13,12,1,0.9230769230769232,23,17,6,0.7391304347826086,0.8209255533199195,llama3,mimiciii,radiology_report,PROMPT1_entailment
52,145,11,11,0,1.0,18,16,2,0.8888888888888888,0.9411764705882352,llama3,mimiciii,radiology_report,PROMPT1_entailment
53,146,11,10,1,0.9090909090909092,11,6,5,0.5454545454545454,0.6818181818181818,llama3,mimiciii,radiology_report,PROMPT1_entailment
54,147,10,8,2,0.8,10,6,4,0.6,0.6857142857142857,llama3,mimiciii,radiology_report,PROMPT1_entailment
55,148,19,17,2,0.8947368421052632,26,22,4,0.8461538461538461,0.8697674418604652,llama3,mimiciii,radiology_report,PROMPT1_entailment
56,149,15,15,0,1.0,20,18,2,0.9,0.9473684210526316,llama3,mimiciii,radiology_report,PROMPT1_entailment
57,15,16,15,1,0.9375,29,25,4,0.8620689655172413,0.8982035928143712,llama3,mimiciii,radiology_report,PROMPT1_entailment
58,150,14,13,1,0.9285714285714286,14,14,0,1.0,0.962962962962963,llama3,mimiciii,radiology_report,PROMPT1_entailment
59,151,15,13,2,0.8666666666666667,15,11,4,0.7333333333333333,0.7944444444444444,llama3,mimiciii,radiology_report,PROMPT1_entailment
60,152,14,14,0,1.0,18,13,5,0.7222222222222222,0.8387096774193548,llama3,mimiciii,radiology_report,PROMPT1_entailment
61,153,12,12,0,1.0,16,16,0,1.0,1.0,llama3,mimiciii,radiology_report,PROMPT1_entailment
62,154,16,12,4,0.75,23,21,2,0.9130434782608696,0.8235294117647057,llama3,mimiciii,radiology_report,PROMPT1_entailment
63,155,23,21,2,0.9130434782608696,47,38,9,0.8085106382978723,0.8576034390112842,llama3,mimiciii,radiology_report,PROMPT1_entailment
64,156,16,14,2,0.875,20,15,5,0.75,0.8076923076923077,llama3,mimiciii,radiology_report,PROMPT1_entailment
65,157,11,10,1,0.9090909090909092,12,9,3,0.75,0.821917808219178,llama3,mimiciii,radiology_report,PROMPT1_entailment
66,158,5,4,1,0.8,6,3,3,0.5,0.6153846153846154,llama3,mimiciii,radiology_report,PROMPT1_entailment
67,159,10,9,1,0.9,13,11,2,0.8461538461538461,0.8722466960352422,llama3,mimiciii,radiology_report,PROMPT1_entailment
68,16,13,13,0,1.0,17,14,3,0.8235294117647058,0.9032258064516128,llama3,mimiciii,radiology_report,PROMPT1_entailment
69,160,12,11,1,0.9166666666666666,12,9,3,0.75,0.8250000000000001,llama3,mimiciii,radiology_report,PROMPT1_entailment
70,161,11,11,0,1.0,13,11,2,0.8461538461538461,0.9166666666666666,llama3,mimiciii,radiology_report,PROMPT1_entailment
71,162,11,11,0,1.0,11,9,2,0.8181818181818182,0.9,llama3,mimiciii,radiology_report,PROMPT1_entailment
72,163,11,10,1,0.9090909090909092,8,5,3,0.625,0.7407407407407406,llama3,mimiciii,radiology_report,PROMPT1_entailment
73,164,10,10,0,1.0,10,10,0,1.0,1.0,llama3,mimiciii,radiology_report,PROMPT1_entailment
74,165,20,17,3,0.85,28,22,6,0.7857142857142857,0.8165938864628821,llama3,mimiciii,radiology_report,PROMPT1_entailment
75,166,20,16,4,0.8,26,22,4,0.8461538461538461,0.8224299065420562,llama3,mimiciii,radiology_report,PROMPT1_entailment
76,167,8,6,2,0.75,10,7,3,0.7,0.7241379310344827,llama3,mimiciii,radiology_report,PROMPT1_entailment
77,168,11,11,0,1.0,13,8,5,0.6153846153846154,0.761904761904762,llama3,mimiciii,radiology_report,PROMPT1_entailment
78,169,15,14,1,0.9333333333333332,22,18,4,0.8181818181818182,0.8719723183391004,llama3,mimiciii,radiology_report,PROMPT1_entailment
79,17,10,10,0,1.0,12,9,3,0.75,0.8571428571428571,llama3,mimiciii,radiology_report,PROMPT1_entailment
80,170,13,12,1,0.9230769230769232,24,17,7,0.7083333333333334,0.801571709233792,llama3,mimiciii,radiology_report,PROMPT1_entailment
81,171,7,7,0,1.0,7,6,1,0.8571428571428571,0.923076923076923,llama3,mimiciii,radiology_report,PROMPT1_entailment
82,172,9,9,0,1.0,14,9,5,0.6428571428571429,0.782608695652174,llama3,mimiciii,radiology_report,PROMPT1_entailment
83,173,9,9,0,1.0,12,10,2,0.8333333333333334,0.9090909090909092,llama3,mimiciii,radiology_report,PROMPT1_entailment
84,174,13,13,0,1.0,20,14,6,0.7,0.8235294117647058,llama3,mimiciii,radiology_report,PROMPT1_entailment
85,175,7,6,1,0.8571428571428571,8,7,1,0.875,0.8659793814432989,llama3,mimiciii,radiology_report,PROMPT1_entailment
86,176,15,13,2,0.8666666666666667,19,17,2,0.8947368421052632,0.8804780876494024,llama3,mimiciii,radiology_report,PROMPT1_entailment
87,177,12,11,1,0.9166666666666666,16,15,1,0.9375,0.9269662921348316,llama3,mimiciii,radiology_report,PROMPT1_entailment
88,178,16,13,3,0.8125,25,21,4,0.84,0.8260211800302573,llama3,mimiciii,radiology_report,PROMPT1_entailment
89,179,11,10,1,0.9090909090909092,17,13,4,0.7647058823529411,0.8306709265175718,llama3,mimiciii,radiology_report,PROMPT1_entailment
90,18,15,15,0,1.0,17,13,4,0.7647058823529411,0.8666666666666666,llama3,mimiciii,radiology_report,PROMPT1_entailment
91,180,12,11,1,0.9166666666666666,11,9,2,0.8181818181818182,0.8646288209606987,llama3,mimiciii,radiology_report,PROMPT1_entailment
92,181,18,14,4,0.7777777777777778,26,20,6,0.7692307692307693,0.7734806629834255,llama3,mimiciii,radiology_report,PROMPT1_entailment
93,182,13,12,1,0.9230769230769232,23,19,4,0.8260869565217391,0.8718929254302104,llama3,mimiciii,radiology_report,PROMPT1_entailment
94,183,12,10,2,0.8333333333333334,17,10,7,0.5882352941176471,0.6896551724137931,llama3,mimiciii,radiology_report,PROMPT1_entailment
95,184,11,11,0,1.0,15,12,3,0.8,0.888888888888889,llama3,mimiciii,radiology_report,PROMPT1_entailment
96,185,8,8,0,1.0,6,3,3,0.5,0.6666666666666666,llama3,mimiciii,radiology_report,PROMPT1_entailment
97,186,17,17,0,1.0,26,25,1,0.9615384615384616,0.9803921568627452,llama3,mimiciii,radiology_report,PROMPT1_entailment
98,187,11,11,0,1.0,14,11,3,0.7857142857142857,0.88,llama3,mimiciii,radiology_report,PROMPT1_entailment
99,188,15,9,6,0.6,22,16,6,0.7272727272727273,0.6575342465753425,llama3,mimiciii,radiology_report,PROMPT1_entailment
100,189,13,10,3,0.7692307692307693,15,13,2,0.8666666666666667,0.8150470219435738,llama3,mimiciii,radiology_report,PROMPT1_entailment
101,19,11,11,0,1.0,14,10,4,0.7142857142857143,0.8333333333333333,llama3,mimiciii,radiology_report,PROMPT1_entailment
102,190,13,13,0,1.0,17,15,2,0.8823529411764706,0.9375,llama3,mimiciii,radiology_report,PROMPT1_entailment
103,191,16,14,2,0.875,15,13,2,0.8666666666666667,0.8708133971291866,llama3,mimiciii,radiology_report,PROMPT1_entailment
104,192,20,18,2,0.9,28,23,5,0.8214285714285714,0.8589211618257261,llama3,mimiciii,radiology_report,PROMPT1_entailment
105,193,11,10,1,0.9090909090909092,14,12,2,0.8571428571428571,0.8823529411764706,llama3,mimiciii,radiology_report,PROMPT1_entailment
106,194,18,18,0,1.0,38,31,7,0.8157894736842105,0.898550724637681,llama3,mimiciii,radiology_report,PROMPT1_entailment
107,195,13,12,1,0.9230769230769232,21,18,3,0.8571428571428571,0.888888888888889,llama3,mimiciii,radiology_report,PROMPT1_entailment
108,196,13,12,1,0.9230769230769232,18,14,4,0.7777777777777778,0.8442211055276381,llama3,mimiciii,radiology_report,PROMPT1_entailment
109,197,12,11,1,0.9166666666666666,15,11,4,0.7333333333333333,0.8148148148148148,llama3,mimiciii,radiology_report,PROMPT1_entailment
110,198,8,8,0,1.0,9,8,1,0.8888888888888888,0.9411764705882352,llama3,mimiciii,radiology_report,PROMPT1_entailment
111,199,18,16,2,0.8888888888888888,23,22,1,0.9565217391304348,0.9214659685863874,llama3,mimiciii,radiology_report,PROMPT1_entailment
112,2,11,11,0,1.0,12,8,4,0.6666666666666666,0.8,llama3,mimiciii,radiology_report,PROMPT1_entailment
113,20,19,18,1,0.9473684210526316,36,33,3,0.9166666666666666,0.9317647058823528,llama3,mimiciii,radiology_report,PROMPT1_entailment
114,200,11,9,2,0.8181818181818182,14,13,1,0.9285714285714286,0.8698884758364314,llama3,mimiciii,radiology_report,PROMPT1_entailment
115,201,12,10,2,0.8333333333333334,18,14,4,0.7777777777777778,0.8045977011494253,llama3,mimiciii,radiology_report,PROMPT1_entailment
116,202,15,14,1,0.9333333333333332,24,15,9,0.625,0.7486631016042781,llama3,mimiciii,radiology_report,PROMPT1_entailment
117,203,13,12,1,0.9230769230769232,19,16,3,0.8421052631578947,0.8807339449541285,llama3,mimiciii,radiology_report,PROMPT1_entailment
118,204,14,12,2,0.8571428571428571,23,22,1,0.9565217391304348,0.904109589041096,llama3,mimiciii,radiology_report,PROMPT1_entailment
119,205,13,13,0,1.0,14,11,3,0.7857142857142857,0.88,llama3,mimiciii,radiology_report,PROMPT1_entailment
120,206,14,13,1,0.9285714285714286,13,10,3,0.7692307692307693,0.8414239482200646,llama3,mimiciii,radiology_report,PROMPT1_entailment
121,207,8,7,1,0.875,9,7,2,0.7777777777777778,0.823529411764706,llama3,mimiciii,radiology_report,PROMPT1_entailment
122,208,20,19,1,0.95,18,16,2,0.8888888888888888,0.918429003021148,llama3,mimiciii,radiology_report,PROMPT1_entailment
123,209,11,10,1,0.9090909090909092,16,11,5,0.6875,0.7829181494661921,llama3,mimiciii,radiology_report,PROMPT1_entailment
124,21,20,19,1,0.95,27,21,6,0.7777777777777778,0.855305466237942,llama3,mimiciii,radiology_report,PROMPT1_entailment
125,210,10,10,0,1.0,14,11,3,0.7857142857142857,0.88,llama3,mimiciii,radiology_report,PROMPT1_entailment
126,211,9,7,2,0.7777777777777778,13,10,3,0.7692307692307693,0.7734806629834255,llama3,mimiciii,radiology_report,PROMPT1_entailment
127,212,17,16,1,0.9411764705882352,19,16,3,0.8421052631578947,0.8888888888888888,llama3,mimiciii,radiology_report,PROMPT1_entailment
128,213,15,13,2,0.8666666666666667,22,16,6,0.7272727272727273,0.790874524714829,llama3,mimiciii,radiology_report,PROMPT1_entailment
129,214,20,15,5,0.75,23,22,1,0.9565217391304348,0.8407643312101911,llama3,mimiciii,radiology_report,PROMPT1_entailment
130,215,8,8,0,1.0,10,8,2,0.8,0.888888888888889,llama3,mimiciii,radiology_report,PROMPT1_entailment
131,216,12,10,2,0.8333333333333334,19,15,4,0.7894736842105263,0.8108108108108109,llama3,mimiciii,radiology_report,PROMPT1_entailment
132,217,13,11,2,0.8461538461538461,20,14,6,0.7,0.7661691542288558,llama3,mimiciii,radiology_report,PROMPT1_entailment
133,218,18,17,1,0.9444444444444444,15,13,2,0.8666666666666667,0.9038854805725972,llama3,mimiciii,radiology_report,PROMPT1_entailment
134,219,10,9,1,0.9,13,10,3,0.7692307692307693,0.8294930875576038,llama3,mimiciii,radiology_report,PROMPT1_entailment
135,22,14,14,0,1.0,19,16,3,0.8421052631578947,0.9142857142857144,llama3,mimiciii,radiology_report,PROMPT1_entailment
136,220,11,10,1,0.9090909090909092,19,17,2,0.8947368421052632,0.9018567639257294,llama3,mimiciii,radiology_report,PROMPT1_entailment
137,221,18,17,1,0.9444444444444444,27,20,7,0.7407407407407407,0.8302808302808302,llama3,mimiciii,radiology_report,PROMPT1_entailment
138,222,11,10,1,0.9090909090909092,16,13,3,0.8125,0.858085808580858,llama3,mimiciii,radiology_report,PROMPT1_entailment
139,223,18,18,0,1.0,21,17,4,0.8095238095238095,0.8947368421052632,llama3,mimiciii,radiology_report,PROMPT1_entailment
140,224,14,13,1,0.9285714285714286,17,14,3,0.8235294117647058,0.8729016786570742,llama3,mimiciii,radiology_report,PROMPT1_entailment
141,225,11,11,0,1.0,11,8,3,0.7272727272727273,0.8421052631578948,llama3,mimiciii,radiology_report,PROMPT1_entailment
142,226,13,13,0,1.0,18,15,3,0.8333333333333334,0.9090909090909092,llama3,mimiciii,radiology_report,PROMPT1_entailment
143,227,16,16,0,1.0,18,14,4,0.7777777777777778,0.8750000000000001,llama3,mimiciii,radiology_report,PROMPT1_entailment
144,228,11,10,1,0.9090909090909092,17,16,1,0.9411764705882352,0.92485549132948,llama3,mimiciii,radiology_report,PROMPT1_entailment
145,229,17,17,0,1.0,44,33,11,0.75,0.8571428571428571,llama3,mimiciii,radiology_report,PROMPT1_entailment
146,23,12,12,0,1.0,15,12,3,0.8,0.888888888888889,llama3,mimiciii,radiology_report,PROMPT1_entailment
147,230,12,10,2,0.8333333333333334,17,15,2,0.8823529411764706,0.8571428571428571,llama3,mimiciii,radiology_report,PROMPT1_entailment
148,231,10,10,0,1.0,13,9,4,0.6923076923076923,0.8181818181818181,llama3,mimiciii,radiology_report,PROMPT1_entailment
149,232,14,14,0,1.0,18,14,4,0.7777777777777778,0.8750000000000001,llama3,mimiciii,radiology_report,PROMPT1_entailment
150,233,14,14,0,1.0,17,12,5,0.7058823529411765,0.8275862068965517,llama3,mimiciii,radiology_report,PROMPT1_entailment
151,234,9,8,1,0.8888888888888888,11,9,2,0.8181818181818182,0.8520710059171598,llama3,mimiciii,radiology_report,PROMPT1_entailment
152,235,10,10,0,1.0,14,11,3,0.7857142857142857,0.88,llama3,mimiciii,radiology_report,PROMPT1_entailment
153,236,14,14,0,1.0,11,9,2,0.8181818181818182,0.9,llama3,mimiciii,radiology_report,PROMPT1_entailment
154,237,13,11,2,0.8461538461538461,17,16,1,0.9411764705882352,0.8911392405063291,llama3,mimiciii,radiology_report,PROMPT1_entailment
155,238,12,12,0,1.0,20,18,2,0.9,0.9473684210526316,llama3,mimiciii,radiology_report,PROMPT1_entailment
156,239,13,13,0,1.0,17,11,6,0.6470588235294118,0.7857142857142858,llama3,mimiciii,radiology_report,PROMPT1_entailment
157,24,11,11,0,1.0,18,14,4,0.7777777777777778,0.8750000000000001,llama3,mimiciii,radiology_report,PROMPT1_entailment
158,240,11,11,0,1.0,13,10,3,0.7692307692307693,0.8695652173913044,llama3,mimiciii,radiology_report,PROMPT1_entailment
159,241,11,11,0,1.0,16,13,3,0.8125,0.896551724137931,llama3,mimiciii,radiology_report,PROMPT1_entailment
160,242,12,12,0,1.0,18,14,4,0.7777777777777778,0.8750000000000001,llama3,mimiciii,radiology_report,PROMPT1_entailment
161,243,10,9,1,0.9,13,9,4,0.6923076923076923,0.7826086956521738,llama3,mimiciii,radiology_report,PROMPT1_entailment
162,244,13,13,0,1.0,17,17,0,1.0,1.0,llama3,mimiciii,radiology_report,PROMPT1_entailment
163,245,20,16,4,0.8,28,26,2,0.9285714285714286,0.859504132231405,llama3,mimiciii,radiology_report,PROMPT1_entailment
164,246,10,10,0,1.0,12,9,3,0.75,0.8571428571428571,llama3,mimiciii,radiology_report,PROMPT1_entailment
165,247,12,9,3,0.75,12,9,3,0.75,0.75,llama3,mimiciii,radiology_report,PROMPT1_entailment
166,248,10,9,1,0.9,17,13,4,0.7647058823529411,0.8268551236749118,llama3,mimiciii,radiology_report,PROMPT1_entailment
167,249,15,13,2,0.8666666666666667,23,20,3,0.8695652173913043,0.8681135225375627,llama3,mimiciii,radiology_report,PROMPT1_entailment
168,25,18,15,3,0.8333333333333334,27,18,9,0.6666666666666666,0.7407407407407408,llama3,mimiciii,radiology_report,PROMPT1_entailment
169,250,9,9,0,1.0,8,6,2,0.75,0.8571428571428571,llama3,mimiciii,radiology_report,PROMPT1_entailment
170,251,19,17,2,0.8947368421052632,22,21,1,0.9545454545454546,0.923673997412678,llama3,mimiciii,radiology_report,PROMPT1_entailment
171,252,9,7,2,0.7777777777777778,10,7,3,0.7,0.7368421052631577,llama3,mimiciii,radiology_report,PROMPT1_entailment
172,253,20,16,4,0.8,24,22,2,0.9166666666666666,0.854368932038835,llama3,mimiciii,radiology_report,PROMPT1_entailment
173,254,10,9,1,0.9,13,7,6,0.5384615384615384,0.6737967914438503,llama3,mimiciii,radiology_report,PROMPT1_entailment
174,255,11,10,1,0.9090909090909092,16,12,4,0.75,0.821917808219178,llama3,mimiciii,radiology_report,PROMPT1_entailment
175,256,16,16,0,1.0,19,17,2,0.8947368421052632,0.9444444444444444,llama3,mimiciii,radiology_report,PROMPT1_entailment
176,257,10,10,0,1.0,15,13,2,0.8666666666666667,0.9285714285714286,llama3,mimiciii,radiology_report,PROMPT1_entailment
177,258,16,15,1,0.9375,20,15,5,0.75,0.8333333333333334,llama3,mimiciii,radiology_report,PROMPT1_entailment
178,259,12,12,0,1.0,17,13,4,0.7647058823529411,0.8666666666666666,llama3,mimiciii,radiology_report,PROMPT1_entailment
179,26,14,14,0,1.0,18,13,5,0.7222222222222222,0.8387096774193548,llama3,mimiciii,radiology_report,PROMPT1_entailment
180,260,15,12,3,0.8,20,11,9,0.55,0.6518518518518519,llama3,mimiciii,radiology_report,PROMPT1_entailment
181,261,20,17,3,0.85,30,28,2,0.9333333333333332,0.8897196261682243,llama3,mimiciii,radiology_report,PROMPT1_entailment
182,262,15,13,2,0.8666666666666667,23,18,5,0.782608695652174,0.8224956063268895,llama3,mimiciii,radiology_report,PROMPT1_entailment
183,263,16,14,2,0.875,27,23,4,0.8518518518518519,0.8632707774798928,llama3,mimiciii,radiology_report,PROMPT1_entailment
184,264,13,11,2,0.8461538461538461,20,16,4,0.8,0.8224299065420562,llama3,mimiciii,radiology_report,PROMPT1_entailment
185,265,10,10,0,1.0,9,8,1,0.8888888888888888,0.9411764705882352,llama3,mimiciii,radiology_report,PROMPT1_entailment
186,266,11,11,0,1.0,18,12,6,0.6666666666666666,0.8,llama3,mimiciii,radiology_report,PROMPT1_entailment
187,267,13,12,1,0.9230769230769232,16,13,3,0.8125,0.8642659279778393,llama3,mimiciii,radiology_report,PROMPT1_entailment
188,268,14,13,1,0.9285714285714286,20,15,5,0.75,0.8297872340425532,llama3,mimiciii,radiology_report,PROMPT1_entailment
189,269,20,20,0,1.0,25,19,6,0.76,0.8636363636363636,llama3,mimiciii,radiology_report,PROMPT1_entailment
190,27,14,14,0,1.0,14,12,2,0.8571428571428571,0.923076923076923,llama3,mimiciii,radiology_report,PROMPT1_entailment
191,270,16,15,1,0.9375,17,15,2,0.8823529411764706,0.9090909090909092,llama3,mimiciii,radiology_report,PROMPT1_entailment
192,271,14,14,0,1.0,17,14,3,0.8235294117647058,0.9032258064516128,llama3,mimiciii,radiology_report,PROMPT1_entailment
193,272,14,13,1,0.9285714285714286,17,17,0,1.0,0.962962962962963,llama3,mimiciii,radiology_report,PROMPT1_entailment
194,273,12,11,1,0.9166666666666666,12,7,5,0.5833333333333334,0.7129629629629629,llama3,mimiciii,radiology_report,PROMPT1_entailment
195,274,14,13,1,0.9285714285714286,20,14,6,0.7,0.7982456140350878,llama3,mimiciii,radiology_report,PROMPT1_entailment
196,275,12,10,2,0.8333333333333334,12,12,0,1.0,0.9090909090909092,llama3,mimiciii,radiology_report,PROMPT1_entailment
197,276,15,14,1,0.9333333333333332,24,18,6,0.75,0.8316831683168316,llama3,mimiciii,radiology_report,PROMPT1_entailment
198,277,20,18,2,0.9,25,22,3,0.88,0.8898876404494382,llama3,mimiciii,radiology_report,PROMPT1_entailment
199,278,14,12,2,0.8571428571428571,16,13,3,0.8125,0.8342245989304812,llama3,mimiciii,radiology_report,PROMPT1_entailment
200,279,12,12,0,1.0,10,8,2,0.8,0.888888888888889,llama3,mimiciii,radiology_report,PROMPT1_entailment
201,28,14,10,4,0.7142857142857143,30,26,4,0.8666666666666667,0.7831325301204819,llama3,mimiciii,radiology_report,PROMPT1_entailment
202,280,8,7,1,0.875,12,10,2,0.8333333333333334,0.8536585365853658,llama3,mimiciii,radiology_report,PROMPT1_entailment
203,281,14,14,0,1.0,24,19,5,0.7916666666666666,0.8837209302325582,llama3,mimiciii,radiology_report,PROMPT1_entailment
204,282,13,13,0,1.0,12,9,3,0.75,0.8571428571428571,llama3,mimiciii,radiology_report,PROMPT1_entailment
205,283,18,16,2,0.8888888888888888,25,20,5,0.8,0.8421052631578948,llama3,mimiciii,radiology_report,PROMPT1_entailment
206,284,13,12,1,0.9230769230769232,14,11,3,0.7857142857142857,0.8488745980707394,llama3,mimiciii,radiology_report,PROMPT1_entailment
207,285,13,13,0,1.0,18,18,0,1.0,1.0,llama3,mimiciii,radiology_report,PROMPT1_entailment
208,286,6,5,1,0.8333333333333334,6,5,1,0.8333333333333334,0.8333333333333334,llama3,mimiciii,radiology_report,PROMPT1_entailment
209,287,12,11,1,0.9166666666666666,18,15,3,0.8333333333333334,0.8730158730158729,llama3,mimiciii,radiology_report,PROMPT1_entailment
210,288,20,16,4,0.8,32,28,4,0.875,0.8358208955223881,llama3,mimiciii,radiology_report,PROMPT1_entailment
211,289,17,17,0,1.0,20,15,5,0.75,0.8571428571428571,llama3,mimiciii,radiology_report,PROMPT1_entailment
212,29,8,7,1,0.875,8,6,2,0.75,0.8076923076923077,llama3,mimiciii,radiology_report,PROMPT1_entailment
213,290,13,12,1,0.9230769230769232,11,8,3,0.7272727272727273,0.8135593220338984,llama3,mimiciii,radiology_report,PROMPT1_entailment
214,291,16,13,3,0.8125,23,14,9,0.6086956521739131,0.6959847036328872,llama3,mimiciii,radiology_report,PROMPT1_entailment
215,292,13,12,1,0.9230769230769232,21,19,2,0.9047619047619048,0.9138276553106212,llama3,mimiciii,radiology_report,PROMPT1_entailment
216,293,13,12,1,0.9230769230769232,18,12,6,0.6666666666666666,0.7741935483870968,llama3,mimiciii,radiology_report,PROMPT1_entailment
217,294,14,13,1,0.9285714285714286,22,17,5,0.7727272727272727,0.8435114503816794,llama3,mimiciii,radiology_report,PROMPT1_entailment
218,295,20,18,2,0.9,32,24,8,0.75,0.8181818181818182,llama3,mimiciii,radiology_report,PROMPT1_entailment
219,296,14,11,3,0.7857142857142857,17,14,3,0.8235294117647058,0.8041775456919059,llama3,mimiciii,radiology_report,PROMPT1_entailment
220,297,11,10,1,0.9090909090909092,24,18,6,0.75,0.821917808219178,llama3,mimiciii,radiology_report,PROMPT1_entailment
221,298,14,13,1,0.9285714285714286,20,16,4,0.8,0.859504132231405,llama3,mimiciii,radiology_report,PROMPT1_entailment
222,299,18,15,3,0.8333333333333334,28,22,6,0.7857142857142857,0.8088235294117647,llama3,mimiciii,radiology_report,PROMPT1_entailment
223,3,11,11,0,1.0,20,16,4,0.8,0.888888888888889,llama3,mimiciii,radiology_report,PROMPT1_entailment
224,30,14,14,0,1.0,21,19,2,0.9047619047619048,0.95,llama3,mimiciii,radiology_report,PROMPT1_entailment
225,300,14,14,0,1.0,13,9,4,0.6923076923076923,0.8181818181818181,llama3,mimiciii,radiology_report,PROMPT1_entailment
226,301,11,11,0,1.0,16,11,5,0.6875,0.8148148148148148,llama3,mimiciii,radiology_report,PROMPT1_entailment
227,302,13,12,1,0.9230769230769232,15,13,2,0.8666666666666667,0.8939828080229226,llama3,mimiciii,radiology_report,PROMPT1_entailment
228,303,18,15,3,0.8333333333333334,24,17,7,0.7083333333333334,0.7657657657657657,llama3,mimiciii,radiology_report,PROMPT1_entailment
229,304,15,13,2,0.8666666666666667,19,15,4,0.7894736842105263,0.826271186440678,llama3,mimiciii,radiology_report,PROMPT1_entailment
230,305,15,13,2,0.8666666666666667,24,15,9,0.625,0.7262569832402236,llama3,mimiciii,radiology_report,PROMPT1_entailment
231,306,12,11,1,0.9166666666666666,14,11,3,0.7857142857142857,0.8461538461538461,llama3,mimiciii,radiology_report,PROMPT1_entailment
232,307,14,13,1,0.9285714285714286,17,13,4,0.7647058823529411,0.8387096774193549,llama3,mimiciii,radiology_report,PROMPT1_entailment
233,308,14,13,1,0.9285714285714286,15,9,6,0.6,0.7289719626168225,llama3,mimiciii,radiology_report,PROMPT1_entailment
234,309,14,13,1,0.9285714285714286,26,16,10,0.6153846153846154,0.7402135231316727,llama3,mimiciii,radiology_report,PROMPT1_entailment
235,31,13,12,1,0.9230769230769232,19,13,6,0.6842105263157895,0.7858942065491183,llama3,mimiciii,radiology_report,PROMPT1_entailment
236,310,14,13,1,0.9285714285714286,24,21,3,0.875,0.900990099009901,llama3,mimiciii,radiology_report,PROMPT1_entailment
237,311,10,10,0,1.0,15,12,3,0.8,0.888888888888889,llama3,mimiciii,radiology_report,PROMPT1_entailment
238,312,11,11,0,1.0,18,14,4,0.7777777777777778,0.8750000000000001,llama3,mimiciii,radiology_report,PROMPT1_entailment
239,313,12,12,0,1.0,17,13,4,0.7647058823529411,0.8666666666666666,llama3,mimiciii,radiology_report,PROMPT1_entailment
240,314,12,11,1,0.9166666666666666,15,11,4,0.7333333333333333,0.8148148148148148,llama3,mimiciii,radiology_report,PROMPT1_entailment
241,315,17,15,2,0.8823529411764706,25,19,6,0.76,0.816618911174785,llama3,mimiciii,radiology_report,PROMPT1_entailment
242,316,9,7,2,0.7777777777777778,10,8,2,0.8,0.7887323943661971,llama3,mimiciii,radiology_report,PROMPT1_entailment
243,317,12,9,3,0.75,26,18,8,0.6923076923076923,0.7199999999999999,llama3,mimiciii,radiology_report,PROMPT1_entailment
244,318,13,12,1,0.9230769230769232,21,17,4,0.8095238095238095,0.8625792811839323,llama3,mimiciii,radiology_report,PROMPT1_entailment
245,319,16,16,0,1.0,12,10,2,0.8333333333333334,0.9090909090909092,llama3,mimiciii,radiology_report,PROMPT1_entailment
246,32,12,12,0,1.0,15,11,4,0.7333333333333333,0.846153846153846,llama3,mimiciii,radiology_report,PROMPT1_entailment
247,320,9,8,1,0.8888888888888888,11,9,2,0.8181818181818182,0.8520710059171598,llama3,mimiciii,radiology_report,PROMPT1_entailment
248,321,15,14,1,0.9333333333333332,21,16,5,0.7619047619047619,0.8389513108614233,llama3,mimiciii,radiology_report,PROMPT1_entailment
249,322,7,7,0,1.0,8,7,1,0.875,0.9333333333333332,llama3,mimiciii,radiology_report,PROMPT1_entailment
250,323,17,16,1,0.9411764705882352,25,19,6,0.76,0.8409405255878285,llama3,mimiciii,radiology_report,PROMPT1_entailment
251,324,17,16,1,0.9411764705882352,18,15,3,0.8333333333333334,0.8839779005524863,llama3,mimiciii,radiology_report,PROMPT1_entailment
252,325,17,16,1,0.9411764705882352,22,17,5,0.7727272727272727,0.8486739469578783,llama3,mimiciii,radiology_report,PROMPT1_entailment
253,326,21,18,3,0.8571428571428571,23,16,7,0.6956521739130435,0.7679999999999999,llama3,mimiciii,radiology_report,PROMPT1_entailment
254,327,10,10,0,1.0,9,9,0,1.0,1.0,llama3,mimiciii,radiology_report,PROMPT1_entailment
255,328,12,12,0,1.0,17,14,3,0.8235294117647058,0.9032258064516128,llama3,mimiciii,radiology_report,PROMPT1_entailment
256,329,18,16,2,0.8888888888888888,24,17,7,0.7083333333333334,0.7884057971014492,llama3,mimiciii,radiology_report,PROMPT1_entailment
257,33,8,8,0,1.0,9,7,2,0.7777777777777778,0.8750000000000001,llama3,mimiciii,radiology_report,PROMPT1_entailment
258,330,15,10,5,0.6666666666666666,11,7,4,0.6363636363636364,0.6511627906976744,llama3,mimiciii,radiology_report,PROMPT1_entailment
259,331,12,11,1,0.9166666666666666,15,12,3,0.8,0.854368932038835,llama3,mimiciii,radiology_report,PROMPT1_entailment
260,332,12,11,1,0.9166666666666666,20,15,5,0.75,0.8250000000000001,llama3,mimiciii,radiology_report,PROMPT1_entailment
261,333,11,10,1,0.9090909090909092,13,12,1,0.9230769230769232,0.9160305343511452,llama3,mimiciii,radiology_report,PROMPT1_entailment
262,334,18,16,2,0.8888888888888888,20,19,1,0.95,0.918429003021148,llama3,mimiciii,radiology_report,PROMPT1_entailment
263,335,16,16,0,1.0,17,14,3,0.8235294117647058,0.9032258064516128,llama3,mimiciii,radiology_report,PROMPT1_entailment
264,336,17,15,2,0.8823529411764706,16,14,2,0.875,0.8786610878661087,llama3,mimiciii,radiology_report,PROMPT1_entailment
265,337,13,13,0,1.0,16,14,2,0.875,0.9333333333333332,llama3,mimiciii,radiology_report,PROMPT1_entailment
266,338,13,12,1,0.9230769230769232,13,9,4,0.6923076923076923,0.7912087912087913,llama3,mimiciii,radiology_report,PROMPT1_entailment
267,339,13,12,1,0.9230769230769232,28,22,6,0.7857142857142857,0.8488745980707394,llama3,mimiciii,radiology_report,PROMPT1_entailment
268,34,12,12,0,1.0,14,12,2,0.8571428571428571,0.923076923076923,llama3,mimiciii,radiology_report,PROMPT1_entailment
269,340,21,19,2,0.9047619047619048,15,12,3,0.8,0.8491620111731844,llama3,mimiciii,radiology_report,PROMPT1_entailment
270,341,5,5,0,1.0,6,5,1,0.8333333333333334,0.9090909090909092,llama3,mimiciii,radiology_report,PROMPT1_entailment
271,342,10,10,0,1.0,15,13,2,0.8666666666666667,0.9285714285714286,llama3,mimiciii,radiology_report,PROMPT1_entailment
272,343,13,13,0,1.0,22,21,1,0.9545454545454546,0.9767441860465116,llama3,mimiciii,radiology_report,PROMPT1_entailment
273,344,17,16,1,0.9411764705882352,19,16,3,0.8421052631578947,0.8888888888888888,llama3,mimiciii,radiology_report,PROMPT1_entailment
274,345,17,14,3,0.8235294117647058,22,18,4,0.8181818181818182,0.8208469055374593,llama3,mimiciii,radiology_report,PROMPT1_entailment
275,346,11,10,1,0.9090909090909092,15,11,4,0.7333333333333333,0.8118081180811808,llama3,mimiciii,radiology_report,PROMPT1_entailment
276,347,13,12,1,0.9230769230769232,15,14,1,0.9333333333333332,0.9281767955801106,llama3,mimiciii,radiology_report,PROMPT1_entailment
277,348,12,10,2,0.8333333333333334,12,8,4,0.6666666666666666,0.7407407407407408,llama3,mimiciii,radiology_report,PROMPT1_entailment
278,349,12,11,1,0.9166666666666666,16,14,2,0.875,0.8953488372093024,llama3,mimiciii,radiology_report,PROMPT1_entailment
279,35,14,14,0,1.0,21,14,7,0.6666666666666666,0.8,llama3,mimiciii,radiology_report,PROMPT1_entailment
280,350,15,14,1,0.9333333333333332,21,14,7,0.6666666666666666,0.7777777777777778,llama3,mimiciii,radiology_report,PROMPT1_entailment
281,351,14,12,2,0.8571428571428571,21,18,3,0.8571428571428571,0.8571428571428571,llama3,mimiciii,radiology_report,PROMPT1_entailment
282,352,14,12,2,0.8571428571428571,22,15,7,0.6818181818181818,0.759493670886076,llama3,mimiciii,radiology_report,PROMPT1_entailment
283,353,15,13,2,0.8666666666666667,23,19,4,0.8260869565217391,0.845890410958904,llama3,mimiciii,radiology_report,PROMPT1_entailment
284,354,15,12,3,0.8,26,22,4,0.8461538461538461,0.8224299065420562,llama3,mimiciii,radiology_report,PROMPT1_entailment
285,355,12,11,1,0.9166666666666666,18,15,3,0.8333333333333334,0.8730158730158729,llama3,mimiciii,radiology_report,PROMPT1_entailment
286,356,15,13,2,0.8666666666666667,22,19,3,0.8636363636363636,0.8651488616462346,llama3,mimiciii,radiology_report,PROMPT1_entailment
287,357,11,11,0,1.0,15,8,7,0.5333333333333333,0.6956521739130436,llama3,mimiciii,radiology_report,PROMPT1_entailment
288,358,11,11,0,1.0,12,7,5,0.5833333333333334,0.7368421052631579,llama3,mimiciii,radiology_report,PROMPT1_entailment
289,359,12,11,1,0.9166666666666666,18,15,3,0.8333333333333334,0.8730158730158729,llama3,mimiciii,radiology_report,PROMPT1_entailment
290,36,16,15,1,0.9375,22,17,5,0.7727272727272727,0.8471760797342192,llama3,mimiciii,radiology_report,PROMPT1_entailment
291,360,14,13,1,0.9285714285714286,15,12,3,0.8,0.859504132231405,llama3,mimiciii,radiology_report,PROMPT1_entailment
292,361,17,13,4,0.7647058823529411,23,16,7,0.6956521739130435,0.7285464098073555,llama3,mimiciii,radiology_report,PROMPT1_entailment
293,362,16,13,3,0.8125,24,15,9,0.625,0.7065217391304348,llama3,mimiciii,radiology_report,PROMPT1_entailment
294,363,19,17,2,0.8947368421052632,22,17,5,0.7727272727272727,0.8292682926829269,llama3,mimiciii,radiology_report,PROMPT1_entailment
295,364,8,7,1,0.875,11,9,2,0.8181818181818182,0.8456375838926175,llama3,mimiciii,radiology_report,PROMPT1_entailment
296,365,21,14,7,0.6666666666666666,29,22,7,0.7586206896551724,0.7096774193548386,llama3,mimiciii,radiology_report,PROMPT1_entailment
297,366,11,10,1,0.9090909090909092,13,9,4,0.6923076923076923,0.7860262008733625,llama3,mimiciii,radiology_report,PROMPT1_entailment
298,367,15,15,0,1.0,16,13,3,0.8125,0.896551724137931,llama3,mimiciii,radiology_report,PROMPT1_entailment
299,368,13,9,4,0.6923076923076923,20,13,7,0.65,0.670487106017192,llama3,mimiciii,radiology_report,PROMPT1_entailment
300,369,13,13,0,1.0,20,15,5,0.75,0.8571428571428571,llama3,mimiciii,radiology_report,PROMPT1_entailment
301,37,14,14,0,1.0,21,15,6,0.7142857142857143,0.8333333333333333,llama3,mimiciii,radiology_report,PROMPT1_entailment
302,370,17,15,2,0.8823529411764706,19,12,7,0.631578947368421,0.7361963190184049,llama3,mimiciii,radiology_report,PROMPT1_entailment
303,371,16,15,1,0.9375,17,16,1,0.9411764705882352,0.9393346379647748,llama3,mimiciii,radiology_report,PROMPT1_entailment
304,372,16,14,2,0.875,27,19,8,0.7037037037037037,0.7800586510263929,llama3,mimiciii,radiology_report,PROMPT1_entailment
305,373,16,16,0,1.0,23,19,4,0.8260869565217391,0.9047619047619048,llama3,mimiciii,radiology_report,PROMPT1_entailment
306,374,9,9,0,1.0,11,8,3,0.7272727272727273,0.8421052631578948,llama3,mimiciii,radiology_report,PROMPT1_entailment
307,375,10,10,0,1.0,16,11,5,0.6875,0.8148148148148148,llama3,mimiciii,radiology_report,PROMPT1_entailment
308,376,15,14,1,0.9333333333333332,18,15,3,0.8333333333333334,0.8805031446540881,llama3,mimiciii,radiology_report,PROMPT1_entailment
309,377,9,8,1,0.8888888888888888,10,7,3,0.7,0.7832167832167831,llama3,mimiciii,radiology_report,PROMPT1_entailment
310,378,16,15,1,0.9375,24,20,4,0.8333333333333334,0.8823529411764706,llama3,mimiciii,radiology_report,PROMPT1_entailment
311,379,14,12,2,0.8571428571428571,18,17,1,0.9444444444444444,0.8986784140969163,llama3,mimiciii,radiology_report,PROMPT1_entailment
312,38,14,13,1,0.9285714285714286,19,14,5,0.7368421052631579,0.8216704288939053,llama3,mimiciii,radiology_report,PROMPT1_entailment
313,380,9,8,1,0.8888888888888888,8,5,3,0.625,0.7339449541284404,llama3,mimiciii,radiology_report,PROMPT1_entailment
314,381,11,11,0,1.0,14,11,3,0.7857142857142857,0.88,llama3,mimiciii,radiology_report,PROMPT1_entailment
315,382,10,10,0,1.0,13,12,1,0.9230769230769232,0.96,llama3,mimiciii,radiology_report,PROMPT1_entailment
316,383,18,18,0,1.0,17,14,3,0.8235294117647058,0.9032258064516128,llama3,mimiciii,radiology_report,PROMPT1_entailment
317,384,10,10,0,1.0,13,11,2,0.8461538461538461,0.9166666666666666,llama3,mimiciii,radiology_report,PROMPT1_entailment
318,385,16,15,1,0.9375,27,22,5,0.8148148148148148,0.8718626155878467,llama3,mimiciii,radiology_report,PROMPT1_entailment
319,386,11,11,0,1.0,18,16,2,0.8888888888888888,0.9411764705882352,llama3,mimiciii,radiology_report,PROMPT1_entailment
320,387,14,14,0,1.0,19,16,3,0.8421052631578947,0.9142857142857144,llama3,mimiciii,radiology_report,PROMPT1_entailment
321,388,14,12,2,0.8571428571428571,33,29,4,0.8787878787878788,0.8678304239401495,llama3,mimiciii,radiology_report,PROMPT1_entailment
322,389,14,14,0,1.0,12,9,3,0.75,0.8571428571428571,llama3,mimiciii,radiology_report,PROMPT1_entailment
323,39,12,11,1,0.9166666666666666,10,7,3,0.7,0.7938144329896907,llama3,mimiciii,radiology_report,PROMPT1_entailment
324,390,11,11,0,1.0,14,12,2,0.8571428571428571,0.923076923076923,llama3,mimiciii,radiology_report,PROMPT1_entailment
325,391,12,11,1,0.9166666666666666,13,7,6,0.5384615384615384,0.6784140969162995,llama3,mimiciii,radiology_report,PROMPT1_entailment
326,392,11,11,0,1.0,15,12,3,0.8,0.888888888888889,llama3,mimiciii,radiology_report,PROMPT1_entailment
327,393,19,17,2,0.8947368421052632,19,16,3,0.8421052631578947,0.8676236044657096,llama3,mimiciii,radiology_report,PROMPT1_entailment
328,394,13,13,0,1.0,18,16,2,0.8888888888888888,0.9411764705882352,llama3,mimiciii,radiology_report,PROMPT1_entailment
329,395,14,14,0,1.0,16,11,5,0.6875,0.8148148148148148,llama3,mimiciii,radiology_report,PROMPT1_entailment
330,396,12,12,0,1.0,19,13,6,0.6842105263157895,0.8125000000000001,llama3,mimiciii,radiology_report,PROMPT1_entailment
331,397,17,16,1,0.9411764705882352,18,13,5,0.7222222222222222,0.8172888015717094,llama3,mimiciii,radiology_report,PROMPT1_entailment
332,398,23,21,2,0.9130434782608696,21,18,3,0.8571428571428571,0.8842105263157894,llama3,mimiciii,radiology_report,PROMPT1_entailment
333,399,13,12,1,0.9230769230769232,19,16,3,0.8421052631578947,0.8807339449541285,llama3,mimiciii,radiology_report,PROMPT1_entailment
334,4,12,10,2,0.8333333333333334,16,12,4,0.75,0.7894736842105262,llama3,mimiciii,radiology_report,PROMPT1_entailment
335,40,18,18,0,1.0,17,14,3,0.8235294117647058,0.9032258064516128,llama3,mimiciii,radiology_report,PROMPT1_entailment
336,400,9,8,1,0.8888888888888888,13,9,4,0.6923076923076923,0.7783783783783783,llama3,mimiciii,radiology_report,PROMPT1_entailment
337,401,9,9,0,1.0,9,9,0,1.0,1.0,llama3,mimiciii,radiology_report,PROMPT1_entailment
338,402,15,13,2,0.8666666666666667,20,17,3,0.85,0.858252427184466,llama3,mimiciii,radiology_report,PROMPT1_entailment
339,403,14,13,1,0.9285714285714286,18,13,5,0.7222222222222222,0.8125000000000001,llama3,mimiciii,radiology_report,PROMPT1_entailment
340,404,14,14,0,1.0,19,16,3,0.8421052631578947,0.9142857142857144,llama3,mimiciii,radiology_report,PROMPT1_entailment
341,405,17,15,2,0.8823529411764706,14,10,4,0.7142857142857143,0.7894736842105262,llama3,mimiciii,radiology_report,PROMPT1_entailment
342,406,19,17,2,0.8947368421052632,25,23,2,0.92,0.9071925754060326,llama3,mimiciii,radiology_report,PROMPT1_entailment
343,407,13,12,1,0.9230769230769232,20,14,6,0.7,0.7962085308056872,llama3,mimiciii,radiology_report,PROMPT1_entailment
344,408,15,14,1,0.9333333333333332,20,15,5,0.75,0.8316831683168316,llama3,mimiciii,radiology_report,PROMPT1_entailment
345,409,18,18,0,1.0,18,14,4,0.7777777777777778,0.8750000000000001,llama3,mimiciii,radiology_report,PROMPT1_entailment
346,41,16,15,1,0.9375,26,23,3,0.8846153846153846,0.9102902374670184,llama3,mimiciii,radiology_report,PROMPT1_entailment
347,410,17,15,2,0.8823529411764706,20,15,5,0.75,0.8108108108108107,llama3,mimiciii,radiology_report,PROMPT1_entailment
348,411,6,6,0,1.0,6,5,1,0.8333333333333334,0.9090909090909092,llama3,mimiciii,radiology_report,PROMPT1_entailment
349,412,16,16,0,1.0,26,21,5,0.8076923076923077,0.8936170212765957,llama3,mimiciii,radiology_report,PROMPT1_entailment
350,413,13,12,1,0.9230769230769232,14,11,3,0.7857142857142857,0.8488745980707394,llama3,mimiciii,radiology_report,PROMPT1_entailment
351,414,17,14,3,0.8235294117647058,28,17,11,0.6071428571428571,0.6989720998531571,llama3,mimiciii,radiology_report,PROMPT1_entailment
352,415,14,14,0,1.0,20,18,2,0.9,0.9473684210526316,llama3,mimiciii,radiology_report,PROMPT1_entailment
353,416,12,12,0,1.0,17,12,5,0.7058823529411765,0.8275862068965517,llama3,mimiciii,radiology_report,PROMPT1_entailment
354,417,16,15,1,0.9375,20,16,4,0.8,0.8633093525179856,llama3,mimiciii,radiology_report,PROMPT1_entailment
355,418,13,12,1,0.9230769230769232,14,9,5,0.6428571428571429,0.7578947368421053,llama3,mimiciii,radiology_report,PROMPT1_entailment
356,419,15,13,2,0.8666666666666667,16,14,2,0.875,0.8708133971291866,llama3,mimiciii,radiology_report,PROMPT1_entailment
357,42,14,13,1,0.9285714285714286,14,10,4,0.7142857142857143,0.8074534161490684,llama3,mimiciii,radiology_report,PROMPT1_entailment
358,420,14,13,1,0.9285714285714286,15,11,4,0.7333333333333333,0.8194842406876792,llama3,mimiciii,radiology_report,PROMPT1_entailment
359,421,16,14,2,0.875,23,21,2,0.9130434782608696,0.8936170212765957,llama3,mimiciii,radiology_report,PROMPT1_entailment
360,422,15,14,1,0.9333333333333332,20,14,6,0.7,0.8,llama3,mimiciii,radiology_report,PROMPT1_entailment
361,423,9,8,1,0.8888888888888888,12,10,2,0.8333333333333334,0.8602150537634408,llama3,mimiciii,radiology_report,PROMPT1_entailment
362,424,8,6,2,0.75,9,7,2,0.7777777777777778,0.7636363636363638,llama3,mimiciii,radiology_report,PROMPT1_entailment
363,425,18,17,1,0.9444444444444444,19,15,4,0.7894736842105263,0.8600337268128162,llama3,mimiciii,radiology_report,PROMPT1_entailment
364,426,12,12,0,1.0,16,14,2,0.875,0.9333333333333332,llama3,mimiciii,radiology_report,PROMPT1_entailment
365,427,11,10,1,0.9090909090909092,15,10,5,0.6666666666666666,0.7692307692307692,llama3,mimiciii,radiology_report,PROMPT1_entailment
366,428,12,10,2,0.8333333333333334,15,12,3,0.8,0.816326530612245,llama3,mimiciii,radiology_report,PROMPT1_entailment
367,429,13,13,0,1.0,13,10,3,0.7692307692307693,0.8695652173913044,llama3,mimiciii,radiology_report,PROMPT1_entailment
368,43,8,8,0,1.0,7,6,1,0.8571428571428571,0.923076923076923,llama3,mimiciii,radiology_report,PROMPT1_entailment
369,430,7,7,0,1.0,7,4,3,0.5714285714285714,0.7272727272727273,llama3,mimiciii,radiology_report,PROMPT1_entailment
370,431,12,6,6,0.5,18,14,4,0.7777777777777778,0.6086956521739131,llama3,mimiciii,radiology_report,PROMPT1_entailment
371,432,16,15,1,0.9375,13,10,3,0.7692307692307693,0.8450704225352113,llama3,mimiciii,radiology_report,PROMPT1_entailment
372,433,11,10,1,0.9090909090909092,18,14,4,0.7777777777777778,0.8383233532934132,llama3,mimiciii,radiology_report,PROMPT1_entailment
373,434,16,15,1,0.9375,27,18,9,0.6666666666666666,0.7792207792207793,llama3,mimiciii,radiology_report,PROMPT1_entailment
374,435,11,11,0,1.0,13,10,3,0.7692307692307693,0.8695652173913044,llama3,mimiciii,radiology_report,PROMPT1_entailment
375,436,16,15,1,0.9375,25,23,2,0.92,0.9286675639300136,llama3,mimiciii,radiology_report,PROMPT1_entailment
376,437,8,8,0,1.0,7,7,0,1.0,1.0,llama3,mimiciii,radiology_report,PROMPT1_entailment
377,438,13,12,1,0.9230769230769232,19,15,4,0.7894736842105263,0.8510638297872342,llama3,mimiciii,radiology_report,PROMPT1_entailment
378,439,16,13,3,0.8125,22,19,3,0.8636363636363636,0.8372881355932202,llama3,mimiciii,radiology_report,PROMPT1_entailment
379,44,9,9,0,1.0,16,11,5,0.6875,0.8148148148148148,llama3,mimiciii,radiology_report,PROMPT1_entailment
380,440,11,10,1,0.9090909090909092,19,12,7,0.631578947368421,0.7453416149068324,llama3,mimiciii,radiology_report,PROMPT1_entailment
381,441,14,14,0,1.0,17,17,0,1.0,1.0,llama3,mimiciii,radiology_report,PROMPT1_entailment
382,442,12,11,1,0.9166666666666666,12,10,2,0.8333333333333334,0.8730158730158729,llama3,mimiciii,radiology_report,PROMPT1_entailment
383,443,13,11,2,0.8461538461538461,21,16,5,0.7619047619047619,0.8018223234624144,llama3,mimiciii,radiology_report,PROMPT1_entailment
384,444,9,8,1,0.8888888888888888,8,5,3,0.625,0.7339449541284404,llama3,mimiciii,radiology_report,PROMPT1_entailment
385,445,15,14,1,0.9333333333333332,22,18,4,0.8181818181818182,0.8719723183391004,llama3,mimiciii,radiology_report,PROMPT1_entailment
386,446,13,9,4,0.6923076923076923,22,12,10,0.5454545454545454,0.6101694915254238,llama3,mimiciii,radiology_report,PROMPT1_entailment
387,447,11,11,0,1.0,14,13,1,0.9285714285714286,0.962962962962963,llama3,mimiciii,radiology_report,PROMPT1_entailment
388,448,16,15,1,0.9375,36,26,10,0.7222222222222222,0.8158995815899581,llama3,mimiciii,radiology_report,PROMPT1_entailment
389,449,10,8,2,0.8,9,7,2,0.7777777777777778,0.7887323943661971,llama3,mimiciii,radiology_report,PROMPT1_entailment
390,45,12,11,1,0.9166666666666666,20,16,4,0.8,0.854368932038835,llama3,mimiciii,radiology_report,PROMPT1_entailment
391,450,16,15,1,0.9375,21,18,3,0.8571428571428571,0.8955223880597014,llama3,mimiciii,radiology_report,PROMPT1_entailment
392,451,9,9,0,1.0,10,7,3,0.7,0.8235294117647058,llama3,mimiciii,radiology_report,PROMPT1_entailment
393,452,16,15,1,0.9375,16,14,2,0.875,0.9051724137931034,llama3,mimiciii,radiology_report,PROMPT1_entailment
394,453,12,11,1,0.9166666666666666,14,12,2,0.8571428571428571,0.8859060402684563,llama3,mimiciii,radiology_report,PROMPT1_entailment
395,454,9,9,0,1.0,10,6,4,0.6,0.7499999999999999,llama3,mimiciii,radiology_report,PROMPT1_entailment
396,455,14,13,1,0.9285714285714286,16,15,1,0.9375,0.9330143540669856,llama3,mimiciii,radiology_report,PROMPT1_entailment
397,456,14,13,1,0.9285714285714286,21,19,2,0.9047619047619048,0.9165120593692022,llama3,mimiciii,radiology_report,PROMPT1_entailment
398,457,14,14,0,1.0,12,10,2,0.8333333333333334,0.9090909090909092,llama3,mimiciii,radiology_report,PROMPT1_entailment
399,458,12,10,2,0.8333333333333334,16,13,3,0.8125,0.8227848101265822,llama3,mimiciii,radiology_report,PROMPT1_entailment
400,459,13,13,0,1.0,13,10,3,0.7692307692307693,0.8695652173913044,llama3,mimiciii,radiology_report,PROMPT1_entailment
401,46,11,10,1,0.9090909090909092,22,13,9,0.5909090909090909,0.7162534435261708,llama3,mimiciii,radiology_report,PROMPT1_entailment
402,460,16,15,1,0.9375,20,17,3,0.85,0.8916083916083916,llama3,mimiciii,radiology_report,PROMPT1_entailment
403,461,13,9,4,0.6923076923076923,22,16,6,0.7272727272727273,0.7093596059113301,llama3,mimiciii,radiology_report,PROMPT1_entailment
404,462,16,15,1,0.9375,20,17,3,0.85,0.8916083916083916,llama3,mimiciii,radiology_report,PROMPT1_entailment
405,463,10,10,0,1.0,12,9,3,0.75,0.8571428571428571,llama3,mimiciii,radiology_report,PROMPT1_entailment
406,464,19,17,2,0.8947368421052632,25,19,6,0.76,0.8218829516539441,llama3,mimiciii,radiology_report,PROMPT1_entailment
407,465,21,20,1,0.9523809523809524,33,21,12,0.6363636363636364,0.762942779291553,llama3,mimiciii,radiology_report,PROMPT1_entailment
408,466,13,10,3,0.7692307692307693,22,18,4,0.8181818181818182,0.7929515418502203,llama3,mimiciii,radiology_report,PROMPT1_entailment
409,467,11,10,1,0.9090909090909092,14,14,0,1.0,0.9523809523809524,llama3,mimiciii,radiology_report,PROMPT1_entailment
410,468,12,12,0,1.0,18,13,5,0.7222222222222222,0.8387096774193548,llama3,mimiciii,radiology_report,PROMPT1_entailment
411,469,18,17,1,0.9444444444444444,25,23,2,0.92,0.932061978545888,llama3,mimiciii,radiology_report,PROMPT1_entailment
412,47,12,12,0,1.0,15,11,4,0.7333333333333333,0.846153846153846,llama3,mimiciii,radiology_report,PROMPT1_entailment
413,470,12,12,0,1.0,15,12,3,0.8,0.888888888888889,llama3,mimiciii,radiology_report,PROMPT1_entailment
414,471,17,16,1,0.9411764705882352,18,15,3,0.8333333333333334,0.8839779005524863,llama3,mimiciii,radiology_report,PROMPT1_entailment
415,472,14,13,1,0.9285714285714286,16,14,2,0.875,0.900990099009901,llama3,mimiciii,radiology_report,PROMPT1_entailment
416,473,8,7,1,0.875,11,9,2,0.8181818181818182,0.8456375838926175,llama3,mimiciii,radiology_report,PROMPT1_entailment
417,474,15,13,2,0.8666666666666667,25,21,4,0.84,0.853125,llama3,mimiciii,radiology_report,PROMPT1_entailment
418,475,8,8,0,1.0,7,5,2,0.7142857142857143,0.8333333333333333,llama3,mimiciii,radiology_report,PROMPT1_entailment
419,476,13,13,0,1.0,12,11,1,0.9166666666666666,0.9565217391304348,llama3,mimiciii,radiology_report,PROMPT1_entailment
420,477,16,15,1,0.9375,16,13,3,0.8125,0.8705357142857143,llama3,mimiciii,radiology_report,PROMPT1_entailment
421,478,19,18,1,0.9473684210526316,21,18,3,0.8571428571428571,0.9,llama3,mimiciii,radiology_report,PROMPT1_entailment
422,479,13,13,0,1.0,22,16,6,0.7272727272727273,0.8421052631578948,llama3,mimiciii,radiology_report,PROMPT1_entailment
423,48,15,14,1,0.9333333333333332,21,16,5,0.7619047619047619,0.8389513108614233,llama3,mimiciii,radiology_report,PROMPT1_entailment
424,480,9,9,0,1.0,10,6,4,0.6,0.7499999999999999,llama3,mimiciii,radiology_report,PROMPT1_entailment
425,481,15,15,0,1.0,17,14,3,0.8235294117647058,0.9032258064516128,llama3,mimiciii,radiology_report,PROMPT1_entailment
426,482,13,13,0,1.0,19,18,1,0.9473684210526316,0.972972972972973,llama3,mimiciii,radiology_report,PROMPT1_entailment
427,483,13,13,0,1.0,23,15,8,0.6521739130434783,0.7894736842105263,llama3,mimiciii,radiology_report,PROMPT1_entailment
428,484,9,8,1,0.8888888888888888,13,7,6,0.5384615384615384,0.6706586826347306,llama3,mimiciii,radiology_report,PROMPT1_entailment
429,485,16,16,0,1.0,24,17,7,0.7083333333333334,0.8292682926829268,llama3,mimiciii,radiology_report,PROMPT1_entailment
430,486,14,12,2,0.8571428571428571,11,10,1,0.9090909090909092,0.8823529411764706,llama3,mimiciii,radiology_report,PROMPT1_entailment
431,487,13,11,2,0.8461538461538461,20,17,3,0.85,0.8480725623582767,llama3,mimiciii,radiology_report,PROMPT1_entailment
432,488,11,9,2,0.8181818181818182,15,12,3,0.8,0.8089887640449439,llama3,mimiciii,radiology_report,PROMPT1_entailment
433,489,16,15,1,0.9375,18,14,4,0.7777777777777778,0.8502024291497976,llama3,mimiciii,radiology_report,PROMPT1_entailment
434,49,15,14,1,0.9333333333333332,24,21,3,0.875,0.9032258064516128,llama3,mimiciii,radiology_report,PROMPT1_entailment
435,490,6,5,1,0.8333333333333334,8,3,5,0.375,0.5172413793103448,llama3,mimiciii,radiology_report,PROMPT1_entailment
436,491,14,12,2,0.8571428571428571,17,10,7,0.5882352941176471,0.6976744186046512,llama3,mimiciii,radiology_report,PROMPT1_entailment
437,492,15,15,0,1.0,13,8,5,0.6153846153846154,0.761904761904762,llama3,mimiciii,radiology_report,PROMPT1_entailment
438,493,12,11,1,0.9166666666666666,9,7,2,0.7777777777777778,0.8415300546448087,llama3,mimiciii,radiology_report,PROMPT1_entailment
439,494,10,9,1,0.9,8,5,3,0.625,0.7377049180327869,llama3,mimiciii,radiology_report,PROMPT1_entailment
440,495,9,9,0,1.0,12,9,3,0.75,0.8571428571428571,llama3,mimiciii,radiology_report,PROMPT1_entailment
441,496,18,18,0,1.0,32,21,11,0.65625,0.7924528301886793,llama3,mimiciii,radiology_report,PROMPT1_entailment
442,497,18,16,2,0.8888888888888888,22,14,8,0.6363636363636364,0.7417218543046358,llama3,mimiciii,radiology_report,PROMPT1_entailment
443,498,17,15,2,0.8823529411764706,22,18,4,0.8181818181818182,0.8490566037735848,llama3,mimiciii,radiology_report,PROMPT1_entailment
444,499,16,16,0,1.0,17,14,3,0.8235294117647058,0.9032258064516128,llama3,mimiciii,radiology_report,PROMPT1_entailment
445,5,16,15,1,0.9375,22,16,6,0.7272727272727273,0.8191126279863482,llama3,mimiciii,radiology_report,PROMPT1_entailment
446,50,13,13,0,1.0,15,10,5,0.6666666666666666,0.8,llama3,mimiciii,radiology_report,PROMPT1_entailment
447,51,11,10,1,0.9090909090909092,13,10,3,0.7692307692307693,0.8333333333333333,llama3,mimiciii,radiology_report,PROMPT1_entailment
448,52,17,16,1,0.9411764705882352,21,16,5,0.7619047619047619,0.8421052631578947,llama3,mimiciii,radiology_report,PROMPT1_entailment
449,53,11,11,0,1.0,12,11,1,0.9166666666666666,0.9565217391304348,llama3,mimiciii,radiology_report,PROMPT1_entailment
450,54,9,9,0,1.0,10,6,4,0.6,0.7499999999999999,llama3,mimiciii,radiology_report,PROMPT1_entailment
451,55,11,11,0,1.0,18,15,3,0.8333333333333334,0.9090909090909092,llama3,mimiciii,radiology_report,PROMPT1_entailment
452,56,14,12,2,0.8571428571428571,21,12,9,0.5714285714285714,0.6857142857142857,llama3,mimiciii,radiology_report,PROMPT1_entailment
453,57,8,7,1,0.875,10,8,2,0.8,0.8358208955223881,llama3,mimiciii,radiology_report,PROMPT1_entailment
454,58,13,13,0,1.0,16,13,3,0.8125,0.896551724137931,llama3,mimiciii,radiology_report,PROMPT1_entailment
455,59,13,13,0,1.0,16,13,3,0.8125,0.896551724137931,llama3,mimiciii,radiology_report,PROMPT1_entailment
456,6,8,8,0,1.0,8,5,3,0.625,0.7692307692307693,llama3,mimiciii,radiology_report,PROMPT1_entailment
457,60,13,13,0,1.0,19,15,4,0.7894736842105263,0.8823529411764706,llama3,mimiciii,radiology_report,PROMPT1_entailment
458,61,15,12,3,0.8,22,17,5,0.7727272727272727,0.7861271676300577,llama3,mimiciii,radiology_report,PROMPT1_entailment
459,62,16,13,3,0.8125,13,10,3,0.7692307692307693,0.790273556231003,llama3,mimiciii,radiology_report,PROMPT1_entailment
460,63,12,11,1,0.9166666666666666,15,10,5,0.6666666666666666,0.7719298245614035,llama3,mimiciii,radiology_report,PROMPT1_entailment
461,64,15,13,2,0.8666666666666667,20,16,4,0.8,0.832,llama3,mimiciii,radiology_report,PROMPT1_entailment
462,65,14,12,2,0.8571428571428571,18,15,3,0.8333333333333334,0.8450704225352113,llama3,mimiciii,radiology_report,PROMPT1_entailment
463,66,14,13,1,0.9285714285714286,29,18,11,0.6206896551724138,0.7440381558028617,llama3,mimiciii,radiology_report,PROMPT1_entailment
464,67,15,12,3,0.8,28,23,5,0.8214285714285714,0.8105726872246696,llama3,mimiciii,radiology_report,PROMPT1_entailment
465,68,21,20,1,0.9523809523809524,30,24,6,0.8,0.8695652173913043,llama3,mimiciii,radiology_report,PROMPT1_entailment
466,69,20,19,1,0.95,31,21,10,0.6774193548387096,0.790882061446977,llama3,mimiciii,radiology_report,PROMPT1_entailment
467,7,13,13,0,1.0,16,15,1,0.9375,0.967741935483871,llama3,mimiciii,radiology_report,PROMPT1_entailment
468,70,13,11,2,0.8461538461538461,17,12,5,0.7058823529411765,0.7696793002915452,llama3,mimiciii,radiology_report,PROMPT1_entailment
469,71,13,12,1,0.9230769230769232,18,13,5,0.7222222222222222,0.8103896103896105,llama3,mimiciii,radiology_report,PROMPT1_entailment
470,72,11,11,0,1.0,13,12,1,0.9230769230769232,0.96,llama3,mimiciii,radiology_report,PROMPT1_entailment
471,73,19,17,2,0.8947368421052632,29,19,10,0.6551724137931034,0.7564402810304449,llama3,mimiciii,radiology_report,PROMPT1_entailment
472,74,14,14,0,1.0,18,16,2,0.8888888888888888,0.9411764705882352,llama3,mimiciii,radiology_report,PROMPT1_entailment
473,75,15,15,0,1.0,12,10,2,0.8333333333333334,0.9090909090909092,llama3,mimiciii,radiology_report,PROMPT1_entailment
474,76,10,10,0,1.0,14,11,3,0.7857142857142857,0.88,llama3,mimiciii,radiology_report,PROMPT1_entailment
475,77,16,14,2,0.875,26,21,5,0.8076923076923077,0.8400000000000001,llama3,mimiciii,radiology_report,PROMPT1_entailment
476,78,19,15,4,0.7894736842105263,33,27,6,0.8181818181818182,0.8035714285714286,llama3,mimiciii,radiology_report,PROMPT1_entailment
477,79,13,13,0,1.0,17,13,4,0.7647058823529411,0.8666666666666666,llama3,mimiciii,radiology_report,PROMPT1_entailment
478,8,10,10,0,1.0,15,14,1,0.9333333333333332,0.9655172413793104,llama3,mimiciii,radiology_report,PROMPT1_entailment
479,80,14,14,0,1.0,25,20,5,0.8,0.888888888888889,llama3,mimiciii,radiology_report,PROMPT1_entailment
480,81,13,13,0,1.0,15,13,2,0.8666666666666667,0.9285714285714286,llama3,mimiciii,radiology_report,PROMPT1_entailment
481,82,11,8,3,0.7272727272727273,14,11,3,0.7857142857142857,0.7553648068669527,llama3,mimiciii,radiology_report,PROMPT1_entailment
482,83,14,12,2,0.8571428571428571,17,14,3,0.8235294117647058,0.84,llama3,mimiciii,radiology_report,PROMPT1_entailment
483,84,14,13,1,0.9285714285714286,20,15,5,0.75,0.8297872340425532,llama3,mimiciii,radiology_report,PROMPT1_entailment
484,85,11,10,1,0.9090909090909092,14,13,1,0.9285714285714286,0.9187279151943464,llama3,mimiciii,radiology_report,PROMPT1_entailment
485,86,11,11,0,1.0,10,9,1,0.9,0.9473684210526316,llama3,mimiciii,radiology_report,PROMPT1_entailment
486,87,12,11,1,0.9166666666666666,14,11,3,0.7857142857142857,0.8461538461538461,llama3,mimiciii,radiology_report,PROMPT1_entailment
487,88,16,16,0,1.0,19,16,3,0.8421052631578947,0.9142857142857144,llama3,mimiciii,radiology_report,PROMPT1_entailment
488,89,16,15,1,0.9375,18,15,3,0.8333333333333334,0.8823529411764706,llama3,mimiciii,radiology_report,PROMPT1_entailment
489,9,9,8,1,0.8888888888888888,13,9,4,0.6923076923076923,0.7783783783783783,llama3,mimiciii,radiology_report,PROMPT1_entailment
490,90,13,13,0,1.0,14,14,0,1.0,1.0,llama3,mimiciii,radiology_report,PROMPT1_entailment
491,91,12,12,0,1.0,13,10,3,0.7692307692307693,0.8695652173913044,llama3,mimiciii,radiology_report,PROMPT1_entailment
492,92,16,15,1,0.9375,21,15,6,0.7142857142857143,0.8108108108108109,llama3,mimiciii,radiology_report,PROMPT1_entailment
493,93,13,12,1,0.9230769230769232,15,14,1,0.9333333333333332,0.9281767955801106,llama3,mimiciii,radiology_report,PROMPT1_entailment
494,94,20,19,1,0.95,28,20,8,0.7142857142857143,0.8154506437768242,llama3,mimiciii,radiology_report,PROMPT1_entailment
495,95,13,12,1,0.9230769230769232,18,10,8,0.5555555555555556,0.6936416184971099,llama3,mimiciii,radiology_report,PROMPT1_entailment
496,96,16,15,1,0.9375,21,15,6,0.7142857142857143,0.8108108108108109,llama3,mimiciii,radiology_report,PROMPT1_entailment
497,97,16,14,2,0.875,23,17,6,0.7391304347826086,0.8013468013468014,llama3,mimiciii,radiology_report,PROMPT1_entailment
498,98,14,14,0,1.0,19,15,4,0.7894736842105263,0.8823529411764706,llama3,mimiciii,radiology_report,PROMPT1_entailment
499,99,13,12,1,0.9230769230769232,13,10,3,0.7692307692307693,0.8391608391608392,llama3,mimiciii,radiology_report,PROMPT1_entailment
0,0,29,17,12,0.5862068965517241,21,12,9,0.5714285714285714,0.5787234042553192,llama3,mimiciii,radiology_report,PROMPT1_ICL_entailment
1,1,19,11,8,0.5789473684210527,15,8,7,0.5333333333333333,0.5552050473186121,llama3,mimiciii,radiology_report,PROMPT1_ICL_entailment
2,10,17,9,8,0.5294117647058824,18,12,6,0.6666666666666666,0.5901639344262295,llama3,mimiciii,radiology_report,PROMPT1_ICL_entailment
3,100,17,11,6,0.6470588235294118,9,7,2,0.7777777777777778,0.7064220183486238,llama3,mimiciii,radiology_report,PROMPT1_ICL_entailment
4,101,17,15,2,0.8823529411764706,15,8,7,0.5333333333333333,0.664819944598338,llama3,mimiciii,radiology_report,PROMPT1_ICL_entailment
5,102,17,10,7,0.5882352941176471,16,8,8,0.5,0.5405405405405405,llama3,mimiciii,radiology_report,PROMPT1_ICL_entailment
6,103,24,16,8,0.6666666666666666,19,16,3,0.8421052631578947,0.744186046511628,llama3,mimiciii,radiology_report,PROMPT1_ICL_entailment
7,104,22,14,8,0.6363636363636364,17,13,4,0.7647058823529411,0.6946564885496184,llama3,mimiciii,radiology_report,PROMPT1_ICL_entailment
8,105,14,5,9,0.3571428571428571,8,6,2,0.75,0.4838709677419354,llama3,mimiciii,radiology_report,PROMPT1_ICL_entailment
9,106,19,12,7,0.631578947368421,12,6,6,0.5,0.5581395348837209,llama3,mimiciii,radiology_report,PROMPT1_ICL_entailment
10,107,22,14,8,0.6363636363636364,19,10,9,0.5263157894736842,0.5761316872427983,llama3,mimiciii,radiology_report,PROMPT1_ICL_entailment
11,108,19,13,6,0.6842105263157895,13,11,2,0.8461538461538461,0.7566137566137566,llama3,mimiciii,radiology_report,PROMPT1_ICL_entailment
12,109,23,10,13,0.4347826086956521,20,16,4,0.8,0.5633802816901409,llama3,mimiciii,radiology_report,PROMPT1_ICL_entailment
13,11,19,12,7,0.631578947368421,20,9,11,0.45,0.5255474452554745,llama3,mimiciii,radiology_report,PROMPT1_ICL_entailment
14,110,21,17,4,0.8095238095238095,17,10,7,0.5882352941176471,0.6813627254509019,llama3,mimiciii,radiology_report,PROMPT1_ICL_entailment
15,111,21,12,9,0.5714285714285714,20,15,5,0.75,0.6486486486486486,llama3,mimiciii,radiology_report,PROMPT1_ICL_entailment
16,112,20,12,8,0.6,14,9,5,0.6428571428571429,0.6206896551724138,llama3,mimiciii,radiology_report,PROMPT1_ICL_entailment
17,113,27,12,15,0.4444444444444444,20,14,6,0.7,0.5436893203883495,llama3,mimiciii,radiology_report,PROMPT1_ICL_entailment
18,114,22,8,14,0.3636363636363636,23,16,7,0.6956521739130435,0.4776119402985074,llama3,mimiciii,radiology_report,PROMPT1_ICL_entailment
19,115,21,14,7,0.6666666666666666,20,15,5,0.75,0.7058823529411765,llama3,mimiciii,radiology_report,PROMPT1_ICL_entailment
20,116,16,8,8,0.5,13,7,6,0.5384615384615384,0.5185185185185186,llama3,mimiciii,radiology_report,PROMPT1_ICL_entailment
21,117,17,8,9,0.4705882352941176,16,9,7,0.5625,0.5124555160142348,llama3,mimiciii,radiology_report,PROMPT1_ICL_entailment
22,118,19,11,8,0.5789473684210527,24,14,10,0.5833333333333334,0.5811320754716981,llama3,mimiciii,radiology_report,PROMPT1_ICL_entailment
23,119,23,16,7,0.6956521739130435,17,11,6,0.6470588235294118,0.6704761904761906,llama3,mimiciii,radiology_report,PROMPT1_ICL_entailment
24,12,18,10,8,0.5555555555555556,17,11,6,0.6470588235294118,0.5978260869565217,llama3,mimiciii,radiology_report,PROMPT1_ICL_entailment
25,120,24,15,9,0.625,16,10,6,0.625,0.625,llama3,mimiciii,radiology_report,PROMPT1_ICL_entailment
26,121,25,14,11,0.56,26,15,11,0.5769230769230769,0.5683355886332883,llama3,mimiciii,radiology_report,PROMPT1_ICL_entailment
27,122,22,14,8,0.6363636363636364,20,14,6,0.7,0.6666666666666666,llama3,mimiciii,radiology_report,PROMPT1_ICL_entailment
28,123,18,11,7,0.6111111111111112,13,8,5,0.6153846153846154,0.613240418118467,llama3,mimiciii,radiology_report,PROMPT1_ICL_entailment
29,124,17,9,8,0.5294117647058824,12,6,6,0.5,0.5142857142857143,llama3,mimiciii,radiology_report,PROMPT1_ICL_entailment
30,125,28,19,9,0.6785714285714286,23,18,5,0.782608695652174,0.7268862911795961,llama3,mimiciii,radiology_report,PROMPT1_ICL_entailment
31,126,15,6,9,0.4,9,7,2,0.7777777777777778,0.5283018867924528,llama3,mimiciii,radiology_report,PROMPT1_ICL_entailment
32,127,27,19,8,0.7037037037037037,43,33,10,0.7674418604651163,0.7341920374707259,llama3,mimiciii,radiology_report,PROMPT1_ICL_entailment
33,128,16,9,7,0.5625,14,8,6,0.5714285714285714,0.5669291338582677,llama3,mimiciii,radiology_report,PROMPT1_ICL_entailment
34,129,20,12,8,0.6,16,10,6,0.625,0.6122448979591836,llama3,mimiciii,radiology_report,PROMPT1_ICL_entailment
35,13,18,11,7,0.6111111111111112,17,12,5,0.7058823529411765,0.6550868486352357,llama3,mimiciii,radiology_report,PROMPT1_ICL_entailment
36,130,19,11,8,0.5789473684210527,25,13,12,0.52,0.5478927203065135,llama3,mimiciii,radiology_report,PROMPT1_ICL_entailment
37,131,20,10,10,0.5,32,20,12,0.625,0.5555555555555556,llama3,mimiciii,radiology_report,PROMPT1_ICL_entailment
38,132,20,7,13,0.35,23,10,13,0.4347826086956521,0.3878116343490304,llama3,mimiciii,radiology_report,PROMPT1_ICL_entailment
39,133,23,18,5,0.782608695652174,21,14,7,0.6666666666666666,0.72,llama3,mimiciii,radiology_report,PROMPT1_ICL_entailment
40,134,18,10,8,0.5555555555555556,23,11,12,0.4782608695652174,0.514018691588785,llama3,mimiciii,radiology_report,PROMPT1_ICL_entailment
41,135,19,11,8,0.5789473684210527,20,11,9,0.55,0.5641025641025641,llama3,mimiciii,radiology_report,PROMPT1_ICL_entailment
42,136,15,6,9,0.4,14,7,7,0.5,0.4444444444444445,llama3,mimiciii,radiology_report,PROMPT1_ICL_entailment
43,137,15,9,6,0.6,10,8,2,0.8,0.6857142857142857,llama3,mimiciii,radiology_report,PROMPT1_ICL_entailment
44,138,18,10,8,0.5555555555555556,14,10,4,0.7142857142857143,0.6250000000000001,llama3,mimiciii,radiology_report,PROMPT1_ICL_entailment
45,139,17,8,9,0.4705882352941176,13,8,5,0.6153846153846154,0.5333333333333333,llama3,mimiciii,radiology_report,PROMPT1_ICL_entailment
46,14,16,8,8,0.5,12,7,5,0.5833333333333334,0.5384615384615384,llama3,mimiciii,radiology_report,PROMPT1_ICL_entailment
47,140,19,11,8,0.5789473684210527,18,10,8,0.5555555555555556,0.5670103092783506,llama3,mimiciii,radiology_report,PROMPT1_ICL_entailment
48,141,24,14,10,0.5833333333333334,16,10,6,0.625,0.603448275862069,llama3,mimiciii,radiology_report,PROMPT1_ICL_entailment
49,142,16,7,9,0.4375,14,7,7,0.5,0.4666666666666667,llama3,mimiciii,radiology_report,PROMPT1_ICL_entailment
50,143,28,20,8,0.7142857142857143,28,20,8,0.7142857142857143,0.7142857142857143,llama3,mimiciii,radiology_report,PROMPT1_ICL_entailment
51,144,19,12,7,0.631578947368421,23,14,9,0.6086956521739131,0.6199261992619925,llama3,mimiciii,radiology_report,PROMPT1_ICL_entailment
52,145,20,12,8,0.6,18,12,6,0.6666666666666666,0.631578947368421,llama3,mimiciii,radiology_report,PROMPT1_ICL_entailment
53,146,16,9,7,0.5625,11,6,5,0.5454545454545454,0.5538461538461538,llama3,mimiciii,radiology_report,PROMPT1_ICL_entailment
54,147,14,4,10,0.2857142857142857,10,3,7,0.3,0.2926829268292683,llama3,mimiciii,radiology_report,PROMPT1_ICL_entailment
55,148,26,17,9,0.6538461538461539,26,22,4,0.8461538461538461,0.7376725838264301,llama3,mimiciii,radiology_report,PROMPT1_ICL_entailment
56,149,19,10,9,0.5263157894736842,20,14,6,0.7,0.6008583690987124,llama3,mimiciii,radiology_report,PROMPT1_ICL_entailment
57,15,25,14,11,0.56,29,20,9,0.6896551724137931,0.6181015452538632,llama3,mimiciii,radiology_report,PROMPT1_ICL_entailment
58,150,23,15,8,0.6521739130434783,14,11,3,0.7857142857142857,0.712742980561555,llama3,mimiciii,radiology_report,PROMPT1_ICL_entailment
59,151,25,18,7,0.72,15,10,5,0.6666666666666666,0.6923076923076923,llama3,mimiciii,radiology_report,PROMPT1_ICL_entailment
60,152,22,14,8,0.6363636363636364,18,12,6,0.6666666666666666,0.6511627906976744,llama3,mimiciii,radiology_report,PROMPT1_ICL_entailment
61,153,17,12,5,0.7058823529411765,16,11,5,0.6875,0.6965699208443272,llama3,mimiciii,radiology_report,PROMPT1_ICL_entailment
62,154,23,15,8,0.6521739130434783,23,15,8,0.6521739130434783,0.6521739130434783,llama3,mimiciii,radiology_report,PROMPT1_ICL_entailment
63,155,25,23,2,0.92,47,36,11,0.7659574468085106,0.8359414437152953,llama3,mimiciii,radiology_report,PROMPT1_ICL_entailment
64,156,21,11,10,0.5238095238095238,20,12,8,0.6,0.559322033898305,llama3,mimiciii,radiology_report,PROMPT1_ICL_entailment
65,157,19,10,9,0.5263157894736842,12,9,3,0.75,0.6185567010309279,llama3,mimiciii,radiology_report,PROMPT1_ICL_entailment
66,158,12,4,8,0.3333333333333333,6,0,6,0.0,0.0,llama3,mimiciii,radiology_report,PROMPT1_ICL_entailment
67,159,18,10,8,0.5555555555555556,13,10,3,0.7692307692307693,0.6451612903225806,llama3,mimiciii,radiology_report,PROMPT1_ICL_entailment
68,16,22,15,7,0.6818181818181818,17,9,8,0.5294117647058824,0.5960264900662252,llama3,mimiciii,radiology_report,PROMPT1_ICL_entailment
69,160,21,12,9,0.5714285714285714,12,8,4,0.6666666666666666,0.6153846153846153,llama3,mimiciii,radiology_report,PROMPT1_ICL_entailment
70,161,19,9,10,0.4736842105263157,13,7,6,0.5384615384615384,0.5039999999999999,llama3,mimiciii,radiology_report,PROMPT1_ICL_entailment
71,162,21,15,6,0.7142857142857143,11,8,3,0.7272727272727273,0.7207207207207208,llama3,mimiciii,radiology_report,PROMPT1_ICL_entailment
72,163,19,10,9,0.5263157894736842,8,5,3,0.625,0.5714285714285714,llama3,mimiciii,radiology_report,PROMPT1_ICL_entailment
73,164,16,9,7,0.5625,10,3,7,0.3,0.3913043478260869,llama3,mimiciii,radiology_report,PROMPT1_ICL_entailment
74,165,24,13,11,0.5416666666666666,28,15,13,0.5357142857142857,0.5386740331491713,llama3,mimiciii,radiology_report,PROMPT1_ICL_entailment
75,166,28,19,9,0.6785714285714286,26,18,8,0.6923076923076923,0.685370741482966,llama3,mimiciii,radiology_report,PROMPT1_ICL_entailment
76,167,15,7,8,0.4666666666666667,10,6,4,0.6,0.5249999999999999,llama3,mimiciii,radiology_report,PROMPT1_ICL_entailment
77,168,18,9,9,0.5,13,6,7,0.4615384615384615,0.48,llama3,mimiciii,radiology_report,PROMPT1_ICL_entailment
78,169,20,13,7,0.65,22,12,10,0.5454545454545454,0.5931558935361217,llama3,mimiciii,radiology_report,PROMPT1_ICL_entailment
79,17,15,7,8,0.4666666666666667,12,6,6,0.5,0.4827586206896552,llama3,mimiciii,radiology_report,PROMPT1_ICL_entailment
80,170,23,16,7,0.6956521739130435,24,17,7,0.7083333333333334,0.7019354838709677,llama3,mimiciii,radiology_report,PROMPT1_ICL_entailment
81,171,15,6,9,0.4,7,5,2,0.7142857142857143,0.5128205128205129,llama3,mimiciii,radiology_report,PROMPT1_ICL_entailment
82,172,17,10,7,0.5882352941176471,14,9,5,0.6428571428571429,0.6143344709897611,llama3,mimiciii,radiology_report,PROMPT1_ICL_entailment
83,173,17,10,7,0.5882352941176471,12,9,3,0.75,0.6593406593406592,llama3,mimiciii,radiology_report,PROMPT1_ICL_entailment
84,174,23,15,8,0.6521739130434783,20,14,6,0.7,0.6752411575562701,llama3,mimiciii,radiology_report,PROMPT1_ICL_entailment
85,175,14,7,7,0.5,8,5,3,0.625,0.5555555555555556,llama3,mimiciii,radiology_report,PROMPT1_ICL_entailment
86,176,20,10,10,0.5,19,14,5,0.7368421052631579,0.5957446808510638,llama3,mimiciii,radiology_report,PROMPT1_ICL_entailment
87,177,17,9,8,0.5294117647058824,16,12,4,0.75,0.6206896551724139,llama3,mimiciii,radiology_report,PROMPT1_ICL_entailment
88,178,21,19,2,0.9047619047619048,25,21,4,0.84,0.87117903930131,llama3,mimiciii,radiology_report,PROMPT1_ICL_entailment
89,179,17,10,7,0.5882352941176471,17,7,10,0.4117647058823529,0.4844290657439446,llama3,mimiciii,radiology_report,PROMPT1_ICL_entailment
90,18,20,12,8,0.6,17,11,6,0.6470588235294118,0.6226415094339622,llama3,mimiciii,radiology_report,PROMPT1_ICL_entailment
91,180,19,11,8,0.5789473684210527,11,7,4,0.6363636363636364,0.6062992125984253,llama3,mimiciii,radiology_report,PROMPT1_ICL_entailment
92,181,22,12,10,0.5454545454545454,26,21,5,0.8076923076923077,0.6511627906976744,llama3,mimiciii,radiology_report,PROMPT1_ICL_entailment
93,182,20,17,3,0.85,23,18,5,0.782608695652174,0.81491344873502,llama3,mimiciii,radiology_report,PROMPT1_ICL_entailment
94,183,20,10,10,0.5,17,10,7,0.5882352941176471,0.5405405405405405,llama3,mimiciii,radiology_report,PROMPT1_ICL_entailment
95,184,17,9,8,0.5294117647058824,15,9,6,0.6,0.5625,llama3,mimiciii,radiology_report,PROMPT1_ICL_entailment
96,185,14,6,8,0.4285714285714285,6,2,4,0.3333333333333333,0.375,llama3,mimiciii,radiology_report,PROMPT1_ICL_entailment
97,186,21,12,9,0.5714285714285714,26,17,9,0.6538461538461539,0.6098654708520179,llama3,mimiciii,radiology_report,PROMPT1_ICL_entailment
98,187,23,14,9,0.6086956521739131,14,12,2,0.8571428571428571,0.7118644067796609,llama3,mimiciii,radiology_report,PROMPT1_ICL_entailment
99,188,20,16,4,0.8,22,18,4,0.8181818181818182,0.8089887640449439,llama3,mimiciii,radiology_report,PROMPT1_ICL_entailment
100,189,20,11,9,0.55,15,10,5,0.6666666666666666,0.6027397260273972,llama3,mimiciii,radiology_report,PROMPT1_ICL_entailment
101,19,16,8,8,0.5,14,8,6,0.5714285714285714,0.5333333333333333,llama3,mimiciii,radiology_report,PROMPT1_ICL_entailment
102,190,21,13,8,0.6190476190476191,17,12,5,0.7058823529411765,0.6596194503171248,llama3,mimiciii,radiology_report,PROMPT1_ICL_entailment
103,191,25,16,9,0.64,15,14,1,0.9333333333333332,0.7593220338983052,llama3,mimiciii,radiology_report,PROMPT1_ICL_entailment
104,192,28,18,10,0.6428571428571429,28,14,14,0.5,0.5625000000000001,llama3,mimiciii,radiology_report,PROMPT1_ICL_entailment
105,193,22,13,9,0.5909090909090909,14,11,3,0.7857142857142857,0.6745283018867925,llama3,mimiciii,radiology_report,PROMPT1_ICL_entailment
106,194,28,23,5,0.8214285714285714,38,28,10,0.7368421052631579,0.7768395657418578,llama3,mimiciii,radiology_report,PROMPT1_ICL_entailment
107,195,24,15,9,0.625,21,14,7,0.6666666666666666,0.6451612903225806,llama3,mimiciii,radiology_report,PROMPT1_ICL_entailment
108,196,19,11,8,0.5789473684210527,18,9,9,0.5,0.5365853658536586,llama3,mimiciii,radiology_report,PROMPT1_ICL_entailment
109,197,16,9,7,0.5625,15,7,8,0.4666666666666667,0.5101214574898785,llama3,mimiciii,radiology_report,PROMPT1_ICL_entailment
110,198,16,9,7,0.5625,9,5,4,0.5555555555555556,0.5590062111801242,llama3,mimiciii,radiology_report,PROMPT1_ICL_entailment
111,199,21,14,7,0.6666666666666666,23,18,5,0.782608695652174,0.72,llama3,mimiciii,radiology_report,PROMPT1_ICL_entailment
112,2,16,8,8,0.5,15,9,6,0.6,0.5454545454545454,llama3,mimiciii,radiology_report,PROMPT1_ICL_entailment
113,20,24,19,5,0.7916666666666666,36,30,6,0.8333333333333334,0.811965811965812,llama3,mimiciii,radiology_report,PROMPT1_ICL_entailment
114,200,21,13,8,0.6190476190476191,14,11,3,0.7857142857142857,0.6924939467312349,llama3,mimiciii,radiology_report,PROMPT1_ICL_entailment
115,201,20,11,9,0.55,18,11,7,0.6111111111111112,0.5789473684210527,llama3,mimiciii,radiology_report,PROMPT1_ICL_entailment
116,202,20,13,7,0.65,24,11,13,0.4583333333333333,0.537593984962406,llama3,mimiciii,radiology_report,PROMPT1_ICL_entailment
117,203,29,20,9,0.6896551724137931,19,16,3,0.8421052631578947,0.7582938388625593,llama3,mimiciii,radiology_report,PROMPT1_ICL_entailment
118,204,20,11,9,0.55,23,16,7,0.6956521739130435,0.6143106457242583,llama3,mimiciii,radiology_report,PROMPT1_ICL_entailment
119,205,21,13,8,0.6190476190476191,14,10,4,0.7142857142857143,0.6632653061224489,llama3,mimiciii,radiology_report,PROMPT1_ICL_entailment
120,206,22,15,7,0.6818181818181818,13,8,5,0.6153846153846154,0.646900269541779,llama3,mimiciii,radiology_report,PROMPT1_ICL_entailment
121,207,14,5,9,0.3571428571428571,9,6,3,0.6666666666666666,0.4651162790697674,llama3,mimiciii,radiology_report,PROMPT1_ICL_entailment
122,208,24,15,9,0.625,18,15,3,0.8333333333333334,0.7142857142857143,llama3,mimiciii,radiology_report,PROMPT1_ICL_entailment
123,209,20,13,7,0.65,16,10,6,0.625,0.6372549019607844,llama3,mimiciii,radiology_report,PROMPT1_ICL_entailment
124,21,24,18,6,0.75,27,17,10,0.6296296296296297,0.6845637583892616,llama3,mimiciii,radiology_report,PROMPT1_ICL_entailment
125,210,15,8,7,0.5333333333333333,14,5,9,0.3571428571428571,0.427807486631016,llama3,mimiciii,radiology_report,PROMPT1_ICL_entailment
126,211,14,7,7,0.5,13,6,7,0.4615384615384615,0.48,llama3,mimiciii,radiology_report,PROMPT1_ICL_entailment
127,212,23,13,10,0.5652173913043478,19,16,3,0.8421052631578947,0.6764227642276422,llama3,mimiciii,radiology_report,PROMPT1_ICL_entailment
128,213,23,13,10,0.5652173913043478,22,14,8,0.6363636363636364,0.5986842105263158,llama3,mimiciii,radiology_report,PROMPT1_ICL_entailment
129,214,30,15,15,0.5,23,19,4,0.8260869565217391,0.6229508196721311,llama3,mimiciii,radiology_report,PROMPT1_ICL_entailment
130,215,17,9,8,0.5294117647058824,10,7,3,0.7,0.6028708133971291,llama3,mimiciii,radiology_report,PROMPT1_ICL_entailment
131,216,17,8,9,0.4705882352941176,19,9,10,0.4736842105263157,0.4721311475409835,llama3,mimiciii,radiology_report,PROMPT1_ICL_entailment
132,217,18,9,9,0.5,20,11,9,0.55,0.5238095238095238,llama3,mimiciii,radiology_report,PROMPT1_ICL_entailment
133,218,27,20,7,0.7407407407407407,15,13,2,0.8666666666666667,0.7987711213517664,llama3,mimiciii,radiology_report,PROMPT1_ICL_entailment
134,219,19,11,8,0.5789473684210527,13,9,4,0.6923076923076923,0.6305732484076433,llama3,mimiciii,radiology_report,PROMPT1_ICL_entailment
135,22,25,18,7,0.72,19,17,2,0.8947368421052632,0.7979139504563234,llama3,mimiciii,radiology_report,PROMPT1_ICL_entailment
136,220,19,10,9,0.5263157894736842,19,8,11,0.4210526315789473,0.4678362573099415,llama3,mimiciii,radiology_report,PROMPT1_ICL_entailment
137,221,23,14,9,0.6086956521739131,27,21,6,0.7777777777777778,0.6829268292682927,llama3,mimiciii,radiology_report,PROMPT1_ICL_entailment
138,222,19,10,9,0.5263157894736842,16,9,7,0.5625,0.5438066465256798,llama3,mimiciii,radiology_report,PROMPT1_ICL_entailment
139,223,21,11,10,0.5238095238095238,21,13,8,0.6190476190476191,0.5674603174603176,llama3,mimiciii,radiology_report,PROMPT1_ICL_entailment
140,224,27,22,5,0.8148148148148148,17,14,3,0.8235294117647058,0.8191489361702128,llama3,mimiciii,radiology_report,PROMPT1_ICL_entailment
141,225,18,10,8,0.5555555555555556,11,9,2,0.8181818181818182,0.661764705882353,llama3,mimiciii,radiology_report,PROMPT1_ICL_entailment
142,226,18,10,8,0.5555555555555556,18,9,9,0.5,0.5263157894736842,llama3,mimiciii,radiology_report,PROMPT1_ICL_entailment
143,227,21,13,8,0.6190476190476191,18,14,4,0.7777777777777778,0.6893939393939394,llama3,mimiciii,radiology_report,PROMPT1_ICL_entailment
144,228,19,12,7,0.631578947368421,17,10,7,0.5882352941176471,0.6091370558375635,llama3,mimiciii,radiology_report,PROMPT1_ICL_entailment
145,229,25,19,6,0.76,44,28,16,0.6363636363636364,0.6927083333333333,llama3,mimiciii,radiology_report,PROMPT1_ICL_entailment
146,23,20,12,8,0.6,15,10,5,0.6666666666666666,0.631578947368421,llama3,mimiciii,radiology_report,PROMPT1_ICL_entailment
147,230,16,7,9,0.4375,17,12,5,0.7058823529411765,0.540192926045016,llama3,mimiciii,radiology_report,PROMPT1_ICL_entailment
148,231,18,13,5,0.7222222222222222,13,8,5,0.6153846153846154,0.6645367412140575,llama3,mimiciii,radiology_report,PROMPT1_ICL_entailment
149,232,19,12,7,0.631578947368421,18,11,7,0.6111111111111112,0.6211764705882353,llama3,mimiciii,radiology_report,PROMPT1_ICL_entailment
150,233,21,13,8,0.6190476190476191,17,10,7,0.5882352941176471,0.6032482598607889,llama3,mimiciii,radiology_report,PROMPT1_ICL_entailment
151,234,14,5,9,0.3571428571428571,11,5,6,0.4545454545454545,0.4,llama3,mimiciii,radiology_report,PROMPT1_ICL_entailment
152,235,19,11,8,0.5789473684210527,14,12,2,0.8571428571428571,0.6910994764397905,llama3,mimiciii,radiology_report,PROMPT1_ICL_entailment
153,236,22,15,7,0.6818181818181818,11,7,4,0.6363636363636364,0.658307210031348,llama3,mimiciii,radiology_report,PROMPT1_ICL_entailment
154,237,21,14,7,0.6666666666666666,17,9,8,0.5294117647058824,0.5901639344262295,llama3,mimiciii,radiology_report,PROMPT1_ICL_entailment
155,238,19,12,7,0.631578947368421,20,13,7,0.65,0.6406570841889117,llama3,mimiciii,radiology_report,PROMPT1_ICL_entailment
156,239,22,14,8,0.6363636363636364,17,11,6,0.6470588235294118,0.6416666666666667,llama3,mimiciii,radiology_report,PROMPT1_ICL_entailment
157,24,20,12,8,0.6,18,7,11,0.3888888888888889,0.4719101123595505,llama3,mimiciii,radiology_report,PROMPT1_ICL_entailment
158,240,17,9,8,0.5294117647058824,13,8,5,0.6153846153846154,0.5691699604743083,llama3,mimiciii,radiology_report,PROMPT1_ICL_entailment
159,241,21,15,6,0.7142857142857143,16,11,5,0.6875,0.7006369426751592,llama3,mimiciii,radiology_report,PROMPT1_ICL_entailment
160,242,23,15,8,0.6521739130434783,18,15,3,0.8333333333333334,0.7317073170731708,llama3,mimiciii,radiology_report,PROMPT1_ICL_entailment
161,243,20,11,9,0.55,13,10,3,0.7692307692307693,0.641399416909621,llama3,mimiciii,radiology_report,PROMPT1_ICL_entailment
162,244,21,14,7,0.6666666666666666,17,13,4,0.7647058823529411,0.7123287671232877,llama3,mimiciii,radiology_report,PROMPT1_ICL_entailment
163,245,25,13,12,0.52,28,23,5,0.8214285714285714,0.6368477103301384,llama3,mimiciii,radiology_report,PROMPT1_ICL_entailment
164,246,16,8,8,0.5,12,6,6,0.5,0.5,llama3,mimiciii,radiology_report,PROMPT1_ICL_entailment
165,247,18,9,9,0.5,12,8,4,0.6666666666666666,0.5714285714285715,llama3,mimiciii,radiology_report,PROMPT1_ICL_entailment
166,248,19,11,8,0.5789473684210527,17,9,8,0.5294117647058824,0.5530726256983242,llama3,mimiciii,radiology_report,PROMPT1_ICL_entailment
167,249,23,14,9,0.6086956521739131,23,14,9,0.6086956521739131,0.6086956521739131,llama3,mimiciii,radiology_report,PROMPT1_ICL_entailment
168,25,27,19,8,0.7037037037037037,27,18,9,0.6666666666666666,0.6846846846846847,llama3,mimiciii,radiology_report,PROMPT1_ICL_entailment
169,250,17,12,5,0.7058823529411765,8,6,2,0.75,0.7272727272727272,llama3,mimiciii,radiology_report,PROMPT1_ICL_entailment
170,251,28,16,12,0.5714285714285714,22,17,5,0.7727272727272727,0.6570048309178744,llama3,mimiciii,radiology_report,PROMPT1_ICL_entailment
171,252,16,7,9,0.4375,10,7,3,0.7,0.5384615384615384,llama3,mimiciii,radiology_report,PROMPT1_ICL_entailment
172,253,21,14,7,0.6666666666666666,24,17,7,0.7083333333333334,0.6868686868686869,llama3,mimiciii,radiology_report,PROMPT1_ICL_entailment
173,254,17,9,8,0.5294117647058824,13,5,8,0.3846153846153846,0.4455445544554455,llama3,mimiciii,radiology_report,PROMPT1_ICL_entailment
174,255,19,12,7,0.631578947368421,16,10,6,0.625,0.6282722513089005,llama3,mimiciii,radiology_report,PROMPT1_ICL_entailment
175,256,21,12,9,0.5714285714285714,19,10,9,0.5263157894736842,0.547945205479452,llama3,mimiciii,radiology_report,PROMPT1_ICL_entailment
176,257,17,10,7,0.5882352941176471,15,10,5,0.6666666666666666,0.625,llama3,mimiciii,radiology_report,PROMPT1_ICL_entailment
177,258,21,13,8,0.6190476190476191,20,10,10,0.5,0.5531914893617021,llama3,mimiciii,radiology_report,PROMPT1_ICL_entailment
178,259,19,12,7,0.631578947368421,17,11,6,0.6470588235294118,0.6392251815980629,llama3,mimiciii,radiology_report,PROMPT1_ICL_entailment
179,26,23,16,7,0.6956521739130435,18,13,5,0.7222222222222222,0.7086882453151618,llama3,mimiciii,radiology_report,PROMPT1_ICL_entailment
180,260,22,14,8,0.6363636363636364,20,12,8,0.6,0.6176470588235293,llama3,mimiciii,radiology_report,PROMPT1_ICL_entailment
181,261,24,19,5,0.7916666666666666,30,28,2,0.9333333333333332,0.8566827697262479,llama3,mimiciii,radiology_report,PROMPT1_ICL_entailment
182,262,26,18,8,0.6923076923076923,23,15,8,0.6521739130434783,0.6716417910447761,llama3,mimiciii,radiology_report,PROMPT1_ICL_entailment
183,263,22,13,9,0.5909090909090909,27,18,9,0.6666666666666666,0.6265060240963856,llama3,mimiciii,radiology_report,PROMPT1_ICL_entailment
184,264,18,9,9,0.5,20,11,9,0.55,0.5238095238095238,llama3,mimiciii,radiology_report,PROMPT1_ICL_entailment
185,265,17,9,8,0.5294117647058824,9,7,2,0.7777777777777778,0.63,llama3,mimiciii,radiology_report,PROMPT1_ICL_entailment
186,266,20,9,11,0.45,18,15,3,0.8333333333333334,0.5844155844155844,llama3,mimiciii,radiology_report,PROMPT1_ICL_entailment
187,267,18,10,8,0.5555555555555556,16,9,7,0.5625,0.5590062111801242,llama3,mimiciii,radiology_report,PROMPT1_ICL_entailment
188,268,18,8,10,0.4444444444444444,20,10,10,0.5,0.4705882352941176,llama3,mimiciii,radiology_report,PROMPT1_ICL_entailment
189,269,24,16,8,0.6666666666666666,25,12,13,0.48,0.5581395348837209,llama3,mimiciii,radiology_report,PROMPT1_ICL_entailment
190,27,22,15,7,0.6818181818181818,14,9,5,0.6428571428571429,0.6617647058823529,llama3,mimiciii,radiology_report,PROMPT1_ICL_entailment
191,270,24,15,9,0.625,17,9,8,0.5294117647058824,0.5732484076433121,llama3,mimiciii,radiology_report,PROMPT1_ICL_entailment
192,271,21,13,8,0.6190476190476191,17,11,6,0.6470588235294118,0.6327433628318585,llama3,mimiciii,radiology_report,PROMPT1_ICL_entailment
193,272,21,15,6,0.7142857142857143,17,10,7,0.5882352941176471,0.6451612903225806,llama3,mimiciii,radiology_report,PROMPT1_ICL_entailment
194,273,21,13,8,0.6190476190476191,12,7,5,0.5833333333333334,0.6006600660066007,llama3,mimiciii,radiology_report,PROMPT1_ICL_entailment
195,274,22,12,10,0.5454545454545454,20,13,7,0.65,0.5931558935361217,llama3,mimiciii,radiology_report,PROMPT1_ICL_entailment
196,275,18,9,9,0.5,12,8,4,0.6666666666666666,0.5714285714285715,llama3,mimiciii,radiology_report,PROMPT1_ICL_entailment
197,276,19,11,8,0.5789473684210527,24,14,10,0.5833333333333334,0.5811320754716981,llama3,mimiciii,radiology_report,PROMPT1_ICL_entailment
198,277,28,16,12,0.5714285714285714,25,21,4,0.84,0.680161943319838,llama3,mimiciii,radiology_report,PROMPT1_ICL_entailment
199,278,23,12,11,0.5217391304347826,16,11,5,0.6875,0.593258426966292,llama3,mimiciii,radiology_report,PROMPT1_ICL_entailment
200,279,18,12,6,0.6666666666666666,9,7,2,0.7777777777777778,0.717948717948718,llama3,mimiciii,radiology_report,PROMPT1_ICL_entailment
201,28,25,15,10,0.6,30,18,12,0.6,0.6,llama3,mimiciii,radiology_report,PROMPT1_ICL_entailment
202,280,17,8,9,0.4705882352941176,8,6,2,0.75,0.5783132530120481,llama3,mimiciii,radiology_report,PROMPT1_ICL_entailment
203,282,19,12,7,0.631578947368421,8,6,2,0.75,0.6857142857142857,llama3,mimiciii,radiology_report,PROMPT1_ICL_entailment
204,283,24,16,8,0.6666666666666666,25,19,6,0.76,0.7102803738317756,llama3,mimiciii,radiology_report,PROMPT1_ICL_entailment
205,284,19,12,7,0.631578947368421,14,10,4,0.7142857142857143,0.670391061452514,llama3,mimiciii,radiology_report,PROMPT1_ICL_entailment
206,285,19,11,8,0.5789473684210527,18,13,5,0.7222222222222222,0.6426966292134831,llama3,mimiciii,radiology_report,PROMPT1_ICL_entailment
207,286,14,6,8,0.4285714285714285,6,4,2,0.6666666666666666,0.5217391304347826,llama3,mimiciii,radiology_report,PROMPT1_ICL_entailment
208,287,20,11,9,0.55,18,13,5,0.7222222222222222,0.6244541484716158,llama3,mimiciii,radiology_report,PROMPT1_ICL_entailment
209,288,25,16,9,0.64,32,25,7,0.78125,0.7036059806508355,llama3,mimiciii,radiology_report,PROMPT1_ICL_entailment
210,289,30,22,8,0.7333333333333333,20,16,4,0.8,0.7652173913043478,llama3,mimiciii,radiology_report,PROMPT1_ICL_entailment
211,29,16,8,8,0.5,8,5,3,0.625,0.5555555555555556,llama3,mimiciii,radiology_report,PROMPT1_ICL_entailment
212,290,19,11,8,0.5789473684210527,11,7,4,0.6363636363636364,0.6062992125984253,llama3,mimiciii,radiology_report,PROMPT1_ICL_entailment
213,291,26,15,11,0.5769230769230769,23,14,9,0.6086956521739131,0.5923836389280677,llama3,mimiciii,radiology_report,PROMPT1_ICL_entailment
214,292,24,15,9,0.625,21,14,7,0.6666666666666666,0.6451612903225806,llama3,mimiciii,radiology_report,PROMPT1_ICL_entailment
215,293,19,11,8,0.5789473684210527,18,12,6,0.6666666666666666,0.619718309859155,llama3,mimiciii,radiology_report,PROMPT1_ICL_entailment
216,294,25,16,9,0.64,22,15,7,0.6818181818181818,0.6602475928473177,llama3,mimiciii,radiology_report,PROMPT1_ICL_entailment
217,295,20,9,11,0.45,32,17,15,0.53125,0.4872611464968153,llama3,mimiciii,radiology_report,PROMPT1_ICL_entailment
218,296,21,10,11,0.4761904761904761,17,9,8,0.5294117647058824,0.5013927576601671,llama3,mimiciii,radiology_report,PROMPT1_ICL_entailment
219,297,23,16,7,0.6956521739130435,24,21,3,0.875,0.7750865051903115,llama3,mimiciii,radiology_report,PROMPT1_ICL_entailment
220,298,19,12,7,0.631578947368421,20,12,8,0.6,0.6153846153846154,llama3,mimiciii,radiology_report,PROMPT1_ICL_entailment
221,299,26,21,5,0.8076923076923077,28,22,6,0.7857142857142857,0.796551724137931,llama3,mimiciii,radiology_report,PROMPT1_ICL_entailment
222,3,21,13,8,0.6190476190476191,20,12,8,0.6,0.609375,llama3,mimiciii,radiology_report,PROMPT1_ICL_entailment
223,30,21,13,8,0.6190476190476191,21,13,8,0.6190476190476191,0.6190476190476191,llama3,mimiciii,radiology_report,PROMPT1_ICL_entailment
224,300,19,11,8,0.5789473684210527,13,7,6,0.5384615384615384,0.5579710144927537,llama3,mimiciii,radiology_report,PROMPT1_ICL_entailment
225,301,16,8,8,0.5,16,10,6,0.625,0.5555555555555556,llama3,mimiciii,radiology_report,PROMPT1_ICL_entailment
226,302,18,11,7,0.6111111111111112,15,10,5,0.6666666666666666,0.6376811594202899,llama3,mimiciii,radiology_report,PROMPT1_ICL_entailment
227,303,24,14,10,0.5833333333333334,24,16,8,0.6666666666666666,0.6222222222222222,llama3,mimiciii,radiology_report,PROMPT1_ICL_entailment
228,304,22,13,9,0.5909090909090909,19,12,7,0.631578947368421,0.6105675146771037,llama3,mimiciii,radiology_report,PROMPT1_ICL_entailment
229,305,17,16,1,0.9411764705882352,24,16,8,0.6666666666666666,0.7804878048780487,llama3,mimiciii,radiology_report,PROMPT1_ICL_entailment
230,306,20,10,10,0.5,14,10,4,0.7142857142857143,0.588235294117647,llama3,mimiciii,radiology_report,PROMPT1_ICL_entailment
231,307,21,13,8,0.6190476190476191,17,10,7,0.5882352941176471,0.6032482598607889,llama3,mimiciii,radiology_report,PROMPT1_ICL_entailment
232,308,22,14,8,0.6363636363636364,15,8,7,0.5333333333333333,0.5803108808290155,llama3,mimiciii,radiology_report,PROMPT1_ICL_entailment
233,309,23,13,10,0.5652173913043478,26,14,12,0.5384615384615384,0.5515151515151515,llama3,mimiciii,radiology_report,PROMPT1_ICL_entailment
234,31,21,10,11,0.4761904761904761,19,8,11,0.4210526315789473,0.4469273743016759,llama3,mimiciii,radiology_report,PROMPT1_ICL_entailment
235,310,20,12,8,0.6,24,12,12,0.5,0.5454545454545454,llama3,mimiciii,radiology_report,PROMPT1_ICL_entailment
236,311,17,10,7,0.5882352941176471,15,8,7,0.5333333333333333,0.5594405594405595,llama3,mimiciii,radiology_report,PROMPT1_ICL_entailment
237,312,24,15,9,0.625,18,12,6,0.6666666666666666,0.6451612903225806,llama3,mimiciii,radiology_report,PROMPT1_ICL_entailment
238,313,21,14,7,0.6666666666666666,17,13,4,0.7647058823529411,0.7123287671232877,llama3,mimiciii,radiology_report,PROMPT1_ICL_entailment
239,314,20,10,10,0.5,15,9,6,0.6,0.5454545454545454,llama3,mimiciii,radiology_report,PROMPT1_ICL_entailment
240,315,28,19,9,0.6785714285714286,25,19,6,0.76,0.7169811320754718,llama3,mimiciii,radiology_report,PROMPT1_ICL_entailment
241,316,16,8,8,0.5,10,6,4,0.6,0.5454545454545454,llama3,mimiciii,radiology_report,PROMPT1_ICL_entailment
242,317,24,12,12,0.5,26,19,7,0.7307692307692307,0.5937499999999999,llama3,mimiciii,radiology_report,PROMPT1_ICL_entailment
243,318,20,12,8,0.6,21,10,11,0.4761904761904761,0.5309734513274337,llama3,mimiciii,radiology_report,PROMPT1_ICL_entailment
244,319,22,18,4,0.8181818181818182,12,9,3,0.75,0.7826086956521738,llama3,mimiciii,radiology_report,PROMPT1_ICL_entailment
245,32,18,10,8,0.5555555555555556,15,6,9,0.4,0.4651162790697674,llama3,mimiciii,radiology_report,PROMPT1_ICL_entailment
246,320,14,6,8,0.4285714285714285,11,7,4,0.6363636363636364,0.5121951219512195,llama3,mimiciii,radiology_report,PROMPT1_ICL_entailment
247,321,24,15,9,0.625,21,16,5,0.7619047619047619,0.6866952789699571,llama3,mimiciii,radiology_report,PROMPT1_ICL_entailment
248,322,15,8,7,0.5333333333333333,8,7,1,0.875,0.6627218934911243,llama3,mimiciii,radiology_report,PROMPT1_ICL_entailment
249,323,21,13,8,0.6190476190476191,25,14,11,0.56,0.5880452342487884,llama3,mimiciii,radiology_report,PROMPT1_ICL_entailment
250,324,25,17,8,0.68,18,12,6,0.6666666666666666,0.6732673267326733,llama3,mimiciii,radiology_report,PROMPT1_ICL_entailment
251,325,26,16,10,0.6153846153846154,22,14,8,0.6363636363636364,0.6256983240223464,llama3,mimiciii,radiology_report,PROMPT1_ICL_entailment
252,326,23,13,10,0.5652173913043478,23,17,6,0.7391304347826086,0.6405797101449274,llama3,mimiciii,radiology_report,PROMPT1_ICL_entailment
253,327,15,7,8,0.4666666666666667,9,6,3,0.6666666666666666,0.5490196078431373,llama3,mimiciii,radiology_report,PROMPT1_ICL_entailment
254,328,20,12,8,0.6,17,13,4,0.7647058823529411,0.6724137931034482,llama3,mimiciii,radiology_report,PROMPT1_ICL_entailment
255,329,21,11,10,0.5238095238095238,24,10,14,0.4166666666666667,0.4641350210970464,llama3,mimiciii,radiology_report,PROMPT1_ICL_entailment
256,33,16,13,3,0.8125,9,7,2,0.7777777777777778,0.7947598253275109,llama3,mimiciii,radiology_report,PROMPT1_ICL_entailment
257,330,21,10,11,0.4761904761904761,11,7,4,0.6363636363636364,0.5447470817120622,llama3,mimiciii,radiology_report,PROMPT1_ICL_entailment
258,331,19,12,7,0.631578947368421,15,11,4,0.7333333333333333,0.6786632390745502,llama3,mimiciii,radiology_report,PROMPT1_ICL_entailment
259,332,19,18,1,0.9473684210526316,20,18,2,0.9,0.9230769230769232,llama3,mimiciii,radiology_report,PROMPT1_ICL_entailment
260,333,16,7,9,0.4375,13,8,5,0.6153846153846154,0.5114155251141553,llama3,mimiciii,radiology_report,PROMPT1_ICL_entailment
261,334,25,15,10,0.6,20,15,5,0.75,0.6666666666666665,llama3,mimiciii,radiology_report,PROMPT1_ICL_entailment
262,335,21,13,8,0.6190476190476191,17,11,6,0.6470588235294118,0.6327433628318585,llama3,mimiciii,radiology_report,PROMPT1_ICL_entailment
263,336,22,14,8,0.6363636363636364,16,13,3,0.8125,0.7137254901960786,llama3,mimiciii,radiology_report,PROMPT1_ICL_entailment
264,337,22,14,8,0.6363636363636364,16,15,1,0.9375,0.7581227436823105,llama3,mimiciii,radiology_report,PROMPT1_ICL_entailment
265,338,18,9,9,0.5,13,7,6,0.5384615384615384,0.5185185185185186,llama3,mimiciii,radiology_report,PROMPT1_ICL_entailment
266,339,18,14,4,0.7777777777777778,28,22,6,0.7857142857142857,0.7817258883248731,llama3,mimiciii,radiology_report,PROMPT1_ICL_entailment
267,34,21,14,7,0.6666666666666666,14,11,3,0.7857142857142857,0.721311475409836,llama3,mimiciii,radiology_report,PROMPT1_ICL_entailment
268,340,30,16,14,0.5333333333333333,15,11,4,0.7333333333333333,0.6175438596491227,llama3,mimiciii,radiology_report,PROMPT1_ICL_entailment
269,341,13,5,8,0.3846153846153846,6,4,2,0.6666666666666666,0.4878048780487804,llama3,mimiciii,radiology_report,PROMPT1_ICL_entailment
270,342,19,12,7,0.631578947368421,15,11,4,0.7333333333333333,0.6786632390745502,llama3,mimiciii,radiology_report,PROMPT1_ICL_entailment
271,343,24,16,8,0.6666666666666666,22,20,2,0.9090909090909092,0.7692307692307692,llama3,mimiciii,radiology_report,PROMPT1_ICL_entailment
272,344,23,15,8,0.6521739130434783,19,12,7,0.631578947368421,0.6417112299465241,llama3,mimiciii,radiology_report,PROMPT1_ICL_entailment
273,345,28,19,9,0.6785714285714286,22,16,6,0.7272727272727273,0.7020785219399539,llama3,mimiciii,radiology_report,PROMPT1_ICL_entailment
274,346,21,14,7,0.6666666666666666,15,9,6,0.6,0.631578947368421,llama3,mimiciii,radiology_report,PROMPT1_ICL_entailment
275,347,24,19,5,0.7916666666666666,15,12,3,0.8,0.7958115183246073,llama3,mimiciii,radiology_report,PROMPT1_ICL_entailment
276,348,18,9,9,0.5,12,9,3,0.75,0.6,llama3,mimiciii,radiology_report,PROMPT1_ICL_entailment
277,349,22,10,12,0.4545454545454545,16,8,8,0.5,0.4761904761904761,llama3,mimiciii,radiology_report,PROMPT1_ICL_entailment
278,35,19,14,5,0.7368421052631579,21,11,10,0.5238095238095238,0.6123260437375745,llama3,mimiciii,radiology_report,PROMPT1_ICL_entailment
279,350,23,13,10,0.5652173913043478,21,14,7,0.6666666666666666,0.6117647058823529,llama3,mimiciii,radiology_report,PROMPT1_ICL_entailment
280,351,21,15,6,0.7142857142857143,21,18,3,0.8571428571428571,0.7792207792207793,llama3,mimiciii,radiology_report,PROMPT1_ICL_entailment
281,352,18,10,8,0.5555555555555556,22,10,12,0.4545454545454545,0.5,llama3,mimiciii,radiology_report,PROMPT1_ICL_entailment
282,353,17,8,9,0.4705882352941176,23,8,15,0.3478260869565217,0.3999999999999999,llama3,mimiciii,radiology_report,PROMPT1_ICL_entailment
283,354,29,14,15,0.4827586206896552,26,22,4,0.8461538461538461,0.6147704590818364,llama3,mimiciii,radiology_report,PROMPT1_ICL_entailment
284,355,20,12,8,0.6,18,14,4,0.7777777777777778,0.6774193548387097,llama3,mimiciii,radiology_report,PROMPT1_ICL_entailment
285,356,24,15,9,0.625,22,19,3,0.8636363636363636,0.7251908396946565,llama3,mimiciii,radiology_report,PROMPT1_ICL_entailment
286,357,18,11,7,0.6111111111111112,15,8,7,0.5333333333333333,0.5695792880258901,llama3,mimiciii,radiology_report,PROMPT1_ICL_entailment
287,358,22,15,7,0.6818181818181818,12,6,6,0.5,0.576923076923077,llama3,mimiciii,radiology_report,PROMPT1_ICL_entailment
288,359,17,8,9,0.4705882352941176,18,10,8,0.5555555555555556,0.5095541401273886,llama3,mimiciii,radiology_report,PROMPT1_ICL_entailment
289,36,23,14,9,0.6086956521739131,22,11,11,0.5,0.5490196078431373,llama3,mimiciii,radiology_report,PROMPT1_ICL_entailment
290,360,23,14,9,0.6086956521739131,15,9,6,0.6,0.6043165467625898,llama3,mimiciii,radiology_report,PROMPT1_ICL_entailment
291,361,14,9,5,0.6428571428571429,23,17,6,0.7391304347826086,0.6876404494382022,llama3,mimiciii,radiology_report,PROMPT1_ICL_entailment
292,362,24,15,9,0.625,24,15,9,0.625,0.625,llama3,mimiciii,radiology_report,PROMPT1_ICL_entailment
293,363,26,17,9,0.6538461538461539,22,17,5,0.7727272727272727,0.7083333333333333,llama3,mimiciii,radiology_report,PROMPT1_ICL_entailment
294,364,13,4,9,0.3076923076923077,11,8,3,0.7272727272727273,0.4324324324324324,llama3,mimiciii,radiology_report,PROMPT1_ICL_entailment
295,365,29,17,12,0.5862068965517241,29,18,11,0.6206896551724138,0.6029556650246306,llama3,mimiciii,radiology_report,PROMPT1_ICL_entailment
296,366,20,13,7,0.65,13,7,6,0.5384615384615384,0.5889967637540453,llama3,mimiciii,radiology_report,PROMPT1_ICL_entailment
297,367,19,12,7,0.631578947368421,16,9,7,0.5625,0.5950413223140496,llama3,mimiciii,radiology_report,PROMPT1_ICL_entailment
298,368,23,12,11,0.5217391304347826,20,11,9,0.55,0.5354969574036512,llama3,mimiciii,radiology_report,PROMPT1_ICL_entailment
299,369,22,14,8,0.6363636363636364,20,17,3,0.85,0.72782874617737,llama3,mimiciii,radiology_report,PROMPT1_ICL_entailment
300,37,21,13,8,0.6190476190476191,21,11,10,0.5238095238095238,0.5674603174603176,llama3,mimiciii,radiology_report,PROMPT1_ICL_entailment
301,370,21,12,9,0.5714285714285714,19,11,8,0.5789473684210527,0.5751633986928104,llama3,mimiciii,radiology_report,PROMPT1_ICL_entailment
302,371,19,11,8,0.5789473684210527,17,11,6,0.6470588235294118,0.6111111111111113,llama3,mimiciii,radiology_report,PROMPT1_ICL_entailment
303,372,17,9,8,0.5294117647058824,27,15,12,0.5555555555555556,0.5421686746987951,llama3,mimiciii,radiology_report,PROMPT1_ICL_entailment
304,373,27,18,9,0.6666666666666666,23,19,4,0.8260869565217391,0.7378640776699029,llama3,mimiciii,radiology_report,PROMPT1_ICL_entailment
305,374,18,11,7,0.6111111111111112,11,7,4,0.6363636363636364,0.6234817813765182,llama3,mimiciii,radiology_report,PROMPT1_ICL_entailment
306,375,20,12,8,0.6,16,8,8,0.5,0.5454545454545454,llama3,mimiciii,radiology_report,PROMPT1_ICL_entailment
307,376,17,14,3,0.8235294117647058,18,16,2,0.8888888888888888,0.8549618320610687,llama3,mimiciii,radiology_report,PROMPT1_ICL_entailment
308,377,19,13,6,0.6842105263157895,10,7,3,0.7,0.6920152091254752,llama3,mimiciii,radiology_report,PROMPT1_ICL_entailment
309,378,24,15,9,0.625,24,19,5,0.7916666666666666,0.698529411764706,llama3,mimiciii,radiology_report,PROMPT1_ICL_entailment
310,379,24,16,8,0.6666666666666666,18,14,4,0.7777777777777778,0.717948717948718,llama3,mimiciii,radiology_report,PROMPT1_ICL_entailment
311,38,22,14,8,0.6363636363636364,19,15,4,0.7894736842105263,0.7046979865771811,llama3,mimiciii,radiology_report,PROMPT1_ICL_entailment
312,380,15,7,8,0.4666666666666667,8,7,1,0.875,0.608695652173913,llama3,mimiciii,radiology_report,PROMPT1_ICL_entailment
313,381,17,10,7,0.5882352941176471,14,7,7,0.5,0.5405405405405405,llama3,mimiciii,radiology_report,PROMPT1_ICL_entailment
314,382,19,9,10,0.4736842105263157,13,7,6,0.5384615384615384,0.5039999999999999,llama3,mimiciii,radiology_report,PROMPT1_ICL_entailment
315,383,25,18,7,0.72,17,15,2,0.8823529411764706,0.7929515418502202,llama3,mimiciii,radiology_report,PROMPT1_ICL_entailment
316,384,18,10,8,0.5555555555555556,13,10,3,0.7692307692307693,0.6451612903225806,llama3,mimiciii,radiology_report,PROMPT1_ICL_entailment
317,385,24,14,10,0.5833333333333334,27,18,9,0.6666666666666666,0.6222222222222222,llama3,mimiciii,radiology_report,PROMPT1_ICL_entailment
318,386,18,10,8,0.5555555555555556,18,13,5,0.7222222222222222,0.6280193236714976,llama3,mimiciii,radiology_report,PROMPT1_ICL_entailment
319,387,19,11,8,0.5789473684210527,19,13,6,0.6842105263157895,0.6271929824561404,llama3,mimiciii,radiology_report,PROMPT1_ICL_entailment
320,388,24,13,11,0.5416666666666666,33,29,4,0.8787878787878788,0.6702222222222222,llama3,mimiciii,radiology_report,PROMPT1_ICL_entailment
321,389,20,12,8,0.6,12,9,3,0.75,0.6666666666666665,llama3,mimiciii,radiology_report,PROMPT1_ICL_entailment
322,39,18,9,9,0.5,10,7,3,0.7,0.5833333333333334,llama3,mimiciii,radiology_report,PROMPT1_ICL_entailment
323,390,14,6,8,0.4285714285714285,14,5,9,0.3571428571428571,0.3896103896103896,llama3,mimiciii,radiology_report,PROMPT1_ICL_entailment
324,391,19,11,8,0.5789473684210527,13,6,7,0.4615384615384615,0.5136186770428015,llama3,mimiciii,radiology_report,PROMPT1_ICL_entailment
325,392,19,11,8,0.5789473684210527,15,8,7,0.5333333333333333,0.5552050473186121,llama3,mimiciii,radiology_report,PROMPT1_ICL_entailment
326,393,22,14,8,0.6363636363636364,19,8,11,0.4210526315789473,0.5067873303167421,llama3,mimiciii,radiology_report,PROMPT1_ICL_entailment
327,394,16,16,0,1.0,18,17,1,0.9444444444444444,0.9714285714285714,llama3,mimiciii,radiology_report,PROMPT1_ICL_entailment
328,395,18,10,8,0.5555555555555556,16,10,6,0.625,0.5882352941176471,llama3,mimiciii,radiology_report,PROMPT1_ICL_entailment
329,396,17,7,10,0.4117647058823529,19,9,10,0.4736842105263157,0.4405594405594405,llama3,mimiciii,radiology_report,PROMPT1_ICL_entailment
330,397,21,13,8,0.6190476190476191,18,9,9,0.5,0.5531914893617021,llama3,mimiciii,radiology_report,PROMPT1_ICL_entailment
331,398,29,20,9,0.6896551724137931,21,16,5,0.7619047619047619,0.7239819004524887,llama3,mimiciii,radiology_report,PROMPT1_ICL_entailment
332,399,22,13,9,0.5909090909090909,19,13,6,0.6842105263157895,0.6341463414634148,llama3,mimiciii,radiology_report,PROMPT1_ICL_entailment
333,4,21,13,8,0.6190476190476191,16,11,5,0.6875,0.6514806378132119,llama3,mimiciii,radiology_report,PROMPT1_ICL_entailment
334,40,20,12,8,0.6,17,9,8,0.5294117647058824,0.5625,llama3,mimiciii,radiology_report,PROMPT1_ICL_entailment
335,400,16,8,8,0.5,13,5,8,0.3846153846153846,0.4347826086956522,llama3,mimiciii,radiology_report,PROMPT1_ICL_entailment
336,401,15,7,8,0.4666666666666667,9,5,4,0.5555555555555556,0.5072463768115943,llama3,mimiciii,radiology_report,PROMPT1_ICL_entailment
337,402,17,15,2,0.8823529411764706,20,17,3,0.85,0.865874363327674,llama3,mimiciii,radiology_report,PROMPT1_ICL_entailment
338,403,17,9,8,0.5294117647058824,18,8,10,0.4444444444444444,0.4832214765100671,llama3,mimiciii,radiology_report,PROMPT1_ICL_entailment
339,404,18,18,0,1.0,19,16,3,0.8421052631578947,0.9142857142857144,llama3,mimiciii,radiology_report,PROMPT1_ICL_entailment
340,405,25,19,6,0.76,14,10,4,0.7142857142857143,0.7364341085271319,llama3,mimiciii,radiology_report,PROMPT1_ICL_entailment
341,406,22,21,1,0.9545454545454546,25,21,4,0.84,0.8936170212765958,llama3,mimiciii,radiology_report,PROMPT1_ICL_entailment
342,407,33,25,8,0.7575757575757576,20,14,6,0.7,0.7276507276507277,llama3,mimiciii,radiology_report,PROMPT1_ICL_entailment
343,408,20,12,8,0.6,20,14,6,0.7,0.6461538461538462,llama3,mimiciii,radiology_report,PROMPT1_ICL_entailment
344,409,25,18,7,0.72,18,15,3,0.8333333333333334,0.7725321888412018,llama3,mimiciii,radiology_report,PROMPT1_ICL_entailment
345,41,23,13,10,0.5652173913043478,26,20,6,0.7692307692307693,0.6516290726817042,llama3,mimiciii,radiology_report,PROMPT1_ICL_entailment
346,410,25,17,8,0.68,20,13,7,0.65,0.6646616541353384,llama3,mimiciii,radiology_report,PROMPT1_ICL_entailment
347,411,13,6,7,0.4615384615384615,6,3,3,0.5,0.48,llama3,mimiciii,radiology_report,PROMPT1_ICL_entailment
348,412,24,16,8,0.6666666666666666,26,21,5,0.8076923076923077,0.7304347826086955,llama3,mimiciii,radiology_report,PROMPT1_ICL_entailment
349,413,19,12,7,0.631578947368421,14,7,7,0.5,0.5581395348837209,llama3,mimiciii,radiology_report,PROMPT1_ICL_entailment
350,414,24,14,10,0.5833333333333334,28,18,10,0.6428571428571429,0.6116504854368933,llama3,mimiciii,radiology_report,PROMPT1_ICL_entailment
351,415,21,12,9,0.5714285714285714,20,15,5,0.75,0.6486486486486486,llama3,mimiciii,radiology_report,PROMPT1_ICL_entailment
352,416,22,18,4,0.8181818181818182,17,11,6,0.6470588235294118,0.7226277372262774,llama3,mimiciii,radiology_report,PROMPT1_ICL_entailment
353,417,27,19,8,0.7037037037037037,20,17,3,0.85,0.769964243146603,llama3,mimiciii,radiology_report,PROMPT1_ICL_entailment
354,418,20,14,6,0.7,14,10,4,0.7142857142857143,0.7070707070707072,llama3,mimiciii,radiology_report,PROMPT1_ICL_entailment
355,419,23,14,9,0.6086956521739131,16,13,3,0.8125,0.6959847036328872,llama3,mimiciii,radiology_report,PROMPT1_ICL_entailment
356,42,20,12,8,0.6,14,11,3,0.7857142857142857,0.6804123711340206,llama3,mimiciii,radiology_report,PROMPT1_ICL_entailment
357,420,21,13,8,0.6190476190476191,15,8,7,0.5333333333333333,0.5730027548209367,llama3,mimiciii,radiology_report,PROMPT1_ICL_entailment
358,421,25,16,9,0.64,23,19,4,0.8260869565217391,0.7212336892052194,llama3,mimiciii,radiology_report,PROMPT1_ICL_entailment
359,422,19,10,9,0.5263157894736842,20,15,5,0.75,0.6185567010309279,llama3,mimiciii,radiology_report,PROMPT1_ICL_entailment
360,423,17,9,8,0.5294117647058824,12,8,4,0.6666666666666666,0.5901639344262295,llama3,mimiciii,radiology_report,PROMPT1_ICL_entailment
361,424,16,6,10,0.375,9,4,5,0.4444444444444444,0.4067796610169491,llama3,mimiciii,radiology_report,PROMPT1_ICL_entailment
362,425,25,16,9,0.64,19,14,5,0.7368421052631579,0.6850152905198776,llama3,mimiciii,radiology_report,PROMPT1_ICL_entailment
363,426,20,14,6,0.7,16,8,8,0.5,0.5833333333333334,llama3,mimiciii,radiology_report,PROMPT1_ICL_entailment
364,427,18,12,6,0.6666666666666666,15,7,8,0.4666666666666667,0.5490196078431373,llama3,mimiciii,radiology_report,PROMPT1_ICL_entailment
365,428,17,10,7,0.5882352941176471,15,9,6,0.6,0.5940594059405941,llama3,mimiciii,radiology_report,PROMPT1_ICL_entailment
366,429,21,12,9,0.5714285714285714,13,10,3,0.7692307692307693,0.6557377049180327,llama3,mimiciii,radiology_report,PROMPT1_ICL_entailment
367,43,15,9,6,0.6,7,4,3,0.5714285714285714,0.5853658536585366,llama3,mimiciii,radiology_report,PROMPT1_ICL_entailment
368,430,14,6,8,0.4285714285714285,7,5,2,0.7142857142857143,0.5357142857142858,llama3,mimiciii,radiology_report,PROMPT1_ICL_entailment
369,431,17,6,11,0.3529411764705882,18,10,8,0.5555555555555556,0.4316546762589928,llama3,mimiciii,radiology_report,PROMPT1_ICL_entailment
370,432,25,17,8,0.68,13,10,3,0.7692307692307693,0.721868365180467,llama3,mimiciii,radiology_report,PROMPT1_ICL_entailment
371,433,17,8,9,0.4705882352941176,18,12,6,0.6666666666666666,0.5517241379310345,llama3,mimiciii,radiology_report,PROMPT1_ICL_entailment
372,434,23,12,11,0.5217391304347826,27,17,10,0.6296296296296297,0.5706293706293707,llama3,mimiciii,radiology_report,PROMPT1_ICL_entailment
373,435,18,12,6,0.6666666666666666,13,9,4,0.6923076923076923,0.6792452830188679,llama3,mimiciii,radiology_report,PROMPT1_ICL_entailment
374,436,27,19,8,0.7037037037037037,25,22,3,0.88,0.7820392890551918,llama3,mimiciii,radiology_report,PROMPT1_ICL_entailment
375,437,15,6,9,0.4,7,5,2,0.7142857142857143,0.5128205128205129,llama3,mimiciii,radiology_report,PROMPT1_ICL_entailment
376,438,18,9,9,0.5,19,11,8,0.5789473684210527,0.5365853658536586,llama3,mimiciii,radiology_report,PROMPT1_ICL_entailment
377,439,24,13,11,0.5416666666666666,22,16,6,0.7272727272727273,0.6208955223880597,llama3,mimiciii,radiology_report,PROMPT1_ICL_entailment
378,44,17,10,7,0.5882352941176471,16,7,9,0.4375,0.5017921146953405,llama3,mimiciii,radiology_report,PROMPT1_ICL_entailment
379,440,20,11,9,0.55,19,11,8,0.5789473684210527,0.5641025641025641,llama3,mimiciii,radiology_report,PROMPT1_ICL_entailment
380,441,24,15,9,0.625,17,14,3,0.8235294117647058,0.7106598984771573,llama3,mimiciii,radiology_report,PROMPT1_ICL_entailment
381,442,19,11,8,0.5789473684210527,12,7,5,0.5833333333333334,0.5811320754716981,llama3,mimiciii,radiology_report,PROMPT1_ICL_entailment
382,443,20,11,9,0.55,21,15,6,0.7142857142857143,0.6214689265536724,llama3,mimiciii,radiology_report,PROMPT1_ICL_entailment
383,444,16,9,7,0.5625,8,3,5,0.375,0.45,llama3,mimiciii,radiology_report,PROMPT1_ICL_entailment
384,445,21,13,8,0.6190476190476191,22,16,6,0.7272727272727273,0.6688102893890675,llama3,mimiciii,radiology_report,PROMPT1_ICL_entailment
385,446,27,18,9,0.6666666666666666,22,14,8,0.6363636363636364,0.6511627906976744,llama3,mimiciii,radiology_report,PROMPT1_ICL_entailment
386,447,20,13,7,0.65,14,9,5,0.6428571428571429,0.6464088397790057,llama3,mimiciii,radiology_report,PROMPT1_ICL_entailment
387,448,25,16,9,0.64,36,22,14,0.6111111111111112,0.625222024866785,llama3,mimiciii,radiology_report,PROMPT1_ICL_entailment
388,449,15,6,9,0.4,9,5,4,0.5555555555555556,0.4651162790697674,llama3,mimiciii,radiology_report,PROMPT1_ICL_entailment
389,45,21,13,8,0.6190476190476191,20,10,10,0.5,0.5531914893617021,llama3,mimiciii,radiology_report,PROMPT1_ICL_entailment
390,450,21,14,7,0.6666666666666666,21,14,7,0.6666666666666666,0.6666666666666666,llama3,mimiciii,radiology_report,PROMPT1_ICL_entailment
391,451,18,12,6,0.6666666666666666,10,8,2,0.8,0.7272727272727272,llama3,mimiciii,radiology_report,PROMPT1_ICL_entailment
392,452,25,17,8,0.68,16,13,3,0.8125,0.7403685092127302,llama3,mimiciii,radiology_report,PROMPT1_ICL_entailment
393,453,19,12,7,0.631578947368421,14,10,4,0.7142857142857143,0.670391061452514,llama3,mimiciii,radiology_report,PROMPT1_ICL_entailment
394,454,15,8,7,0.5333333333333333,10,4,6,0.4,0.4571428571428572,llama3,mimiciii,radiology_report,PROMPT1_ICL_entailment
395,455,23,16,7,0.6956521739130435,16,12,4,0.75,0.7218045112781954,llama3,mimiciii,radiology_report,PROMPT1_ICL_entailment
396,456,21,12,9,0.5714285714285714,21,18,3,0.8571428571428571,0.6857142857142857,llama3,mimiciii,radiology_report,PROMPT1_ICL_entailment
397,457,15,8,7,0.5333333333333333,12,8,4,0.6666666666666666,0.5925925925925926,llama3,mimiciii,radiology_report,PROMPT1_ICL_entailment
398,458,20,13,7,0.65,16,8,8,0.5,0.5652173913043479,llama3,mimiciii,radiology_report,PROMPT1_ICL_entailment
399,459,18,10,8,0.5555555555555556,13,9,4,0.6923076923076923,0.6164383561643836,llama3,mimiciii,radiology_report,PROMPT1_ICL_entailment
400,46,18,9,9,0.5,22,16,6,0.7272727272727273,0.5925925925925926,llama3,mimiciii,radiology_report,PROMPT1_ICL_entailment
401,460,26,17,9,0.6538461538461539,20,16,4,0.8,0.7195767195767195,llama3,mimiciii,radiology_report,PROMPT1_ICL_entailment
402,461,25,16,9,0.64,22,14,8,0.6363636363636364,0.6381766381766382,llama3,mimiciii,radiology_report,PROMPT1_ICL_entailment
403,462,26,20,6,0.7692307692307693,20,14,6,0.7,0.7329842931937172,llama3,mimiciii,radiology_report,PROMPT1_ICL_entailment
404,463,15,7,8,0.4666666666666667,12,6,6,0.5,0.4827586206896552,llama3,mimiciii,radiology_report,PROMPT1_ICL_entailment
405,464,31,19,12,0.6129032258064516,25,16,9,0.64,0.6261585993820803,llama3,mimiciii,radiology_report,PROMPT1_ICL_entailment
406,465,28,19,9,0.6785714285714286,33,24,9,0.7272727272727273,0.7020785219399539,llama3,mimiciii,radiology_report,PROMPT1_ICL_entailment
407,466,17,8,9,0.4705882352941176,22,10,12,0.4545454545454545,0.4624277456647399,llama3,mimiciii,radiology_report,PROMPT1_ICL_entailment
408,467,19,10,9,0.5263157894736842,14,10,4,0.7142857142857143,0.6060606060606061,llama3,mimiciii,radiology_report,PROMPT1_ICL_entailment
409,468,17,16,1,0.9411764705882352,18,13,5,0.7222222222222222,0.8172888015717094,llama3,mimiciii,radiology_report,PROMPT1_ICL_entailment
410,469,30,19,11,0.6333333333333333,25,17,8,0.68,0.6558375634517767,llama3,mimiciii,radiology_report,PROMPT1_ICL_entailment
411,47,18,11,7,0.6111111111111112,15,9,6,0.6,0.6055045871559633,llama3,mimiciii,radiology_report,PROMPT1_ICL_entailment
412,470,19,11,8,0.5789473684210527,15,10,5,0.6666666666666666,0.619718309859155,llama3,mimiciii,radiology_report,PROMPT1_ICL_entailment
413,471,27,19,8,0.7037037037037037,18,13,5,0.7222222222222222,0.7128427128427127,llama3,mimiciii,radiology_report,PROMPT1_ICL_entailment
414,472,24,15,9,0.625,16,10,6,0.625,0.625,llama3,mimiciii,radiology_report,PROMPT1_ICL_entailment
415,473,18,15,3,0.8333333333333334,11,9,2,0.8181818181818182,0.8256880733944955,llama3,mimiciii,radiology_report,PROMPT1_ICL_entailment
416,474,26,17,9,0.6538461538461539,25,19,6,0.76,0.7029379760609357,llama3,mimiciii,radiology_report,PROMPT1_ICL_entailment
417,475,15,7,8,0.4666666666666667,7,3,4,0.4285714285714285,0.4468085106382978,llama3,mimiciii,radiology_report,PROMPT1_ICL_entailment
418,476,22,14,8,0.6363636363636364,12,8,4,0.6666666666666666,0.6511627906976744,llama3,mimiciii,radiology_report,PROMPT1_ICL_entailment
419,477,25,13,12,0.52,16,12,4,0.75,0.6141732283464567,llama3,mimiciii,radiology_report,PROMPT1_ICL_entailment
420,478,26,17,9,0.6538461538461539,21,16,5,0.7619047619047619,0.703751617076326,llama3,mimiciii,radiology_report,PROMPT1_ICL_entailment
421,479,22,12,10,0.5454545454545454,22,14,8,0.6363636363636364,0.5874125874125874,llama3,mimiciii,radiology_report,PROMPT1_ICL_entailment
422,48,22,17,5,0.7727272727272727,21,15,6,0.7142857142857143,0.7423580786026202,llama3,mimiciii,radiology_report,PROMPT1_ICL_entailment
423,480,17,14,3,0.8235294117647058,10,5,5,0.5,0.6222222222222222,llama3,mimiciii,radiology_report,PROMPT1_ICL_entailment
424,481,25,16,9,0.64,17,13,4,0.7647058823529411,0.6968174204355108,llama3,mimiciii,radiology_report,PROMPT1_ICL_entailment
425,482,16,12,4,0.75,19,16,3,0.8421052631578947,0.7933884297520661,llama3,mimiciii,radiology_report,PROMPT1_ICL_entailment
426,483,22,15,7,0.6818181818181818,23,14,9,0.6086956521739131,0.6431852986217458,llama3,mimiciii,radiology_report,PROMPT1_ICL_entailment
427,484,15,7,8,0.4666666666666667,13,7,6,0.5384615384615384,0.5,llama3,mimiciii,radiology_report,PROMPT1_ICL_entailment
428,485,25,17,8,0.68,24,19,5,0.7916666666666666,0.7315968289920725,llama3,mimiciii,radiology_report,PROMPT1_ICL_entailment
429,486,21,15,6,0.7142857142857143,11,6,5,0.5454545454545454,0.6185567010309277,llama3,mimiciii,radiology_report,PROMPT1_ICL_entailment
430,487,19,13,6,0.6842105263157895,20,11,9,0.55,0.6098081023454158,llama3,mimiciii,radiology_report,PROMPT1_ICL_entailment
431,488,15,7,8,0.4666666666666667,15,9,6,0.6,0.5249999999999999,llama3,mimiciii,radiology_report,PROMPT1_ICL_entailment
432,489,25,18,7,0.72,18,13,5,0.7222222222222222,0.7211093990755009,llama3,mimiciii,radiology_report,PROMPT1_ICL_entailment
433,49,21,16,5,0.7619047619047619,24,16,8,0.6666666666666666,0.7111111111111111,llama3,mimiciii,radiology_report,PROMPT1_ICL_entailment
434,490,14,7,7,0.5,8,4,4,0.5,0.5,llama3,mimiciii,radiology_report,PROMPT1_ICL_entailment
435,491,20,12,8,0.6,17,7,10,0.4117647058823529,0.4883720930232558,llama3,mimiciii,radiology_report,PROMPT1_ICL_entailment
436,492,18,10,8,0.5555555555555556,13,5,8,0.3846153846153846,0.4545454545454546,llama3,mimiciii,radiology_report,PROMPT1_ICL_entailment
437,493,18,10,8,0.5555555555555556,9,6,3,0.6666666666666666,0.606060606060606,llama3,mimiciii,radiology_report,PROMPT1_ICL_entailment
438,494,17,7,10,0.4117647058823529,8,5,3,0.625,0.4964539007092198,llama3,mimiciii,radiology_report,PROMPT1_ICL_entailment
439,495,16,9,7,0.5625,12,8,4,0.6666666666666666,0.6101694915254238,llama3,mimiciii,radiology_report,PROMPT1_ICL_entailment
440,496,28,21,7,0.75,32,19,13,0.59375,0.6627906976744186,llama3,mimiciii,radiology_report,PROMPT1_ICL_entailment
441,497,19,10,9,0.5263157894736842,22,12,10,0.5454545454545454,0.5357142857142857,llama3,mimiciii,radiology_report,PROMPT1_ICL_entailment
442,498,23,11,12,0.4782608695652174,22,13,9,0.5909090909090909,0.5286506469500925,llama3,mimiciii,radiology_report,PROMPT1_ICL_entailment
443,499,27,18,9,0.6666666666666666,17,12,5,0.7058823529411765,0.6857142857142857,llama3,mimiciii,radiology_report,PROMPT1_ICL_entailment
444,5,21,13,8,0.6190476190476191,22,10,12,0.4545454545454545,0.5241935483870968,llama3,mimiciii,radiology_report,PROMPT1_ICL_entailment
445,50,18,10,8,0.5555555555555556,15,7,8,0.4666666666666667,0.5072463768115943,llama3,mimiciii,radiology_report,PROMPT1_ICL_entailment
446,51,17,9,8,0.5294117647058824,13,8,5,0.6153846153846154,0.5691699604743083,llama3,mimiciii,radiology_report,PROMPT1_ICL_entailment
447,52,25,16,9,0.64,21,13,8,0.6190476190476191,0.6293494704992435,llama3,mimiciii,radiology_report,PROMPT1_ICL_entailment
448,53,18,12,6,0.6666666666666666,12,7,5,0.5833333333333334,0.6222222222222222,llama3,mimiciii,radiology_report,PROMPT1_ICL_entailment
449,54,18,11,7,0.6111111111111112,10,6,4,0.6,0.6055045871559633,llama3,mimiciii,radiology_report,PROMPT1_ICL_entailment
450,55,19,11,8,0.5789473684210527,18,13,5,0.7222222222222222,0.6426966292134831,llama3,mimiciii,radiology_report,PROMPT1_ICL_entailment
451,56,23,13,10,0.5652173913043478,21,17,4,0.8095238095238095,0.6656626506024096,llama3,mimiciii,radiology_report,PROMPT1_ICL_entailment
452,57,16,8,8,0.5,10,5,5,0.5,0.5,llama3,mimiciii,radiology_report,PROMPT1_ICL_entailment
453,58,18,13,5,0.7222222222222222,16,9,7,0.5625,0.6324324324324324,llama3,mimiciii,radiology_report,PROMPT1_ICL_entailment
454,59,20,13,7,0.65,16,11,5,0.6875,0.6682242990654207,llama3,mimiciii,radiology_report,PROMPT1_ICL_entailment
455,6,16,8,8,0.5,8,5,3,0.625,0.5555555555555556,llama3,mimiciii,radiology_report,PROMPT1_ICL_entailment
456,60,22,17,5,0.7727272727272727,19,12,7,0.631578947368421,0.6950596252129472,llama3,mimiciii,radiology_report,PROMPT1_ICL_entailment
457,61,16,15,1,0.9375,22,18,4,0.8181818181818182,0.8737864077669902,llama3,mimiciii,radiology_report,PROMPT1_ICL_entailment
458,62,24,16,8,0.6666666666666666,13,6,7,0.4615384615384615,0.5454545454545455,llama3,mimiciii,radiology_report,PROMPT1_ICL_entailment
459,63,20,11,9,0.55,15,9,6,0.6,0.5739130434782609,llama3,mimiciii,radiology_report,PROMPT1_ICL_entailment
460,64,28,20,8,0.7142857142857143,20,12,8,0.6,0.6521739130434783,llama3,mimiciii,radiology_report,PROMPT1_ICL_entailment
461,65,24,15,9,0.625,18,13,5,0.7222222222222222,0.6701030927835051,llama3,mimiciii,radiology_report,PROMPT1_ICL_entailment
462,66,18,11,7,0.6111111111111112,29,16,13,0.5517241379310345,0.5799011532125206,llama3,mimiciii,radiology_report,PROMPT1_ICL_entailment
463,67,23,14,9,0.6086956521739131,28,22,6,0.7857142857142857,0.6859688195991092,llama3,mimiciii,radiology_report,PROMPT1_ICL_entailment
464,68,20,16,4,0.8,30,22,8,0.7333333333333333,0.7652173913043478,llama3,mimiciii,radiology_report,PROMPT1_ICL_entailment
465,69,26,18,8,0.6923076923076923,31,21,10,0.6774193548387096,0.684782608695652,llama3,mimiciii,radiology_report,PROMPT1_ICL_entailment
466,7,21,12,9,0.5714285714285714,16,12,4,0.75,0.6486486486486486,llama3,mimiciii,radiology_report,PROMPT1_ICL_entailment
467,70,17,9,8,0.5294117647058824,17,13,4,0.7647058823529411,0.625668449197861,llama3,mimiciii,radiology_report,PROMPT1_ICL_entailment
468,71,19,11,8,0.5789473684210527,18,12,6,0.6666666666666666,0.619718309859155,llama3,mimiciii,radiology_report,PROMPT1_ICL_entailment
469,72,24,16,8,0.6666666666666666,13,12,1,0.9230769230769232,0.7741935483870968,llama3,mimiciii,radiology_report,PROMPT1_ICL_entailment
470,73,27,18,9,0.6666666666666666,29,22,7,0.7586206896551724,0.7096774193548386,llama3,mimiciii,radiology_report,PROMPT1_ICL_entailment
471,74,23,16,7,0.6956521739130435,18,12,6,0.6666666666666666,0.6808510638297872,llama3,mimiciii,radiology_report,PROMPT1_ICL_entailment
472,75,22,15,7,0.6818181818181818,12,11,1,0.9166666666666666,0.7819905213270141,llama3,mimiciii,radiology_report,PROMPT1_ICL_entailment
473,76,21,12,9,0.5714285714285714,14,9,5,0.6428571428571429,0.6050420168067226,llama3,mimiciii,radiology_report,PROMPT1_ICL_entailment
474,77,22,12,10,0.5454545454545454,26,15,11,0.5769230769230769,0.5607476635514018,llama3,mimiciii,radiology_report,PROMPT1_ICL_entailment
475,78,29,18,11,0.6206896551724138,33,24,9,0.7272727272727273,0.6697674418604651,llama3,mimiciii,radiology_report,PROMPT1_ICL_entailment
476,79,19,14,5,0.7368421052631579,17,11,6,0.6470588235294118,0.6890380313199105,llama3,mimiciii,radiology_report,PROMPT1_ICL_entailment
477,8,20,14,6,0.7,15,12,3,0.8,0.7466666666666666,llama3,mimiciii,radiology_report,PROMPT1_ICL_entailment
478,80,23,15,8,0.6521739130434783,25,20,5,0.8,0.718562874251497,llama3,mimiciii,radiology_report,PROMPT1_ICL_entailment
479,81,24,16,8,0.6666666666666666,15,8,7,0.5333333333333333,0.5925925925925926,llama3,mimiciii,radiology_report,PROMPT1_ICL_entailment
480,82,14,10,4,0.7142857142857143,14,11,3,0.7857142857142857,0.7482993197278911,llama3,mimiciii,radiology_report,PROMPT1_ICL_entailment
481,83,24,15,9,0.625,17,12,5,0.7058823529411765,0.6629834254143646,llama3,mimiciii,radiology_report,PROMPT1_ICL_entailment
482,84,23,17,6,0.7391304347826086,20,16,4,0.8,0.768361581920904,llama3,mimiciii,radiology_report,PROMPT1_ICL_entailment
483,85,22,19,3,0.8636363636363636,14,12,2,0.8571428571428571,0.860377358490566,llama3,mimiciii,radiology_report,PROMPT1_ICL_entailment
484,86,19,14,5,0.7368421052631579,10,8,2,0.8,0.7671232876712328,llama3,mimiciii,radiology_report,PROMPT1_ICL_entailment
485,87,19,11,8,0.5789473684210527,14,9,5,0.6428571428571429,0.6092307692307694,llama3,mimiciii,radiology_report,PROMPT1_ICL_entailment
486,88,27,18,9,0.6666666666666666,19,17,2,0.8947368421052632,0.7640449438202247,llama3,mimiciii,radiology_report,PROMPT1_ICL_entailment
487,89,23,13,10,0.5652173913043478,18,14,4,0.7777777777777778,0.6546762589928057,llama3,mimiciii,radiology_report,PROMPT1_ICL_entailment
488,9,15,7,8,0.4666666666666667,13,7,6,0.5384615384615384,0.5,llama3,mimiciii,radiology_report,PROMPT1_ICL_entailment
489,90,16,9,7,0.5625,14,9,5,0.6428571428571429,0.6000000000000001,llama3,mimiciii,radiology_report,PROMPT1_ICL_entailment
490,91,17,10,7,0.5882352941176471,13,7,6,0.5384615384615384,0.5622489959839357,llama3,mimiciii,radiology_report,PROMPT1_ICL_entailment
491,92,21,14,7,0.6666666666666666,21,12,9,0.5714285714285714,0.6153846153846153,llama3,mimiciii,radiology_report,PROMPT1_ICL_entailment
492,93,22,13,9,0.5909090909090909,15,12,3,0.8,0.6797385620915033,llama3,mimiciii,radiology_report,PROMPT1_ICL_entailment
493,94,23,16,7,0.6956521739130435,28,21,7,0.75,0.7218045112781954,llama3,mimiciii,radiology_report,PROMPT1_ICL_entailment
494,95,25,17,8,0.68,18,11,7,0.6111111111111112,0.6437177280550774,llama3,mimiciii,radiology_report,PROMPT1_ICL_entailment
495,96,21,12,9,0.5714285714285714,21,12,9,0.5714285714285714,0.5714285714285714,llama3,mimiciii,radiology_report,PROMPT1_ICL_entailment
496,97,20,11,9,0.55,23,13,10,0.5652173913043478,0.5575048732943468,llama3,mimiciii,radiology_report,PROMPT1_ICL_entailment
497,98,24,16,8,0.6666666666666666,19,14,5,0.7368421052631579,0.7,llama3,mimiciii,radiology_report,PROMPT1_ICL_entailment
498,99,18,14,4,0.7777777777777778,13,11,2,0.8461538461538461,0.8105263157894737,llama3,mimiciii,radiology_report,PROMPT1_ICL_entailment
0,0,25,23,2,0.92,21,16,5,0.7619047619047619,0.8335220838052096,llama3,mimiciii,radiology_report,PROMPT2_ICL_entailment
1,1,15,15,0,1.0,15,10,5,0.6666666666666666,0.8,llama3,mimiciii,radiology_report,PROMPT2_ICL_entailment
2,10,16,14,2,0.875,18,15,3,0.8333333333333334,0.8536585365853658,llama3,mimiciii,radiology_report,PROMPT2_ICL_entailment
3,100,14,14,0,1.0,9,8,1,0.8888888888888888,0.9411764705882352,llama3,mimiciii,radiology_report,PROMPT2_ICL_entailment
4,101,21,20,1,0.9523809523809524,15,10,5,0.6666666666666666,0.7843137254901961,llama3,mimiciii,radiology_report,PROMPT2_ICL_entailment
5,102,16,16,0,1.0,16,12,4,0.75,0.8571428571428571,llama3,mimiciii,radiology_report,PROMPT2_ICL_entailment
6,103,23,21,2,0.9130434782608696,19,16,3,0.8421052631578947,0.8761408083441982,llama3,mimiciii,radiology_report,PROMPT2_ICL_entailment
7,104,22,21,1,0.9545454545454546,17,15,2,0.8823529411764706,0.9170305676855895,llama3,mimiciii,radiology_report,PROMPT2_ICL_entailment
8,105,8,7,1,0.875,8,6,2,0.75,0.8076923076923077,llama3,mimiciii,radiology_report,PROMPT2_ICL_entailment
9,106,11,11,0,1.0,12,7,5,0.5833333333333334,0.7368421052631579,llama3,mimiciii,radiology_report,PROMPT2_ICL_entailment
10,107,15,14,1,0.9333333333333332,19,13,6,0.6842105263157895,0.789587852494577,llama3,mimiciii,radiology_report,PROMPT2_ICL_entailment
11,108,14,14,0,1.0,13,12,1,0.9230769230769232,0.96,llama3,mimiciii,radiology_report,PROMPT2_ICL_entailment
12,109,18,17,1,0.9444444444444444,20,17,3,0.85,0.8947368421052632,llama3,mimiciii,radiology_report,PROMPT2_ICL_entailment
13,11,15,15,0,1.0,20,13,7,0.65,0.787878787878788,llama3,mimiciii,radiology_report,PROMPT2_ICL_entailment
14,110,16,16,0,1.0,17,15,2,0.8823529411764706,0.9375,llama3,mimiciii,radiology_report,PROMPT2_ICL_entailment
15,111,16,16,0,1.0,20,16,4,0.8,0.888888888888889,llama3,mimiciii,radiology_report,PROMPT2_ICL_entailment
16,112,15,15,0,1.0,14,14,0,1.0,1.0,llama3,mimiciii,radiology_report,PROMPT2_ICL_entailment
17,113,21,15,6,0.7142857142857143,20,17,3,0.85,0.776255707762557,llama3,mimiciii,radiology_report,PROMPT2_ICL_entailment
18,114,16,15,1,0.9375,23,18,5,0.782608695652174,0.8530805687203792,llama3,mimiciii,radiology_report,PROMPT2_ICL_entailment
19,115,17,17,0,1.0,20,17,3,0.85,0.9189189189189187,llama3,mimiciii,radiology_report,PROMPT2_ICL_entailment
20,116,13,12,1,0.9230769230769232,13,9,4,0.6923076923076923,0.7912087912087913,llama3,mimiciii,radiology_report,PROMPT2_ICL_entailment
21,117,11,9,2,0.8181818181818182,16,9,7,0.5625,0.6666666666666666,llama3,mimiciii,radiology_report,PROMPT2_ICL_entailment
22,118,23,22,1,0.9565217391304348,24,21,3,0.875,0.913946587537092,llama3,mimiciii,radiology_report,PROMPT2_ICL_entailment
23,119,19,19,0,1.0,17,15,2,0.8823529411764706,0.9375,llama3,mimiciii,radiology_report,PROMPT2_ICL_entailment
24,12,14,13,1,0.9285714285714286,17,12,5,0.7058823529411765,0.802056555269923,llama3,mimiciii,radiology_report,PROMPT2_ICL_entailment
25,120,17,15,2,0.8823529411764706,16,11,5,0.6875,0.7728337236533958,llama3,mimiciii,radiology_report,PROMPT2_ICL_entailment
26,121,21,18,3,0.8571428571428571,26,23,3,0.8846153846153846,0.8706624605678233,llama3,mimiciii,radiology_report,PROMPT2_ICL_entailment
27,122,15,15,0,1.0,20,16,4,0.8,0.888888888888889,llama3,mimiciii,radiology_report,PROMPT2_ICL_entailment
28,123,13,12,1,0.9230769230769232,13,10,3,0.7692307692307693,0.8391608391608392,llama3,mimiciii,radiology_report,PROMPT2_ICL_entailment
29,124,10,9,1,0.9,12,6,6,0.5,0.6428571428571429,llama3,mimiciii,radiology_report,PROMPT2_ICL_entailment
30,125,17,17,0,1.0,23,18,5,0.782608695652174,0.878048780487805,llama3,mimiciii,radiology_report,PROMPT2_ICL_entailment
31,126,12,11,1,0.9166666666666666,9,7,2,0.7777777777777778,0.8415300546448087,llama3,mimiciii,radiology_report,PROMPT2_ICL_entailment
32,127,34,31,3,0.9117647058823528,43,30,13,0.6976744186046512,0.7904802379940502,llama3,mimiciii,radiology_report,PROMPT2_ICL_entailment
33,128,11,11,0,1.0,14,11,3,0.7857142857142857,0.88,llama3,mimiciii,radiology_report,PROMPT2_ICL_entailment
34,129,15,15,0,1.0,16,12,4,0.75,0.8571428571428571,llama3,mimiciii,radiology_report,PROMPT2_ICL_entailment
35,13,14,14,0,1.0,17,15,2,0.8823529411764706,0.9375,llama3,mimiciii,radiology_report,PROMPT2_ICL_entailment
36,130,18,15,3,0.8333333333333334,25,14,11,0.56,0.6698564593301435,llama3,mimiciii,radiology_report,PROMPT2_ICL_entailment
37,131,11,10,1,0.9090909090909092,32,23,9,0.71875,0.8027923211169284,llama3,mimiciii,radiology_report,PROMPT2_ICL_entailment
38,132,19,16,3,0.8421052631578947,23,15,8,0.6521739130434783,0.7350689127105666,llama3,mimiciii,radiology_report,PROMPT2_ICL_entailment
39,133,21,19,2,0.9047619047619048,21,17,4,0.8095238095238095,0.8544973544973544,llama3,mimiciii,radiology_report,PROMPT2_ICL_entailment
40,134,14,12,2,0.8571428571428571,23,17,6,0.7391304347826086,0.7937743190661479,llama3,mimiciii,radiology_report,PROMPT2_ICL_entailment
41,135,16,16,0,1.0,20,14,6,0.7,0.8235294117647058,llama3,mimiciii,radiology_report,PROMPT2_ICL_entailment
42,136,15,13,2,0.8666666666666667,14,10,4,0.7142857142857143,0.7831325301204819,llama3,mimiciii,radiology_report,PROMPT2_ICL_entailment
43,137,13,13,0,1.0,10,8,2,0.8,0.888888888888889,llama3,mimiciii,radiology_report,PROMPT2_ICL_entailment
44,138,15,15,0,1.0,14,9,5,0.6428571428571429,0.782608695652174,llama3,mimiciii,radiology_report,PROMPT2_ICL_entailment
45,139,10,9,1,0.9,13,10,3,0.7692307692307693,0.8294930875576038,llama3,mimiciii,radiology_report,PROMPT2_ICL_entailment
46,14,8,8,0,1.0,12,8,4,0.6666666666666666,0.8,llama3,mimiciii,radiology_report,PROMPT2_ICL_entailment
47,140,15,15,0,1.0,18,12,6,0.6666666666666666,0.8,llama3,mimiciii,radiology_report,PROMPT2_ICL_entailment
48,141,16,16,0,1.0,16,12,4,0.75,0.8571428571428571,llama3,mimiciii,radiology_report,PROMPT2_ICL_entailment
49,142,20,19,1,0.95,14,12,2,0.8571428571428571,0.9011857707509882,llama3,mimiciii,radiology_report,PROMPT2_ICL_entailment
50,143,21,19,2,0.9047619047619048,28,20,8,0.7142857142857143,0.7983193277310925,llama3,mimiciii,radiology_report,PROMPT2_ICL_entailment
51,144,16,16,0,1.0,23,19,4,0.8260869565217391,0.9047619047619048,llama3,mimiciii,radiology_report,PROMPT2_ICL_entailment
52,145,18,18,0,1.0,18,16,2,0.8888888888888888,0.9411764705882352,llama3,mimiciii,radiology_report,PROMPT2_ICL_entailment
53,146,12,11,1,0.9166666666666666,11,6,5,0.5454545454545454,0.6839378238341969,llama3,mimiciii,radiology_report,PROMPT2_ICL_entailment
54,147,9,8,1,0.8888888888888888,10,5,5,0.5,0.64,llama3,mimiciii,radiology_report,PROMPT2_ICL_entailment
55,148,16,14,2,0.875,26,17,9,0.6538461538461539,0.7484276729559749,llama3,mimiciii,radiology_report,PROMPT2_ICL_entailment
56,149,19,18,1,0.9473684210526316,20,17,3,0.85,0.8960468521229868,llama3,mimiciii,radiology_report,PROMPT2_ICL_entailment
57,15,29,22,7,0.7586206896551724,29,23,6,0.7931034482758621,0.7754789272030652,llama3,mimiciii,radiology_report,PROMPT2_ICL_entailment
58,150,21,21,0,1.0,14,12,2,0.8571428571428571,0.923076923076923,llama3,mimiciii,radiology_report,PROMPT2_ICL_entailment
59,151,19,15,4,0.7894736842105263,15,11,4,0.7333333333333333,0.76036866359447,llama3,mimiciii,radiology_report,PROMPT2_ICL_entailment
60,152,18,18,0,1.0,18,12,6,0.6666666666666666,0.8,llama3,mimiciii,radiology_report,PROMPT2_ICL_entailment
61,153,14,13,1,0.9285714285714286,16,15,1,0.9375,0.9330143540669856,llama3,mimiciii,radiology_report,PROMPT2_ICL_entailment
62,154,18,16,2,0.8888888888888888,23,20,3,0.8695652173913043,0.8791208791208792,llama3,mimiciii,radiology_report,PROMPT2_ICL_entailment
63,155,32,29,3,0.90625,47,30,17,0.6382978723404256,0.7490314248816186,llama3,mimiciii,radiology_report,PROMPT2_ICL_entailment
64,156,20,18,2,0.9,20,15,5,0.75,0.8181818181818182,llama3,mimiciii,radiology_report,PROMPT2_ICL_entailment
65,157,15,14,1,0.9333333333333332,12,11,1,0.9166666666666666,0.9249249249249248,llama3,mimiciii,radiology_report,PROMPT2_ICL_entailment
66,158,10,8,2,0.8,6,3,3,0.5,0.6153846153846154,llama3,mimiciii,radiology_report,PROMPT2_ICL_entailment
67,159,11,11,0,1.0,13,10,3,0.7692307692307693,0.8695652173913044,llama3,mimiciii,radiology_report,PROMPT2_ICL_entailment
68,16,16,16,0,1.0,17,13,4,0.7647058823529411,0.8666666666666666,llama3,mimiciii,radiology_report,PROMPT2_ICL_entailment
69,160,18,15,3,0.8333333333333334,12,10,2,0.8333333333333334,0.8333333333333334,llama3,mimiciii,radiology_report,PROMPT2_ICL_entailment
70,161,14,14,0,1.0,13,9,4,0.6923076923076923,0.8181818181818181,llama3,mimiciii,radiology_report,PROMPT2_ICL_entailment
71,162,17,16,1,0.9411764705882352,11,8,3,0.7272727272727273,0.8205128205128205,llama3,mimiciii,radiology_report,PROMPT2_ICL_entailment
72,163,12,11,1,0.9166666666666666,8,5,3,0.625,0.7432432432432433,llama3,mimiciii,radiology_report,PROMPT2_ICL_entailment
73,164,15,15,0,1.0,10,8,2,0.8,0.888888888888889,llama3,mimiciii,radiology_report,PROMPT2_ICL_entailment
74,165,22,17,5,0.7727272727272727,28,22,6,0.7857142857142857,0.7791666666666666,llama3,mimiciii,radiology_report,PROMPT2_ICL_entailment
75,166,21,19,2,0.9047619047619048,26,21,5,0.8076923076923077,0.853475935828877,llama3,mimiciii,radiology_report,PROMPT2_ICL_entailment
76,167,9,8,1,0.8888888888888888,10,7,3,0.7,0.7832167832167831,llama3,mimiciii,radiology_report,PROMPT2_ICL_entailment
77,168,12,12,0,1.0,13,8,5,0.6153846153846154,0.761904761904762,llama3,mimiciii,radiology_report,PROMPT2_ICL_entailment
78,169,14,14,0,1.0,22,16,6,0.7272727272727273,0.8421052631578948,llama3,mimiciii,radiology_report,PROMPT2_ICL_entailment
79,17,10,10,0,1.0,12,10,2,0.8333333333333334,0.9090909090909092,llama3,mimiciii,radiology_report,PROMPT2_ICL_entailment
80,170,24,23,1,0.9583333333333334,24,18,6,0.75,0.8414634146341463,llama3,mimiciii,radiology_report,PROMPT2_ICL_entailment
81,171,9,8,1,0.8888888888888888,7,5,2,0.7142857142857143,0.792079207920792,llama3,mimiciii,radiology_report,PROMPT2_ICL_entailment
82,172,13,13,0,1.0,14,11,3,0.7857142857142857,0.88,llama3,mimiciii,radiology_report,PROMPT2_ICL_entailment
83,173,15,15,0,1.0,12,8,4,0.6666666666666666,0.8,llama3,mimiciii,radiology_report,PROMPT2_ICL_entailment
84,174,13,13,0,1.0,20,13,7,0.65,0.787878787878788,llama3,mimiciii,radiology_report,PROMPT2_ICL_entailment
85,175,10,9,1,0.9,8,7,1,0.875,0.8873239436619719,llama3,mimiciii,radiology_report,PROMPT2_ICL_entailment
86,176,21,19,2,0.9047619047619048,19,17,2,0.8947368421052632,0.8997214484679665,llama3,mimiciii,radiology_report,PROMPT2_ICL_entailment
87,177,19,17,2,0.8947368421052632,16,12,4,0.75,0.816,llama3,mimiciii,radiology_report,PROMPT2_ICL_entailment
88,178,23,20,3,0.8695652173913043,25,22,3,0.88,0.874751491053678,llama3,mimiciii,radiology_report,PROMPT2_ICL_entailment
89,179,13,13,0,1.0,17,9,8,0.5294117647058824,0.6923076923076924,llama3,mimiciii,radiology_report,PROMPT2_ICL_entailment
90,18,16,16,0,1.0,17,13,4,0.7647058823529411,0.8666666666666666,llama3,mimiciii,radiology_report,PROMPT2_ICL_entailment
91,180,13,11,2,0.8461538461538461,11,8,3,0.7272727272727273,0.7822222222222223,llama3,mimiciii,radiology_report,PROMPT2_ICL_entailment
92,181,23,19,4,0.8260869565217391,26,17,9,0.6538461538461539,0.7299435028248588,llama3,mimiciii,radiology_report,PROMPT2_ICL_entailment
93,182,16,16,0,1.0,23,17,6,0.7391304347826086,0.85,llama3,mimiciii,radiology_report,PROMPT2_ICL_entailment
94,183,13,12,1,0.9230769230769232,17,12,5,0.7058823529411765,0.8000000000000002,llama3,mimiciii,radiology_report,PROMPT2_ICL_entailment
95,184,12,12,0,1.0,15,12,3,0.8,0.888888888888889,llama3,mimiciii,radiology_report,PROMPT2_ICL_entailment
96,185,10,8,2,0.8,6,5,1,0.8333333333333334,0.816326530612245,llama3,mimiciii,radiology_report,PROMPT2_ICL_entailment
97,186,19,19,0,1.0,26,22,4,0.8461538461538461,0.9166666666666666,llama3,mimiciii,radiology_report,PROMPT2_ICL_entailment
98,187,20,20,0,1.0,14,11,3,0.7857142857142857,0.88,llama3,mimiciii,radiology_report,PROMPT2_ICL_entailment
99,188,24,23,1,0.9583333333333334,22,18,4,0.8181818181818182,0.8827292110874201,llama3,mimiciii,radiology_report,PROMPT2_ICL_entailment
100,189,15,14,1,0.9333333333333332,15,14,1,0.9333333333333332,0.9333333333333332,llama3,mimiciii,radiology_report,PROMPT2_ICL_entailment
101,19,14,14,0,1.0,14,9,5,0.6428571428571429,0.782608695652174,llama3,mimiciii,radiology_report,PROMPT2_ICL_entailment
102,190,15,14,1,0.9333333333333332,17,14,3,0.8235294117647058,0.8749999999999999,llama3,mimiciii,radiology_report,PROMPT2_ICL_entailment
103,191,24,22,2,0.9166666666666666,15,13,2,0.8666666666666667,0.8909657320872274,llama3,mimiciii,radiology_report,PROMPT2_ICL_entailment
104,192,23,20,3,0.8695652173913043,28,23,5,0.8214285714285714,0.8448117539026628,llama3,mimiciii,radiology_report,PROMPT2_ICL_entailment
105,193,14,14,0,1.0,14,10,4,0.7142857142857143,0.8333333333333333,llama3,mimiciii,radiology_report,PROMPT2_ICL_entailment
106,194,23,21,2,0.9130434782608696,38,29,9,0.7631578947368421,0.8313993174061434,llama3,mimiciii,radiology_report,PROMPT2_ICL_entailment
107,195,20,19,1,0.95,21,18,3,0.8571428571428571,0.9011857707509882,llama3,mimiciii,radiology_report,PROMPT2_ICL_entailment
108,196,16,14,2,0.875,18,13,5,0.7222222222222222,0.7913043478260868,llama3,mimiciii,radiology_report,PROMPT2_ICL_entailment
109,197,13,13,0,1.0,15,10,5,0.6666666666666666,0.8,llama3,mimiciii,radiology_report,PROMPT2_ICL_entailment
110,198,8,8,0,1.0,9,8,1,0.8888888888888888,0.9411764705882352,llama3,mimiciii,radiology_report,PROMPT2_ICL_entailment
111,199,20,17,3,0.85,23,20,3,0.8695652173913043,0.8596713021491782,llama3,mimiciii,radiology_report,PROMPT2_ICL_entailment
112,2,11,10,1,0.9090909090909092,15,9,6,0.6,0.7228915662650602,llama3,mimiciii,radiology_report,PROMPT2_ICL_entailment
113,20,20,19,1,0.95,36,29,7,0.8055555555555556,0.8718354430379747,llama3,mimiciii,radiology_report,PROMPT2_ICL_entailment
114,200,14,14,0,1.0,14,11,3,0.7857142857142857,0.88,llama3,mimiciii,radiology_report,PROMPT2_ICL_entailment
115,201,17,15,2,0.8823529411764706,18,13,5,0.7222222222222222,0.7942973523421588,llama3,mimiciii,radiology_report,PROMPT2_ICL_entailment
116,202,15,14,1,0.9333333333333332,24,12,12,0.5,0.6511627906976745,llama3,mimiciii,radiology_report,PROMPT2_ICL_entailment
117,203,23,21,2,0.9130434782608696,19,15,4,0.7894736842105263,0.8467741935483872,llama3,mimiciii,radiology_report,PROMPT2_ICL_entailment
118,204,16,15,1,0.9375,23,20,3,0.8695652173913043,0.9022556390977444,llama3,mimiciii,radiology_report,PROMPT2_ICL_entailment
119,205,17,17,0,1.0,14,10,4,0.7142857142857143,0.8333333333333333,llama3,mimiciii,radiology_report,PROMPT2_ICL_entailment
120,206,18,17,1,0.9444444444444444,13,10,3,0.7692307692307693,0.8478802992518703,llama3,mimiciii,radiology_report,PROMPT2_ICL_entailment
121,207,9,8,1,0.8888888888888888,9,7,2,0.7777777777777778,0.8296296296296296,llama3,mimiciii,radiology_report,PROMPT2_ICL_entailment
122,208,27,26,1,0.9629629629629628,18,13,5,0.7222222222222222,0.8253968253968254,llama3,mimiciii,radiology_report,PROMPT2_ICL_entailment
123,209,17,17,0,1.0,16,14,2,0.875,0.9333333333333332,llama3,mimiciii,radiology_report,PROMPT2_ICL_entailment
124,21,20,20,0,1.0,27,20,7,0.7407407407407407,0.851063829787234,llama3,mimiciii,radiology_report,PROMPT2_ICL_entailment
125,210,11,11,0,1.0,14,10,4,0.7142857142857143,0.8333333333333333,llama3,mimiciii,radiology_report,PROMPT2_ICL_entailment
126,211,10,10,0,1.0,13,12,1,0.9230769230769232,0.96,llama3,mimiciii,radiology_report,PROMPT2_ICL_entailment
127,212,18,15,3,0.8333333333333334,19,17,2,0.8947368421052632,0.8629441624365481,llama3,mimiciii,radiology_report,PROMPT2_ICL_entailment
128,213,18,17,1,0.9444444444444444,22,17,5,0.7727272727272727,0.85,llama3,mimiciii,radiology_report,PROMPT2_ICL_entailment
129,214,24,15,9,0.625,23,18,5,0.782608695652174,0.694980694980695,llama3,mimiciii,radiology_report,PROMPT2_ICL_entailment
130,215,13,12,1,0.9230769230769232,10,7,3,0.7,0.7962085308056872,llama3,mimiciii,radiology_report,PROMPT2_ICL_entailment
131,216,11,11,0,1.0,19,14,5,0.7368421052631579,0.8484848484848484,llama3,mimiciii,radiology_report,PROMPT2_ICL_entailment
132,217,15,12,3,0.8,20,14,6,0.7,0.7466666666666666,llama3,mimiciii,radiology_report,PROMPT2_ICL_entailment
133,218,20,18,2,0.9,15,12,3,0.8,0.8470588235294118,llama3,mimiciii,radiology_report,PROMPT2_ICL_entailment
134,219,18,16,2,0.8888888888888888,13,10,3,0.7692307692307693,0.8247422680412372,llama3,mimiciii,radiology_report,PROMPT2_ICL_entailment
135,22,20,18,2,0.9,19,16,3,0.8421052631578947,0.8700906344410877,llama3,mimiciii,radiology_report,PROMPT2_ICL_entailment
136,220,17,17,0,1.0,19,12,7,0.631578947368421,0.7741935483870968,llama3,mimiciii,radiology_report,PROMPT2_ICL_entailment
137,221,23,22,1,0.9565217391304348,27,22,5,0.8148148148148148,0.8800000000000001,llama3,mimiciii,radiology_report,PROMPT2_ICL_entailment
138,222,14,13,1,0.9285714285714286,16,9,7,0.5625,0.7005988023952097,llama3,mimiciii,radiology_report,PROMPT2_ICL_entailment
139,223,20,19,1,0.95,21,18,3,0.8571428571428571,0.9011857707509882,llama3,mimiciii,radiology_report,PROMPT2_ICL_entailment
140,224,27,25,2,0.925925925925926,17,14,3,0.8235294117647058,0.87173100871731,llama3,mimiciii,radiology_report,PROMPT2_ICL_entailment
141,225,12,12,0,1.0,11,8,3,0.7272727272727273,0.8421052631578948,llama3,mimiciii,radiology_report,PROMPT2_ICL_entailment
142,226,15,13,2,0.8666666666666667,18,15,3,0.8333333333333334,0.8496732026143791,llama3,mimiciii,radiology_report,PROMPT2_ICL_entailment
143,227,17,16,1,0.9411764705882352,18,13,5,0.7222222222222222,0.8172888015717094,llama3,mimiciii,radiology_report,PROMPT2_ICL_entailment
144,228,17,16,1,0.9411764705882352,17,15,2,0.8823529411764706,0.9108159392789372,llama3,mimiciii,radiology_report,PROMPT2_ICL_entailment
145,229,29,29,0,1.0,44,32,12,0.7272727272727273,0.8421052631578948,llama3,mimiciii,radiology_report,PROMPT2_ICL_entailment
146,23,15,15,0,1.0,15,11,4,0.7333333333333333,0.846153846153846,llama3,mimiciii,radiology_report,PROMPT2_ICL_entailment
147,230,15,13,2,0.8666666666666667,17,15,2,0.8823529411764706,0.8744394618834082,llama3,mimiciii,radiology_report,PROMPT2_ICL_entailment
148,231,12,12,0,1.0,13,11,2,0.8461538461538461,0.9166666666666666,llama3,mimiciii,radiology_report,PROMPT2_ICL_entailment
149,232,15,13,2,0.8666666666666667,18,14,4,0.7777777777777778,0.81981981981982,llama3,mimiciii,radiology_report,PROMPT2_ICL_entailment
150,233,21,20,1,0.9523809523809524,17,12,5,0.7058823529411765,0.810810810810811,llama3,mimiciii,radiology_report,PROMPT2_ICL_entailment
151,234,10,9,1,0.9,11,7,4,0.6363636363636364,0.7455621301775148,llama3,mimiciii,radiology_report,PROMPT2_ICL_entailment
152,235,12,12,0,1.0,14,10,4,0.7142857142857143,0.8333333333333333,llama3,mimiciii,radiology_report,PROMPT2_ICL_entailment
153,236,15,15,0,1.0,11,8,3,0.7272727272727273,0.8421052631578948,llama3,mimiciii,radiology_report,PROMPT2_ICL_entailment
154,237,17,17,0,1.0,17,15,2,0.8823529411764706,0.9375,llama3,mimiciii,radiology_report,PROMPT2_ICL_entailment
155,238,14,13,1,0.9285714285714286,20,16,4,0.8,0.859504132231405,llama3,mimiciii,radiology_report,PROMPT2_ICL_entailment
156,239,14,13,1,0.9285714285714286,17,11,6,0.6470588235294118,0.7626666666666667,llama3,mimiciii,radiology_report,PROMPT2_ICL_entailment
157,24,13,13,0,1.0,18,13,5,0.7222222222222222,0.8387096774193548,llama3,mimiciii,radiology_report,PROMPT2_ICL_entailment
158,240,11,11,0,1.0,13,11,2,0.8461538461538461,0.9166666666666666,llama3,mimiciii,radiology_report,PROMPT2_ICL_entailment
159,241,17,15,2,0.8823529411764706,16,13,3,0.8125,0.8459869848156183,llama3,mimiciii,radiology_report,PROMPT2_ICL_entailment
160,242,23,23,0,1.0,18,13,5,0.7222222222222222,0.8387096774193548,llama3,mimiciii,radiology_report,PROMPT2_ICL_entailment
161,243,15,13,2,0.8666666666666667,13,7,6,0.5384615384615384,0.6642335766423358,llama3,mimiciii,radiology_report,PROMPT2_ICL_entailment
162,244,17,17,0,1.0,17,17,0,1.0,1.0,llama3,mimiciii,radiology_report,PROMPT2_ICL_entailment
163,245,27,22,5,0.8148148148148148,28,25,3,0.8928571428571429,0.8520526723470179,llama3,mimiciii,radiology_report,PROMPT2_ICL_entailment
164,246,10,10,0,1.0,12,8,4,0.6666666666666666,0.8,llama3,mimiciii,radiology_report,PROMPT2_ICL_entailment
165,247,13,13,0,1.0,12,9,3,0.75,0.8571428571428571,llama3,mimiciii,radiology_report,PROMPT2_ICL_entailment
166,248,18,16,2,0.8888888888888888,17,13,4,0.7647058823529411,0.8221343873517786,llama3,mimiciii,radiology_report,PROMPT2_ICL_entailment
167,249,19,16,3,0.8421052631578947,23,20,3,0.8695652173913043,0.8556149732620322,llama3,mimiciii,radiology_report,PROMPT2_ICL_entailment
168,25,26,23,3,0.8846153846153846,27,20,7,0.7407407407407407,0.8063102541630148,llama3,mimiciii,radiology_report,PROMPT2_ICL_entailment
169,250,10,10,0,1.0,8,6,2,0.75,0.8571428571428571,llama3,mimiciii,radiology_report,PROMPT2_ICL_entailment
170,251,23,19,4,0.8260869565217391,22,20,2,0.9090909090909092,0.8656036446469249,llama3,mimiciii,radiology_report,PROMPT2_ICL_entailment
171,252,10,9,1,0.9,10,7,3,0.7,0.7875,llama3,mimiciii,radiology_report,PROMPT2_ICL_entailment
172,253,26,26,0,1.0,24,22,2,0.9166666666666666,0.9565217391304348,llama3,mimiciii,radiology_report,PROMPT2_ICL_entailment
173,254,13,12,1,0.9230769230769232,13,7,6,0.5384615384615384,0.6801619433198379,llama3,mimiciii,radiology_report,PROMPT2_ICL_entailment
174,255,15,14,1,0.9333333333333332,16,12,4,0.75,0.8316831683168316,llama3,mimiciii,radiology_report,PROMPT2_ICL_entailment
175,256,17,17,0,1.0,19,17,2,0.8947368421052632,0.9444444444444444,llama3,mimiciii,radiology_report,PROMPT2_ICL_entailment
176,257,16,15,1,0.9375,15,14,1,0.9333333333333332,0.935412026726058,llama3,mimiciii,radiology_report,PROMPT2_ICL_entailment
177,258,15,15,0,1.0,20,10,10,0.5,0.6666666666666666,llama3,mimiciii,radiology_report,PROMPT2_ICL_entailment
178,259,13,13,0,1.0,17,15,2,0.8823529411764706,0.9375,llama3,mimiciii,radiology_report,PROMPT2_ICL_entailment
179,26,20,18,2,0.9,18,14,4,0.7777777777777778,0.8344370860927153,llama3,mimiciii,radiology_report,PROMPT2_ICL_entailment
180,260,23,19,4,0.8260869565217391,20,13,7,0.65,0.727540500736377,llama3,mimiciii,radiology_report,PROMPT2_ICL_entailment
181,261,23,22,1,0.9565217391304348,30,28,2,0.9333333333333332,0.9447852760736196,llama3,mimiciii,radiology_report,PROMPT2_ICL_entailment
182,262,22,21,1,0.9545454545454546,23,16,7,0.6956521739130435,0.8047904191616767,llama3,mimiciii,radiology_report,PROMPT2_ICL_entailment
183,263,18,17,1,0.9444444444444444,27,23,4,0.8518518518518519,0.8957617411225658,llama3,mimiciii,radiology_report,PROMPT2_ICL_entailment
184,264,17,17,0,1.0,20,16,4,0.8,0.888888888888889,llama3,mimiciii,radiology_report,PROMPT2_ICL_entailment
185,265,14,14,0,1.0,9,8,1,0.8888888888888888,0.9411764705882352,llama3,mimiciii,radiology_report,PROMPT2_ICL_entailment
186,266,17,15,2,0.8823529411764706,18,13,5,0.7222222222222222,0.7942973523421588,llama3,mimiciii,radiology_report,PROMPT2_ICL_entailment
187,267,12,11,1,0.9166666666666666,16,13,3,0.8125,0.8614457831325302,llama3,mimiciii,radiology_report,PROMPT2_ICL_entailment
188,268,17,17,0,1.0,20,15,5,0.75,0.8571428571428571,llama3,mimiciii,radiology_report,PROMPT2_ICL_entailment
189,269,16,16,0,1.0,25,17,8,0.68,0.8095238095238095,llama3,mimiciii,radiology_report,PROMPT2_ICL_entailment
190,27,20,16,4,0.8,14,10,4,0.7142857142857143,0.7547169811320756,llama3,mimiciii,radiology_report,PROMPT2_ICL_entailment
191,270,18,14,4,0.7777777777777778,17,15,2,0.8823529411764706,0.8267716535433072,llama3,mimiciii,radiology_report,PROMPT2_ICL_entailment
192,271,17,17,0,1.0,17,15,2,0.8823529411764706,0.9375,llama3,mimiciii,radiology_report,PROMPT2_ICL_entailment
193,272,24,23,1,0.9583333333333334,17,15,2,0.8823529411764706,0.918774966711052,llama3,mimiciii,radiology_report,PROMPT2_ICL_entailment
194,273,13,13,0,1.0,12,8,4,0.6666666666666666,0.8,llama3,mimiciii,radiology_report,PROMPT2_ICL_entailment
195,274,16,15,1,0.9375,20,14,6,0.7,0.8015267175572519,llama3,mimiciii,radiology_report,PROMPT2_ICL_entailment
196,275,14,13,1,0.9285714285714286,12,11,1,0.9166666666666666,0.9225806451612902,llama3,mimiciii,radiology_report,PROMPT2_ICL_entailment
197,276,17,17,0,1.0,24,19,5,0.7916666666666666,0.8837209302325582,llama3,mimiciii,radiology_report,PROMPT2_ICL_entailment
198,277,21,16,5,0.7619047619047619,25,22,3,0.88,0.8167053364269142,llama3,mimiciii,radiology_report,PROMPT2_ICL_entailment
199,278,16,15,1,0.9375,16,13,3,0.8125,0.8705357142857143,llama3,mimiciii,radiology_report,PROMPT2_ICL_entailment
200,279,17,16,1,0.9411764705882352,10,8,2,0.8,0.8648648648648648,llama3,mimiciii,radiology_report,PROMPT2_ICL_entailment
201,28,18,15,3,0.8333333333333334,30,27,3,0.9,0.8653846153846153,llama3,mimiciii,radiology_report,PROMPT2_ICL_entailment
202,280,11,10,1,0.9090909090909092,12,10,2,0.8333333333333334,0.8695652173913043,llama3,mimiciii,radiology_report,PROMPT2_ICL_entailment
203,281,18,16,2,0.8888888888888888,24,19,5,0.7916666666666666,0.837465564738292,llama3,mimiciii,radiology_report,PROMPT2_ICL_entailment
204,282,13,13,0,1.0,12,8,4,0.6666666666666666,0.8,llama3,mimiciii,radiology_report,PROMPT2_ICL_entailment
205,283,14,14,0,1.0,25,17,8,0.68,0.8095238095238095,llama3,mimiciii,radiology_report,PROMPT2_ICL_entailment
206,284,16,16,0,1.0,14,11,3,0.7857142857142857,0.88,llama3,mimiciii,radiology_report,PROMPT2_ICL_entailment
207,285,15,15,0,1.0,18,17,1,0.9444444444444444,0.9714285714285714,llama3,mimiciii,radiology_report,PROMPT2_ICL_entailment
208,286,8,7,1,0.875,6,5,1,0.8333333333333334,0.8536585365853658,llama3,mimiciii,radiology_report,PROMPT2_ICL_entailment
209,287,17,16,1,0.9411764705882352,18,16,2,0.8888888888888888,0.9142857142857144,llama3,mimiciii,radiology_report,PROMPT2_ICL_entailment
210,288,24,19,5,0.7916666666666666,32,27,5,0.84375,0.8168789808917198,llama3,mimiciii,radiology_report,PROMPT2_ICL_entailment
211,289,25,25,0,1.0,20,16,4,0.8,0.888888888888889,llama3,mimiciii,radiology_report,PROMPT2_ICL_entailment
212,29,11,10,1,0.9090909090909092,8,6,2,0.75,0.821917808219178,llama3,mimiciii,radiology_report,PROMPT2_ICL_entailment
213,290,13,13,0,1.0,11,8,3,0.7272727272727273,0.8421052631578948,llama3,mimiciii,radiology_report,PROMPT2_ICL_entailment
214,291,21,19,2,0.9047619047619048,23,14,9,0.6086956521739131,0.7277701778385773,llama3,mimiciii,radiology_report,PROMPT2_ICL_entailment
215,292,18,16,2,0.8888888888888888,21,17,4,0.8095238095238095,0.8473520249221184,llama3,mimiciii,radiology_report,PROMPT2_ICL_entailment
216,293,11,11,0,1.0,18,11,7,0.6111111111111112,0.7586206896551725,llama3,mimiciii,radiology_report,PROMPT2_ICL_entailment
217,294,19,16,3,0.8421052631578947,22,16,6,0.7272727272727273,0.7804878048780488,llama3,mimiciii,radiology_report,PROMPT2_ICL_entailment
218,295,14,12,2,0.8571428571428571,32,21,11,0.65625,0.743362831858407,llama3,mimiciii,radiology_report,PROMPT2_ICL_entailment
219,296,19,16,3,0.8421052631578947,17,15,2,0.8823529411764706,0.8617594254937163,llama3,mimiciii,radiology_report,PROMPT2_ICL_entailment
220,297,20,19,1,0.95,24,19,5,0.7916666666666666,0.8636363636363635,llama3,mimiciii,radiology_report,PROMPT2_ICL_entailment
221,298,18,17,1,0.9444444444444444,20,15,5,0.75,0.8360655737704917,llama3,mimiciii,radiology_report,PROMPT2_ICL_entailment
222,299,19,18,1,0.9473684210526316,28,23,5,0.8214285714285714,0.8799149840595111,llama3,mimiciii,radiology_report,PROMPT2_ICL_entailment
223,3,19,16,3,0.8421052631578947,20,16,4,0.8,0.8205128205128205,llama3,mimiciii,radiology_report,PROMPT2_ICL_entailment
224,30,15,15,0,1.0,21,17,4,0.8095238095238095,0.8947368421052632,llama3,mimiciii,radiology_report,PROMPT2_ICL_entailment
225,300,15,15,0,1.0,13,7,6,0.5384615384615384,0.7000000000000001,llama3,mimiciii,radiology_report,PROMPT2_ICL_entailment
226,301,11,11,0,1.0,16,11,5,0.6875,0.8148148148148148,llama3,mimiciii,radiology_report,PROMPT2_ICL_entailment
227,302,15,14,1,0.9333333333333332,15,11,4,0.7333333333333333,0.8213333333333334,llama3,mimiciii,radiology_report,PROMPT2_ICL_entailment
228,303,23,22,1,0.9565217391304348,24,16,8,0.6666666666666666,0.7857142857142856,llama3,mimiciii,radiology_report,PROMPT2_ICL_entailment
229,304,19,16,3,0.8421052631578947,19,15,4,0.7894736842105263,0.8149405772495756,llama3,mimiciii,radiology_report,PROMPT2_ICL_entailment
230,305,21,20,1,0.9523809523809524,24,16,8,0.6666666666666666,0.7843137254901961,llama3,mimiciii,radiology_report,PROMPT2_ICL_entailment
231,306,14,13,1,0.9285714285714286,14,10,4,0.7142857142857143,0.8074534161490684,llama3,mimiciii,radiology_report,PROMPT2_ICL_entailment
232,307,18,18,0,1.0,17,14,3,0.8235294117647058,0.9032258064516128,llama3,mimiciii,radiology_report,PROMPT2_ICL_entailment
233,308,18,17,1,0.9444444444444444,15,9,6,0.6,0.7338129496402879,llama3,mimiciii,radiology_report,PROMPT2_ICL_entailment
234,309,17,15,2,0.8823529411764706,26,15,11,0.5769230769230769,0.6976744186046512,llama3,mimiciii,radiology_report,PROMPT2_ICL_entailment
235,31,12,10,2,0.8333333333333334,19,14,5,0.7368421052631579,0.782122905027933,llama3,mimiciii,radiology_report,PROMPT2_ICL_entailment
236,310,13,13,0,1.0,24,16,8,0.6666666666666666,0.8,llama3,mimiciii,radiology_report,PROMPT2_ICL_entailment
237,311,14,14,0,1.0,15,13,2,0.8666666666666667,0.9285714285714286,llama3,mimiciii,radiology_report,PROMPT2_ICL_entailment
238,312,17,17,0,1.0,18,15,3,0.8333333333333334,0.9090909090909092,llama3,mimiciii,radiology_report,PROMPT2_ICL_entailment
239,313,17,17,0,1.0,17,15,2,0.8823529411764706,0.9375,llama3,mimiciii,radiology_report,PROMPT2_ICL_entailment
240,314,17,16,1,0.9411764705882352,15,11,4,0.7333333333333333,0.8243559718969555,llama3,mimiciii,radiology_report,PROMPT2_ICL_entailment
241,315,30,26,4,0.8666666666666667,25,21,4,0.84,0.853125,llama3,mimiciii,radiology_report,PROMPT2_ICL_entailment
242,316,8,8,0,1.0,10,7,3,0.7,0.8235294117647058,llama3,mimiciii,radiology_report,PROMPT2_ICL_entailment
243,317,22,17,5,0.7727272727272727,26,21,5,0.8076923076923077,0.7898230088495576,llama3,mimiciii,radiology_report,PROMPT2_ICL_entailment
244,318,16,14,2,0.875,21,17,4,0.8095238095238095,0.8409893992932863,llama3,mimiciii,radiology_report,PROMPT2_ICL_entailment
245,319,19,18,1,0.9473684210526316,12,11,1,0.9166666666666666,0.9317647058823528,llama3,mimiciii,radiology_report,PROMPT2_ICL_entailment
246,32,14,13,1,0.9285714285714286,15,11,4,0.7333333333333333,0.8194842406876792,llama3,mimiciii,radiology_report,PROMPT2_ICL_entailment
247,320,10,9,1,0.9,11,9,2,0.8181818181818182,0.8571428571428572,llama3,mimiciii,radiology_report,PROMPT2_ICL_entailment
248,321,17,16,1,0.9411764705882352,21,16,5,0.7619047619047619,0.8421052631578947,llama3,mimiciii,radiology_report,PROMPT2_ICL_entailment
249,322,8,8,0,1.0,8,7,1,0.875,0.9333333333333332,llama3,mimiciii,radiology_report,PROMPT2_ICL_entailment
250,323,20,18,2,0.9,25,19,6,0.76,0.8240963855421687,llama3,mimiciii,radiology_report,PROMPT2_ICL_entailment
251,324,25,23,2,0.92,18,16,2,0.8888888888888888,0.9041769041769042,llama3,mimiciii,radiology_report,PROMPT2_ICL_entailment
252,325,20,18,2,0.9,22,15,7,0.6818181818181818,0.7758620689655172,llama3,mimiciii,radiology_report,PROMPT2_ICL_entailment
253,326,24,23,1,0.9583333333333334,23,19,4,0.8260869565217391,0.8873096446700508,llama3,mimiciii,radiology_report,PROMPT2_ICL_entailment
254,327,10,10,0,1.0,9,7,2,0.7777777777777778,0.8750000000000001,llama3,mimiciii,radiology_report,PROMPT2_ICL_entailment
255,328,13,13,0,1.0,17,14,3,0.8235294117647058,0.9032258064516128,llama3,mimiciii,radiology_report,PROMPT2_ICL_entailment
256,329,19,18,1,0.9473684210526316,24,16,8,0.6666666666666666,0.782608695652174,llama3,mimiciii,radiology_report,PROMPT2_ICL_entailment
257,33,10,10,0,1.0,9,7,2,0.7777777777777778,0.8750000000000001,llama3,mimiciii,radiology_report,PROMPT2_ICL_entailment
258,330,15,12,3,0.8,11,7,4,0.6363636363636364,0.7088607594936709,llama3,mimiciii,radiology_report,PROMPT2_ICL_entailment
259,331,14,13,1,0.9285714285714286,15,12,3,0.8,0.859504132231405,llama3,mimiciii,radiology_report,PROMPT2_ICL_entailment
260,332,16,15,1,0.9375,20,14,6,0.7,0.8015267175572519,llama3,mimiciii,radiology_report,PROMPT2_ICL_entailment
261,333,12,12,0,1.0,13,10,3,0.7692307692307693,0.8695652173913044,llama3,mimiciii,radiology_report,PROMPT2_ICL_entailment
262,334,23,23,0,1.0,20,16,4,0.8,0.888888888888889,llama3,mimiciii,radiology_report,PROMPT2_ICL_entailment
263,335,18,18,0,1.0,17,13,4,0.7647058823529411,0.8666666666666666,llama3,mimiciii,radiology_report,PROMPT2_ICL_entailment
264,336,18,17,1,0.9444444444444444,16,14,2,0.875,0.9083969465648856,llama3,mimiciii,radiology_report,PROMPT2_ICL_entailment
265,337,22,21,1,0.9545454545454546,16,16,0,1.0,0.9767441860465116,llama3,mimiciii,radiology_report,PROMPT2_ICL_entailment
266,338,17,16,1,0.9411764705882352,13,7,6,0.5384615384615384,0.6850152905198776,llama3,mimiciii,radiology_report,PROMPT2_ICL_entailment
267,339,22,21,1,0.9545454545454546,28,22,6,0.7857142857142857,0.8619402985074627,llama3,mimiciii,radiology_report,PROMPT2_ICL_entailment
268,34,13,13,0,1.0,14,12,2,0.8571428571428571,0.923076923076923,llama3,mimiciii,radiology_report,PROMPT2_ICL_entailment
269,340,24,14,10,0.5833333333333334,15,12,3,0.8,0.674698795180723,llama3,mimiciii,radiology_report,PROMPT2_ICL_entailment
270,341,7,7,0,1.0,6,5,1,0.8333333333333334,0.9090909090909092,llama3,mimiciii,radiology_report,PROMPT2_ICL_entailment
271,342,14,14,0,1.0,15,13,2,0.8666666666666667,0.9285714285714286,llama3,mimiciii,radiology_report,PROMPT2_ICL_entailment
272,343,15,15,0,1.0,22,17,5,0.7727272727272727,0.8717948717948718,llama3,mimiciii,radiology_report,PROMPT2_ICL_entailment
273,344,17,17,0,1.0,19,13,6,0.6842105263157895,0.8125000000000001,llama3,mimiciii,radiology_report,PROMPT2_ICL_entailment
274,345,24,23,1,0.9583333333333334,22,16,6,0.7272727272727273,0.8269662921348315,llama3,mimiciii,radiology_report,PROMPT2_ICL_entailment
275,346,10,10,0,1.0,15,10,5,0.6666666666666666,0.8,llama3,mimiciii,radiology_report,PROMPT2_ICL_entailment
276,347,19,18,1,0.9473684210526316,15,13,2,0.8666666666666667,0.9052224371373307,llama3,mimiciii,radiology_report,PROMPT2_ICL_entailment
277,348,14,12,2,0.8571428571428571,12,10,2,0.8333333333333334,0.8450704225352113,llama3,mimiciii,radiology_report,PROMPT2_ICL_entailment
278,349,16,14,2,0.875,16,12,4,0.75,0.8076923076923077,llama3,mimiciii,radiology_report,PROMPT2_ICL_entailment
279,35,17,15,2,0.8823529411764706,21,17,4,0.8095238095238095,0.8443708609271523,llama3,mimiciii,radiology_report,PROMPT2_ICL_entailment
280,350,18,16,2,0.8888888888888888,21,16,5,0.7619047619047619,0.8205128205128205,llama3,mimiciii,radiology_report,PROMPT2_ICL_entailment
281,351,23,13,10,0.5652173913043478,21,19,2,0.9047619047619048,0.695774647887324,llama3,mimiciii,radiology_report,PROMPT2_ICL_entailment
282,352,17,16,1,0.9411764705882352,22,16,6,0.7272727272727273,0.8205128205128205,llama3,mimiciii,radiology_report,PROMPT2_ICL_entailment
283,353,16,13,3,0.8125,23,15,8,0.6521739130434783,0.7235621521335807,llama3,mimiciii,radiology_report,PROMPT2_ICL_entailment
284,354,24,17,7,0.7083333333333334,26,21,5,0.8076923076923077,0.7547568710359409,llama3,mimiciii,radiology_report,PROMPT2_ICL_entailment
285,355,18,16,2,0.8888888888888888,18,14,4,0.7777777777777778,0.8296296296296296,llama3,mimiciii,radiology_report,PROMPT2_ICL_entailment
286,356,20,18,2,0.9,22,18,4,0.8181818181818182,0.8571428571428572,llama3,mimiciii,radiology_report,PROMPT2_ICL_entailment
287,357,11,11,0,1.0,15,8,7,0.5333333333333333,0.6956521739130436,llama3,mimiciii,radiology_report,PROMPT2_ICL_entailment
288,358,15,15,0,1.0,12,8,4,0.6666666666666666,0.8,llama3,mimiciii,radiology_report,PROMPT2_ICL_entailment
289,359,13,11,2,0.8461538461538461,18,16,2,0.8888888888888888,0.8669950738916256,llama3,mimiciii,radiology_report,PROMPT2_ICL_entailment
290,36,19,19,0,1.0,22,18,4,0.8181818181818182,0.9,llama3,mimiciii,radiology_report,PROMPT2_ICL_entailment
291,360,16,14,2,0.875,15,10,5,0.6666666666666666,0.7567567567567567,llama3,mimiciii,radiology_report,PROMPT2_ICL_entailment
292,361,19,12,7,0.631578947368421,23,14,9,0.6086956521739131,0.6199261992619925,llama3,mimiciii,radiology_report,PROMPT2_ICL_entailment
293,362,22,21,1,0.9545454545454546,24,17,7,0.7083333333333334,0.8132118451025057,llama3,mimiciii,radiology_report,PROMPT2_ICL_entailment
294,363,25,22,3,0.88,22,19,3,0.8636363636363636,0.8717413972888426,llama3,mimiciii,radiology_report,PROMPT2_ICL_entailment
295,364,10,9,1,0.9,11,10,1,0.9090909090909092,0.9045226130653266,llama3,mimiciii,radiology_report,PROMPT2_ICL_entailment
296,365,22,15,7,0.6818181818181818,29,20,9,0.6896551724137931,0.6857142857142858,llama3,mimiciii,radiology_report,PROMPT2_ICL_entailment
297,366,14,14,0,1.0,13,7,6,0.5384615384615384,0.7000000000000001,llama3,mimiciii,radiology_report,PROMPT2_ICL_entailment
298,367,21,19,2,0.9047619047619048,16,12,4,0.75,0.8201438848920864,llama3,mimiciii,radiology_report,PROMPT2_ICL_entailment
299,368,18,15,3,0.8333333333333334,20,14,6,0.7,0.7608695652173915,llama3,mimiciii,radiology_report,PROMPT2_ICL_entailment
300,369,19,19,0,1.0,20,16,4,0.8,0.888888888888889,llama3,mimiciii,radiology_report,PROMPT2_ICL_entailment
301,37,11,11,0,1.0,21,12,9,0.5714285714285714,0.7272727272727273,llama3,mimiciii,radiology_report,PROMPT2_ICL_entailment
302,370,20,16,4,0.8,19,12,7,0.631578947368421,0.7058823529411765,llama3,mimiciii,radiology_report,PROMPT2_ICL_entailment
303,371,16,15,1,0.9375,17,14,3,0.8235294117647058,0.8768267223382046,llama3,mimiciii,radiology_report,PROMPT2_ICL_entailment
304,372,23,22,1,0.9565217391304348,27,20,7,0.7407407407407407,0.8349146110056925,llama3,mimiciii,radiology_report,PROMPT2_ICL_entailment
305,373,21,18,3,0.8571428571428571,23,17,6,0.7391304347826086,0.7937743190661479,llama3,mimiciii,radiology_report,PROMPT2_ICL_entailment
306,374,12,12,0,1.0,11,7,4,0.6363636363636364,0.7777777777777778,llama3,mimiciii,radiology_report,PROMPT2_ICL_entailment
307,375,13,13,0,1.0,16,10,6,0.625,0.7692307692307693,llama3,mimiciii,radiology_report,PROMPT2_ICL_entailment
308,376,20,18,2,0.9,18,16,2,0.8888888888888888,0.8944099378881988,llama3,mimiciii,radiology_report,PROMPT2_ICL_entailment
309,377,15,14,1,0.9333333333333332,10,8,2,0.8,0.8615384615384616,llama3,mimiciii,radiology_report,PROMPT2_ICL_entailment
310,378,20,18,2,0.9,24,19,5,0.7916666666666666,0.8423645320197045,llama3,mimiciii,radiology_report,PROMPT2_ICL_entailment
311,379,19,18,1,0.9473684210526316,18,14,4,0.7777777777777778,0.8542372881355932,llama3,mimiciii,radiology_report,PROMPT2_ICL_entailment
312,38,15,14,1,0.9333333333333332,19,16,3,0.8421052631578947,0.8853754940711462,llama3,mimiciii,radiology_report,PROMPT2_ICL_entailment
313,380,11,11,0,1.0,8,6,2,0.75,0.8571428571428571,llama3,mimiciii,radiology_report,PROMPT2_ICL_entailment
314,381,12,12,0,1.0,14,7,7,0.5,0.6666666666666666,llama3,mimiciii,radiology_report,PROMPT2_ICL_entailment
315,382,11,11,0,1.0,13,8,5,0.6153846153846154,0.761904761904762,llama3,mimiciii,radiology_report,PROMPT2_ICL_entailment
316,383,18,18,0,1.0,17,16,1,0.9411764705882352,0.9696969696969696,llama3,mimiciii,radiology_report,PROMPT2_ICL_entailment
317,384,13,13,0,1.0,13,11,2,0.8461538461538461,0.9166666666666666,llama3,mimiciii,radiology_report,PROMPT2_ICL_entailment
318,385,23,18,5,0.782608695652174,27,23,4,0.8518518518518519,0.8157635467980295,llama3,mimiciii,radiology_report,PROMPT2_ICL_entailment
319,386,19,19,0,1.0,18,13,5,0.7222222222222222,0.8387096774193548,llama3,mimiciii,radiology_report,PROMPT2_ICL_entailment
320,387,17,17,0,1.0,19,14,5,0.7368421052631579,0.8484848484848484,llama3,mimiciii,radiology_report,PROMPT2_ICL_entailment
321,388,17,16,1,0.9411764705882352,33,27,6,0.8181818181818182,0.8753799392097266,llama3,mimiciii,radiology_report,PROMPT2_ICL_entailment
322,389,18,17,1,0.9444444444444444,12,11,1,0.9166666666666666,0.9303482587064676,llama3,mimiciii,radiology_report,PROMPT2_ICL_entailment
323,39,15,13,2,0.8666666666666667,10,7,3,0.7,0.774468085106383,llama3,mimiciii,radiology_report,PROMPT2_ICL_entailment
324,390,12,12,0,1.0,14,12,2,0.8571428571428571,0.923076923076923,llama3,mimiciii,radiology_report,PROMPT2_ICL_entailment
325,391,11,11,0,1.0,13,8,5,0.6153846153846154,0.761904761904762,llama3,mimiciii,radiology_report,PROMPT2_ICL_entailment
326,392,12,12,0,1.0,15,11,4,0.7333333333333333,0.846153846153846,llama3,mimiciii,radiology_report,PROMPT2_ICL_entailment
327,393,21,20,1,0.9523809523809524,19,17,2,0.8947368421052632,0.9226594301221168,llama3,mimiciii,radiology_report,PROMPT2_ICL_entailment
328,394,16,16,0,1.0,18,17,1,0.9444444444444444,0.9714285714285714,llama3,mimiciii,radiology_report,PROMPT2_ICL_entailment
329,395,13,13,0,1.0,16,10,6,0.625,0.7692307692307693,llama3,mimiciii,radiology_report,PROMPT2_ICL_entailment
330,396,17,16,1,0.9411764705882352,19,12,7,0.631578947368421,0.7559055118110236,llama3,mimiciii,radiology_report,PROMPT2_ICL_entailment
331,397,18,17,1,0.9444444444444444,18,12,6,0.6666666666666666,0.7816091954022987,llama3,mimiciii,radiology_report,PROMPT2_ICL_entailment
332,398,29,28,1,0.9655172413793104,21,19,2,0.9047619047619048,0.9341527655838456,llama3,mimiciii,radiology_report,PROMPT2_ICL_entailment
333,399,12,12,0,1.0,19,13,6,0.6842105263157895,0.8125000000000001,llama3,mimiciii,radiology_report,PROMPT2_ICL_entailment
334,4,16,15,1,0.9375,16,13,3,0.8125,0.8705357142857143,llama3,mimiciii,radiology_report,PROMPT2_ICL_entailment
335,40,19,18,1,0.9473684210526316,17,16,1,0.9411764705882352,0.9442622950819672,llama3,mimiciii,radiology_report,PROMPT2_ICL_entailment
336,400,9,9,0,1.0,13,7,6,0.5384615384615384,0.7000000000000001,llama3,mimiciii,radiology_report,PROMPT2_ICL_entailment
337,401,11,11,0,1.0,9,9,0,1.0,1.0,llama3,mimiciii,radiology_report,PROMPT2_ICL_entailment
338,402,21,16,5,0.7619047619047619,20,17,3,0.85,0.8035450516986705,llama3,mimiciii,radiology_report,PROMPT2_ICL_entailment
339,403,15,15,0,1.0,18,14,4,0.7777777777777778,0.8750000000000001,llama3,mimiciii,radiology_report,PROMPT2_ICL_entailment
340,404,16,14,2,0.875,19,16,3,0.8421052631578947,0.8582375478927203,llama3,mimiciii,radiology_report,PROMPT2_ICL_entailment
341,405,21,20,1,0.9523809523809524,14,10,4,0.7142857142857143,0.8163265306122449,llama3,mimiciii,radiology_report,PROMPT2_ICL_entailment
342,406,25,22,3,0.88,25,20,5,0.8,0.8380952380952381,llama3,mimiciii,radiology_report,PROMPT2_ICL_entailment
343,407,26,25,1,0.9615384615384616,20,16,4,0.8,0.8733624454148472,llama3,mimiciii,radiology_report,PROMPT2_ICL_entailment
344,408,17,16,1,0.9411764705882352,20,15,5,0.75,0.8347826086956521,llama3,mimiciii,radiology_report,PROMPT2_ICL_entailment
345,409,20,19,1,0.95,18,15,3,0.8333333333333334,0.8878504672897196,llama3,mimiciii,radiology_report,PROMPT2_ICL_entailment
346,41,19,17,2,0.8947368421052632,26,25,1,0.9615384615384616,0.9269356597600872,llama3,mimiciii,radiology_report,PROMPT2_ICL_entailment
347,410,20,18,2,0.9,20,17,3,0.85,0.8742857142857143,llama3,mimiciii,radiology_report,PROMPT2_ICL_entailment
348,411,8,8,0,1.0,6,4,2,0.6666666666666666,0.8,llama3,mimiciii,radiology_report,PROMPT2_ICL_entailment
349,412,18,16,2,0.8888888888888888,26,19,7,0.7307692307692307,0.8021108179419524,llama3,mimiciii,radiology_report,PROMPT2_ICL_entailment
350,413,13,13,0,1.0,14,9,5,0.6428571428571429,0.782608695652174,llama3,mimiciii,radiology_report,PROMPT2_ICL_entailment
351,414,18,15,3,0.8333333333333334,28,20,8,0.7142857142857143,0.7692307692307692,llama3,mimiciii,radiology_report,PROMPT2_ICL_entailment
352,415,15,14,1,0.9333333333333332,20,16,4,0.8,0.8615384615384616,llama3,mimiciii,radiology_report,PROMPT2_ICL_entailment
353,416,16,16,0,1.0,17,10,7,0.5882352941176471,0.7407407407407407,llama3,mimiciii,radiology_report,PROMPT2_ICL_entailment
354,417,23,18,5,0.782608695652174,20,17,3,0.85,0.81491344873502,llama3,mimiciii,radiology_report,PROMPT2_ICL_entailment
355,418,14,14,0,1.0,14,10,4,0.7142857142857143,0.8333333333333333,llama3,mimiciii,radiology_report,PROMPT2_ICL_entailment
356,419,21,19,2,0.9047619047619048,16,12,4,0.75,0.8201438848920864,llama3,mimiciii,radiology_report,PROMPT2_ICL_entailment
357,42,12,12,0,1.0,14,10,4,0.7142857142857143,0.8333333333333333,llama3,mimiciii,radiology_report,PROMPT2_ICL_entailment
358,420,14,13,1,0.9285714285714286,15,11,4,0.7333333333333333,0.8194842406876792,llama3,mimiciii,radiology_report,PROMPT2_ICL_entailment
359,421,21,20,1,0.9523809523809524,23,21,2,0.9130434782608696,0.9322974472807992,llama3,mimiciii,radiology_report,PROMPT2_ICL_entailment
360,422,21,20,1,0.9523809523809524,20,17,3,0.85,0.8982826948480845,llama3,mimiciii,radiology_report,PROMPT2_ICL_entailment
361,423,14,14,0,1.0,12,10,2,0.8333333333333334,0.9090909090909092,llama3,mimiciii,radiology_report,PROMPT2_ICL_entailment
362,424,8,6,2,0.75,9,5,4,0.5555555555555556,0.6382978723404256,llama3,mimiciii,radiology_report,PROMPT2_ICL_entailment
363,425,21,20,1,0.9523809523809524,19,15,4,0.7894736842105263,0.8633093525179856,llama3,mimiciii,radiology_report,PROMPT2_ICL_entailment
364,426,14,14,0,1.0,16,14,2,0.875,0.9333333333333332,llama3,mimiciii,radiology_report,PROMPT2_ICL_entailment
365,427,12,12,0,1.0,15,11,4,0.7333333333333333,0.846153846153846,llama3,mimiciii,radiology_report,PROMPT2_ICL_entailment
366,428,11,11,0,1.0,15,14,1,0.9333333333333332,0.9655172413793104,llama3,mimiciii,radiology_report,PROMPT2_ICL_entailment
367,429,13,12,1,0.9230769230769232,13,10,3,0.7692307692307693,0.8391608391608392,llama3,mimiciii,radiology_report,PROMPT2_ICL_entailment
368,43,8,8,0,1.0,7,6,1,0.8571428571428571,0.923076923076923,llama3,mimiciii,radiology_report,PROMPT2_ICL_entailment
369,430,7,7,0,1.0,7,5,2,0.7142857142857143,0.8333333333333333,llama3,mimiciii,radiology_report,PROMPT2_ICL_entailment
370,431,14,10,4,0.7142857142857143,18,14,4,0.7777777777777778,0.7446808510638298,llama3,mimiciii,radiology_report,PROMPT2_ICL_entailment
371,432,22,22,0,1.0,13,11,2,0.8461538461538461,0.9166666666666666,llama3,mimiciii,radiology_report,PROMPT2_ICL_entailment
372,433,15,13,2,0.8666666666666667,18,15,3,0.8333333333333334,0.8496732026143791,llama3,mimiciii,radiology_report,PROMPT2_ICL_entailment
373,434,19,17,2,0.8947368421052632,27,22,5,0.8148148148148148,0.8529076396807297,llama3,mimiciii,radiology_report,PROMPT2_ICL_entailment
374,435,14,14,0,1.0,13,11,2,0.8461538461538461,0.9166666666666666,llama3,mimiciii,radiology_report,PROMPT2_ICL_entailment
375,436,20,18,2,0.9,25,23,2,0.92,0.90989010989011,llama3,mimiciii,radiology_report,PROMPT2_ICL_entailment
376,437,8,7,1,0.875,7,6,1,0.8571428571428571,0.8659793814432989,llama3,mimiciii,radiology_report,PROMPT2_ICL_entailment
377,438,15,15,0,1.0,19,13,6,0.6842105263157895,0.8125000000000001,llama3,mimiciii,radiology_report,PROMPT2_ICL_entailment
378,439,20,18,2,0.9,22,20,2,0.9090909090909092,0.9045226130653266,llama3,mimiciii,radiology_report,PROMPT2_ICL_entailment
379,44,13,13,0,1.0,16,11,5,0.6875,0.8148148148148148,llama3,mimiciii,radiology_report,PROMPT2_ICL_entailment
380,440,18,18,0,1.0,19,12,7,0.631578947368421,0.7741935483870968,llama3,mimiciii,radiology_report,PROMPT2_ICL_entailment
381,441,21,19,2,0.9047619047619048,17,17,0,1.0,0.95,llama3,mimiciii,radiology_report,PROMPT2_ICL_entailment
382,442,13,12,1,0.9230769230769232,12,9,3,0.75,0.8275862068965517,llama3,mimiciii,radiology_report,PROMPT2_ICL_entailment
383,443,18,17,1,0.9444444444444444,21,15,6,0.7142857142857143,0.813397129186603,llama3,mimiciii,radiology_report,PROMPT2_ICL_entailment
384,444,10,8,2,0.8,8,6,2,0.75,0.7741935483870969,llama3,mimiciii,radiology_report,PROMPT2_ICL_entailment
385,445,19,18,1,0.9473684210526316,22,18,4,0.8181818181818182,0.8780487804878049,llama3,mimiciii,radiology_report,PROMPT2_ICL_entailment
386,446,22,16,6,0.7272727272727273,22,15,7,0.6818181818181818,0.7038123167155425,llama3,mimiciii,radiology_report,PROMPT2_ICL_entailment
387,447,18,17,1,0.9444444444444444,14,9,5,0.6428571428571429,0.765,llama3,mimiciii,radiology_report,PROMPT2_ICL_entailment
388,448,24,24,0,1.0,36,30,6,0.8333333333333334,0.9090909090909092,llama3,mimiciii,radiology_report,PROMPT2_ICL_entailment
389,449,11,9,2,0.8181818181818182,9,6,3,0.6666666666666666,0.7346938775510203,llama3,mimiciii,radiology_report,PROMPT2_ICL_entailment
390,45,14,14,0,1.0,20,13,7,0.65,0.787878787878788,llama3,mimiciii,radiology_report,PROMPT2_ICL_entailment
391,450,23,20,3,0.8695652173913043,21,20,1,0.9523809523809524,0.909090909090909,llama3,mimiciii,radiology_report,PROMPT2_ICL_entailment
392,451,12,12,0,1.0,10,8,2,0.8,0.888888888888889,llama3,mimiciii,radiology_report,PROMPT2_ICL_entailment
393,452,18,18,0,1.0,16,13,3,0.8125,0.896551724137931,llama3,mimiciii,radiology_report,PROMPT2_ICL_entailment
394,453,14,13,1,0.9285714285714286,14,11,3,0.7857142857142857,0.851190476190476,llama3,mimiciii,radiology_report,PROMPT2_ICL_entailment
395,454,11,11,0,1.0,10,7,3,0.7,0.8235294117647058,llama3,mimiciii,radiology_report,PROMPT2_ICL_entailment
396,455,18,17,1,0.9444444444444444,16,13,3,0.8125,0.8735177865612648,llama3,mimiciii,radiology_report,PROMPT2_ICL_entailment
397,456,21,16,5,0.7619047619047619,21,20,1,0.9523809523809524,0.8465608465608465,llama3,mimiciii,radiology_report,PROMPT2_ICL_entailment
398,457,17,15,2,0.8823529411764706,12,9,3,0.75,0.8108108108108107,llama3,mimiciii,radiology_report,PROMPT2_ICL_entailment
399,458,15,15,0,1.0,16,9,7,0.5625,0.72,llama3,mimiciii,radiology_report,PROMPT2_ICL_entailment
400,459,13,13,0,1.0,13,8,5,0.6153846153846154,0.761904761904762,llama3,mimiciii,radiology_report,PROMPT2_ICL_entailment
401,46,17,16,1,0.9411764705882352,22,18,4,0.8181818181818182,0.8753799392097266,llama3,mimiciii,radiology_report,PROMPT2_ICL_entailment
402,460,21,20,1,0.9523809523809524,20,17,3,0.85,0.8982826948480845,llama3,mimiciii,radiology_report,PROMPT2_ICL_entailment
403,461,21,16,5,0.7619047619047619,22,15,7,0.6818181818181818,0.719640179910045,llama3,mimiciii,radiology_report,PROMPT2_ICL_entailment
404,462,22,19,3,0.8636363636363636,20,18,2,0.9,0.8814432989690723,llama3,mimiciii,radiology_report,PROMPT2_ICL_entailment
405,463,9,9,0,1.0,12,9,3,0.75,0.8571428571428571,llama3,mimiciii,radiology_report,PROMPT2_ICL_entailment
406,464,22,18,4,0.8181818181818182,25,20,5,0.8,0.8089887640449439,llama3,mimiciii,radiology_report,PROMPT2_ICL_entailment
407,465,20,19,1,0.95,33,28,5,0.8484848484848485,0.8963774220724516,llama3,mimiciii,radiology_report,PROMPT2_ICL_entailment
408,466,15,14,1,0.9333333333333332,22,14,8,0.6363636363636364,0.7567567567567568,llama3,mimiciii,radiology_report,PROMPT2_ICL_entailment
409,467,12,11,1,0.9166666666666666,14,13,1,0.9285714285714286,0.9225806451612902,llama3,mimiciii,radiology_report,PROMPT2_ICL_entailment
410,468,19,18,1,0.9473684210526316,18,14,4,0.7777777777777778,0.8542372881355932,llama3,mimiciii,radiology_report,PROMPT2_ICL_entailment
411,469,23,20,3,0.8695652173913043,25,22,3,0.88,0.874751491053678,llama3,mimiciii,radiology_report,PROMPT2_ICL_entailment
412,47,19,17,2,0.8947368421052632,15,13,2,0.8666666666666667,0.8804780876494024,llama3,mimiciii,radiology_report,PROMPT2_ICL_entailment
413,470,13,12,1,0.9230769230769232,15,11,4,0.7333333333333333,0.8173374613003097,llama3,mimiciii,radiology_report,PROMPT2_ICL_entailment
414,471,22,21,1,0.9545454545454546,18,15,3,0.8333333333333334,0.8898305084745762,llama3,mimiciii,radiology_report,PROMPT2_ICL_entailment
415,472,15,14,1,0.9333333333333332,16,13,3,0.8125,0.8687350835322195,llama3,mimiciii,radiology_report,PROMPT2_ICL_entailment
416,473,15,15,0,1.0,11,10,1,0.9090909090909092,0.9523809523809524,llama3,mimiciii,radiology_report,PROMPT2_ICL_entailment
417,474,21,21,0,1.0,25,23,2,0.92,0.9583333333333334,llama3,mimiciii,radiology_report,PROMPT2_ICL_entailment
418,475,8,7,1,0.875,7,5,2,0.7142857142857143,0.7865168539325842,llama3,mimiciii,radiology_report,PROMPT2_ICL_entailment
419,476,22,21,1,0.9545454545454546,12,10,2,0.8333333333333334,0.8898305084745762,llama3,mimiciii,radiology_report,PROMPT2_ICL_entailment
420,477,19,15,4,0.7894736842105263,16,11,5,0.6875,0.7349665924276169,llama3,mimiciii,radiology_report,PROMPT2_ICL_entailment
421,478,20,19,1,0.95,21,18,3,0.8571428571428571,0.9011857707509882,llama3,mimiciii,radiology_report,PROMPT2_ICL_entailment
422,479,13,12,1,0.9230769230769232,22,17,5,0.7727272727272727,0.8412371134020619,llama3,mimiciii,radiology_report,PROMPT2_ICL_entailment
423,48,16,15,1,0.9375,21,15,6,0.7142857142857143,0.8108108108108109,llama3,mimiciii,radiology_report,PROMPT2_ICL_entailment
424,480,13,13,0,1.0,10,7,3,0.7,0.8235294117647058,llama3,mimiciii,radiology_report,PROMPT2_ICL_entailment
425,481,19,18,1,0.9473684210526316,17,12,5,0.7058823529411765,0.8089887640449439,llama3,mimiciii,radiology_report,PROMPT2_ICL_entailment
426,482,21,19,2,0.9047619047619048,19,15,4,0.7894736842105263,0.8431952662721893,llama3,mimiciii,radiology_report,PROMPT2_ICL_entailment
427,483,18,17,1,0.9444444444444444,23,14,9,0.6086956521739131,0.7402799377916018,llama3,mimiciii,radiology_report,PROMPT2_ICL_entailment
428,484,11,10,1,0.9090909090909092,13,8,5,0.6153846153846154,0.7339449541284404,llama3,mimiciii,radiology_report,PROMPT2_ICL_entailment
429,485,14,14,0,1.0,24,14,10,0.5833333333333334,0.7368421052631579,llama3,mimiciii,radiology_report,PROMPT2_ICL_entailment
430,486,17,16,1,0.9411764705882352,11,9,2,0.8181818181818182,0.8753799392097266,llama3,mimiciii,radiology_report,PROMPT2_ICL_entailment
431,487,19,18,1,0.9473684210526316,20,19,1,0.95,0.9486823855755894,llama3,mimiciii,radiology_report,PROMPT2_ICL_entailment
432,488,14,12,2,0.8571428571428571,15,14,1,0.9333333333333332,0.8936170212765957,llama3,mimiciii,radiology_report,PROMPT2_ICL_entailment
433,489,23,22,1,0.9565217391304348,18,14,4,0.7777777777777778,0.8579387186629527,llama3,mimiciii,radiology_report,PROMPT2_ICL_entailment
434,49,23,22,1,0.9565217391304348,24,18,6,0.75,0.8407643312101911,llama3,mimiciii,radiology_report,PROMPT2_ICL_entailment
435,490,8,7,1,0.875,8,4,4,0.5,0.6363636363636364,llama3,mimiciii,radiology_report,PROMPT2_ICL_entailment
436,491,15,15,0,1.0,17,10,7,0.5882352941176471,0.7407407407407407,llama3,mimiciii,radiology_report,PROMPT2_ICL_entailment
437,492,13,13,0,1.0,13,7,6,0.5384615384615384,0.7000000000000001,llama3,mimiciii,radiology_report,PROMPT2_ICL_entailment
438,493,13,13,0,1.0,9,7,2,0.7777777777777778,0.8750000000000001,llama3,mimiciii,radiology_report,PROMPT2_ICL_entailment
439,494,9,8,1,0.8888888888888888,8,5,3,0.625,0.7339449541284404,llama3,mimiciii,radiology_report,PROMPT2_ICL_entailment
440,495,13,13,0,1.0,12,10,2,0.8333333333333334,0.9090909090909092,llama3,mimiciii,radiology_report,PROMPT2_ICL_entailment
441,496,20,20,0,1.0,32,16,16,0.5,0.6666666666666666,llama3,mimiciii,radiology_report,PROMPT2_ICL_entailment
442,497,21,17,4,0.8095238095238095,22,18,4,0.8181818181818182,0.8138297872340425,llama3,mimiciii,radiology_report,PROMPT2_ICL_entailment
443,498,23,19,4,0.8260869565217391,22,17,5,0.7727272727272727,0.7985166872682324,llama3,mimiciii,radiology_report,PROMPT2_ICL_entailment
444,499,21,21,0,1.0,17,13,4,0.7647058823529411,0.8666666666666666,llama3,mimiciii,radiology_report,PROMPT2_ICL_entailment
445,5,21,20,1,0.9523809523809524,22,15,7,0.6818181818181818,0.7947019867549667,llama3,mimiciii,radiology_report,PROMPT2_ICL_entailment
446,50,15,15,0,1.0,15,11,4,0.7333333333333333,0.846153846153846,llama3,mimiciii,radiology_report,PROMPT2_ICL_entailment
447,51,14,13,1,0.9285714285714286,13,8,5,0.6153846153846154,0.7402135231316727,llama3,mimiciii,radiology_report,PROMPT2_ICL_entailment
448,52,17,16,1,0.9411764705882352,21,15,6,0.7142857142857143,0.8121827411167514,llama3,mimiciii,radiology_report,PROMPT2_ICL_entailment
449,53,11,11,0,1.0,12,9,3,0.75,0.8571428571428571,llama3,mimiciii,radiology_report,PROMPT2_ICL_entailment
450,54,10,10,0,1.0,10,6,4,0.6,0.7499999999999999,llama3,mimiciii,radiology_report,PROMPT2_ICL_entailment
451,55,14,14,0,1.0,18,15,3,0.8333333333333334,0.9090909090909092,llama3,mimiciii,radiology_report,PROMPT2_ICL_entailment
452,56,17,13,4,0.7647058823529411,21,12,9,0.5714285714285714,0.6540880503144654,llama3,mimiciii,radiology_report,PROMPT2_ICL_entailment
453,57,12,10,2,0.8333333333333334,10,7,3,0.7,0.7608695652173915,llama3,mimiciii,radiology_report,PROMPT2_ICL_entailment
454,58,15,14,1,0.9333333333333332,16,11,5,0.6875,0.7917737789203085,llama3,mimiciii,radiology_report,PROMPT2_ICL_entailment
455,59,13,13,0,1.0,16,14,2,0.875,0.9333333333333332,llama3,mimiciii,radiology_report,PROMPT2_ICL_entailment
456,6,10,10,0,1.0,8,6,2,0.75,0.8571428571428571,llama3,mimiciii,radiology_report,PROMPT2_ICL_entailment
457,60,16,16,0,1.0,19,13,6,0.6842105263157895,0.8125000000000001,llama3,mimiciii,radiology_report,PROMPT2_ICL_entailment
458,61,21,21,0,1.0,22,18,4,0.8181818181818182,0.9,llama3,mimiciii,radiology_report,PROMPT2_ICL_entailment
459,62,22,20,2,0.9090909090909092,13,10,3,0.7692307692307693,0.8333333333333333,llama3,mimiciii,radiology_report,PROMPT2_ICL_entailment
460,63,14,14,0,1.0,15,10,5,0.6666666666666666,0.8,llama3,mimiciii,radiology_report,PROMPT2_ICL_entailment
461,64,23,19,4,0.8260869565217391,20,13,7,0.65,0.727540500736377,llama3,mimiciii,radiology_report,PROMPT2_ICL_entailment
462,65,19,18,1,0.9473684210526316,18,17,1,0.9444444444444444,0.945904173106646,llama3,mimiciii,radiology_report,PROMPT2_ICL_entailment
463,66,21,20,1,0.9523809523809524,29,22,7,0.7586206896551724,0.8445297504798464,llama3,mimiciii,radiology_report,PROMPT2_ICL_entailment
464,67,20,18,2,0.9,28,24,4,0.8571428571428571,0.8780487804878048,llama3,mimiciii,radiology_report,PROMPT2_ICL_entailment
465,68,27,24,3,0.8888888888888888,30,24,6,0.8,0.8421052631578948,llama3,mimiciii,radiology_report,PROMPT2_ICL_entailment
466,69,19,17,2,0.8947368421052632,31,23,8,0.7419354838709677,0.8112033195020748,llama3,mimiciii,radiology_report,PROMPT2_ICL_entailment
467,7,14,13,1,0.9285714285714286,16,14,2,0.875,0.900990099009901,llama3,mimiciii,radiology_report,PROMPT2_ICL_entailment
468,70,19,19,0,1.0,17,17,0,1.0,1.0,llama3,mimiciii,radiology_report,PROMPT2_ICL_entailment
469,71,14,12,2,0.8571428571428571,18,15,3,0.8333333333333334,0.8450704225352113,llama3,mimiciii,radiology_report,PROMPT2_ICL_entailment
470,72,16,15,1,0.9375,13,12,1,0.9230769230769232,0.9302325581395348,llama3,mimiciii,radiology_report,PROMPT2_ICL_entailment
471,73,21,20,1,0.9523809523809524,29,21,8,0.7241379310344828,0.8227228207639568,llama3,mimiciii,radiology_report,PROMPT2_ICL_entailment
472,74,16,16,0,1.0,18,12,6,0.6666666666666666,0.8,llama3,mimiciii,radiology_report,PROMPT2_ICL_entailment
473,75,19,18,1,0.9473684210526316,12,11,1,0.9166666666666666,0.9317647058823528,llama3,mimiciii,radiology_report,PROMPT2_ICL_entailment
474,76,14,12,2,0.8571428571428571,14,10,4,0.7142857142857143,0.7792207792207793,llama3,mimiciii,radiology_report,PROMPT2_ICL_entailment
475,77,25,20,5,0.8,26,22,4,0.8461538461538461,0.8224299065420562,llama3,mimiciii,radiology_report,PROMPT2_ICL_entailment
476,78,21,16,5,0.7619047619047619,33,24,9,0.7272727272727273,0.7441860465116279,llama3,mimiciii,radiology_report,PROMPT2_ICL_entailment
477,79,17,17,0,1.0,17,13,4,0.7647058823529411,0.8666666666666666,llama3,mimiciii,radiology_report,PROMPT2_ICL_entailment
478,8,18,18,0,1.0,15,12,3,0.8,0.888888888888889,llama3,mimiciii,radiology_report,PROMPT2_ICL_entailment
479,80,16,14,2,0.875,25,20,5,0.8,0.8358208955223881,llama3,mimiciii,radiology_report,PROMPT2_ICL_entailment
480,81,17,17,0,1.0,15,9,6,0.6,0.7499999999999999,llama3,mimiciii,radiology_report,PROMPT2_ICL_entailment
481,82,14,11,3,0.7857142857142857,14,12,2,0.8571428571428571,0.8198757763975155,llama3,mimiciii,radiology_report,PROMPT2_ICL_entailment
482,83,24,22,2,0.9166666666666666,17,13,4,0.7647058823529411,0.8338192419825073,llama3,mimiciii,radiology_report,PROMPT2_ICL_entailment
483,84,18,18,0,1.0,20,16,4,0.8,0.888888888888889,llama3,mimiciii,radiology_report,PROMPT2_ICL_entailment
484,85,17,15,2,0.8823529411764706,14,12,2,0.8571428571428571,0.8695652173913043,llama3,mimiciii,radiology_report,PROMPT2_ICL_entailment
485,86,15,15,0,1.0,10,9,1,0.9,0.9473684210526316,llama3,mimiciii,radiology_report,PROMPT2_ICL_entailment
486,87,17,16,1,0.9411764705882352,14,10,4,0.7142857142857143,0.8121827411167514,llama3,mimiciii,radiology_report,PROMPT2_ICL_entailment
487,88,19,17,2,0.8947368421052632,19,16,3,0.8421052631578947,0.8676236044657096,llama3,mimiciii,radiology_report,PROMPT2_ICL_entailment
488,89,23,21,2,0.9130434782608696,18,12,6,0.6666666666666666,0.7706422018348623,llama3,mimiciii,radiology_report,PROMPT2_ICL_entailment
489,9,11,11,0,1.0,13,11,2,0.8461538461538461,0.9166666666666666,llama3,mimiciii,radiology_report,PROMPT2_ICL_entailment
490,90,13,13,0,1.0,14,12,2,0.8571428571428571,0.923076923076923,llama3,mimiciii,radiology_report,PROMPT2_ICL_entailment
491,91,14,14,0,1.0,13,10,3,0.7692307692307693,0.8695652173913044,llama3,mimiciii,radiology_report,PROMPT2_ICL_entailment
492,92,17,15,2,0.8823529411764706,21,14,7,0.6666666666666666,0.7594936708860759,llama3,mimiciii,radiology_report,PROMPT2_ICL_entailment
493,93,19,17,2,0.8947368421052632,15,12,3,0.8,0.84472049689441,llama3,mimiciii,radiology_report,PROMPT2_ICL_entailment
494,94,26,19,7,0.7307692307692307,28,22,6,0.7857142857142857,0.7572463768115941,llama3,mimiciii,radiology_report,PROMPT2_ICL_entailment
495,95,20,19,1,0.95,18,12,6,0.6666666666666666,0.7835051546391752,llama3,mimiciii,radiology_report,PROMPT2_ICL_entailment
496,96,21,20,1,0.9523809523809524,21,16,5,0.7619047619047619,0.8465608465608465,llama3,mimiciii,radiology_report,PROMPT2_ICL_entailment
497,97,18,14,4,0.7777777777777778,23,17,6,0.7391304347826086,0.7579617834394904,llama3,mimiciii,radiology_report,PROMPT2_ICL_entailment
498,98,22,18,4,0.8181818181818182,19,16,3,0.8421052631578947,0.829971181556196,llama3,mimiciii,radiology_report,PROMPT2_ICL_entailment
499,99,16,15,1,0.9375,13,12,1,0.9230769230769232,0.9302325581395348,llama3,mimiciii,radiology_report,PROMPT2_ICL_entailment
0,0,20,19,1,0.95,21,19,2,0.9047619047619048,0.9268292682926828,llama3,mimiciii,radiology_report,PROMPT2_entailment
1,1,15,14,1,0.9333333333333332,15,12,3,0.8,0.8615384615384616,llama3,mimiciii,radiology_report,PROMPT2_entailment
2,10,13,13,0,1.0,18,17,1,0.9444444444444444,0.9714285714285714,llama3,mimiciii,radiology_report,PROMPT2_entailment
3,100,11,11,0,1.0,9,9,0,1.0,1.0,llama3,mimiciii,radiology_report,PROMPT2_entailment
4,101,13,12,1,0.9230769230769232,15,11,4,0.7333333333333333,0.8173374613003097,llama3,mimiciii,radiology_report,PROMPT2_entailment
5,102,11,11,0,1.0,16,13,3,0.8125,0.896551724137931,llama3,mimiciii,radiology_report,PROMPT2_entailment
6,103,17,17,0,1.0,19,17,2,0.8947368421052632,0.9444444444444444,llama3,mimiciii,radiology_report,PROMPT2_entailment
7,104,15,14,1,0.9333333333333332,17,14,3,0.8235294117647058,0.8749999999999999,llama3,mimiciii,radiology_report,PROMPT2_entailment
8,105,7,7,0,1.0,8,6,2,0.75,0.8571428571428571,llama3,mimiciii,radiology_report,PROMPT2_entailment
9,106,12,12,0,1.0,12,9,3,0.75,0.8571428571428571,llama3,mimiciii,radiology_report,PROMPT2_entailment
10,107,14,13,1,0.9285714285714286,19,14,5,0.7368421052631579,0.8216704288939053,llama3,mimiciii,radiology_report,PROMPT2_entailment
11,108,13,13,0,1.0,13,12,1,0.9230769230769232,0.96,llama3,mimiciii,radiology_report,PROMPT2_entailment
12,109,14,14,0,1.0,20,18,2,0.9,0.9473684210526316,llama3,mimiciii,radiology_report,PROMPT2_entailment
13,11,12,12,0,1.0,20,16,4,0.8,0.888888888888889,llama3,mimiciii,radiology_report,PROMPT2_entailment
14,110,16,16,0,1.0,17,17,0,1.0,1.0,llama3,mimiciii,radiology_report,PROMPT2_entailment
15,111,14,13,1,0.9285714285714286,20,17,3,0.85,0.8875502008032129,llama3,mimiciii,radiology_report,PROMPT2_entailment
16,112,10,10,0,1.0,14,14,0,1.0,1.0,llama3,mimiciii,radiology_report,PROMPT2_entailment
17,113,20,14,6,0.7,20,17,3,0.85,0.767741935483871,llama3,mimiciii,radiology_report,PROMPT2_entailment
18,114,11,9,2,0.8181818181818182,23,18,5,0.782608695652174,0.8,llama3,mimiciii,radiology_report,PROMPT2_entailment
19,115,17,17,0,1.0,20,17,3,0.85,0.9189189189189187,llama3,mimiciii,radiology_report,PROMPT2_entailment
20,116,10,10,0,1.0,13,10,3,0.7692307692307693,0.8695652173913044,llama3,mimiciii,radiology_report,PROMPT2_entailment
21,117,12,10,2,0.8333333333333334,16,13,3,0.8125,0.8227848101265822,llama3,mimiciii,radiology_report,PROMPT2_entailment
22,118,16,13,3,0.8125,24,21,3,0.875,0.8425925925925926,llama3,mimiciii,radiology_report,PROMPT2_entailment
23,119,16,15,1,0.9375,17,12,5,0.7058823529411765,0.8053691275167786,llama3,mimiciii,radiology_report,PROMPT2_entailment
24,12,12,12,0,1.0,17,16,1,0.9411764705882352,0.9696969696969696,llama3,mimiciii,radiology_report,PROMPT2_entailment
25,120,16,15,1,0.9375,16,11,5,0.6875,0.7932692307692307,llama3,mimiciii,radiology_report,PROMPT2_entailment
26,121,16,14,2,0.875,26,25,1,0.9615384615384616,0.9162303664921464,llama3,mimiciii,radiology_report,PROMPT2_entailment
27,122,13,13,0,1.0,20,15,5,0.75,0.8571428571428571,llama3,mimiciii,radiology_report,PROMPT2_entailment
28,123,11,11,0,1.0,13,10,3,0.7692307692307693,0.8695652173913044,llama3,mimiciii,radiology_report,PROMPT2_entailment
29,124,10,9,1,0.9,12,8,4,0.6666666666666666,0.7659574468085106,llama3,mimiciii,radiology_report,PROMPT2_entailment
30,125,17,16,1,0.9411764705882352,23,20,3,0.8695652173913043,0.903954802259887,llama3,mimiciii,radiology_report,PROMPT2_entailment
31,126,8,8,0,1.0,9,7,2,0.7777777777777778,0.8750000000000001,llama3,mimiciii,radiology_report,PROMPT2_entailment
32,127,22,21,1,0.9545454545454546,43,32,11,0.7441860465116279,0.836341008089608,llama3,mimiciii,radiology_report,PROMPT2_entailment
33,128,12,12,0,1.0,14,11,3,0.7857142857142857,0.88,llama3,mimiciii,radiology_report,PROMPT2_entailment
34,129,11,11,0,1.0,16,13,3,0.8125,0.896551724137931,llama3,mimiciii,radiology_report,PROMPT2_entailment
35,13,14,13,1,0.9285714285714286,17,15,2,0.8823529411764706,0.9048723897911832,llama3,mimiciii,radiology_report,PROMPT2_entailment
36,130,18,18,0,1.0,25,17,8,0.68,0.8095238095238095,llama3,mimiciii,radiology_report,PROMPT2_entailment
37,131,11,10,1,0.9090909090909092,32,23,9,0.71875,0.8027923211169284,llama3,mimiciii,radiology_report,PROMPT2_entailment
38,132,14,11,3,0.7857142857142857,23,21,2,0.9130434782608696,0.8446069469835467,llama3,mimiciii,radiology_report,PROMPT2_entailment
39,133,16,14,2,0.875,21,16,5,0.7619047619047619,0.8145454545454546,llama3,mimiciii,radiology_report,PROMPT2_entailment
40,134,11,11,0,1.0,23,16,7,0.6956521739130435,0.8205128205128205,llama3,mimiciii,radiology_report,PROMPT2_entailment
41,135,15,14,1,0.9333333333333332,20,17,3,0.85,0.8897196261682243,llama3,mimiciii,radiology_report,PROMPT2_entailment
42,136,11,11,0,1.0,14,11,3,0.7857142857142857,0.88,llama3,mimiciii,radiology_report,PROMPT2_entailment
43,137,8,8,0,1.0,10,8,2,0.8,0.888888888888889,llama3,mimiciii,radiology_report,PROMPT2_entailment
44,138,16,15,1,0.9375,14,12,2,0.8571428571428571,0.8955223880597014,llama3,mimiciii,radiology_report,PROMPT2_entailment
45,139,10,10,0,1.0,13,11,2,0.8461538461538461,0.9166666666666666,llama3,mimiciii,radiology_report,PROMPT2_entailment
46,14,9,9,0,1.0,12,12,0,1.0,1.0,llama3,mimiciii,radiology_report,PROMPT2_entailment
47,140,14,14,0,1.0,18,15,3,0.8333333333333334,0.9090909090909092,llama3,mimiciii,radiology_report,PROMPT2_entailment
48,141,16,13,3,0.8125,16,11,5,0.6875,0.7447916666666666,llama3,mimiciii,radiology_report,PROMPT2_entailment
49,142,11,10,1,0.9090909090909092,14,13,1,0.9285714285714286,0.9187279151943464,llama3,mimiciii,radiology_report,PROMPT2_entailment
50,143,20,16,4,0.8,28,21,7,0.75,0.7741935483870969,llama3,mimiciii,radiology_report,PROMPT2_entailment
51,144,10,10,0,1.0,23,19,4,0.8260869565217391,0.9047619047619048,llama3,mimiciii,radiology_report,PROMPT2_entailment
52,145,15,15,0,1.0,18,16,2,0.8888888888888888,0.9411764705882352,llama3,mimiciii,radiology_report,PROMPT2_entailment
53,146,10,10,0,1.0,11,6,5,0.5454545454545454,0.7058823529411764,llama3,mimiciii,radiology_report,PROMPT2_entailment
54,147,8,7,1,0.875,10,6,4,0.6,0.711864406779661,llama3,mimiciii,radiology_report,PROMPT2_entailment
55,148,17,16,1,0.9411764705882352,26,22,4,0.8461538461538461,0.8911392405063291,llama3,mimiciii,radiology_report,PROMPT2_entailment
56,149,14,13,1,0.9285714285714286,20,19,1,0.95,0.9391634980988592,llama3,mimiciii,radiology_report,PROMPT2_entailment
57,15,16,13,3,0.8125,29,22,7,0.7586206896551724,0.784636488340192,llama3,mimiciii,radiology_report,PROMPT2_entailment
58,150,14,13,1,0.9285714285714286,14,12,2,0.8571428571428571,0.8914285714285715,llama3,mimiciii,radiology_report,PROMPT2_entailment
59,151,14,11,3,0.7857142857142857,15,10,5,0.6666666666666666,0.721311475409836,llama3,mimiciii,radiology_report,PROMPT2_entailment
60,152,16,14,2,0.875,18,12,6,0.6666666666666666,0.7567567567567567,llama3,mimiciii,radiology_report,PROMPT2_entailment
61,153,13,12,1,0.9230769230769232,16,16,0,1.0,0.96,llama3,mimiciii,radiology_report,PROMPT2_entailment
62,154,17,15,2,0.8823529411764706,23,20,3,0.8695652173913043,0.8759124087591241,llama3,mimiciii,radiology_report,PROMPT2_entailment
63,155,23,22,1,0.9565217391304348,47,36,11,0.7659574468085106,0.8506981740064447,llama3,mimiciii,radiology_report,PROMPT2_entailment
64,156,16,14,2,0.875,20,14,6,0.7,0.7777777777777777,llama3,mimiciii,radiology_report,PROMPT2_entailment
65,157,14,14,0,1.0,12,10,2,0.8333333333333334,0.9090909090909092,llama3,mimiciii,radiology_report,PROMPT2_entailment
66,158,8,8,0,1.0,6,3,3,0.5,0.6666666666666666,llama3,mimiciii,radiology_report,PROMPT2_entailment
67,159,10,9,1,0.9,13,11,2,0.8461538461538461,0.8722466960352422,llama3,mimiciii,radiology_report,PROMPT2_entailment
68,16,15,14,1,0.9333333333333332,17,16,1,0.9411764705882352,0.9372384937238494,llama3,mimiciii,radiology_report,PROMPT2_entailment
69,160,16,16,0,1.0,12,11,1,0.9166666666666666,0.9565217391304348,llama3,mimiciii,radiology_report,PROMPT2_entailment
70,161,12,11,1,0.9166666666666666,13,10,3,0.7692307692307693,0.8365019011406845,llama3,mimiciii,radiology_report,PROMPT2_entailment
71,162,14,14,0,1.0,11,9,2,0.8181818181818182,0.9,llama3,mimiciii,radiology_report,PROMPT2_entailment
72,163,11,11,0,1.0,8,5,3,0.625,0.7692307692307693,llama3,mimiciii,radiology_report,PROMPT2_entailment
73,164,10,10,0,1.0,10,7,3,0.7,0.8235294117647058,llama3,mimiciii,radiology_report,PROMPT2_entailment
74,165,18,13,5,0.7222222222222222,28,22,6,0.7857142857142857,0.7526315789473684,llama3,mimiciii,radiology_report,PROMPT2_entailment
75,166,20,19,1,0.95,26,19,7,0.7307692307692307,0.8260869565217392,llama3,mimiciii,radiology_report,PROMPT2_entailment
76,167,9,9,0,1.0,10,8,2,0.8,0.888888888888889,llama3,mimiciii,radiology_report,PROMPT2_entailment
77,168,10,9,1,0.9,13,8,5,0.6153846153846154,0.7309644670050762,llama3,mimiciii,radiology_report,PROMPT2_entailment
78,169,16,15,1,0.9375,22,20,2,0.9090909090909092,0.923076923076923,llama3,mimiciii,radiology_report,PROMPT2_entailment
79,17,8,8,0,1.0,12,9,3,0.75,0.8571428571428571,llama3,mimiciii,radiology_report,PROMPT2_entailment
80,170,20,19,1,0.95,24,19,5,0.7916666666666666,0.8636363636363635,llama3,mimiciii,radiology_report,PROMPT2_entailment
81,171,9,8,1,0.8888888888888888,7,5,2,0.7142857142857143,0.792079207920792,llama3,mimiciii,radiology_report,PROMPT2_entailment
82,172,8,8,0,1.0,14,10,4,0.7142857142857143,0.8333333333333333,llama3,mimiciii,radiology_report,PROMPT2_entailment
83,173,10,10,0,1.0,12,11,1,0.9166666666666666,0.9565217391304348,llama3,mimiciii,radiology_report,PROMPT2_entailment
84,174,14,13,1,0.9285714285714286,20,13,7,0.65,0.7647058823529412,llama3,mimiciii,radiology_report,PROMPT2_entailment
85,175,9,9,0,1.0,8,7,1,0.875,0.9333333333333332,llama3,mimiciii,radiology_report,PROMPT2_entailment
86,176,19,18,1,0.9473684210526316,19,18,1,0.9473684210526316,0.9473684210526316,llama3,mimiciii,radiology_report,PROMPT2_entailment
87,177,16,15,1,0.9375,16,13,3,0.8125,0.8705357142857143,llama3,mimiciii,radiology_report,PROMPT2_entailment
88,178,15,11,4,0.7333333333333333,25,21,4,0.84,0.783050847457627,llama3,mimiciii,radiology_report,PROMPT2_entailment
89,179,10,10,0,1.0,17,11,6,0.6470588235294118,0.7857142857142858,llama3,mimiciii,radiology_report,PROMPT2_entailment
90,18,15,15,0,1.0,17,13,4,0.7647058823529411,0.8666666666666666,llama3,mimiciii,radiology_report,PROMPT2_entailment
91,180,12,12,0,1.0,11,10,1,0.9090909090909092,0.9523809523809524,llama3,mimiciii,radiology_report,PROMPT2_entailment
92,181,17,11,6,0.6470588235294118,26,22,4,0.8461538461538461,0.7333333333333334,llama3,mimiciii,radiology_report,PROMPT2_entailment
93,182,16,15,1,0.9375,23,18,5,0.782608695652174,0.8530805687203792,llama3,mimiciii,radiology_report,PROMPT2_entailment
94,183,15,13,2,0.8666666666666667,17,11,6,0.6470588235294118,0.7409326424870467,llama3,mimiciii,radiology_report,PROMPT2_entailment
95,184,9,9,0,1.0,15,12,3,0.8,0.888888888888889,llama3,mimiciii,radiology_report,PROMPT2_entailment
96,185,8,8,0,1.0,6,5,1,0.8333333333333334,0.9090909090909092,llama3,mimiciii,radiology_report,PROMPT2_entailment
97,186,15,14,1,0.9333333333333332,26,25,1,0.9615384615384616,0.9472259810554804,llama3,mimiciii,radiology_report,PROMPT2_entailment
98,187,13,12,1,0.9230769230769232,14,12,2,0.8571428571428571,0.888888888888889,llama3,mimiciii,radiology_report,PROMPT2_entailment
99,188,15,13,2,0.8666666666666667,22,19,3,0.8636363636363636,0.8651488616462346,llama3,mimiciii,radiology_report,PROMPT2_entailment
100,189,13,11,2,0.8461538461538461,15,13,2,0.8666666666666667,0.8562874251497006,llama3,mimiciii,radiology_report,PROMPT2_entailment
101,19,10,10,0,1.0,14,11,3,0.7857142857142857,0.88,llama3,mimiciii,radiology_report,PROMPT2_entailment
102,190,14,13,1,0.9285714285714286,17,15,2,0.8823529411764706,0.9048723897911832,llama3,mimiciii,radiology_report,PROMPT2_entailment
103,191,15,13,2,0.8666666666666667,15,12,3,0.8,0.832,llama3,mimiciii,radiology_report,PROMPT2_entailment
104,192,16,14,2,0.875,28,21,7,0.75,0.8076923076923077,llama3,mimiciii,radiology_report,PROMPT2_entailment
105,193,15,13,2,0.8666666666666667,14,12,2,0.8571428571428571,0.861878453038674,llama3,mimiciii,radiology_report,PROMPT2_entailment
106,194,16,16,0,1.0,38,19,19,0.5,0.6666666666666666,llama3,mimiciii,radiology_report,PROMPT2_entailment
107,195,19,19,0,1.0,21,19,2,0.9047619047619048,0.95,llama3,mimiciii,radiology_report,PROMPT2_entailment
108,196,13,12,1,0.9230769230769232,18,14,4,0.7777777777777778,0.8442211055276381,llama3,mimiciii,radiology_report,PROMPT2_entailment
109,197,11,11,0,1.0,15,13,2,0.8666666666666667,0.9285714285714286,llama3,mimiciii,radiology_report,PROMPT2_entailment
110,198,8,8,0,1.0,9,8,1,0.8888888888888888,0.9411764705882352,llama3,mimiciii,radiology_report,PROMPT2_entailment
111,199,16,13,3,0.8125,23,20,3,0.8695652173913043,0.8400646203554121,llama3,mimiciii,radiology_report,PROMPT2_entailment
112,2,10,9,1,0.9,15,9,6,0.6,0.7200000000000001,llama3,mimiciii,radiology_report,PROMPT2_entailment
113,20,18,18,0,1.0,36,33,3,0.9166666666666666,0.9565217391304348,llama3,mimiciii,radiology_report,PROMPT2_entailment
114,200,13,12,1,0.9230769230769232,14,13,1,0.9285714285714286,0.9258160237388724,llama3,mimiciii,radiology_report,PROMPT2_entailment
115,201,14,13,1,0.9285714285714286,18,15,3,0.8333333333333334,0.8783783783783784,llama3,mimiciii,radiology_report,PROMPT2_entailment
116,202,16,15,1,0.9375,24,14,10,0.5833333333333334,0.7191780821917807,llama3,mimiciii,radiology_report,PROMPT2_entailment
117,203,21,16,5,0.7619047619047619,19,16,3,0.8421052631578947,0.8,llama3,mimiciii,radiology_report,PROMPT2_entailment
118,204,15,15,0,1.0,23,20,3,0.8695652173913043,0.9302325581395348,llama3,mimiciii,radiology_report,PROMPT2_entailment
119,205,14,14,0,1.0,14,11,3,0.7857142857142857,0.88,llama3,mimiciii,radiology_report,PROMPT2_entailment
120,206,14,13,1,0.9285714285714286,13,9,4,0.6923076923076923,0.7932203389830509,llama3,mimiciii,radiology_report,PROMPT2_entailment
121,207,8,7,1,0.875,9,6,3,0.6666666666666666,0.7567567567567567,llama3,mimiciii,radiology_report,PROMPT2_entailment
122,208,15,14,1,0.9333333333333332,18,15,3,0.8333333333333334,0.8805031446540881,llama3,mimiciii,radiology_report,PROMPT2_entailment
123,209,15,15,0,1.0,16,14,2,0.875,0.9333333333333332,llama3,mimiciii,radiology_report,PROMPT2_entailment
124,21,19,19,0,1.0,27,21,6,0.7777777777777778,0.8750000000000001,llama3,mimiciii,radiology_report,PROMPT2_entailment
125,210,9,9,0,1.0,14,11,3,0.7857142857142857,0.88,llama3,mimiciii,radiology_report,PROMPT2_entailment
126,211,12,11,1,0.9166666666666666,13,11,2,0.8461538461538461,0.8799999999999999,llama3,mimiciii,radiology_report,PROMPT2_entailment
127,212,14,11,3,0.7857142857142857,19,18,1,0.9473684210526316,0.8590021691973969,llama3,mimiciii,radiology_report,PROMPT2_entailment
128,213,15,14,1,0.9333333333333332,22,17,5,0.7727272727272727,0.8454706927175843,llama3,mimiciii,radiology_report,PROMPT2_entailment
129,214,22,15,7,0.6818181818181818,23,16,7,0.6956521739130435,0.6886657101865136,llama3,mimiciii,radiology_report,PROMPT2_entailment
130,215,9,9,0,1.0,10,7,3,0.7,0.8235294117647058,llama3,mimiciii,radiology_report,PROMPT2_entailment
131,216,10,10,0,1.0,19,16,3,0.8421052631578947,0.9142857142857144,llama3,mimiciii,radiology_report,PROMPT2_entailment
132,217,15,13,2,0.8666666666666667,20,13,7,0.65,0.7428571428571429,llama3,mimiciii,radiology_report,PROMPT2_entailment
133,218,18,17,1,0.9444444444444444,15,13,2,0.8666666666666667,0.9038854805725972,llama3,mimiciii,radiology_report,PROMPT2_entailment
134,219,14,11,3,0.7857142857142857,13,10,3,0.7692307692307693,0.7773851590106008,llama3,mimiciii,radiology_report,PROMPT2_entailment
135,22,15,15,0,1.0,19,18,1,0.9473684210526316,0.972972972972973,llama3,mimiciii,radiology_report,PROMPT2_entailment
136,220,14,13,1,0.9285714285714286,19,13,6,0.6842105263157895,0.7878787878787878,llama3,mimiciii,radiology_report,PROMPT2_entailment
137,221,17,17,0,1.0,27,20,7,0.7407407407407407,0.851063829787234,llama3,mimiciii,radiology_report,PROMPT2_entailment
138,222,14,14,0,1.0,16,13,3,0.8125,0.896551724137931,llama3,mimiciii,radiology_report,PROMPT2_entailment
139,223,15,14,1,0.9333333333333332,21,17,4,0.8095238095238095,0.8670309653916211,llama3,mimiciii,radiology_report,PROMPT2_entailment
140,224,14,13,1,0.9285714285714286,17,15,2,0.8823529411764706,0.9048723897911832,llama3,mimiciii,radiology_report,PROMPT2_entailment
141,225,12,12,0,1.0,11,8,3,0.7272727272727273,0.8421052631578948,llama3,mimiciii,radiology_report,PROMPT2_entailment
142,226,16,14,2,0.875,18,16,2,0.8888888888888888,0.8818897637795274,llama3,mimiciii,radiology_report,PROMPT2_entailment
143,227,15,15,0,1.0,18,16,2,0.8888888888888888,0.9411764705882352,llama3,mimiciii,radiology_report,PROMPT2_entailment
144,228,11,11,0,1.0,17,16,1,0.9411764705882352,0.9696969696969696,llama3,mimiciii,radiology_report,PROMPT2_entailment
145,229,15,15,0,1.0,44,32,12,0.7272727272727273,0.8421052631578948,llama3,mimiciii,radiology_report,PROMPT2_entailment
146,23,15,15,0,1.0,15,13,2,0.8666666666666667,0.9285714285714286,llama3,mimiciii,radiology_report,PROMPT2_entailment
147,230,12,9,3,0.75,17,16,1,0.9411764705882352,0.8347826086956521,llama3,mimiciii,radiology_report,PROMPT2_entailment
148,231,10,10,0,1.0,13,8,5,0.6153846153846154,0.761904761904762,llama3,mimiciii,radiology_report,PROMPT2_entailment
149,232,15,14,1,0.9333333333333332,18,17,1,0.9444444444444444,0.9388560157790926,llama3,mimiciii,radiology_report,PROMPT2_entailment
150,233,14,13,1,0.9285714285714286,17,12,5,0.7058823529411765,0.802056555269923,llama3,mimiciii,radiology_report,PROMPT2_entailment
151,234,9,8,1,0.8888888888888888,11,9,2,0.8181818181818182,0.8520710059171598,llama3,mimiciii,radiology_report,PROMPT2_entailment
152,235,10,10,0,1.0,14,10,4,0.7142857142857143,0.8333333333333333,llama3,mimiciii,radiology_report,PROMPT2_entailment
153,236,14,14,0,1.0,11,9,2,0.8181818181818182,0.9,llama3,mimiciii,radiology_report,PROMPT2_entailment
154,237,17,17,0,1.0,17,15,2,0.8823529411764706,0.9375,llama3,mimiciii,radiology_report,PROMPT2_entailment
155,238,16,15,1,0.9375,20,16,4,0.8,0.8633093525179856,llama3,mimiciii,radiology_report,PROMPT2_entailment
156,239,15,14,1,0.9333333333333332,17,11,6,0.6470588235294118,0.7642679900744417,llama3,mimiciii,radiology_report,PROMPT2_entailment
157,24,11,11,0,1.0,18,15,3,0.8333333333333334,0.9090909090909092,llama3,mimiciii,radiology_report,PROMPT2_entailment
158,240,10,10,0,1.0,13,12,1,0.9230769230769232,0.96,llama3,mimiciii,radiology_report,PROMPT2_entailment
159,241,12,12,0,1.0,16,14,2,0.875,0.9333333333333332,llama3,mimiciii,radiology_report,PROMPT2_entailment
160,242,10,10,0,1.0,18,14,4,0.7777777777777778,0.8750000000000001,llama3,mimiciii,radiology_report,PROMPT2_entailment
161,243,12,12,0,1.0,13,8,5,0.6153846153846154,0.761904761904762,llama3,mimiciii,radiology_report,PROMPT2_entailment
162,244,13,13,0,1.0,17,17,0,1.0,1.0,llama3,mimiciii,radiology_report,PROMPT2_entailment
163,245,21,17,4,0.8095238095238095,28,25,3,0.8928571428571429,0.8491508491508492,llama3,mimiciii,radiology_report,PROMPT2_entailment
164,246,9,9,0,1.0,12,8,4,0.6666666666666666,0.8,llama3,mimiciii,radiology_report,PROMPT2_entailment
165,247,11,10,1,0.9090909090909092,12,9,3,0.75,0.821917808219178,llama3,mimiciii,radiology_report,PROMPT2_entailment
166,248,16,15,1,0.9375,17,13,4,0.7647058823529411,0.8423326133909286,llama3,mimiciii,radiology_report,PROMPT2_entailment
167,249,17,16,1,0.9411764705882352,23,17,6,0.7391304347826086,0.8280060882800608,llama3,mimiciii,radiology_report,PROMPT2_entailment
168,25,18,16,2,0.8888888888888888,27,20,7,0.7407407407407407,0.808080808080808,llama3,mimiciii,radiology_report,PROMPT2_entailment
169,250,10,10,0,1.0,8,6,2,0.75,0.8571428571428571,llama3,mimiciii,radiology_report,PROMPT2_entailment
170,251,18,16,2,0.8888888888888888,22,18,4,0.8181818181818182,0.8520710059171598,llama3,mimiciii,radiology_report,PROMPT2_entailment
171,252,9,8,1,0.8888888888888888,10,7,3,0.7,0.7832167832167831,llama3,mimiciii,radiology_report,PROMPT2_entailment
172,253,17,13,4,0.7647058823529411,24,21,3,0.875,0.8161434977578476,llama3,mimiciii,radiology_report,PROMPT2_entailment
173,254,11,10,1,0.9090909090909092,13,9,4,0.6923076923076923,0.7860262008733625,llama3,mimiciii,radiology_report,PROMPT2_entailment
174,255,13,13,0,1.0,16,13,3,0.8125,0.896551724137931,llama3,mimiciii,radiology_report,PROMPT2_entailment
175,256,15,13,2,0.8666666666666667,19,17,2,0.8947368421052632,0.8804780876494024,llama3,mimiciii,radiology_report,PROMPT2_entailment
176,257,11,11,0,1.0,15,14,1,0.9333333333333332,0.9655172413793104,llama3,mimiciii,radiology_report,PROMPT2_entailment
177,258,15,15,0,1.0,20,12,8,0.6,0.7499999999999999,llama3,mimiciii,radiology_report,PROMPT2_entailment
178,259,13,12,1,0.9230769230769232,17,14,3,0.8235294117647058,0.8704663212435233,llama3,mimiciii,radiology_report,PROMPT2_entailment
179,26,16,15,1,0.9375,18,13,5,0.7222222222222222,0.8158995815899581,llama3,mimiciii,radiology_report,PROMPT2_entailment
180,260,19,19,0,1.0,20,12,8,0.6,0.7499999999999999,llama3,mimiciii,radiology_report,PROMPT2_entailment
181,261,21,18,3,0.8571428571428571,30,27,3,0.9,0.8780487804878048,llama3,mimiciii,radiology_report,PROMPT2_entailment
182,262,14,13,1,0.9285714285714286,23,16,7,0.6956521739130435,0.7954110898661568,llama3,mimiciii,radiology_report,PROMPT2_entailment
183,263,15,15,0,1.0,27,22,5,0.8148148148148148,0.8979591836734693,llama3,mimiciii,radiology_report,PROMPT2_entailment
184,264,13,13,0,1.0,20,17,3,0.85,0.9189189189189187,llama3,mimiciii,radiology_report,PROMPT2_entailment
185,265,10,10,0,1.0,9,9,0,1.0,1.0,llama3,mimiciii,radiology_report,PROMPT2_entailment
186,266,13,11,2,0.8461538461538461,18,17,1,0.9444444444444444,0.8926014319809069,llama3,mimiciii,radiology_report,PROMPT2_entailment
187,267,11,11,0,1.0,16,14,2,0.875,0.9333333333333332,llama3,mimiciii,radiology_report,PROMPT2_entailment
188,268,13,13,0,1.0,20,14,6,0.7,0.8235294117647058,llama3,mimiciii,radiology_report,PROMPT2_entailment
189,269,16,16,0,1.0,25,19,6,0.76,0.8636363636363636,llama3,mimiciii,radiology_report,PROMPT2_entailment
190,27,15,14,1,0.9333333333333332,14,11,3,0.7857142857142857,0.8531855955678669,llama3,mimiciii,radiology_report,PROMPT2_entailment
191,270,16,14,2,0.875,17,16,1,0.9411764705882352,0.9068825910931174,llama3,mimiciii,radiology_report,PROMPT2_entailment
192,271,15,14,1,0.9333333333333332,17,13,4,0.7647058823529411,0.8406466512702079,llama3,mimiciii,radiology_report,PROMPT2_entailment
193,272,17,15,2,0.8823529411764706,17,15,2,0.8823529411764706,0.8823529411764706,llama3,mimiciii,radiology_report,PROMPT2_entailment
194,273,13,11,2,0.8461538461538461,12,8,4,0.6666666666666666,0.7457627118644068,llama3,mimiciii,radiology_report,PROMPT2_entailment
195,274,12,11,1,0.9166666666666666,20,15,5,0.75,0.8250000000000001,llama3,mimiciii,radiology_report,PROMPT2_entailment
196,275,12,12,0,1.0,12,11,1,0.9166666666666666,0.9565217391304348,llama3,mimiciii,radiology_report,PROMPT2_entailment
197,276,13,13,0,1.0,24,19,5,0.7916666666666666,0.8837209302325582,llama3,mimiciii,radiology_report,PROMPT2_entailment
198,277,17,15,2,0.8823529411764706,25,22,3,0.88,0.8811748998664888,llama3,mimiciii,radiology_report,PROMPT2_entailment
199,278,16,15,1,0.9375,16,13,3,0.8125,0.8705357142857143,llama3,mimiciii,radiology_report,PROMPT2_entailment
200,279,11,11,0,1.0,10,8,2,0.8,0.888888888888889,llama3,mimiciii,radiology_report,PROMPT2_entailment
201,28,20,16,4,0.8,30,24,6,0.8,0.8000000000000002,llama3,mimiciii,radiology_report,PROMPT2_entailment
202,280,11,11,0,1.0,12,11,1,0.9166666666666666,0.9565217391304348,llama3,mimiciii,radiology_report,PROMPT2_entailment
203,281,13,13,0,1.0,24,19,5,0.7916666666666666,0.8837209302325582,llama3,mimiciii,radiology_report,PROMPT2_entailment
204,282,16,16,0,1.0,12,10,2,0.8333333333333334,0.9090909090909092,llama3,mimiciii,radiology_report,PROMPT2_entailment
205,283,16,15,1,0.9375,25,20,5,0.8,0.8633093525179856,llama3,mimiciii,radiology_report,PROMPT2_entailment
206,284,14,13,1,0.9285714285714286,14,12,2,0.8571428571428571,0.8914285714285715,llama3,mimiciii,radiology_report,PROMPT2_entailment
207,285,12,12,0,1.0,18,18,0,1.0,1.0,llama3,mimiciii,radiology_report,PROMPT2_entailment
208,286,6,6,0,1.0,6,5,1,0.8333333333333334,0.9090909090909092,llama3,mimiciii,radiology_report,PROMPT2_entailment
209,287,13,13,0,1.0,18,16,2,0.8888888888888888,0.9411764705882352,llama3,mimiciii,radiology_report,PROMPT2_entailment
210,288,19,16,3,0.8421052631578947,32,26,6,0.8125,0.8270377733598409,llama3,mimiciii,radiology_report,PROMPT2_entailment
211,289,22,21,1,0.9545454545454546,20,18,2,0.9,0.9264705882352942,llama3,mimiciii,radiology_report,PROMPT2_entailment
212,29,9,9,0,1.0,8,6,2,0.75,0.8571428571428571,llama3,mimiciii,radiology_report,PROMPT2_entailment
213,290,12,11,1,0.9166666666666666,11,9,2,0.8181818181818182,0.8646288209606987,llama3,mimiciii,radiology_report,PROMPT2_entailment
214,291,18,17,1,0.9444444444444444,23,16,7,0.6956521739130435,0.8011782032400588,llama3,mimiciii,radiology_report,PROMPT2_entailment
215,292,13,10,3,0.7692307692307693,21,15,6,0.7142857142857143,0.7407407407407408,llama3,mimiciii,radiology_report,PROMPT2_entailment
216,293,14,14,0,1.0,18,15,3,0.8333333333333334,0.9090909090909092,llama3,mimiciii,radiology_report,PROMPT2_entailment
217,294,14,11,3,0.7857142857142857,22,14,8,0.6363636363636364,0.7031963470319634,llama3,mimiciii,radiology_report,PROMPT2_entailment
218,295,13,10,3,0.7692307692307693,32,21,11,0.65625,0.7082630691399663,llama3,mimiciii,radiology_report,PROMPT2_entailment
219,296,16,14,2,0.875,17,14,3,0.8235294117647058,0.8484848484848485,llama3,mimiciii,radiology_report,PROMPT2_entailment
220,297,14,13,1,0.9285714285714286,24,21,3,0.875,0.900990099009901,llama3,mimiciii,radiology_report,PROMPT2_entailment
221,298,15,15,0,1.0,20,14,6,0.7,0.8235294117647058,llama3,mimiciii,radiology_report,PROMPT2_entailment
222,299,18,16,2,0.8888888888888888,28,23,5,0.8214285714285714,0.8538283062645011,llama3,mimiciii,radiology_report,PROMPT2_entailment
223,3,13,11,2,0.8461538461538461,20,14,6,0.7,0.7661691542288558,llama3,mimiciii,radiology_report,PROMPT2_entailment
224,30,15,13,2,0.8666666666666667,21,18,3,0.8571428571428571,0.861878453038674,llama3,mimiciii,radiology_report,PROMPT2_entailment
225,300,14,13,1,0.9285714285714286,13,8,5,0.6153846153846154,0.7402135231316727,llama3,mimiciii,radiology_report,PROMPT2_entailment
226,301,11,11,0,1.0,16,10,6,0.625,0.7692307692307693,llama3,mimiciii,radiology_report,PROMPT2_entailment
227,302,13,12,1,0.9230769230769232,15,13,2,0.8666666666666667,0.8939828080229226,llama3,mimiciii,radiology_report,PROMPT2_entailment
228,303,17,16,1,0.9411764705882352,24,17,7,0.7083333333333334,0.8083209509658248,llama3,mimiciii,radiology_report,PROMPT2_entailment
229,304,14,13,1,0.9285714285714286,19,16,3,0.8421052631578947,0.8832271762208067,llama3,mimiciii,radiology_report,PROMPT2_entailment
230,305,15,13,2,0.8666666666666667,24,15,9,0.625,0.7262569832402236,llama3,mimiciii,radiology_report,PROMPT2_entailment
231,306,12,11,1,0.9166666666666666,14,11,3,0.7857142857142857,0.8461538461538461,llama3,mimiciii,radiology_report,PROMPT2_entailment
232,307,15,15,0,1.0,17,14,3,0.8235294117647058,0.9032258064516128,llama3,mimiciii,radiology_report,PROMPT2_entailment
233,308,14,13,1,0.9285714285714286,15,11,4,0.7333333333333333,0.8194842406876792,llama3,mimiciii,radiology_report,PROMPT2_entailment
234,309,11,11,0,1.0,26,17,9,0.6538461538461539,0.7906976744186047,llama3,mimiciii,radiology_report,PROMPT2_entailment
235,31,11,10,1,0.9090909090909092,19,10,9,0.5263157894736842,0.6666666666666666,llama3,mimiciii,radiology_report,PROMPT2_entailment
236,310,13,13,0,1.0,24,19,5,0.7916666666666666,0.8837209302325582,llama3,mimiciii,radiology_report,PROMPT2_entailment
237,311,13,13,0,1.0,15,12,3,0.8,0.888888888888889,llama3,mimiciii,radiology_report,PROMPT2_entailment
238,312,18,18,0,1.0,18,14,4,0.7777777777777778,0.8750000000000001,llama3,mimiciii,radiology_report,PROMPT2_entailment
239,313,14,14,0,1.0,17,13,4,0.7647058823529411,0.8666666666666666,llama3,mimiciii,radiology_report,PROMPT2_entailment
240,314,11,8,3,0.7272727272727273,15,12,3,0.8,0.761904761904762,llama3,mimiciii,radiology_report,PROMPT2_entailment
241,315,21,18,3,0.8571428571428571,25,20,5,0.8,0.8275862068965518,llama3,mimiciii,radiology_report,PROMPT2_entailment
242,316,9,9,0,1.0,10,7,3,0.7,0.8235294117647058,llama3,mimiciii,radiology_report,PROMPT2_entailment
243,317,18,13,5,0.7222222222222222,26,19,7,0.7307692307692307,0.7264705882352942,llama3,mimiciii,radiology_report,PROMPT2_entailment
244,318,14,12,2,0.8571428571428571,21,17,4,0.8095238095238095,0.8326530612244899,llama3,mimiciii,radiology_report,PROMPT2_entailment
245,319,15,14,1,0.9333333333333332,12,11,1,0.9166666666666666,0.9249249249249248,llama3,mimiciii,radiology_report,PROMPT2_entailment
246,32,13,13,0,1.0,15,10,5,0.6666666666666666,0.8,llama3,mimiciii,radiology_report,PROMPT2_entailment
247,320,8,8,0,1.0,11,9,2,0.8181818181818182,0.9,llama3,mimiciii,radiology_report,PROMPT2_entailment
248,321,14,13,1,0.9285714285714286,21,16,5,0.7619047619047619,0.8370221327967807,llama3,mimiciii,radiology_report,PROMPT2_entailment
249,322,8,8,0,1.0,8,7,1,0.875,0.9333333333333332,llama3,mimiciii,radiology_report,PROMPT2_entailment
250,323,16,16,0,1.0,25,18,7,0.72,0.8372093023255813,llama3,mimiciii,radiology_report,PROMPT2_entailment
251,324,18,15,3,0.8333333333333334,18,17,1,0.9444444444444444,0.8854166666666667,llama3,mimiciii,radiology_report,PROMPT2_entailment
252,325,17,16,1,0.9411764705882352,22,17,5,0.7727272727272727,0.8486739469578783,llama3,mimiciii,radiology_report,PROMPT2_entailment
253,326,17,15,2,0.8823529411764706,23,16,7,0.6956521739130435,0.7779578606158833,llama3,mimiciii,radiology_report,PROMPT2_entailment
254,327,10,10,0,1.0,9,8,1,0.8888888888888888,0.9411764705882352,llama3,mimiciii,radiology_report,PROMPT2_entailment
255,328,13,13,0,1.0,17,12,5,0.7058823529411765,0.8275862068965517,llama3,mimiciii,radiology_report,PROMPT2_entailment
256,329,14,13,1,0.9285714285714286,24,11,13,0.4583333333333333,0.6137339055793991,llama3,mimiciii,radiology_report,PROMPT2_entailment
257,33,9,9,0,1.0,9,7,2,0.7777777777777778,0.8750000000000001,llama3,mimiciii,radiology_report,PROMPT2_entailment
258,330,13,10,3,0.7692307692307693,11,7,4,0.6363636363636364,0.6965174129353234,llama3,mimiciii,radiology_report,PROMPT2_entailment
259,331,12,11,1,0.9166666666666666,15,12,3,0.8,0.854368932038835,llama3,mimiciii,radiology_report,PROMPT2_entailment
260,332,14,13,1,0.9285714285714286,20,14,6,0.7,0.7982456140350878,llama3,mimiciii,radiology_report,PROMPT2_entailment
261,333,11,11,0,1.0,13,11,2,0.8461538461538461,0.9166666666666666,llama3,mimiciii,radiology_report,PROMPT2_entailment
262,334,17,14,3,0.8235294117647058,20,15,5,0.75,0.7850467289719627,llama3,mimiciii,radiology_report,PROMPT2_entailment
263,335,15,14,1,0.9333333333333332,17,14,3,0.8235294117647058,0.8749999999999999,llama3,mimiciii,radiology_report,PROMPT2_entailment
264,336,16,15,1,0.9375,16,14,2,0.875,0.9051724137931034,llama3,mimiciii,radiology_report,PROMPT2_entailment
265,337,17,16,1,0.9411764705882352,16,14,2,0.875,0.9068825910931174,llama3,mimiciii,radiology_report,PROMPT2_entailment
266,338,14,13,1,0.9285714285714286,13,9,4,0.6923076923076923,0.7932203389830509,llama3,mimiciii,radiology_report,PROMPT2_entailment
267,339,15,13,2,0.8666666666666667,28,24,4,0.8571428571428571,0.861878453038674,llama3,mimiciii,radiology_report,PROMPT2_entailment
268,34,14,14,0,1.0,14,13,1,0.9285714285714286,0.962962962962963,llama3,mimiciii,radiology_report,PROMPT2_entailment
269,340,13,12,1,0.9230769230769232,15,13,2,0.8666666666666667,0.8939828080229226,llama3,mimiciii,radiology_report,PROMPT2_entailment
270,341,7,7,0,1.0,6,4,2,0.6666666666666666,0.8,llama3,mimiciii,radiology_report,PROMPT2_entailment
271,342,13,13,0,1.0,15,14,1,0.9333333333333332,0.9655172413793104,llama3,mimiciii,radiology_report,PROMPT2_entailment
272,343,13,13,0,1.0,22,18,4,0.8181818181818182,0.9,llama3,mimiciii,radiology_report,PROMPT2_entailment
273,344,16,16,0,1.0,19,15,4,0.7894736842105263,0.8823529411764706,llama3,mimiciii,radiology_report,PROMPT2_entailment
274,345,17,16,1,0.9411764705882352,22,16,6,0.7272727272727273,0.8205128205128205,llama3,mimiciii,radiology_report,PROMPT2_entailment
275,346,13,13,0,1.0,15,12,3,0.8,0.888888888888889,llama3,mimiciii,radiology_report,PROMPT2_entailment
276,347,17,16,1,0.9411764705882352,15,14,1,0.9333333333333332,0.9372384937238494,llama3,mimiciii,radiology_report,PROMPT2_entailment
277,348,12,10,2,0.8333333333333334,12,8,4,0.6666666666666666,0.7407407407407408,llama3,mimiciii,radiology_report,PROMPT2_entailment
278,349,13,12,1,0.9230769230769232,16,13,3,0.8125,0.8642659279778393,llama3,mimiciii,radiology_report,PROMPT2_entailment
279,35,13,13,0,1.0,21,15,6,0.7142857142857143,0.8333333333333333,llama3,mimiciii,radiology_report,PROMPT2_entailment
280,350,17,14,3,0.8235294117647058,21,18,3,0.8571428571428571,0.84,llama3,mimiciii,radiology_report,PROMPT2_entailment
281,351,14,11,3,0.7857142857142857,21,17,4,0.8095238095238095,0.7974413646055437,llama3,mimiciii,radiology_report,PROMPT2_entailment
282,352,15,14,1,0.9333333333333332,22,16,6,0.7272727272727273,0.8175182481751825,llama3,mimiciii,radiology_report,PROMPT2_entailment
283,353,14,12,2,0.8571428571428571,23,19,4,0.8260869565217391,0.8413284132841329,llama3,mimiciii,radiology_report,PROMPT2_entailment
284,354,21,16,5,0.7619047619047619,26,22,4,0.8461538461538461,0.8018223234624144,llama3,mimiciii,radiology_report,PROMPT2_entailment
285,355,14,14,0,1.0,18,17,1,0.9444444444444444,0.9714285714285714,llama3,mimiciii,radiology_report,PROMPT2_entailment
286,356,14,13,1,0.9285714285714286,22,18,4,0.8181818181818182,0.8698884758364314,llama3,mimiciii,radiology_report,PROMPT2_entailment
287,357,11,11,0,1.0,15,10,5,0.6666666666666666,0.8,llama3,mimiciii,radiology_report,PROMPT2_entailment
288,358,17,16,1,0.9411764705882352,12,8,4,0.6666666666666666,0.7804878048780487,llama3,mimiciii,radiology_report,PROMPT2_entailment
289,359,11,11,0,1.0,18,13,5,0.7222222222222222,0.8387096774193548,llama3,mimiciii,radiology_report,PROMPT2_entailment
290,36,18,17,1,0.9444444444444444,22,15,7,0.6818181818181818,0.7919254658385093,llama3,mimiciii,radiology_report,PROMPT2_entailment
291,360,16,14,2,0.875,15,13,2,0.8666666666666667,0.8708133971291866,llama3,mimiciii,radiology_report,PROMPT2_entailment
292,361,17,14,3,0.8235294117647058,23,18,5,0.782608695652174,0.8025477707006369,llama3,mimiciii,radiology_report,PROMPT2_entailment
293,362,19,17,2,0.8947368421052632,24,16,8,0.6666666666666666,0.7640449438202247,llama3,mimiciii,radiology_report,PROMPT2_entailment
294,363,22,18,4,0.8181818181818182,22,17,5,0.7727272727272727,0.7948051948051948,llama3,mimiciii,radiology_report,PROMPT2_entailment
295,364,8,7,1,0.875,11,9,2,0.8181818181818182,0.8456375838926175,llama3,mimiciii,radiology_report,PROMPT2_entailment
296,365,18,13,5,0.7222222222222222,29,20,9,0.6896551724137931,0.7055630936227951,llama3,mimiciii,radiology_report,PROMPT2_entailment
297,366,11,9,2,0.8181818181818182,13,9,4,0.6923076923076923,0.7500000000000001,llama3,mimiciii,radiology_report,PROMPT2_entailment
298,367,16,13,3,0.8125,16,13,3,0.8125,0.8125,llama3,mimiciii,radiology_report,PROMPT2_entailment
299,368,12,11,1,0.9166666666666666,20,15,5,0.75,0.8250000000000001,llama3,mimiciii,radiology_report,PROMPT2_entailment
300,369,16,15,1,0.9375,20,15,5,0.75,0.8333333333333334,llama3,mimiciii,radiology_report,PROMPT2_entailment
301,37,11,11,0,1.0,21,12,9,0.5714285714285714,0.7272727272727273,llama3,mimiciii,radiology_report,PROMPT2_entailment
302,370,16,13,3,0.8125,19,13,6,0.6842105263157895,0.742857142857143,llama3,mimiciii,radiology_report,PROMPT2_entailment
303,371,12,11,1,0.9166666666666666,17,14,3,0.8235294117647058,0.8676056338028169,llama3,mimiciii,radiology_report,PROMPT2_entailment
304,372,13,11,2,0.8461538461538461,27,17,10,0.6296296296296297,0.7220077220077219,llama3,mimiciii,radiology_report,PROMPT2_entailment
305,373,17,16,1,0.9411764705882352,23,18,5,0.782608695652174,0.8545994065281899,llama3,mimiciii,radiology_report,PROMPT2_entailment
306,374,14,14,0,1.0,11,9,2,0.8181818181818182,0.9,llama3,mimiciii,radiology_report,PROMPT2_entailment
307,375,11,10,1,0.9090909090909092,16,11,5,0.6875,0.7829181494661921,llama3,mimiciii,radiology_report,PROMPT2_entailment
308,376,16,15,1,0.9375,18,16,2,0.8888888888888888,0.9125475285171102,llama3,mimiciii,radiology_report,PROMPT2_entailment
309,377,11,10,1,0.9090909090909092,10,8,2,0.8,0.8510638297872342,llama3,mimiciii,radiology_report,PROMPT2_entailment
310,378,16,14,2,0.875,24,18,6,0.75,0.8076923076923077,llama3,mimiciii,radiology_report,PROMPT2_entailment
311,379,16,16,0,1.0,18,16,2,0.8888888888888888,0.9411764705882352,llama3,mimiciii,radiology_report,PROMPT2_entailment
312,38,16,14,2,0.875,19,15,4,0.7894736842105263,0.8300395256916996,llama3,mimiciii,radiology_report,PROMPT2_entailment
313,380,9,8,1,0.8888888888888888,8,7,1,0.875,0.8818897637795274,llama3,mimiciii,radiology_report,PROMPT2_entailment
314,381,13,12,1,0.9230769230769232,14,11,3,0.7857142857142857,0.8488745980707394,llama3,mimiciii,radiology_report,PROMPT2_entailment
315,382,11,11,0,1.0,13,8,5,0.6153846153846154,0.761904761904762,llama3,mimiciii,radiology_report,PROMPT2_entailment
316,383,15,14,1,0.9333333333333332,17,14,3,0.8235294117647058,0.8749999999999999,llama3,mimiciii,radiology_report,PROMPT2_entailment
317,384,10,10,0,1.0,13,11,2,0.8461538461538461,0.9166666666666666,llama3,mimiciii,radiology_report,PROMPT2_entailment
318,385,18,15,3,0.8333333333333334,27,20,7,0.7407407407407407,0.7843137254901961,llama3,mimiciii,radiology_report,PROMPT2_entailment
319,386,12,12,0,1.0,18,15,3,0.8333333333333334,0.9090909090909092,llama3,mimiciii,radiology_report,PROMPT2_entailment
320,387,15,15,0,1.0,19,15,4,0.7894736842105263,0.8823529411764706,llama3,mimiciii,radiology_report,PROMPT2_entailment
321,388,16,13,3,0.8125,33,26,7,0.7878787878787878,0.8,llama3,mimiciii,radiology_report,PROMPT2_entailment
322,389,14,13,1,0.9285714285714286,12,9,3,0.75,0.8297872340425532,llama3,mimiciii,radiology_report,PROMPT2_entailment
323,39,13,12,1,0.9230769230769232,10,8,2,0.8,0.8571428571428571,llama3,mimiciii,radiology_report,PROMPT2_entailment
324,390,13,13,0,1.0,14,13,1,0.9285714285714286,0.962962962962963,llama3,mimiciii,radiology_report,PROMPT2_entailment
325,391,11,11,0,1.0,13,7,6,0.5384615384615384,0.7000000000000001,llama3,mimiciii,radiology_report,PROMPT2_entailment
326,392,12,12,0,1.0,15,13,2,0.8666666666666667,0.9285714285714286,llama3,mimiciii,radiology_report,PROMPT2_entailment
327,393,20,19,1,0.95,19,18,1,0.9473684210526316,0.9486823855755894,llama3,mimiciii,radiology_report,PROMPT2_entailment
328,394,14,14,0,1.0,18,17,1,0.9444444444444444,0.9714285714285714,llama3,mimiciii,radiology_report,PROMPT2_entailment
329,395,13,13,0,1.0,16,10,6,0.625,0.7692307692307693,llama3,mimiciii,radiology_report,PROMPT2_entailment
330,396,15,14,1,0.9333333333333332,19,16,3,0.8421052631578947,0.8853754940711462,llama3,mimiciii,radiology_report,PROMPT2_entailment
331,397,15,14,1,0.9333333333333332,18,12,6,0.6666666666666666,0.7777777777777778,llama3,mimiciii,radiology_report,PROMPT2_entailment
332,398,21,20,1,0.9523809523809524,21,18,3,0.8571428571428571,0.9022556390977444,llama3,mimiciii,radiology_report,PROMPT2_entailment
333,399,14,14,0,1.0,19,14,5,0.7368421052631579,0.8484848484848484,llama3,mimiciii,radiology_report,PROMPT2_entailment
334,4,14,13,1,0.9285714285714286,16,14,2,0.875,0.900990099009901,llama3,mimiciii,radiology_report,PROMPT2_entailment
335,40,16,15,1,0.9375,17,16,1,0.9411764705882352,0.9393346379647748,llama3,mimiciii,radiology_report,PROMPT2_entailment
336,400,10,8,2,0.8,13,9,4,0.6923076923076923,0.7422680412371134,llama3,mimiciii,radiology_report,PROMPT2_entailment
337,401,11,11,0,1.0,9,8,1,0.8888888888888888,0.9411764705882352,llama3,mimiciii,radiology_report,PROMPT2_entailment
338,402,20,16,4,0.8,20,16,4,0.8,0.8000000000000002,llama3,mimiciii,radiology_report,PROMPT2_entailment
339,403,13,13,0,1.0,18,14,4,0.7777777777777778,0.8750000000000001,llama3,mimiciii,radiology_report,PROMPT2_entailment
340,404,14,14,0,1.0,19,18,1,0.9473684210526316,0.972972972972973,llama3,mimiciii,radiology_report,PROMPT2_entailment
341,405,16,15,1,0.9375,14,11,3,0.7857142857142857,0.8549222797927462,llama3,mimiciii,radiology_report,PROMPT2_entailment
342,406,19,16,3,0.8421052631578947,25,19,6,0.76,0.7989487516425756,llama3,mimiciii,radiology_report,PROMPT2_entailment
343,407,20,19,1,0.95,20,16,4,0.8,0.8685714285714285,llama3,mimiciii,radiology_report,PROMPT2_entailment
344,408,18,17,1,0.9444444444444444,20,13,7,0.65,0.7700348432055749,llama3,mimiciii,radiology_report,PROMPT2_entailment
345,409,19,19,0,1.0,18,17,1,0.9444444444444444,0.9714285714285714,llama3,mimiciii,radiology_report,PROMPT2_entailment
346,41,16,13,3,0.8125,26,21,5,0.8076923076923077,0.8100890207715133,llama3,mimiciii,radiology_report,PROMPT2_entailment
347,410,17,16,1,0.9411764705882352,20,13,7,0.65,0.7689463955637708,llama3,mimiciii,radiology_report,PROMPT2_entailment
348,411,10,10,0,1.0,6,5,1,0.8333333333333334,0.9090909090909092,llama3,mimiciii,radiology_report,PROMPT2_entailment
349,412,17,14,3,0.8235294117647058,26,20,6,0.7692307692307693,0.7954545454545454,llama3,mimiciii,radiology_report,PROMPT2_entailment
350,413,13,12,1,0.9230769230769232,14,13,1,0.9285714285714286,0.9258160237388724,llama3,mimiciii,radiology_report,PROMPT2_entailment
351,414,17,14,3,0.8235294117647058,28,19,9,0.6785714285714286,0.7440559440559441,llama3,mimiciii,radiology_report,PROMPT2_entailment
352,415,15,13,2,0.8666666666666667,20,17,3,0.85,0.858252427184466,llama3,mimiciii,radiology_report,PROMPT2_entailment
353,416,17,17,0,1.0,17,14,3,0.8235294117647058,0.9032258064516128,llama3,mimiciii,radiology_report,PROMPT2_entailment
354,417,19,16,3,0.8421052631578947,20,18,2,0.9,0.8700906344410877,llama3,mimiciii,radiology_report,PROMPT2_entailment
355,418,13,13,0,1.0,14,10,4,0.7142857142857143,0.8333333333333333,llama3,mimiciii,radiology_report,PROMPT2_entailment
356,419,13,12,1,0.9230769230769232,16,14,2,0.875,0.8983957219251337,llama3,mimiciii,radiology_report,PROMPT2_entailment
357,42,17,17,0,1.0,14,12,2,0.8571428571428571,0.923076923076923,llama3,mimiciii,radiology_report,PROMPT2_entailment
358,420,12,11,1,0.9166666666666666,15,10,5,0.6666666666666666,0.7719298245614035,llama3,mimiciii,radiology_report,PROMPT2_entailment
359,421,14,12,2,0.8571428571428571,23,21,2,0.9130434782608696,0.8842105263157894,llama3,mimiciii,radiology_report,PROMPT2_entailment
360,422,15,14,1,0.9333333333333332,20,15,5,0.75,0.8316831683168316,llama3,mimiciii,radiology_report,PROMPT2_entailment
361,423,11,11,0,1.0,12,11,1,0.9166666666666666,0.9565217391304348,llama3,mimiciii,radiology_report,PROMPT2_entailment
362,424,10,8,2,0.8,9,7,2,0.7777777777777778,0.7887323943661971,llama3,mimiciii,radiology_report,PROMPT2_entailment
363,425,16,16,0,1.0,19,15,4,0.7894736842105263,0.8823529411764706,llama3,mimiciii,radiology_report,PROMPT2_entailment
364,426,12,12,0,1.0,16,15,1,0.9375,0.967741935483871,llama3,mimiciii,radiology_report,PROMPT2_entailment
365,427,11,11,0,1.0,15,10,5,0.6666666666666666,0.8,llama3,mimiciii,radiology_report,PROMPT2_entailment
366,428,10,10,0,1.0,15,14,1,0.9333333333333332,0.9655172413793104,llama3,mimiciii,radiology_report,PROMPT2_entailment
367,429,13,12,1,0.9230769230769232,13,10,3,0.7692307692307693,0.8391608391608392,llama3,mimiciii,radiology_report,PROMPT2_entailment
368,43,11,10,1,0.9090909090909092,7,6,1,0.8571428571428571,0.8823529411764706,llama3,mimiciii,radiology_report,PROMPT2_entailment
369,430,6,6,0,1.0,7,5,2,0.7142857142857143,0.8333333333333333,llama3,mimiciii,radiology_report,PROMPT2_entailment
370,431,13,9,4,0.6923076923076923,18,14,4,0.7777777777777778,0.7325581395348836,llama3,mimiciii,radiology_report,PROMPT2_entailment
371,432,20,19,1,0.95,13,10,3,0.7692307692307693,0.8501118568232661,llama3,mimiciii,radiology_report,PROMPT2_entailment
372,433,11,10,1,0.9090909090909092,18,18,0,1.0,0.9523809523809524,llama3,mimiciii,radiology_report,PROMPT2_entailment
373,434,17,15,2,0.8823529411764706,27,23,4,0.8518518518518519,0.8668341708542714,llama3,mimiciii,radiology_report,PROMPT2_entailment
374,435,10,10,0,1.0,13,10,3,0.7692307692307693,0.8695652173913044,llama3,mimiciii,radiology_report,PROMPT2_entailment
375,436,18,15,3,0.8333333333333334,25,22,3,0.88,0.8560311284046693,llama3,mimiciii,radiology_report,PROMPT2_entailment
376,437,7,6,1,0.8571428571428571,7,6,1,0.8571428571428571,0.8571428571428571,llama3,mimiciii,radiology_report,PROMPT2_entailment
377,438,13,12,1,0.9230769230769232,19,15,4,0.7894736842105263,0.8510638297872342,llama3,mimiciii,radiology_report,PROMPT2_entailment
378,439,14,11,3,0.7857142857142857,22,17,5,0.7727272727272727,0.7791666666666666,llama3,mimiciii,radiology_report,PROMPT2_entailment
379,44,11,11,0,1.0,16,13,3,0.8125,0.896551724137931,llama3,mimiciii,radiology_report,PROMPT2_entailment
380,440,17,16,1,0.9411764705882352,19,13,6,0.6842105263157895,0.7923809523809523,llama3,mimiciii,radiology_report,PROMPT2_entailment
381,441,14,13,1,0.9285714285714286,17,16,1,0.9411764705882352,0.9348314606741572,llama3,mimiciii,radiology_report,PROMPT2_entailment
382,442,11,11,0,1.0,12,9,3,0.75,0.8571428571428571,llama3,mimiciii,radiology_report,PROMPT2_entailment
383,443,14,14,0,1.0,21,16,5,0.7619047619047619,0.8648648648648648,llama3,mimiciii,radiology_report,PROMPT2_entailment
384,444,9,8,1,0.8888888888888888,8,5,3,0.625,0.7339449541284404,llama3,mimiciii,radiology_report,PROMPT2_entailment
385,445,17,15,2,0.8823529411764706,22,16,6,0.7272727272727273,0.7973421926910299,llama3,mimiciii,radiology_report,PROMPT2_entailment
386,446,19,13,6,0.6842105263157895,22,11,11,0.5,0.5777777777777778,llama3,mimiciii,radiology_report,PROMPT2_entailment
387,447,12,12,0,1.0,14,13,1,0.9285714285714286,0.962962962962963,llama3,mimiciii,radiology_report,PROMPT2_entailment
388,448,16,16,0,1.0,36,27,9,0.75,0.8571428571428571,llama3,mimiciii,radiology_report,PROMPT2_entailment
389,449,10,9,1,0.9,9,7,2,0.7777777777777778,0.8344370860927153,llama3,mimiciii,radiology_report,PROMPT2_entailment
390,45,14,13,1,0.9285714285714286,20,12,8,0.6,0.7289719626168225,llama3,mimiciii,radiology_report,PROMPT2_entailment
391,450,15,14,1,0.9333333333333332,21,18,3,0.8571428571428571,0.8936170212765957,llama3,mimiciii,radiology_report,PROMPT2_entailment
392,451,10,10,0,1.0,10,9,1,0.9,0.9473684210526316,llama3,mimiciii,radiology_report,PROMPT2_entailment
393,452,16,15,1,0.9375,16,14,2,0.875,0.9051724137931034,llama3,mimiciii,radiology_report,PROMPT2_entailment
394,453,11,10,1,0.9090909090909092,14,11,3,0.7857142857142857,0.842911877394636,llama3,mimiciii,radiology_report,PROMPT2_entailment
395,454,9,9,0,1.0,10,6,4,0.6,0.7499999999999999,llama3,mimiciii,radiology_report,PROMPT2_entailment
396,455,14,13,1,0.9285714285714286,16,13,3,0.8125,0.8666666666666666,llama3,mimiciii,radiology_report,PROMPT2_entailment
397,456,16,14,2,0.875,21,20,1,0.9523809523809524,0.9120521172638436,llama3,mimiciii,radiology_report,PROMPT2_entailment
398,457,14,14,0,1.0,12,11,1,0.9166666666666666,0.9565217391304348,llama3,mimiciii,radiology_report,PROMPT2_entailment
399,458,12,11,1,0.9166666666666666,16,11,5,0.6875,0.7857142857142857,llama3,mimiciii,radiology_report,PROMPT2_entailment
400,459,12,11,1,0.9166666666666666,13,9,4,0.6923076923076923,0.7888446215139442,llama3,mimiciii,radiology_report,PROMPT2_entailment
401,46,11,11,0,1.0,22,18,4,0.8181818181818182,0.9,llama3,mimiciii,radiology_report,PROMPT2_entailment
402,460,16,15,1,0.9375,20,15,5,0.75,0.8333333333333334,llama3,mimiciii,radiology_report,PROMPT2_entailment
403,461,15,13,2,0.8666666666666667,22,14,8,0.6363636363636364,0.7338709677419355,llama3,mimiciii,radiology_report,PROMPT2_entailment
404,462,19,18,1,0.9473684210526316,20,17,3,0.85,0.8960468521229868,llama3,mimiciii,radiology_report,PROMPT2_entailment
405,463,9,9,0,1.0,12,9,3,0.75,0.8571428571428571,llama3,mimiciii,radiology_report,PROMPT2_entailment
406,464,15,12,3,0.8,25,16,9,0.64,0.7111111111111111,llama3,mimiciii,radiology_report,PROMPT2_entailment
407,465,16,15,1,0.9375,33,26,7,0.7878787878787878,0.8562019758507136,llama3,mimiciii,radiology_report,PROMPT2_entailment
408,466,12,11,1,0.9166666666666666,22,15,7,0.6818181818181818,0.7819905213270141,llama3,mimiciii,radiology_report,PROMPT2_entailment
409,467,11,11,0,1.0,14,13,1,0.9285714285714286,0.962962962962963,llama3,mimiciii,radiology_report,PROMPT2_entailment
410,468,13,13,0,1.0,18,14,4,0.7777777777777778,0.8750000000000001,llama3,mimiciii,radiology_report,PROMPT2_entailment
411,469,14,13,1,0.9285714285714286,25,18,7,0.72,0.8110918544194108,llama3,mimiciii,radiology_report,PROMPT2_entailment
412,47,13,13,0,1.0,15,12,3,0.8,0.888888888888889,llama3,mimiciii,radiology_report,PROMPT2_entailment
413,470,11,11,0,1.0,15,12,3,0.8,0.888888888888889,llama3,mimiciii,radiology_report,PROMPT2_entailment
414,471,19,17,2,0.8947368421052632,18,17,1,0.9444444444444444,0.918918918918919,llama3,mimiciii,radiology_report,PROMPT2_entailment
415,472,13,12,1,0.9230769230769232,16,13,3,0.8125,0.8642659279778393,llama3,mimiciii,radiology_report,PROMPT2_entailment
416,473,11,11,0,1.0,11,9,2,0.8181818181818182,0.9,llama3,mimiciii,radiology_report,PROMPT2_entailment
417,474,13,13,0,1.0,25,21,4,0.84,0.9130434782608696,llama3,mimiciii,radiology_report,PROMPT2_entailment
418,475,7,7,0,1.0,7,5,2,0.7142857142857143,0.8333333333333333,llama3,mimiciii,radiology_report,PROMPT2_entailment
419,476,16,16,0,1.0,12,11,1,0.9166666666666666,0.9565217391304348,llama3,mimiciii,radiology_report,PROMPT2_entailment
420,477,15,14,1,0.9333333333333332,16,13,3,0.8125,0.8687350835322195,llama3,mimiciii,radiology_report,PROMPT2_entailment
421,478,14,13,1,0.9285714285714286,21,16,5,0.7619047619047619,0.8370221327967807,llama3,mimiciii,radiology_report,PROMPT2_entailment
422,479,13,13,0,1.0,22,14,8,0.6363636363636364,0.7777777777777778,llama3,mimiciii,radiology_report,PROMPT2_entailment
423,48,16,15,1,0.9375,21,17,4,0.8095238095238095,0.868824531516184,llama3,mimiciii,radiology_report,PROMPT2_entailment
424,480,9,9,0,1.0,10,4,6,0.4,0.5714285714285715,llama3,mimiciii,radiology_report,PROMPT2_entailment
425,481,18,17,1,0.9444444444444444,17,15,2,0.8823529411764706,0.9123434704830052,llama3,mimiciii,radiology_report,PROMPT2_entailment
426,482,15,14,1,0.9333333333333332,19,16,3,0.8421052631578947,0.8853754940711462,llama3,mimiciii,radiology_report,PROMPT2_entailment
427,483,16,16,0,1.0,23,16,7,0.6956521739130435,0.8205128205128205,llama3,mimiciii,radiology_report,PROMPT2_entailment
428,484,9,9,0,1.0,13,7,6,0.5384615384615384,0.7000000000000001,llama3,mimiciii,radiology_report,PROMPT2_entailment
429,485,17,16,1,0.9411764705882352,24,20,4,0.8333333333333334,0.8839779005524863,llama3,mimiciii,radiology_report,PROMPT2_entailment
430,486,15,14,1,0.9333333333333332,11,9,2,0.8181818181818182,0.8719723183391004,llama3,mimiciii,radiology_report,PROMPT2_entailment
431,487,16,16,0,1.0,20,15,5,0.75,0.8571428571428571,llama3,mimiciii,radiology_report,PROMPT2_entailment
432,488,11,11,0,1.0,15,13,2,0.8666666666666667,0.9285714285714286,llama3,mimiciii,radiology_report,PROMPT2_entailment
433,489,18,17,1,0.9444444444444444,18,13,5,0.7222222222222222,0.8185185185185185,llama3,mimiciii,radiology_report,PROMPT2_entailment
434,49,15,15,0,1.0,24,21,3,0.875,0.9333333333333332,llama3,mimiciii,radiology_report,PROMPT2_entailment
435,490,8,6,2,0.75,8,4,4,0.5,0.6,llama3,mimiciii,radiology_report,PROMPT2_entailment
436,491,13,13,0,1.0,17,11,6,0.6470588235294118,0.7857142857142858,llama3,mimiciii,radiology_report,PROMPT2_entailment
437,492,14,14,0,1.0,13,8,5,0.6153846153846154,0.761904761904762,llama3,mimiciii,radiology_report,PROMPT2_entailment
438,493,13,13,0,1.0,9,7,2,0.7777777777777778,0.8750000000000001,llama3,mimiciii,radiology_report,PROMPT2_entailment
439,494,11,11,0,1.0,8,5,3,0.625,0.7692307692307693,llama3,mimiciii,radiology_report,PROMPT2_entailment
440,495,9,9,0,1.0,12,9,3,0.75,0.8571428571428571,llama3,mimiciii,radiology_report,PROMPT2_entailment
441,496,16,16,0,1.0,32,18,14,0.5625,0.72,llama3,mimiciii,radiology_report,PROMPT2_entailment
442,497,16,14,2,0.875,22,17,5,0.7727272727272727,0.8206896551724138,llama3,mimiciii,radiology_report,PROMPT2_entailment
443,498,19,18,1,0.9473684210526316,22,17,5,0.7727272727272727,0.8511821974965229,llama3,mimiciii,radiology_report,PROMPT2_entailment
444,499,19,18,1,0.9473684210526316,17,13,4,0.7647058823529411,0.8462929475587704,llama3,mimiciii,radiology_report,PROMPT2_entailment
445,5,19,17,2,0.8947368421052632,22,17,5,0.7727272727272727,0.8292682926829269,llama3,mimiciii,radiology_report,PROMPT2_entailment
446,50,14,14,0,1.0,15,11,4,0.7333333333333333,0.846153846153846,llama3,mimiciii,radiology_report,PROMPT2_entailment
447,51,13,12,1,0.9230769230769232,13,9,4,0.6923076923076923,0.7912087912087913,llama3,mimiciii,radiology_report,PROMPT2_entailment
448,52,18,17,1,0.9444444444444444,21,16,5,0.7619047619047619,0.8434108527131783,llama3,mimiciii,radiology_report,PROMPT2_entailment
449,53,12,12,0,1.0,12,10,2,0.8333333333333334,0.9090909090909092,llama3,mimiciii,radiology_report,PROMPT2_entailment
450,54,10,9,1,0.9,10,6,4,0.6,0.7200000000000001,llama3,mimiciii,radiology_report,PROMPT2_entailment
451,55,12,12,0,1.0,18,16,2,0.8888888888888888,0.9411764705882352,llama3,mimiciii,radiology_report,PROMPT2_entailment
452,56,13,11,2,0.8461538461538461,21,12,9,0.5714285714285714,0.6821705426356589,llama3,mimiciii,radiology_report,PROMPT2_entailment
453,57,10,10,0,1.0,10,7,3,0.7,0.8235294117647058,llama3,mimiciii,radiology_report,PROMPT2_entailment
454,58,13,13,0,1.0,16,13,3,0.8125,0.896551724137931,llama3,mimiciii,radiology_report,PROMPT2_entailment
455,59,12,12,0,1.0,16,13,3,0.8125,0.896551724137931,llama3,mimiciii,radiology_report,PROMPT2_entailment
456,6,9,9,0,1.0,8,6,2,0.75,0.8571428571428571,llama3,mimiciii,radiology_report,PROMPT2_entailment
457,60,15,15,0,1.0,19,15,4,0.7894736842105263,0.8823529411764706,llama3,mimiciii,radiology_report,PROMPT2_entailment
458,61,13,12,1,0.9230769230769232,22,17,5,0.7727272727272727,0.8412371134020619,llama3,mimiciii,radiology_report,PROMPT2_entailment
459,62,17,15,2,0.8823529411764706,13,8,5,0.6153846153846154,0.7250755287009064,llama3,mimiciii,radiology_report,PROMPT2_entailment
460,63,12,12,0,1.0,15,11,4,0.7333333333333333,0.846153846153846,llama3,mimiciii,radiology_report,PROMPT2_entailment
461,64,21,20,1,0.9523809523809524,20,13,7,0.65,0.7726597325408618,llama3,mimiciii,radiology_report,PROMPT2_entailment
462,65,17,16,1,0.9411764705882352,18,17,1,0.9444444444444444,0.9428076256499132,llama3,mimiciii,radiology_report,PROMPT2_entailment
463,66,12,12,0,1.0,29,22,7,0.7586206896551724,0.8627450980392156,llama3,mimiciii,radiology_report,PROMPT2_entailment
464,67,18,15,3,0.8333333333333334,28,18,10,0.6428571428571429,0.7258064516129034,llama3,mimiciii,radiology_report,PROMPT2_entailment
465,68,16,16,0,1.0,30,25,5,0.8333333333333334,0.9090909090909092,llama3,mimiciii,radiology_report,PROMPT2_entailment
466,69,16,14,2,0.875,31,18,13,0.5806451612903226,0.6980609418282548,llama3,mimiciii,radiology_report,PROMPT2_entailment
467,7,13,12,1,0.9230769230769232,16,15,1,0.9375,0.9302325581395348,llama3,mimiciii,radiology_report,PROMPT2_entailment
468,70,14,13,1,0.9285714285714286,17,15,2,0.8823529411764706,0.9048723897911832,llama3,mimiciii,radiology_report,PROMPT2_entailment
469,71,13,12,1,0.9230769230769232,18,14,4,0.7777777777777778,0.8442211055276381,llama3,mimiciii,radiology_report,PROMPT2_entailment
470,72,15,13,2,0.8666666666666667,13,12,1,0.9230769230769232,0.8939828080229226,llama3,mimiciii,radiology_report,PROMPT2_entailment
471,73,17,16,1,0.9411764705882352,29,20,9,0.6896551724137931,0.7960199004975124,llama3,mimiciii,radiology_report,PROMPT2_entailment
472,74,13,12,1,0.9230769230769232,18,13,5,0.7222222222222222,0.8103896103896105,llama3,mimiciii,radiology_report,PROMPT2_entailment
473,75,11,11,0,1.0,12,10,2,0.8333333333333334,0.9090909090909092,llama3,mimiciii,radiology_report,PROMPT2_entailment
474,76,11,10,1,0.9090909090909092,14,12,2,0.8571428571428571,0.8823529411764706,llama3,mimiciii,radiology_report,PROMPT2_entailment
475,77,14,11,3,0.7857142857142857,26,19,7,0.7307692307692307,0.7572463768115941,llama3,mimiciii,radiology_report,PROMPT2_entailment
476,78,18,16,2,0.8888888888888888,33,24,9,0.7272727272727273,0.7999999999999999,llama3,mimiciii,radiology_report,PROMPT2_entailment
477,79,13,13,0,1.0,17,13,4,0.7647058823529411,0.8666666666666666,llama3,mimiciii,radiology_report,PROMPT2_entailment
478,8,13,12,1,0.9230769230769232,15,13,2,0.8666666666666667,0.8939828080229226,llama3,mimiciii,radiology_report,PROMPT2_entailment
479,80,17,17,0,1.0,25,19,6,0.76,0.8636363636363636,llama3,mimiciii,radiology_report,PROMPT2_entailment
480,81,12,11,1,0.9166666666666666,15,11,4,0.7333333333333333,0.8148148148148148,llama3,mimiciii,radiology_report,PROMPT2_entailment
481,82,10,7,3,0.7,14,12,2,0.8571428571428571,0.7706422018348624,llama3,mimiciii,radiology_report,PROMPT2_entailment
482,83,13,11,2,0.8461538461538461,17,13,4,0.7647058823529411,0.8033707865168538,llama3,mimiciii,radiology_report,PROMPT2_entailment
483,84,17,16,1,0.9411764705882352,20,17,3,0.85,0.8932676518883416,llama3,mimiciii,radiology_report,PROMPT2_entailment
484,85,11,11,0,1.0,14,13,1,0.9285714285714286,0.962962962962963,llama3,mimiciii,radiology_report,PROMPT2_entailment
485,86,14,14,0,1.0,10,9,1,0.9,0.9473684210526316,llama3,mimiciii,radiology_report,PROMPT2_entailment
486,87,12,11,1,0.9166666666666666,14,11,3,0.7857142857142857,0.8461538461538461,llama3,mimiciii,radiology_report,PROMPT2_entailment
487,88,16,14,2,0.875,19,15,4,0.7894736842105263,0.8300395256916996,llama3,mimiciii,radiology_report,PROMPT2_entailment
488,89,16,15,1,0.9375,18,14,4,0.7777777777777778,0.8502024291497976,llama3,mimiciii,radiology_report,PROMPT2_entailment
489,9,9,9,0,1.0,13,11,2,0.8461538461538461,0.9166666666666666,llama3,mimiciii,radiology_report,PROMPT2_entailment
490,90,12,12,0,1.0,14,14,0,1.0,1.0,llama3,mimiciii,radiology_report,PROMPT2_entailment
491,91,12,12,0,1.0,13,11,2,0.8461538461538461,0.9166666666666666,llama3,mimiciii,radiology_report,PROMPT2_entailment
492,92,16,15,1,0.9375,21,15,6,0.7142857142857143,0.8108108108108109,llama3,mimiciii,radiology_report,PROMPT2_entailment
493,93,13,13,0,1.0,15,13,2,0.8666666666666667,0.9285714285714286,llama3,mimiciii,radiology_report,PROMPT2_entailment
494,94,19,17,2,0.8947368421052632,28,20,8,0.7142857142857143,0.794392523364486,llama3,mimiciii,radiology_report,PROMPT2_entailment
495,95,15,14,1,0.9333333333333332,18,11,7,0.6111111111111112,0.7386091127098322,llama3,mimiciii,radiology_report,PROMPT2_entailment
496,96,15,14,1,0.9333333333333332,21,18,3,0.8571428571428571,0.8936170212765957,llama3,mimiciii,radiology_report,PROMPT2_entailment
497,97,16,16,0,1.0,23,19,4,0.8260869565217391,0.9047619047619048,llama3,mimiciii,radiology_report,PROMPT2_entailment
498,98,14,14,0,1.0,19,15,4,0.7894736842105263,0.8823529411764706,llama3,mimiciii,radiology_report,PROMPT2_entailment
499,99,16,16,0,1.0,13,12,1,0.9230769230769232,0.96,llama3,mimiciii,radiology_report,PROMPT2_entailment
0,0,29,28,1,0.9655172413793104,78,49,29,0.6282051282051282,0.7611650485436893,llama3,mimiciii,progress_note,PROMPT1_entailment
1,1,47,39,8,0.8297872340425532,189,65,124,0.3439153439153439,0.486284289276808,llama3,mimiciii,progress_note,PROMPT1_entailment
2,10,60,46,14,0.7666666666666667,140,63,77,0.45,0.5671232876712329,llama3,mimiciii,progress_note,PROMPT1_entailment
3,100,31,25,6,0.8064516129032258,77,54,23,0.7012987012987013,0.7502083912197832,llama3,mimiciii,progress_note,PROMPT1_entailment
4,101,18,18,0,1.0,36,29,7,0.8055555555555556,0.8923076923076924,llama3,mimiciii,progress_note,PROMPT1_entailment
5,102,22,19,3,0.8636363636363636,42,34,8,0.8095238095238095,0.8357050452781372,llama3,mimiciii,progress_note,PROMPT1_entailment
6,103,69,52,17,0.7536231884057971,204,100,104,0.4901960784313725,0.5940141649531643,llama3,mimiciii,progress_note,PROMPT1_entailment
7,104,21,19,2,0.9047619047619048,39,28,11,0.717948717948718,0.8006019563581641,llama3,mimiciii,progress_note,PROMPT1_entailment
8,105,14,13,1,0.9285714285714286,17,12,5,0.7058823529411765,0.802056555269923,llama3,mimiciii,progress_note,PROMPT1_entailment
9,106,16,14,2,0.875,40,27,13,0.675,0.7620967741935485,llama3,mimiciii,progress_note,PROMPT1_entailment
10,107,21,19,2,0.9047619047619048,31,24,7,0.7741935483870968,0.8344007319304665,llama3,mimiciii,progress_note,PROMPT1_entailment
11,108,37,32,5,0.8648648648648649,68,48,20,0.7058823529411765,0.7773279352226721,llama3,mimiciii,progress_note,PROMPT1_entailment
12,109,46,45,1,0.9782608695652174,176,69,107,0.3920454545454545,0.5597620335316387,llama3,mimiciii,progress_note,PROMPT1_entailment
13,11,52,43,9,0.8269230769230769,141,53,88,0.375886524822695,0.5168386438371697,llama3,mimiciii,progress_note,PROMPT1_entailment
14,110,63,51,12,0.8095238095238095,215,94,121,0.4372093023255814,0.567774027358323,llama3,mimiciii,progress_note,PROMPT1_entailment
15,111,90,61,29,0.6777777777777778,219,102,117,0.4657534246575342,0.5521096765606283,llama3,mimiciii,progress_note,PROMPT1_entailment
16,112,58,44,14,0.7586206896551724,234,96,138,0.4102564102564102,0.5325264750378214,llama3,mimiciii,progress_note,PROMPT1_entailment
17,113,57,50,7,0.8771929824561403,196,92,104,0.4693877551020408,0.6115394841797395,llama3,mimiciii,progress_note,PROMPT1_entailment
18,114,102,74,28,0.7254901960784313,225,88,137,0.3911111111111111,0.5082338250214626,llama3,mimiciii,progress_note,PROMPT1_entailment
19,115,52,34,18,0.6538461538461539,280,119,161,0.425,0.5151515151515152,llama3,mimiciii,progress_note,PROMPT1_entailment
20,116,18,18,0,1.0,35,24,11,0.6857142857142857,0.8135593220338984,llama3,mimiciii,progress_note,PROMPT1_entailment
21,117,14,13,1,0.9285714285714286,20,17,3,0.85,0.8875502008032129,llama3,mimiciii,progress_note,PROMPT1_entailment
22,118,23,23,0,1.0,23,20,3,0.8695652173913043,0.9302325581395348,llama3,mimiciii,progress_note,PROMPT1_entailment
23,119,14,13,1,0.9285714285714286,14,10,4,0.7142857142857143,0.8074534161490684,llama3,mimiciii,progress_note,PROMPT1_entailment
24,12,51,37,14,0.7254901960784313,225,90,135,0.4,0.5156794425087109,llama3,mimiciii,progress_note,PROMPT1_entailment
25,120,25,25,0,1.0,64,38,26,0.59375,0.7450980392156863,llama3,mimiciii,progress_note,PROMPT1_entailment
26,121,14,13,1,0.9285714285714286,14,9,5,0.6428571428571429,0.7597402597402597,llama3,mimiciii,progress_note,PROMPT1_entailment
27,122,25,19,6,0.76,47,31,16,0.6595744680851063,0.7062350119904077,llama3,mimiciii,progress_note,PROMPT1_entailment
28,123,23,21,2,0.9130434782608696,50,28,22,0.56,0.6942148760330579,llama3,mimiciii,progress_note,PROMPT1_entailment
29,124,26,23,3,0.8846153846153846,65,44,21,0.676923076923077,0.7669571807502842,llama3,mimiciii,progress_note,PROMPT1_entailment
30,125,21,18,3,0.8571428571428571,50,33,17,0.66,0.7457627118644068,llama3,mimiciii,progress_note,PROMPT1_entailment
31,126,18,18,0,1.0,27,18,9,0.6666666666666666,0.8,llama3,mimiciii,progress_note,PROMPT1_entailment
32,127,16,14,2,0.875,27,14,13,0.5185185185185185,0.6511627906976744,llama3,mimiciii,progress_note,PROMPT1_entailment
33,128,21,20,1,0.9523809523809524,37,29,8,0.7837837837837838,0.859896219421794,llama3,mimiciii,progress_note,PROMPT1_entailment
34,129,26,15,11,0.5769230769230769,66,45,21,0.6818181818181818,0.6249999999999999,llama3,mimiciii,progress_note,PROMPT1_entailment
35,13,26,22,4,0.8461538461538461,73,39,34,0.5342465753424658,0.6549618320610687,llama3,mimiciii,progress_note,PROMPT1_entailment
36,130,17,15,2,0.8823529411764706,44,34,10,0.7727272727272727,0.8239095315024232,llama3,mimiciii,progress_note,PROMPT1_entailment
37,131,73,57,16,0.7808219178082192,202,98,104,0.4851485148514851,0.5984572530533533,llama3,mimiciii,progress_note,PROMPT1_entailment
38,132,76,55,21,0.7236842105263158,193,99,94,0.5129533678756477,0.6003638568829593,llama3,mimiciii,progress_note,PROMPT1_entailment
39,133,70,54,16,0.7714285714285715,157,72,85,0.4585987261146497,0.5752330226364847,llama3,mimiciii,progress_note,PROMPT1_entailment
40,134,15,10,5,0.6666666666666666,18,12,6,0.6666666666666666,0.6666666666666666,llama3,mimiciii,progress_note,PROMPT1_entailment
41,135,21,20,1,0.9523809523809524,35,22,13,0.6285714285714286,0.7573149741824441,llama3,mimiciii,progress_note,PROMPT1_entailment
42,136,19,17,2,0.8947368421052632,43,27,16,0.627906976744186,0.7379421221864954,llama3,mimiciii,progress_note,PROMPT1_entailment
43,137,16,15,1,0.9375,26,17,9,0.6538461538461539,0.7703927492447131,llama3,mimiciii,progress_note,PROMPT1_entailment
44,138,19,15,4,0.7894736842105263,45,22,23,0.4888888888888889,0.6038426349496797,llama3,mimiciii,progress_note,PROMPT1_entailment
45,139,24,22,2,0.9166666666666666,45,26,19,0.5777777777777777,0.7087980173482031,llama3,mimiciii,progress_note,PROMPT1_entailment
46,14,39,34,5,0.8717948717948718,43,39,4,0.9069767441860463,0.8890378813275227,llama3,mimiciii,progress_note,PROMPT1_entailment
47,140,18,14,4,0.7777777777777778,25,18,7,0.72,0.747774480712166,llama3,mimiciii,progress_note,PROMPT1_entailment
48,141,21,20,1,0.9523809523809524,45,24,21,0.5333333333333333,0.6837606837606837,llama3,mimiciii,progress_note,PROMPT1_entailment
49,142,17,14,3,0.8235294117647058,50,32,18,0.64,0.7202572347266882,llama3,mimiciii,progress_note,PROMPT1_entailment
50,143,10,9,1,0.9,11,7,4,0.6363636363636364,0.7455621301775148,llama3,mimiciii,progress_note,PROMPT1_entailment
51,144,26,25,1,0.9615384615384616,50,40,10,0.8,0.8733624454148472,llama3,mimiciii,progress_note,PROMPT1_entailment
52,145,24,22,2,0.9166666666666666,43,27,16,0.627906976744186,0.7452948557089084,llama3,mimiciii,progress_note,PROMPT1_entailment
53,146,29,27,2,0.9310344827586208,32,20,12,0.625,0.7479224376731303,llama3,mimiciii,progress_note,PROMPT1_entailment
54,147,31,28,3,0.9032258064516128,56,40,16,0.7142857142857143,0.7977207977207977,llama3,mimiciii,progress_note,PROMPT1_entailment
55,148,9,8,1,0.8888888888888888,4,3,1,0.75,0.8135593220338982,llama3,mimiciii,progress_note,PROMPT1_entailment
56,149,18,16,2,0.8888888888888888,29,22,7,0.7586206896551724,0.8186046511627907,llama3,mimiciii,progress_note,PROMPT1_entailment
57,15,65,46,19,0.7076923076923077,163,75,88,0.4601226993865031,0.5576658853956195,llama3,mimiciii,progress_note,PROMPT1_entailment
58,150,26,22,4,0.8461538461538461,83,61,22,0.7349397590361446,0.7866354044548652,llama3,mimiciii,progress_note,PROMPT1_entailment
59,151,62,52,10,0.8387096774193549,201,76,125,0.3781094527363184,0.5212345027697177,llama3,mimiciii,progress_note,PROMPT1_entailment
60,152,41,24,17,0.5853658536585366,45,16,29,0.3555555555555555,0.4423963133640553,llama3,mimiciii,progress_note,PROMPT1_entailment
61,153,50,44,6,0.88,219,91,128,0.4155251141552511,0.5645002114761032,llama3,mimiciii,progress_note,PROMPT1_entailment
62,154,11,10,1,0.9090909090909092,15,15,0,1.0,0.9523809523809524,llama3,mimiciii,progress_note,PROMPT1_entailment
63,155,18,18,0,1.0,32,26,6,0.8125,0.896551724137931,llama3,mimiciii,progress_note,PROMPT1_entailment
64,156,18,18,0,1.0,32,25,7,0.78125,0.8771929824561403,llama3,mimiciii,progress_note,PROMPT1_entailment
65,157,16,14,2,0.875,29,26,3,0.896551724137931,0.8856447688564477,llama3,mimiciii,progress_note,PROMPT1_entailment
66,158,24,19,5,0.7916666666666666,242,80,162,0.3305785123966942,0.4664007364222153,llama3,mimiciii,progress_note,PROMPT1_entailment
67,159,13,11,2,0.8461538461538461,22,14,8,0.6363636363636364,0.7264150943396226,llama3,mimiciii,progress_note,PROMPT1_entailment
68,16,16,15,1,0.9375,28,20,8,0.7142857142857143,0.8108108108108109,llama3,mimiciii,progress_note,PROMPT1_entailment
69,160,28,26,2,0.9285714285714286,65,44,21,0.676923076923077,0.7830253251197811,llama3,mimiciii,progress_note,PROMPT1_entailment
70,161,57,41,16,0.7192982456140351,201,91,110,0.4527363184079602,0.5557044980637473,llama3,mimiciii,progress_note,PROMPT1_entailment
71,162,55,44,11,0.8,177,75,102,0.423728813559322,0.5540166204986149,llama3,mimiciii,progress_note,PROMPT1_entailment
72,163,15,14,1,0.9333333333333332,28,16,12,0.5714285714285714,0.7088607594936709,llama3,mimiciii,progress_note,PROMPT1_entailment
73,164,27,24,3,0.8888888888888888,57,32,25,0.5614035087719298,0.6881720430107527,llama3,mimiciii,progress_note,PROMPT1_entailment
74,165,8,7,1,0.875,25,17,8,0.68,0.7652733118971061,llama3,mimiciii,progress_note,PROMPT1_entailment
75,166,18,17,1,0.9444444444444444,42,30,12,0.7142857142857143,0.813397129186603,llama3,mimiciii,progress_note,PROMPT1_entailment
76,167,24,24,0,1.0,52,25,27,0.4807692307692308,0.6493506493506493,llama3,mimiciii,progress_note,PROMPT1_entailment
77,168,55,41,14,0.7454545454545455,182,85,97,0.467032967032967,0.5742770042020269,llama3,mimiciii,progress_note,PROMPT1_entailment
78,169,24,21,3,0.875,219,86,133,0.3926940639269406,0.5420981539846915,llama3,mimiciii,progress_note,PROMPT1_entailment
79,17,9,8,1,0.8888888888888888,15,6,9,0.4,0.5517241379310346,llama3,mimiciii,progress_note,PROMPT1_entailment
80,170,79,65,14,0.8227848101265823,184,83,101,0.4510869565217391,0.5827077820381271,llama3,mimiciii,progress_note,PROMPT1_entailment
81,171,83,60,23,0.7228915662650602,222,105,117,0.4729729729729729,0.5718175629680055,llama3,mimiciii,progress_note,PROMPT1_entailment
82,172,48,39,9,0.8125,198,80,118,0.404040404040404,0.5396990140114167,llama3,mimiciii,progress_note,PROMPT1_entailment
83,173,65,48,17,0.7384615384615385,172,88,84,0.5116279069767442,0.6044647967945049,llama3,mimiciii,progress_note,PROMPT1_entailment
84,174,51,39,12,0.7647058823529411,200,77,123,0.385,0.5121514453824507,llama3,mimiciii,progress_note,PROMPT1_entailment
85,175,78,59,19,0.7564102564102564,207,89,118,0.429951690821256,0.5482641607935265,llama3,mimiciii,progress_note,PROMPT1_entailment
86,176,74,55,19,0.7432432432432432,192,72,120,0.375,0.4984894259818731,llama3,mimiciii,progress_note,PROMPT1_entailment
87,177,74,55,19,0.7432432432432432,192,75,117,0.390625,0.5121042830540037,llama3,mimiciii,progress_note,PROMPT1_entailment
88,178,15,13,2,0.8666666666666667,17,13,4,0.7647058823529411,0.8125,llama3,mimiciii,progress_note,PROMPT1_entailment
89,179,102,72,30,0.7058823529411765,197,100,97,0.5076142131979695,0.5905511811023623,llama3,mimiciii,progress_note,PROMPT1_entailment
90,18,16,15,1,0.9375,18,14,4,0.7777777777777778,0.8502024291497976,llama3,mimiciii,progress_note,PROMPT1_entailment
91,180,56,49,7,0.875,201,45,156,0.2238805970149253,0.3565365025466893,llama3,mimiciii,progress_note,PROMPT1_entailment
92,181,57,38,19,0.6666666666666666,208,88,120,0.4230769230769231,0.5176470588235295,llama3,mimiciii,progress_note,PROMPT1_entailment
93,182,82,73,9,0.8902439024390244,214,87,127,0.4065420560747663,0.5581824573738794,llama3,mimiciii,progress_note,PROMPT1_entailment
94,183,52,39,13,0.75,226,95,131,0.4203539823008849,0.5387523629489602,llama3,mimiciii,progress_note,PROMPT1_entailment
95,184,57,48,9,0.8421052631578947,194,60,134,0.3092783505154639,0.4524033930254477,llama3,mimiciii,progress_note,PROMPT1_entailment
96,185,17,12,5,0.7058823529411765,48,18,30,0.375,0.4897959183673468,llama3,mimiciii,progress_note,PROMPT1_entailment
97,186,53,49,4,0.9245283018867924,205,91,114,0.4439024390243902,0.5998116760828626,llama3,mimiciii,progress_note,PROMPT1_entailment
98,187,72,53,19,0.7361111111111112,170,71,99,0.4176470588235294,0.5329273474012179,llama3,mimiciii,progress_note,PROMPT1_entailment
99,188,53,40,13,0.7547169811320755,202,58,144,0.2871287128712871,0.4159942621481082,llama3,mimiciii,progress_note,PROMPT1_entailment
100,189,60,53,7,0.8833333333333333,225,92,133,0.4088888888888889,0.5590140441387218,llama3,mimiciii,progress_note,PROMPT1_entailment
101,19,21,20,1,0.9523809523809524,38,22,16,0.5789473684210527,0.7201309328968903,llama3,mimiciii,progress_note,PROMPT1_entailment
102,190,64,50,14,0.78125,223,81,142,0.3632286995515695,0.4958981266070773,llama3,mimiciii,progress_note,PROMPT1_entailment
103,191,68,57,11,0.8382352941176471,206,101,105,0.4902912621359223,0.6186996238581407,llama3,mimiciii,progress_note,PROMPT1_entailment
104,192,83,69,14,0.8313253012048193,208,94,114,0.4519230769230769,0.5855376004333304,llama3,mimiciii,progress_note,PROMPT1_entailment
105,193,72,52,20,0.7222222222222222,243,89,154,0.3662551440329218,0.4860323461457675,llama3,mimiciii,progress_note,PROMPT1_entailment
106,194,62,47,15,0.7580645161290323,211,95,116,0.4502369668246445,0.5649395837287279,llama3,mimiciii,progress_note,PROMPT1_entailment
107,195,19,17,2,0.8947368421052632,44,32,12,0.7272727272727273,0.8023598820058998,llama3,mimiciii,progress_note,PROMPT1_entailment
108,196,25,24,1,0.96,42,26,16,0.6190476190476191,0.7527141133896261,llama3,mimiciii,progress_note,PROMPT1_entailment
109,197,46,44,2,0.9565217391304348,90,53,37,0.5888888888888889,0.7289778055642389,llama3,mimiciii,progress_note,PROMPT1_entailment
110,198,21,20,1,0.9523809523809524,34,29,5,0.8529411764705882,0.899922420480993,llama3,mimiciii,progress_note,PROMPT1_entailment
111,199,25,23,2,0.92,52,35,17,0.6730769230769231,0.7774022211492032,llama3,mimiciii,progress_note,PROMPT1_entailment
112,2,59,35,24,0.5932203389830508,140,52,88,0.3714285714285714,0.4568273092369478,llama3,mimiciii,progress_note,PROMPT1_entailment
113,20,13,12,1,0.9230769230769232,33,25,8,0.7575757575757576,0.8321775312066575,llama3,mimiciii,progress_note,PROMPT1_entailment
114,200,56,33,23,0.5892857142857143,164,57,107,0.3475609756097561,0.4372384937238494,llama3,mimiciii,progress_note,PROMPT1_entailment
115,201,65,57,8,0.8769230769230769,200,88,112,0.44,0.585981308411215,llama3,mimiciii,progress_note,PROMPT1_entailment
116,202,58,34,24,0.5862068965517241,176,74,102,0.4204545454545454,0.4896847022187621,llama3,mimiciii,progress_note,PROMPT1_entailment
117,203,51,43,8,0.8431372549019608,211,74,137,0.3507109004739336,0.4953685685374017,llama3,mimiciii,progress_note,PROMPT1_entailment
118,204,62,56,6,0.9032258064516128,201,68,133,0.3383084577114428,0.4922440537745605,llama3,mimiciii,progress_note,PROMPT1_entailment
119,205,61,48,13,0.7868852459016393,195,90,105,0.4615384615384615,0.5818181818181818,llama3,mimiciii,progress_note,PROMPT1_entailment
120,206,49,37,12,0.7551020408163265,239,84,155,0.3514644351464435,0.4796666409445172,llama3,mimiciii,progress_note,PROMPT1_entailment
121,207,40,30,10,0.75,233,100,133,0.4291845493562232,0.545950864422202,llama3,mimiciii,progress_note,PROMPT1_entailment
122,208,75,62,13,0.8266666666666667,229,94,135,0.4104803493449782,0.5485692771084337,llama3,mimiciii,progress_note,PROMPT1_entailment
123,209,57,52,5,0.912280701754386,205,79,126,0.3853658536585366,0.5418452812767921,llama3,mimiciii,progress_note,PROMPT1_entailment
124,21,58,47,11,0.8103448275862069,217,92,125,0.423963133640553,0.5566784679755391,llama3,mimiciii,progress_note,PROMPT1_entailment
125,210,16,15,1,0.9375,28,24,4,0.8571428571428571,0.8955223880597014,llama3,mimiciii,progress_note,PROMPT1_entailment
126,211,20,19,1,0.95,54,43,11,0.7962962962962963,0.8663838812301166,llama3,mimiciii,progress_note,PROMPT1_entailment
127,212,13,13,0,1.0,14,12,2,0.8571428571428571,0.923076923076923,llama3,mimiciii,progress_note,PROMPT1_entailment
128,213,19,18,1,0.9473684210526316,41,27,14,0.6585365853658537,0.776978417266187,llama3,mimiciii,progress_note,PROMPT1_entailment
129,214,15,15,0,1.0,27,20,7,0.7407407407407407,0.851063829787234,llama3,mimiciii,progress_note,PROMPT1_entailment
130,215,25,15,10,0.6,66,36,30,0.5454545454545454,0.5714285714285713,llama3,mimiciii,progress_note,PROMPT1_entailment
131,216,24,19,5,0.7916666666666666,67,39,28,0.582089552238806,0.6708918062471706,llama3,mimiciii,progress_note,PROMPT1_entailment
132,217,31,28,3,0.9032258064516128,73,40,33,0.547945205479452,0.682095006090134,llama3,mimiciii,progress_note,PROMPT1_entailment
133,218,16,15,1,0.9375,27,23,4,0.8518518518518519,0.8926261319534282,llama3,mimiciii,progress_note,PROMPT1_entailment
134,219,14,13,1,0.9285714285714286,17,10,7,0.5882352941176471,0.7202216066481996,llama3,mimiciii,progress_note,PROMPT1_entailment
135,22,13,12,1,0.9230769230769232,38,27,11,0.7105263157894737,0.8029739776951672,llama3,mimiciii,progress_note,PROMPT1_entailment
136,220,28,26,2,0.9285714285714286,34,23,11,0.6764705882352942,0.7827225130890053,llama3,mimiciii,progress_note,PROMPT1_entailment
137,221,59,54,5,0.9152542372881356,188,78,110,0.4148936170212766,0.570963806425376,llama3,mimiciii,progress_note,PROMPT1_entailment
138,222,39,30,9,0.7692307692307693,263,97,166,0.3688212927756654,0.4985864816242611,llama3,mimiciii,progress_note,PROMPT1_entailment
139,223,14,13,1,0.9285714285714286,30,22,8,0.7333333333333333,0.8194842406876792,llama3,mimiciii,progress_note,PROMPT1_entailment
140,224,14,13,1,0.9285714285714286,33,24,9,0.7272727272727273,0.8156862745098039,llama3,mimiciii,progress_note,PROMPT1_entailment
141,225,17,17,0,1.0,37,25,12,0.6756756756756757,0.8064516129032258,llama3,mimiciii,progress_note,PROMPT1_entailment
142,226,20,20,0,1.0,33,25,8,0.7575757575757576,0.8620689655172413,llama3,mimiciii,progress_note,PROMPT1_entailment
143,227,18,16,2,0.8888888888888888,15,15,0,1.0,0.9411764705882352,llama3,mimiciii,progress_note,PROMPT1_entailment
144,228,15,13,2,0.8666666666666667,15,8,7,0.5333333333333333,0.6603174603174604,llama3,mimiciii,progress_note,PROMPT1_entailment
145,229,15,13,2,0.8666666666666667,15,8,7,0.5333333333333333,0.6603174603174604,llama3,mimiciii,progress_note,PROMPT1_entailment
146,23,23,23,0,1.0,37,26,11,0.7027027027027027,0.8253968253968255,llama3,mimiciii,progress_note,PROMPT1_entailment
147,230,18,15,3,0.8333333333333334,26,12,14,0.4615384615384615,0.594059405940594,llama3,mimiciii,progress_note,PROMPT1_entailment
148,231,31,30,1,0.967741935483871,102,61,41,0.5980392156862745,0.7392445970511007,llama3,mimiciii,progress_note,PROMPT1_entailment
149,232,29,24,5,0.8275862068965517,72,42,30,0.5833333333333334,0.6843177189409368,llama3,mimiciii,progress_note,PROMPT1_entailment
150,233,22,17,5,0.7727272727272727,82,48,34,0.5853658536585366,0.6661224489795918,llama3,mimiciii,progress_note,PROMPT1_entailment
151,234,18,17,1,0.9444444444444444,42,30,12,0.7142857142857143,0.813397129186603,llama3,mimiciii,progress_note,PROMPT1_entailment
152,24,12,11,1,0.9166666666666666,22,16,6,0.7272727272727273,0.8110599078341013,llama3,mimiciii,progress_note,PROMPT1_entailment
153,25,15,12,3,0.8,22,16,6,0.7272727272727273,0.761904761904762,llama3,mimiciii,progress_note,PROMPT1_entailment
154,26,15,13,2,0.8666666666666667,22,14,8,0.6363636363636364,0.7338709677419355,llama3,mimiciii,progress_note,PROMPT1_entailment
155,27,20,17,3,0.85,19,11,8,0.5789473684210527,0.6887661141804788,llama3,mimiciii,progress_note,PROMPT1_entailment
156,28,39,33,6,0.8461538461538461,50,43,7,0.86,0.8530207394048692,llama3,mimiciii,progress_note,PROMPT1_entailment
157,29,18,16,2,0.8888888888888888,52,32,20,0.6153846153846154,0.7272727272727274,llama3,mimiciii,progress_note,PROMPT1_entailment
158,3,48,37,11,0.7708333333333334,157,62,95,0.3949044585987261,0.5222538417757542,llama3,mimiciii,progress_note,PROMPT1_entailment
159,30,18,18,0,1.0,18,13,5,0.7222222222222222,0.8387096774193548,llama3,mimiciii,progress_note,PROMPT1_entailment
160,31,19,18,1,0.9473684210526316,17,15,2,0.8823529411764706,0.9137055837563453,llama3,mimiciii,progress_note,PROMPT1_entailment
161,32,25,24,1,0.96,99,41,58,0.4141414141414141,0.5786533372537489,llama3,mimiciii,progress_note,PROMPT1_entailment
162,33,27,27,0,1.0,65,47,18,0.7230769230769231,0.8392857142857142,llama3,mimiciii,progress_note,PROMPT1_entailment
163,34,35,30,5,0.8571428571428571,71,44,27,0.6197183098591549,0.7193460490463215,llama3,mimiciii,progress_note,PROMPT1_entailment
164,35,7,6,1,0.8571428571428571,20,11,9,0.55,0.6700507614213198,llama3,mimiciii,progress_note,PROMPT1_entailment
165,36,17,15,2,0.8823529411764706,40,21,19,0.525,0.6583072100313481,llama3,mimiciii,progress_note,PROMPT1_entailment
166,37,73,63,10,0.863013698630137,199,93,106,0.4673366834170854,0.6063334368208632,llama3,mimiciii,progress_note,PROMPT1_entailment
167,38,49,46,3,0.9387755102040816,158,53,105,0.3354430379746835,0.494272681196148,llama3,mimiciii,progress_note,PROMPT1_entailment
168,39,29,28,1,0.9655172413793104,76,53,23,0.6973684210526315,0.8098226466575715,llama3,mimiciii,progress_note,PROMPT1_entailment
169,4,48,31,17,0.6458333333333334,162,67,95,0.4135802469135802,0.5042486040301044,llama3,mimiciii,progress_note,PROMPT1_entailment
170,40,27,26,1,0.9629629629629628,76,50,26,0.6578947368421053,0.7817197835237524,llama3,mimiciii,progress_note,PROMPT1_entailment
171,41,28,26,2,0.9285714285714286,78,43,35,0.5512820512820513,0.6918316831683169,llama3,mimiciii,progress_note,PROMPT1_entailment
172,42,33,32,1,0.9696969696969696,78,51,27,0.6538461538461539,0.7810480976310124,llama3,mimiciii,progress_note,PROMPT1_entailment
173,43,27,19,8,0.7037037037037037,79,41,38,0.5189873417721519,0.5973926380368098,llama3,mimiciii,progress_note,PROMPT1_entailment
174,44,29,27,2,0.9310344827586208,96,68,28,0.7083333333333334,0.8045574057843997,llama3,mimiciii,progress_note,PROMPT1_entailment
175,45,29,27,2,0.9310344827586208,82,64,18,0.7804878048780488,0.849140049140049,llama3,mimiciii,progress_note,PROMPT1_entailment
176,46,15,14,1,0.9333333333333332,36,29,7,0.8055555555555556,0.8647497337593184,llama3,mimiciii,progress_note,PROMPT1_entailment
177,47,13,12,1,0.9230769230769232,10,9,1,0.9,0.9113924050632912,llama3,mimiciii,progress_note,PROMPT1_entailment
178,48,36,31,5,0.8611111111111112,30,19,11,0.6333333333333333,0.7298636926889716,llama3,mimiciii,progress_note,PROMPT1_entailment
179,49,33,31,2,0.9393939393939394,57,43,14,0.7543859649122807,0.8367859384808537,llama3,mimiciii,progress_note,PROMPT1_entailment
180,5,51,37,14,0.7254901960784313,175,71,104,0.4057142857142857,0.52040412044374,llama3,mimiciii,progress_note,PROMPT1_entailment
181,50,27,26,1,0.9629629629629628,116,53,63,0.4568965517241379,0.6197436474027433,llama3,mimiciii,progress_note,PROMPT1_entailment
182,51,79,45,34,0.569620253164557,180,56,124,0.3111111111111111,0.4024273395081444,llama3,mimiciii,progress_note,PROMPT1_entailment
183,52,71,41,30,0.5774647887323944,180,71,109,0.3944444444444444,0.4687223250945978,llama3,mimiciii,progress_note,PROMPT1_entailment
184,53,40,28,12,0.7,221,77,144,0.3484162895927601,0.4652567975830816,llama3,mimiciii,progress_note,PROMPT1_entailment
185,54,49,34,15,0.6938775510204082,131,52,79,0.3969465648854962,0.504998571836618,llama3,mimiciii,progress_note,PROMPT1_entailment
186,55,56,41,15,0.7321428571428571,169,60,109,0.3550295857988165,0.4781805812032267,llama3,mimiciii,progress_note,PROMPT1_entailment
187,56,9,8,1,0.8888888888888888,40,5,35,0.125,0.2191780821917808,llama3,mimiciii,progress_note,PROMPT1_entailment
188,57,14,14,0,1.0,28,21,7,0.75,0.8571428571428571,llama3,mimiciii,progress_note,PROMPT1_entailment
189,58,18,13,5,0.7222222222222222,25,20,5,0.8,0.759124087591241,llama3,mimiciii,progress_note,PROMPT1_entailment
190,59,18,14,4,0.7777777777777778,25,20,5,0.8,0.7887323943661971,llama3,mimiciii,progress_note,PROMPT1_entailment
191,6,57,44,13,0.7719298245614035,188,73,115,0.3882978723404255,0.5166894554813801,llama3,mimiciii,progress_note,PROMPT1_entailment
192,60,52,43,9,0.8269230769230769,161,65,96,0.4037267080745341,0.5425604192953509,llama3,mimiciii,progress_note,PROMPT1_entailment
193,61,21,20,1,0.9523809523809524,37,27,10,0.7297297297297297,0.8263198163733741,llama3,mimiciii,progress_note,PROMPT1_entailment
194,62,23,22,1,0.9565217391304348,37,26,11,0.7027027027027027,0.810198300283286,llama3,mimiciii,progress_note,PROMPT1_entailment
195,63,32,29,3,0.90625,96,61,35,0.6354166666666666,0.747043918918919,llama3,mimiciii,progress_note,PROMPT1_entailment
196,64,1,0,1,0.0,1,0,1,0.0,,llama3,mimiciii,progress_note,PROMPT1_entailment
197,65,13,12,1,0.9230769230769232,8,8,0,1.0,0.96,llama3,mimiciii,progress_note,PROMPT1_entailment
198,66,18,15,3,0.8333333333333334,48,29,19,0.6041666666666666,0.7004830917874396,llama3,mimiciii,progress_note,PROMPT1_entailment
199,67,45,25,20,0.5555555555555556,180,46,134,0.2555555555555555,0.350076103500761,llama3,mimiciii,progress_note,PROMPT1_entailment
200,68,61,42,19,0.6885245901639344,206,87,119,0.4223300970873786,0.5235332043842682,llama3,mimiciii,progress_note,PROMPT1_entailment
201,69,73,65,8,0.8904109589041096,219,107,112,0.4885844748858447,0.6309534609452961,llama3,mimiciii,progress_note,PROMPT1_entailment
202,7,56,46,10,0.8214285714285714,187,71,116,0.3796791443850267,0.5193194466528861,llama3,mimiciii,progress_note,PROMPT1_entailment
203,70,49,45,4,0.9183673469387756,217,85,132,0.391705069124424,0.5491744436468055,llama3,mimiciii,progress_note,PROMPT1_entailment
204,71,42,41,1,0.9761904761904762,213,91,122,0.4272300469483568,0.5943448825169255,llama3,mimiciii,progress_note,PROMPT1_entailment
205,72,9,8,1,0.8888888888888888,15,8,7,0.5333333333333333,0.6666666666666667,llama3,mimiciii,progress_note,PROMPT1_entailment
206,73,60,40,20,0.6666666666666666,264,97,167,0.3674242424242424,0.4737484737484737,llama3,mimiciii,progress_note,PROMPT1_entailment
207,74,44,39,5,0.8863636363636364,184,107,77,0.5815217391304348,0.7022887916526421,llama3,mimiciii,progress_note,PROMPT1_entailment
208,75,31,30,1,0.967741935483871,40,28,12,0.7,0.8123791102514506,llama3,mimiciii,progress_note,PROMPT1_entailment
209,76,27,25,2,0.925925925925926,58,47,11,0.8103448275862069,0.8642883413019491,llama3,mimiciii,progress_note,PROMPT1_entailment
210,77,16,15,1,0.9375,27,20,7,0.7407407407407407,0.8275862068965517,llama3,mimiciii,progress_note,PROMPT1_entailment
211,78,21,20,1,0.9523809523809524,20,15,5,0.75,0.8391608391608391,llama3,mimiciii,progress_note,PROMPT1_entailment
212,79,18,16,2,0.8888888888888888,43,21,22,0.4883720930232558,0.6303939962476547,llama3,mimiciii,progress_note,PROMPT1_entailment
213,8,29,26,3,0.896551724137931,78,49,29,0.6282051282051282,0.7387648593795303,llama3,mimiciii,progress_note,PROMPT1_entailment
214,80,20,19,1,0.95,21,18,3,0.8571428571428571,0.9011857707509882,llama3,mimiciii,progress_note,PROMPT1_entailment
215,81,22,19,3,0.8636363636363636,32,22,10,0.6875,0.7655677655677655,llama3,mimiciii,progress_note,PROMPT1_entailment
216,82,18,16,2,0.8888888888888888,15,13,2,0.8666666666666667,0.8776371308016878,llama3,mimiciii,progress_note,PROMPT1_entailment
217,83,23,21,2,0.9130434782608696,43,30,13,0.6976744186046512,0.7909604519774012,llama3,mimiciii,progress_note,PROMPT1_entailment
218,84,24,23,1,0.9583333333333334,35,20,15,0.5714285714285714,0.7159533073929961,llama3,mimiciii,progress_note,PROMPT1_entailment
219,85,24,22,2,0.9166666666666666,50,39,11,0.78,0.8428290766208251,llama3,mimiciii,progress_note,PROMPT1_entailment
220,86,47,42,5,0.8936170212765957,32,23,9,0.71875,0.7967010309278351,llama3,mimiciii,progress_note,PROMPT1_entailment
221,87,6,5,1,0.8333333333333334,12,2,10,0.1666666666666666,0.2777777777777778,llama3,mimiciii,progress_note,PROMPT1_entailment
222,88,31,27,4,0.8709677419354839,67,41,26,0.6119402985074627,0.7188311688311688,llama3,mimiciii,progress_note,PROMPT1_entailment
223,89,49,33,16,0.673469387755102,199,61,138,0.3065326633165829,0.4213059857681038,llama3,mimiciii,progress_note,PROMPT1_entailment
224,9,19,18,1,0.9473684210526316,42,31,11,0.7380952380952381,0.8297397769516729,llama3,mimiciii,progress_note,PROMPT1_entailment
225,90,7,6,1,0.8571428571428571,3,3,0,1.0,0.923076923076923,llama3,mimiciii,progress_note,PROMPT1_entailment
226,91,22,18,4,0.8181818181818182,79,51,28,0.6455696202531646,0.7216981132075472,llama3,mimiciii,progress_note,PROMPT1_entailment
227,92,65,50,15,0.7692307692307693,143,86,57,0.6013986013986014,0.6750392464678179,llama3,mimiciii,progress_note,PROMPT1_entailment
228,93,16,13,3,0.8125,27,18,9,0.6666666666666666,0.7323943661971831,llama3,mimiciii,progress_note,PROMPT1_entailment
229,94,22,19,3,0.8636363636363636,80,46,34,0.575,0.6903633491311217,llama3,mimiciii,progress_note,PROMPT1_entailment
230,95,18,16,2,0.8888888888888888,32,18,14,0.5625,0.6889952153110048,llama3,mimiciii,progress_note,PROMPT1_entailment
231,96,8,7,1,0.875,11,2,9,0.1818181818181818,0.3010752688172042,llama3,mimiciii,progress_note,PROMPT1_entailment
232,97,5,4,1,0.8,14,10,4,0.7142857142857143,0.7547169811320756,llama3,mimiciii,progress_note,PROMPT1_entailment
233,98,14,13,1,0.9285714285714286,24,22,2,0.9166666666666666,0.9225806451612902,llama3,mimiciii,progress_note,PROMPT1_entailment
234,99,21,17,4,0.8095238095238095,70,26,44,0.3714285714285714,0.5092165898617512,llama3,mimiciii,progress_note,PROMPT1_entailment
0,0,36,31,5,0.8611111111111112,78,55,23,0.7051282051282052,0.7753524329240564,llama3,mimiciii,progress_note,PROMPT1_ICL_entailment
1,1,40,28,12,0.7,189,93,96,0.492063492063492,0.5778961384820239,llama3,mimiciii,progress_note,PROMPT1_ICL_entailment
2,10,32,19,13,0.59375,140,51,89,0.3642857142857142,0.4515377446411928,llama3,mimiciii,progress_note,PROMPT1_ICL_entailment
3,100,32,27,5,0.84375,77,51,26,0.6623376623376623,0.7421180274858529,llama3,mimiciii,progress_note,PROMPT1_ICL_entailment
4,101,24,17,7,0.7083333333333334,36,22,14,0.6111111111111112,0.6561403508771929,llama3,mimiciii,progress_note,PROMPT1_ICL_entailment
5,102,26,24,2,0.9230769230769232,42,32,10,0.7619047619047619,0.8347826086956522,llama3,mimiciii,progress_note,PROMPT1_ICL_entailment
6,103,34,28,6,0.8235294117647058,204,80,124,0.392156862745098,0.5313092979127135,llama3,mimiciii,progress_note,PROMPT1_ICL_entailment
7,104,31,21,10,0.6774193548387096,39,22,17,0.5641025641025641,0.6155896069287141,llama3,mimiciii,progress_note,PROMPT1_ICL_entailment
8,105,24,22,2,0.9166666666666666,17,15,2,0.8823529411764706,0.8991825613079019,llama3,mimiciii,progress_note,PROMPT1_ICL_entailment
9,106,28,17,11,0.6071428571428571,40,25,15,0.625,0.6159420289855072,llama3,mimiciii,progress_note,PROMPT1_ICL_entailment
10,107,31,21,10,0.6774193548387096,31,22,9,0.7096774193548387,0.6931732933233308,llama3,mimiciii,progress_note,PROMPT1_ICL_entailment
11,108,49,33,16,0.673469387755102,68,44,24,0.6470588235294118,0.66,llama3,mimiciii,progress_note,PROMPT1_ICL_entailment
12,109,24,15,9,0.625,176,49,127,0.2784090909090909,0.3852201257861635,llama3,mimiciii,progress_note,PROMPT1_ICL_entailment
13,11,43,24,19,0.5581395348837209,141,70,71,0.4964539007092198,0.5254926493587738,llama3,mimiciii,progress_note,PROMPT1_ICL_entailment
14,110,21,18,3,0.8571428571428571,215,73,142,0.3395348837209302,0.4863964464186562,llama3,mimiciii,progress_note,PROMPT1_ICL_entailment
15,111,49,32,17,0.6530612244897959,219,74,145,0.3378995433789954,0.4453639270265187,llama3,mimiciii,progress_note,PROMPT1_ICL_entailment
16,112,500,277,223,0.554,182,32,150,0.1758241758241758,0.2669316710332159,llama3,mimiciii,progress_note,PROMPT1_ICL_entailment
17,113,47,33,14,0.7021276595744681,196,85,111,0.4336734693877551,0.5361750931855108,llama3,mimiciii,progress_note,PROMPT1_ICL_entailment
18,114,45,30,15,0.6666666666666666,225,68,157,0.3022222222222222,0.4159021406727828,llama3,mimiciii,progress_note,PROMPT1_ICL_entailment
19,115,259,28,231,0.1081081081081081,280,59,221,0.2107142857142857,0.1429003935815924,llama3,mimiciii,progress_note,PROMPT1_ICL_entailment
20,116,26,17,9,0.6538461538461539,35,25,10,0.7142857142857143,0.6827309236947792,llama3,mimiciii,progress_note,PROMPT1_ICL_entailment
21,117,30,21,9,0.7,20,13,7,0.65,0.6740740740740739,llama3,mimiciii,progress_note,PROMPT1_ICL_entailment
22,118,24,23,1,0.9583333333333334,23,17,6,0.7391304347826086,0.8345784418356457,llama3,mimiciii,progress_note,PROMPT1_ICL_entailment
23,119,21,13,8,0.6190476190476191,14,11,3,0.7857142857142857,0.6924939467312349,llama3,mimiciii,progress_note,PROMPT1_ICL_entailment
24,12,472,347,125,0.7351694915254238,225,31,194,0.1377777777777777,0.2320644611518008,llama3,mimiciii,progress_note,PROMPT1_ICL_entailment
25,120,24,17,7,0.7083333333333334,64,29,35,0.453125,0.5526905829596412,llama3,mimiciii,progress_note,PROMPT1_ICL_entailment
26,121,25,18,7,0.72,14,11,3,0.7857142857142857,0.7514231499051233,llama3,mimiciii,progress_note,PROMPT1_ICL_entailment
27,122,35,17,18,0.4857142857142857,47,22,25,0.4680851063829787,0.4767367750159337,llama3,mimiciii,progress_note,PROMPT1_ICL_entailment
28,123,33,17,16,0.5151515151515151,50,25,25,0.5,0.5074626865671642,llama3,mimiciii,progress_note,PROMPT1_ICL_entailment
29,124,54,45,9,0.8333333333333334,65,47,18,0.7230769230769231,0.7742998352553542,llama3,mimiciii,progress_note,PROMPT1_ICL_entailment
30,125,38,29,9,0.7631578947368421,50,32,18,0.64,0.6961740435108777,llama3,mimiciii,progress_note,PROMPT1_ICL_entailment
31,126,29,17,12,0.5862068965517241,27,21,6,0.7777777777777778,0.6685393258426966,llama3,mimiciii,progress_note,PROMPT1_ICL_entailment
32,127,24,15,9,0.625,27,12,15,0.4444444444444444,0.5194805194805195,llama3,mimiciii,progress_note,PROMPT1_ICL_entailment
33,128,24,23,1,0.9583333333333334,37,29,8,0.7837837837837838,0.8623141564318034,llama3,mimiciii,progress_note,PROMPT1_ICL_entailment
34,129,41,30,11,0.7317073170731707,66,47,19,0.7121212121212122,0.7217814179677503,llama3,mimiciii,progress_note,PROMPT1_ICL_entailment
35,13,33,18,15,0.5454545454545454,73,36,37,0.4931506849315068,0.5179856115107914,llama3,mimiciii,progress_note,PROMPT1_ICL_entailment
36,130,23,12,11,0.5217391304347826,44,23,21,0.5227272727272727,0.522232734153264,llama3,mimiciii,progress_note,PROMPT1_ICL_entailment
37,131,40,31,9,0.775,202,88,114,0.4356435643564356,0.5577591494581885,llama3,mimiciii,progress_note,PROMPT1_ICL_entailment
38,132,450,364,86,0.8088888888888889,193,81,112,0.4196891191709844,0.5526419373582501,llama3,mimiciii,progress_note,PROMPT1_ICL_entailment
39,133,35,26,9,0.7428571428571429,157,65,92,0.4140127388535032,0.5316973415132924,llama3,mimiciii,progress_note,PROMPT1_ICL_entailment
40,134,23,10,13,0.4347826086956521,18,11,7,0.6111111111111112,0.5080831408775982,llama3,mimiciii,progress_note,PROMPT1_ICL_entailment
41,135,29,21,8,0.7241379310344828,35,24,11,0.6857142857142857,0.7044025157232704,llama3,mimiciii,progress_note,PROMPT1_ICL_entailment
42,136,32,21,11,0.65625,43,29,14,0.6744186046511628,0.6652102676133261,llama3,mimiciii,progress_note,PROMPT1_ICL_entailment
43,137,22,14,8,0.6363636363636364,26,16,10,0.6153846153846154,0.6256983240223464,llama3,mimiciii,progress_note,PROMPT1_ICL_entailment
44,138,29,23,6,0.7931034482758621,45,23,22,0.5111111111111111,0.6216216216216216,llama3,mimiciii,progress_note,PROMPT1_ICL_entailment
45,139,37,28,9,0.7567567567567568,45,32,13,0.7111111111111111,0.7332242225859248,llama3,mimiciii,progress_note,PROMPT1_ICL_entailment
46,14,46,33,13,0.717391304347826,43,36,7,0.8372093023255814,0.7726829268292683,llama3,mimiciii,progress_note,PROMPT1_ICL_entailment
47,140,26,16,10,0.6153846153846154,25,15,10,0.6,0.6075949367088608,llama3,mimiciii,progress_note,PROMPT1_ICL_entailment
48,141,37,28,9,0.7567567567567568,45,33,12,0.7333333333333333,0.7448609431680775,llama3,mimiciii,progress_note,PROMPT1_ICL_entailment
49,142,39,23,16,0.5897435897435898,50,27,23,0.54,0.5637766681797548,llama3,mimiciii,progress_note,PROMPT1_ICL_entailment
50,143,15,7,8,0.4666666666666667,11,1,10,0.0909090909090909,0.1521739130434782,llama3,mimiciii,progress_note,PROMPT1_ICL_entailment
51,144,35,19,16,0.5428571428571428,50,29,21,0.58,0.5608142493638677,llama3,mimiciii,progress_note,PROMPT1_ICL_entailment
52,145,34,26,8,0.7647058823529411,43,25,18,0.5813953488372093,0.6605691056910569,llama3,mimiciii,progress_note,PROMPT1_ICL_entailment
53,146,36,24,12,0.6666666666666666,32,16,16,0.5,0.5714285714285715,llama3,mimiciii,progress_note,PROMPT1_ICL_entailment
54,147,33,31,2,0.9393939393939394,56,43,13,0.7678571428571429,0.8450079239302695,llama3,mimiciii,progress_note,PROMPT1_ICL_entailment
55,148,18,10,8,0.5555555555555556,4,3,1,0.75,0.6382978723404256,llama3,mimiciii,progress_note,PROMPT1_ICL_entailment
56,149,18,17,1,0.9444444444444444,29,25,4,0.8620689655172413,0.9013785790031812,llama3,mimiciii,progress_note,PROMPT1_ICL_entailment
57,15,26,16,10,0.6153846153846154,163,68,95,0.4171779141104294,0.4972577696526508,llama3,mimiciii,progress_note,PROMPT1_ICL_entailment
58,150,36,30,6,0.8333333333333334,83,53,30,0.6385542168674698,0.7230559345156888,llama3,mimiciii,progress_note,PROMPT1_ICL_entailment
59,151,766,20,746,0.0261096605744125,201,40,161,0.1990049751243781,0.0461627236006924,llama3,mimiciii,progress_note,PROMPT1_ICL_entailment
60,152,648,0,648,0.0,45,14,31,0.3111111111111111,0.0,llama3,mimiciii,progress_note,PROMPT1_ICL_entailment
61,153,32,23,9,0.71875,219,65,154,0.2968036529680365,0.4201208374315021,llama3,mimiciii,progress_note,PROMPT1_ICL_entailment
62,154,14,13,1,0.9285714285714286,15,14,1,0.9333333333333332,0.9309462915601024,llama3,mimiciii,progress_note,PROMPT1_ICL_entailment
63,155,27,20,7,0.7407407407407407,32,21,11,0.65625,0.695940347970174,llama3,mimiciii,progress_note,PROMPT1_ICL_entailment
64,156,27,21,6,0.7777777777777778,32,21,11,0.65625,0.711864406779661,llama3,mimiciii,progress_note,PROMPT1_ICL_entailment
65,157,25,18,7,0.72,29,19,10,0.6551724137931034,0.6860581745235707,llama3,mimiciii,progress_note,PROMPT1_ICL_entailment
66,158,34,23,11,0.6764705882352942,242,108,134,0.4462809917355372,0.5377787399870102,llama3,mimiciii,progress_note,PROMPT1_ICL_entailment
67,159,23,13,10,0.5652173913043478,22,12,10,0.5454545454545454,0.5551601423487544,llama3,mimiciii,progress_note,PROMPT1_ICL_entailment
68,16,21,13,8,0.6190476190476191,28,12,16,0.4285714285714285,0.5064935064935066,llama3,mimiciii,progress_note,PROMPT1_ICL_entailment
69,160,53,44,9,0.8301886792452831,65,40,25,0.6153846153846154,0.7068273092369478,llama3,mimiciii,progress_note,PROMPT1_ICL_entailment
70,161,25,21,4,0.84,201,86,115,0.4278606965174129,0.5669439648406844,llama3,mimiciii,progress_note,PROMPT1_ICL_entailment
71,162,25,18,7,0.72,177,72,105,0.4067796610169492,0.51985559566787,llama3,mimiciii,progress_note,PROMPT1_ICL_entailment
72,163,22,13,9,0.5909090909090909,28,11,17,0.3928571428571428,0.4719471947194719,llama3,mimiciii,progress_note,PROMPT1_ICL_entailment
73,164,31,19,12,0.6129032258064516,57,30,27,0.5263157894736842,0.5663189269746647,llama3,mimiciii,progress_note,PROMPT1_ICL_entailment
74,165,16,8,8,0.5,25,4,21,0.16,0.2424242424242424,llama3,mimiciii,progress_note,PROMPT1_ICL_entailment
75,166,26,18,8,0.6923076923076923,42,23,19,0.5476190476190477,0.6115214180206795,llama3,mimiciii,progress_note,PROMPT1_ICL_entailment
76,167,40,31,9,0.775,52,29,23,0.5576923076923077,0.6486291486291486,llama3,mimiciii,progress_note,PROMPT1_ICL_entailment
77,168,30,21,9,0.7,182,84,98,0.4615384615384615,0.5562913907284769,llama3,mimiciii,progress_note,PROMPT1_ICL_entailment
78,169,37,32,5,0.8648648648648649,219,96,123,0.4383561643835616,0.5818181818181818,llama3,mimiciii,progress_note,PROMPT1_ICL_entailment
79,17,16,6,10,0.375,15,4,11,0.2666666666666666,0.3116883116883117,llama3,mimiciii,progress_note,PROMPT1_ICL_entailment
80,170,39,31,8,0.7948717948717948,184,80,104,0.4347826086956521,0.5621033544877606,llama3,mimiciii,progress_note,PROMPT1_ICL_entailment
81,171,39,28,11,0.717948717948718,222,111,111,0.5,0.5894736842105263,llama3,mimiciii,progress_note,PROMPT1_ICL_entailment
82,172,47,36,11,0.7659574468085106,198,68,130,0.3434343434343434,0.4742347927160015,llama3,mimiciii,progress_note,PROMPT1_ICL_entailment
83,173,26,20,6,0.7692307692307693,172,77,95,0.4476744186046512,0.5659683939728042,llama3,mimiciii,progress_note,PROMPT1_ICL_entailment
84,174,35,20,15,0.5714285714285714,200,48,152,0.24,0.3380281690140844,llama3,mimiciii,progress_note,PROMPT1_ICL_entailment
85,175,47,35,12,0.7446808510638298,64,30,34,0.46875,0.5753424657534246,llama3,mimiciii,progress_note,PROMPT1_ICL_entailment
86,176,24,17,7,0.7083333333333334,192,75,117,0.390625,0.5035545023696683,llama3,mimiciii,progress_note,PROMPT1_ICL_entailment
87,177,30,22,8,0.7333333333333333,192,88,104,0.4583333333333333,0.5641025641025641,llama3,mimiciii,progress_note,PROMPT1_ICL_entailment
88,178,24,15,9,0.625,17,13,4,0.7647058823529411,0.6878306878306878,llama3,mimiciii,progress_note,PROMPT1_ICL_entailment
89,179,21,14,7,0.6666666666666666,197,81,116,0.4111675126903553,0.5086342229199372,llama3,mimiciii,progress_note,PROMPT1_ICL_entailment
90,18,24,9,15,0.375,18,18,0,1.0,0.5454545454545454,llama3,mimiciii,progress_note,PROMPT1_ICL_entailment
91,180,26,22,4,0.8461538461538461,201,74,127,0.3681592039800995,0.5130791049479987,llama3,mimiciii,progress_note,PROMPT1_ICL_entailment
92,181,36,30,6,0.8333333333333334,208,85,123,0.4086538461538461,0.5483870967741935,llama3,mimiciii,progress_note,PROMPT1_ICL_entailment
93,182,37,30,7,0.8108108108108109,214,102,112,0.4766355140186916,0.6003531489111242,llama3,mimiciii,progress_note,PROMPT1_ICL_entailment
94,183,31,26,5,0.8387096774193549,226,87,139,0.3849557522123893,0.5277032544033594,llama3,mimiciii,progress_note,PROMPT1_ICL_entailment
95,184,79,73,6,0.9240506329113924,194,99,95,0.5103092783505154,0.6575080744211436,llama3,mimiciii,progress_note,PROMPT1_ICL_entailment
96,185,26,16,10,0.6153846153846154,48,15,33,0.3125,0.4145077720207254,llama3,mimiciii,progress_note,PROMPT1_ICL_entailment
97,186,27,22,5,0.8148148148148148,205,77,128,0.375609756097561,0.5141903171953256,llama3,mimiciii,progress_note,PROMPT1_ICL_entailment
98,187,17,10,7,0.5882352941176471,170,47,123,0.2764705882352941,0.3761504601840736,llama3,mimiciii,progress_note,PROMPT1_ICL_entailment
99,188,214,200,14,0.9345794392523364,202,55,147,0.2722772277227723,0.4216982940387196,llama3,mimiciii,progress_note,PROMPT1_ICL_entailment
100,189,41,31,10,0.7560975609756098,225,110,115,0.4888888888888889,0.5938180235089247,llama3,mimiciii,progress_note,PROMPT1_ICL_entailment
101,19,28,17,11,0.6071428571428571,38,19,19,0.5,0.5483870967741935,llama3,mimiciii,progress_note,PROMPT1_ICL_entailment
102,190,42,30,12,0.7142857142857143,223,112,111,0.5022421524663677,0.5897840968931016,llama3,mimiciii,progress_note,PROMPT1_ICL_entailment
103,191,45,33,12,0.7333333333333333,206,94,112,0.4563106796116505,0.5625680087051143,llama3,mimiciii,progress_note,PROMPT1_ICL_entailment
104,192,41,31,10,0.7560975609756098,208,74,134,0.3557692307692308,0.4838641636785488,llama3,mimiciii,progress_note,PROMPT1_ICL_entailment
105,193,33,27,6,0.8181818181818182,243,87,156,0.3580246913580246,0.4980916030534351,llama3,mimiciii,progress_note,PROMPT1_ICL_entailment
106,194,31,21,10,0.6774193548387096,211,49,162,0.2322274881516587,0.3458823529411765,llama3,mimiciii,progress_note,PROMPT1_ICL_entailment
107,195,32,21,11,0.65625,44,30,14,0.6818181818181818,0.6687898089171974,llama3,mimiciii,progress_note,PROMPT1_ICL_entailment
108,196,37,26,11,0.7027027027027027,42,26,16,0.6190476190476191,0.6582278481012659,llama3,mimiciii,progress_note,PROMPT1_ICL_entailment
109,197,55,48,7,0.8727272727272727,90,64,26,0.7111111111111111,0.7836734693877551,llama3,mimiciii,progress_note,PROMPT1_ICL_entailment
110,198,22,21,1,0.9545454545454546,34,28,6,0.8235294117647058,0.8842105263157896,llama3,mimiciii,progress_note,PROMPT1_ICL_entailment
111,199,36,24,12,0.6666666666666666,52,25,27,0.4807692307692308,0.5586592178770949,llama3,mimiciii,progress_note,PROMPT1_ICL_entailment
112,2,23,15,8,0.6521739130434783,140,41,99,0.2928571428571428,0.4042063752875451,llama3,mimiciii,progress_note,PROMPT1_ICL_entailment
113,20,26,18,8,0.6923076923076923,33,21,12,0.6363636363636364,0.663157894736842,llama3,mimiciii,progress_note,PROMPT1_ICL_entailment
114,200,39,24,15,0.6153846153846154,164,53,111,0.3231707317073171,0.4237881059470265,llama3,mimiciii,progress_note,PROMPT1_ICL_entailment
115,201,42,38,4,0.9047619047619048,200,111,89,0.555,0.6879791224922526,llama3,mimiciii,progress_note,PROMPT1_ICL_entailment
116,202,43,24,19,0.5581395348837209,176,64,112,0.3636363636363636,0.4403669724770642,llama3,mimiciii,progress_note,PROMPT1_ICL_entailment
117,203,26,18,8,0.6923076923076923,211,75,136,0.3554502369668246,0.4697286012526095,llama3,mimiciii,progress_note,PROMPT1_ICL_entailment
118,204,28,21,7,0.75,201,80,121,0.3980099502487562,0.5200433369447455,llama3,mimiciii,progress_note,PROMPT1_ICL_entailment
119,205,46,35,11,0.7608695652173914,195,85,110,0.4358974358974359,0.5542617605961807,llama3,mimiciii,progress_note,PROMPT1_ICL_entailment
120,206,47,33,14,0.7021276595744681,239,111,128,0.4644351464435146,0.5590659340659341,llama3,mimiciii,progress_note,PROMPT1_ICL_entailment
121,207,73,42,31,0.5753424657534246,233,79,154,0.3390557939914163,0.4266700958014531,llama3,mimiciii,progress_note,PROMPT1_ICL_entailment
122,208,48,40,8,0.8333333333333334,229,100,129,0.4366812227074236,0.5730659025787966,llama3,mimiciii,progress_note,PROMPT1_ICL_entailment
123,209,28,20,8,0.7142857142857143,205,76,129,0.3707317073170731,0.4881181759794476,llama3,mimiciii,progress_note,PROMPT1_ICL_entailment
124,21,60,49,11,0.8166666666666667,217,110,107,0.5069124423963134,0.625544014390994,llama3,mimiciii,progress_note,PROMPT1_ICL_entailment
125,210,17,16,1,0.9411764705882352,28,23,5,0.8214285714285714,0.8772348033373063,llama3,mimiciii,progress_note,PROMPT1_ICL_entailment
126,211,44,26,18,0.5909090909090909,54,35,19,0.6481481481481481,0.6182065217391304,llama3,mimiciii,progress_note,PROMPT1_ICL_entailment
127,212,16,9,7,0.5625,14,8,6,0.5714285714285714,0.5669291338582677,llama3,mimiciii,progress_note,PROMPT1_ICL_entailment
128,213,34,26,8,0.7647058823529411,41,26,15,0.6341463414634146,0.6933333333333332,llama3,mimiciii,progress_note,PROMPT1_ICL_entailment
129,214,23,14,9,0.6086956521739131,27,13,14,0.4814814814814814,0.5376661742983753,llama3,mimiciii,progress_note,PROMPT1_ICL_entailment
130,215,42,30,12,0.7142857142857143,66,15,51,0.2272727272727272,0.3448275862068965,llama3,mimiciii,progress_note,PROMPT1_ICL_entailment
131,216,36,28,8,0.7777777777777778,67,37,30,0.5522388059701493,0.6458852867830425,llama3,mimiciii,progress_note,PROMPT1_ICL_entailment
132,217,35,34,1,0.9714285714285714,73,49,24,0.6712328767123288,0.7939004050512269,llama3,mimiciii,progress_note,PROMPT1_ICL_entailment
133,218,34,25,9,0.7352941176470589,27,12,15,0.4444444444444444,0.554016620498615,llama3,mimiciii,progress_note,PROMPT1_ICL_entailment
134,219,28,19,9,0.6785714285714286,17,11,6,0.6470588235294118,0.6624405705229793,llama3,mimiciii,progress_note,PROMPT1_ICL_entailment
135,22,26,16,10,0.6153846153846154,38,26,12,0.6842105263157895,0.64797507788162,llama3,mimiciii,progress_note,PROMPT1_ICL_entailment
136,220,38,29,9,0.7631578947368421,34,18,16,0.5294117647058824,0.6251497005988024,llama3,mimiciii,progress_note,PROMPT1_ICL_entailment
137,221,506,88,418,0.1739130434782608,188,23,165,0.1223404255319148,0.1436377829820453,llama3,mimiciii,progress_note,PROMPT1_ICL_entailment
138,222,18,15,3,0.8333333333333334,263,110,153,0.4182509505703422,0.5569620253164558,llama3,mimiciii,progress_note,PROMPT1_ICL_entailment
139,223,22,13,9,0.5909090909090909,30,15,15,0.5,0.5416666666666667,llama3,mimiciii,progress_note,PROMPT1_ICL_entailment
140,224,26,18,8,0.6923076923076923,33,21,12,0.6363636363636364,0.663157894736842,llama3,mimiciii,progress_note,PROMPT1_ICL_entailment
141,225,25,17,8,0.68,37,18,19,0.4864864864864865,0.5671918443002781,llama3,mimiciii,progress_note,PROMPT1_ICL_entailment
142,226,29,21,8,0.7241379310344828,33,15,18,0.4545454545454545,0.5585106382978724,llama3,mimiciii,progress_note,PROMPT1_ICL_entailment
143,227,13,5,8,0.3846153846153846,15,2,13,0.1333333333333333,0.198019801980198,llama3,mimiciii,progress_note,PROMPT1_ICL_entailment
144,228,13,5,8,0.3846153846153846,15,2,13,0.1333333333333333,0.198019801980198,llama3,mimiciii,progress_note,PROMPT1_ICL_entailment
145,229,13,5,8,0.3846153846153846,15,2,13,0.1333333333333333,0.198019801980198,llama3,mimiciii,progress_note,PROMPT1_ICL_entailment
146,23,31,16,15,0.5161290322580645,37,19,18,0.5135135135135135,0.514817950889077,llama3,mimiciii,progress_note,PROMPT1_ICL_entailment
147,230,26,15,11,0.5769230769230769,26,11,15,0.4230769230769231,0.4881656804733727,llama3,mimiciii,progress_note,PROMPT1_ICL_entailment
148,231,21,19,2,0.9047619047619048,102,62,40,0.6078431372549019,0.7271604938271604,llama3,mimiciii,progress_note,PROMPT1_ICL_entailment
149,232,47,40,7,0.851063829787234,72,49,23,0.6805555555555556,0.7563187343237507,llama3,mimiciii,progress_note,PROMPT1_ICL_entailment
150,233,21,16,5,0.7619047619047619,82,42,40,0.5121951219512195,0.6125797629899727,llama3,mimiciii,progress_note,PROMPT1_ICL_entailment
151,234,26,19,7,0.7307692307692307,42,22,20,0.5238095238095238,0.6102189781021897,llama3,mimiciii,progress_note,PROMPT1_ICL_entailment
152,24,25,9,16,0.36,22,11,11,0.5,0.4186046511627906,llama3,mimiciii,progress_note,PROMPT1_ICL_entailment
153,25,21,9,12,0.4285714285714285,22,12,10,0.5454545454545454,0.4799999999999999,llama3,mimiciii,progress_note,PROMPT1_ICL_entailment
154,26,21,9,12,0.4285714285714285,22,10,12,0.4545454545454545,0.4411764705882353,llama3,mimiciii,progress_note,PROMPT1_ICL_entailment
155,27,28,6,22,0.2142857142857142,19,14,5,0.7368421052631579,0.3320158102766798,llama3,mimiciii,progress_note,PROMPT1_ICL_entailment
156,28,45,32,13,0.7111111111111111,50,33,17,0.66,0.6846029173419773,llama3,mimiciii,progress_note,PROMPT1_ICL_entailment
157,29,36,29,7,0.8055555555555556,52,32,20,0.6153846153846154,0.6977443609022557,llama3,mimiciii,progress_note,PROMPT1_ICL_entailment
158,3,48,31,17,0.6458333333333334,157,68,89,0.4331210191082802,0.5185094084368467,llama3,mimiciii,progress_note,PROMPT1_ICL_entailment
159,30,28,20,8,0.7142857142857143,18,13,5,0.7222222222222222,0.7182320441988951,llama3,mimiciii,progress_note,PROMPT1_ICL_entailment
160,31,31,19,12,0.6129032258064516,17,14,3,0.8235294117647058,0.7027741083223249,llama3,mimiciii,progress_note,PROMPT1_ICL_entailment
161,32,43,39,4,0.9069767441860463,99,53,46,0.5353535353535354,0.6732899022801303,llama3,mimiciii,progress_note,PROMPT1_ICL_entailment
162,33,37,24,13,0.6486486486486487,65,35,30,0.5384615384615384,0.5884413309982488,llama3,mimiciii,progress_note,PROMPT1_ICL_entailment
163,34,39,28,11,0.717948717948718,71,34,37,0.4788732394366197,0.5745322872661436,llama3,mimiciii,progress_note,PROMPT1_ICL_entailment
164,35,18,10,8,0.5555555555555556,20,5,15,0.25,0.3448275862068966,llama3,mimiciii,progress_note,PROMPT1_ICL_entailment
165,36,30,16,14,0.5333333333333333,40,23,17,0.575,0.5533834586466164,llama3,mimiciii,progress_note,PROMPT1_ICL_entailment
166,37,71,61,10,0.8591549295774648,199,133,66,0.6683417085427136,0.7518302288944492,llama3,mimiciii,progress_note,PROMPT1_ICL_entailment
167,38,33,20,13,0.6060606060606061,158,84,74,0.5316455696202531,0.5664194200944032,llama3,mimiciii,progress_note,PROMPT1_ICL_entailment
168,39,38,31,7,0.8157894736842105,76,57,19,0.75,0.7815126050420167,llama3,mimiciii,progress_note,PROMPT1_ICL_entailment
169,4,41,23,18,0.5609756097560976,162,68,94,0.419753086419753,0.4801964998464845,llama3,mimiciii,progress_note,PROMPT1_ICL_entailment
170,40,32,26,6,0.8125,76,53,23,0.6973684210526315,0.7505446623093682,llama3,mimiciii,progress_note,PROMPT1_ICL_entailment
171,41,33,28,5,0.8484848484848485,78,57,21,0.7307692307692307,0.785239852398524,llama3,mimiciii,progress_note,PROMPT1_ICL_entailment
172,42,33,27,6,0.8181818181818182,78,57,21,0.7307692307692307,0.7720090293453725,llama3,mimiciii,progress_note,PROMPT1_ICL_entailment
173,43,38,22,16,0.5789473684210527,79,43,36,0.5443037974683544,0.561091340450771,llama3,mimiciii,progress_note,PROMPT1_ICL_entailment
174,44,37,30,7,0.8108108108108109,96,62,34,0.6458333333333334,0.7189795129493622,llama3,mimiciii,progress_note,PROMPT1_ICL_entailment
175,45,34,23,11,0.6764705882352942,82,64,18,0.7804878048780488,0.7247661250615461,llama3,mimiciii,progress_note,PROMPT1_ICL_entailment
176,46,26,12,14,0.4615384615384615,36,23,13,0.6388888888888888,0.5359223300970873,llama3,mimiciii,progress_note,PROMPT1_ICL_entailment
177,47,11,3,8,0.2727272727272727,10,1,9,0.1,0.1463414634146341,llama3,mimiciii,progress_note,PROMPT1_ICL_entailment
178,48,51,42,9,0.8235294117647058,30,23,7,0.7666666666666667,0.7940813810110974,llama3,mimiciii,progress_note,PROMPT1_ICL_entailment
179,49,65,55,10,0.8461538461538461,57,49,8,0.8596491228070176,0.8528481012658227,llama3,mimiciii,progress_note,PROMPT1_ICL_entailment
180,5,63,50,13,0.7936507936507936,175,67,108,0.3828571428571428,0.5165368899853519,llama3,mimiciii,progress_note,PROMPT1_ICL_entailment
181,50,38,30,8,0.7894736842105263,116,64,52,0.5517241379310345,0.6495263870094723,llama3,mimiciii,progress_note,PROMPT1_ICL_entailment
182,51,28,19,9,0.6785714285714286,180,69,111,0.3833333333333333,0.4899103139013453,llama3,mimiciii,progress_note,PROMPT1_ICL_entailment
183,52,28,20,8,0.7142857142857143,180,75,105,0.4166666666666667,0.5263157894736842,llama3,mimiciii,progress_note,PROMPT1_ICL_entailment
184,53,43,31,12,0.7209302325581395,221,89,132,0.4027149321266968,0.516763438846226,llama3,mimiciii,progress_note,PROMPT1_ICL_entailment
185,54,48,29,19,0.6041666666666666,131,48,83,0.366412213740458,0.4561690971653285,llama3,mimiciii,progress_note,PROMPT1_ICL_entailment
186,55,75,60,15,0.8,169,63,106,0.3727810650887574,0.508577194752775,llama3,mimiciii,progress_note,PROMPT1_ICL_entailment
187,56,17,9,8,0.5294117647058824,40,6,34,0.15,0.2337662337662337,llama3,mimiciii,progress_note,PROMPT1_ICL_entailment
188,57,25,15,10,0.6,28,16,12,0.5714285714285714,0.5853658536585366,llama3,mimiciii,progress_note,PROMPT1_ICL_entailment
189,58,26,13,13,0.5,25,15,10,0.6,0.5454545454545454,llama3,mimiciii,progress_note,PROMPT1_ICL_entailment
190,59,28,14,14,0.5,25,15,10,0.6,0.5454545454545454,llama3,mimiciii,progress_note,PROMPT1_ICL_entailment
191,6,27,22,5,0.8148148148148148,188,55,133,0.2925531914893617,0.4305283757338552,llama3,mimiciii,progress_note,PROMPT1_ICL_entailment
192,60,38,28,10,0.7368421052631579,161,80,81,0.4968944099378882,0.59353471118177,llama3,mimiciii,progress_note,PROMPT1_ICL_entailment
193,61,30,15,15,0.5,37,18,19,0.4864864864864865,0.4931506849315069,llama3,mimiciii,progress_note,PROMPT1_ICL_entailment
194,62,30,15,15,0.5,37,18,19,0.4864864864864865,0.4931506849315069,llama3,mimiciii,progress_note,PROMPT1_ICL_entailment
195,63,36,32,4,0.8888888888888888,96,68,28,0.7083333333333334,0.7884057971014492,llama3,mimiciii,progress_note,PROMPT1_ICL_entailment
196,64,10,0,10,0.0,1,0,1,0.0,,llama3,mimiciii,progress_note,PROMPT1_ICL_entailment
197,65,26,18,8,0.6923076923076923,8,8,0,1.0,0.8181818181818181,llama3,mimiciii,progress_note,PROMPT1_ICL_entailment
198,66,34,24,10,0.7058823529411765,48,31,17,0.6458333333333334,0.6745240253853129,llama3,mimiciii,progress_note,PROMPT1_ICL_entailment
199,67,33,20,13,0.6060606060606061,285,137,148,0.4807017543859649,0.5361510615399667,llama3,mimiciii,progress_note,PROMPT1_ICL_entailment
200,68,18,13,5,0.7222222222222222,206,81,125,0.3932038834951456,0.5091876208897486,llama3,mimiciii,progress_note,PROMPT1_ICL_entailment
201,69,22,22,0,1.0,219,95,124,0.4337899543378995,0.6050955414012739,llama3,mimiciii,progress_note,PROMPT1_ICL_entailment
202,7,42,35,7,0.8333333333333334,187,90,97,0.481283422459893,0.6101694915254237,llama3,mimiciii,progress_note,PROMPT1_ICL_entailment
203,70,24,18,6,0.75,217,84,133,0.3870967741935484,0.5106382978723403,llama3,mimiciii,progress_note,PROMPT1_ICL_entailment
204,71,497,485,12,0.9758551307847082,11,6,5,0.5454545454545454,0.6997715522423951,llama3,mimiciii,progress_note,PROMPT1_ICL_entailment
205,72,14,5,9,0.3571428571428571,15,7,8,0.4666666666666667,0.4046242774566475,llama3,mimiciii,progress_note,PROMPT1_ICL_entailment
206,73,550,22,528,0.04,1,0,1,0.0,0.0,llama3,mimiciii,progress_note,PROMPT1_ICL_entailment
207,74,21,20,1,0.9523809523809524,184,93,91,0.5054347826086957,0.660394106160128,llama3,mimiciii,progress_note,PROMPT1_ICL_entailment
208,75,39,31,8,0.7948717948717948,40,25,15,0.625,0.6997742663656885,llama3,mimiciii,progress_note,PROMPT1_ICL_entailment
209,76,39,25,14,0.6410256410256411,58,29,29,0.5,0.5617977528089888,llama3,mimiciii,progress_note,PROMPT1_ICL_entailment
210,77,24,13,11,0.5416666666666666,27,15,12,0.5555555555555556,0.5485232067510548,llama3,mimiciii,progress_note,PROMPT1_ICL_entailment
211,78,25,16,9,0.64,20,10,10,0.5,0.5614035087719298,llama3,mimiciii,progress_note,PROMPT1_ICL_entailment
212,79,31,19,12,0.6129032258064516,43,21,22,0.4883720930232558,0.5435967302452317,llama3,mimiciii,progress_note,PROMPT1_ICL_entailment
213,8,36,29,7,0.8055555555555556,78,54,24,0.6923076923076923,0.7446504992867332,llama3,mimiciii,progress_note,PROMPT1_ICL_entailment
214,80,30,22,8,0.7333333333333333,21,12,9,0.5714285714285714,0.6423357664233577,llama3,mimiciii,progress_note,PROMPT1_ICL_entailment
215,81,27,21,6,0.7777777777777778,32,22,10,0.6875,0.7298578199052133,llama3,mimiciii,progress_note,PROMPT1_ICL_entailment
216,82,13,5,8,0.3846153846153846,15,2,13,0.1333333333333333,0.198019801980198,llama3,mimiciii,progress_note,PROMPT1_ICL_entailment
217,83,37,22,15,0.5945945945945946,43,25,18,0.5813953488372093,0.5879208979155532,llama3,mimiciii,progress_note,PROMPT1_ICL_entailment
218,84,30,22,8,0.7333333333333333,35,20,15,0.5714285714285714,0.6423357664233577,llama3,mimiciii,progress_note,PROMPT1_ICL_entailment
219,85,39,25,14,0.6410256410256411,50,24,26,0.48,0.5489478499542544,llama3,mimiciii,progress_note,PROMPT1_ICL_entailment
220,86,32,24,8,0.75,18,17,1,0.9444444444444444,0.8360655737704917,llama3,mimiciii,progress_note,PROMPT1_ICL_entailment
221,87,14,7,7,0.5,12,2,10,0.1666666666666666,0.25,llama3,mimiciii,progress_note,PROMPT1_ICL_entailment
222,88,33,29,4,0.8787878787878788,67,41,26,0.6119402985074627,0.7214805825242719,llama3,mimiciii,progress_note,PROMPT1_ICL_entailment
223,89,21,13,8,0.6190476190476191,199,50,149,0.2512562814070351,0.3574374484465218,llama3,mimiciii,progress_note,PROMPT1_ICL_entailment
224,9,28,20,8,0.7142857142857143,42,22,20,0.5238095238095238,0.6043956043956045,llama3,mimiciii,progress_note,PROMPT1_ICL_entailment
225,90,14,5,9,0.3571428571428571,3,3,0,1.0,0.5263157894736842,llama3,mimiciii,progress_note,PROMPT1_ICL_entailment
226,91,36,27,9,0.75,79,45,34,0.569620253164557,0.6474820143884893,llama3,mimiciii,progress_note,PROMPT1_ICL_entailment
227,92,37,34,3,0.918918918918919,143,63,80,0.4405594405594406,0.595579035173085,llama3,mimiciii,progress_note,PROMPT1_ICL_entailment
228,93,24,13,11,0.5416666666666666,27,18,9,0.6666666666666666,0.5977011494252873,llama3,mimiciii,progress_note,PROMPT1_ICL_entailment
229,94,36,25,11,0.6944444444444444,80,38,42,0.475,0.5641330166270785,llama3,mimiciii,progress_note,PROMPT1_ICL_entailment
230,95,25,15,10,0.6,32,19,13,0.59375,0.5968586387434555,llama3,mimiciii,progress_note,PROMPT1_ICL_entailment
231,96,11,3,8,0.2727272727272727,11,1,10,0.0909090909090909,0.1363636363636363,llama3,mimiciii,progress_note,PROMPT1_ICL_entailment
232,97,16,7,9,0.4375,14,4,10,0.2857142857142857,0.345679012345679,llama3,mimiciii,progress_note,PROMPT1_ICL_entailment
233,98,18,10,8,0.5555555555555556,24,9,15,0.375,0.4477611940298507,llama3,mimiciii,progress_note,PROMPT1_ICL_entailment
234,99,35,25,10,0.7142857142857143,70,30,40,0.4285714285714285,0.5357142857142858,llama3,mimiciii,progress_note,PROMPT1_ICL_entailment
0,0,37,31,6,0.8378378378378378,78,55,23,0.7051282051282052,0.7657758814282506,llama3,mimiciii,progress_note,PROMPT2_ICL_entailment
1,1,15,15,0,1.0,189,60,129,0.3174603174603174,0.4819277108433735,llama3,mimiciii,progress_note,PROMPT2_ICL_entailment
2,10,20,17,3,0.85,140,68,72,0.4857142857142857,0.6181818181818183,llama3,mimiciii,progress_note,PROMPT2_ICL_entailment
3,100,27,22,5,0.8148148148148148,77,45,32,0.5844155844155844,0.6806462701959436,llama3,mimiciii,progress_note,PROMPT2_ICL_entailment
4,101,23,21,2,0.9130434782608696,36,21,15,0.5833333333333334,0.7118644067796611,llama3,mimiciii,progress_note,PROMPT2_ICL_entailment
5,102,28,28,0,1.0,42,28,14,0.6666666666666666,0.8,llama3,mimiciii,progress_note,PROMPT2_ICL_entailment
6,103,17,15,2,0.8823529411764706,204,72,132,0.3529411764705882,0.5042016806722689,llama3,mimiciii,progress_note,PROMPT2_ICL_entailment
7,104,27,24,3,0.8888888888888888,39,33,6,0.8461538461538461,0.8669950738916256,llama3,mimiciii,progress_note,PROMPT2_ICL_entailment
8,105,27,27,0,1.0,17,15,2,0.8823529411764706,0.9375,llama3,mimiciii,progress_note,PROMPT2_ICL_entailment
9,106,20,19,1,0.95,40,28,12,0.7,0.806060606060606,llama3,mimiciii,progress_note,PROMPT2_ICL_entailment
10,107,24,23,1,0.9583333333333334,31,26,5,0.8387096774193549,0.8945400149588631,llama3,mimiciii,progress_note,PROMPT2_ICL_entailment
11,108,40,34,6,0.85,68,48,20,0.7058823529411765,0.771266540642722,llama3,mimiciii,progress_note,PROMPT2_ICL_entailment
12,109,52,45,7,0.8653846153846154,176,65,111,0.3693181818181818,0.5176991150442478,llama3,mimiciii,progress_note,PROMPT2_ICL_entailment
13,11,19,16,3,0.8421052631578947,141,52,89,0.3687943262411347,0.5129469790382243,llama3,mimiciii,progress_note,PROMPT2_ICL_entailment
14,110,20,18,2,0.9,215,80,135,0.3720930232558139,0.526508226691042,llama3,mimiciii,progress_note,PROMPT2_ICL_entailment
15,111,16,12,4,0.75,219,73,146,0.3333333333333333,0.4615384615384615,llama3,mimiciii,progress_note,PROMPT2_ICL_entailment
16,112,20,17,3,0.85,234,89,145,0.3803418803418803,0.5255296978117401,llama3,mimiciii,progress_note,PROMPT2_ICL_entailment
17,113,577,16,561,0.0277296360485268,196,18,178,0.0918367346938775,0.0425972489276734,llama3,mimiciii,progress_note,PROMPT2_ICL_entailment
18,114,298,13,285,0.0436241610738255,225,38,187,0.1688888888888889,0.0693381991718717,llama3,mimiciii,progress_note,PROMPT2_ICL_entailment
19,115,38,24,14,0.631578947368421,280,93,187,0.3321428571428571,0.4353423054417788,llama3,mimiciii,progress_note,PROMPT2_ICL_entailment
20,116,21,19,2,0.9047619047619048,35,25,10,0.7142857142857143,0.7983193277310925,llama3,mimiciii,progress_note,PROMPT2_ICL_entailment
21,117,25,24,1,0.96,20,15,5,0.75,0.8421052631578947,llama3,mimiciii,progress_note,PROMPT2_ICL_entailment
22,118,35,34,1,0.9714285714285714,23,18,5,0.782608695652174,0.8668555240793201,llama3,mimiciii,progress_note,PROMPT2_ICL_entailment
23,119,14,14,0,1.0,14,12,2,0.8571428571428571,0.923076923076923,llama3,mimiciii,progress_note,PROMPT2_ICL_entailment
24,12,25,21,4,0.84,225,64,161,0.2844444444444444,0.4249802371541502,llama3,mimiciii,progress_note,PROMPT2_ICL_entailment
25,120,22,19,3,0.8636363636363636,64,31,33,0.484375,0.6206533192834562,llama3,mimiciii,progress_note,PROMPT2_ICL_entailment
26,121,16,16,0,1.0,14,8,6,0.5714285714285714,0.7272727272727273,llama3,mimiciii,progress_note,PROMPT2_ICL_entailment
27,122,39,28,11,0.717948717948718,47,31,16,0.6595744680851063,0.6875247524752474,llama3,mimiciii,progress_note,PROMPT2_ICL_entailment
28,123,31,25,6,0.8064516129032258,50,27,23,0.54,0.6468615237182559,llama3,mimiciii,progress_note,PROMPT2_ICL_entailment
29,124,42,40,2,0.9523809523809524,65,45,20,0.6923076923076923,0.8017817371937639,llama3,mimiciii,progress_note,PROMPT2_ICL_entailment
30,125,29,25,4,0.8620689655172413,50,32,18,0.64,0.7346189164370983,llama3,mimiciii,progress_note,PROMPT2_ICL_entailment
31,126,21,20,1,0.9523809523809524,27,20,7,0.7407407407407407,0.8333333333333334,llama3,mimiciii,progress_note,PROMPT2_ICL_entailment
32,127,20,19,1,0.95,27,17,10,0.6296296296296297,0.757327080890973,llama3,mimiciii,progress_note,PROMPT2_ICL_entailment
33,128,28,27,1,0.9642857142857144,37,31,6,0.8378378378378378,0.8966256025709695,llama3,mimiciii,progress_note,PROMPT2_ICL_entailment
34,129,31,27,4,0.8709677419354839,66,43,23,0.6515151515151515,0.7454253611556981,llama3,mimiciii,progress_note,PROMPT2_ICL_entailment
35,13,21,20,1,0.9523809523809524,73,33,40,0.4520547945205479,0.613098002786809,llama3,mimiciii,progress_note,PROMPT2_ICL_entailment
36,130,27,20,7,0.7407407407407407,44,32,12,0.7272727272727273,0.7339449541284404,llama3,mimiciii,progress_note,PROMPT2_ICL_entailment
37,131,23,21,2,0.9130434782608696,202,88,114,0.4356435643564356,0.5898499840408554,llama3,mimiciii,progress_note,PROMPT2_ICL_entailment
38,132,569,24,545,0.0421792618629174,193,31,162,0.160621761658031,0.0668133447083651,llama3,mimiciii,progress_note,PROMPT2_ICL_entailment
39,133,21,18,3,0.8571428571428571,157,57,100,0.3630573248407643,0.5100671140939597,llama3,mimiciii,progress_note,PROMPT2_ICL_entailment
40,134,16,15,1,0.9375,18,8,10,0.4444444444444444,0.6030150753768844,llama3,mimiciii,progress_note,PROMPT2_ICL_entailment
41,135,27,26,1,0.9629629629629628,35,29,6,0.8285714285714286,0.8907265209686946,llama3,mimiciii,progress_note,PROMPT2_ICL_entailment
42,136,25,22,3,0.88,43,29,14,0.6744186046511628,0.7636146020347097,llama3,mimiciii,progress_note,PROMPT2_ICL_entailment
43,137,15,15,0,1.0,26,17,9,0.6538461538461539,0.7906976744186047,llama3,mimiciii,progress_note,PROMPT2_ICL_entailment
44,138,30,28,2,0.9333333333333332,45,29,16,0.6444444444444445,0.7624413145539906,llama3,mimiciii,progress_note,PROMPT2_ICL_entailment
45,139,19,19,0,1.0,45,26,19,0.5777777777777777,0.732394366197183,llama3,mimiciii,progress_note,PROMPT2_ICL_entailment
46,14,29,16,13,0.5517241379310345,43,26,17,0.6046511627906976,0.5769764216366158,llama3,mimiciii,progress_note,PROMPT2_ICL_entailment
47,140,24,20,4,0.8333333333333334,25,19,6,0.76,0.7949790794979081,llama3,mimiciii,progress_note,PROMPT2_ICL_entailment
48,141,19,19,0,1.0,45,26,19,0.5777777777777777,0.732394366197183,llama3,mimiciii,progress_note,PROMPT2_ICL_entailment
49,142,36,31,5,0.8611111111111112,50,37,13,0.74,0.7959750173490632,llama3,mimiciii,progress_note,PROMPT2_ICL_entailment
50,143,10,10,0,1.0,11,9,2,0.8181818181818182,0.9,llama3,mimiciii,progress_note,PROMPT2_ICL_entailment
51,144,36,31,5,0.8611111111111112,50,35,15,0.7,0.7722419928825622,llama3,mimiciii,progress_note,PROMPT2_ICL_entailment
52,145,31,27,4,0.8709677419354839,43,29,14,0.6744186046511628,0.7601941747572816,llama3,mimiciii,progress_note,PROMPT2_ICL_entailment
53,146,32,29,3,0.90625,32,19,13,0.59375,0.7174479166666666,llama3,mimiciii,progress_note,PROMPT2_ICL_entailment
54,147,36,35,1,0.9722222222222222,56,40,16,0.7142857142857143,0.8235294117647058,llama3,mimiciii,progress_note,PROMPT2_ICL_entailment
55,148,10,10,0,1.0,4,3,1,0.75,0.8571428571428571,llama3,mimiciii,progress_note,PROMPT2_ICL_entailment
56,149,20,20,0,1.0,29,24,5,0.8275862068965517,0.9056603773584906,llama3,mimiciii,progress_note,PROMPT2_ICL_entailment
57,15,27,16,11,0.5925925925925926,163,62,101,0.3803680981595092,0.4633348902382064,llama3,mimiciii,progress_note,PROMPT2_ICL_entailment
58,150,36,34,2,0.9444444444444444,83,51,32,0.6144578313253012,0.7445255474452556,llama3,mimiciii,progress_note,PROMPT2_ICL_entailment
59,151,29,22,7,0.7586206896551724,201,59,142,0.2935323383084577,0.4232838741235936,llama3,mimiciii,progress_note,PROMPT2_ICL_entailment
60,152,42,32,10,0.7619047619047619,45,33,12,0.7333333333333333,0.7473460721868364,llama3,mimiciii,progress_note,PROMPT2_ICL_entailment
61,153,21,16,5,0.7619047619047619,219,52,167,0.2374429223744292,0.3620539599651871,llama3,mimiciii,progress_note,PROMPT2_ICL_entailment
62,154,17,16,1,0.9411764705882352,15,15,0,1.0,0.9696969696969696,llama3,mimiciii,progress_note,PROMPT2_ICL_entailment
63,155,23,21,2,0.9130434782608696,32,23,9,0.71875,0.8043297252289758,llama3,mimiciii,progress_note,PROMPT2_ICL_entailment
64,156,23,20,3,0.8695652173913043,32,23,9,0.71875,0.7869974337040206,llama3,mimiciii,progress_note,PROMPT2_ICL_entailment
65,157,23,22,1,0.9565217391304348,29,23,6,0.7931034482758621,0.8671808054841474,llama3,mimiciii,progress_note,PROMPT2_ICL_entailment
66,158,43,33,10,0.7674418604651163,242,125,117,0.5165289256198347,0.6174687523388968,llama3,mimiciii,progress_note,PROMPT2_ICL_entailment
67,159,19,17,2,0.8947368421052632,22,14,8,0.6363636363636364,0.74375,llama3,mimiciii,progress_note,PROMPT2_ICL_entailment
68,16,19,18,1,0.9473684210526316,28,21,7,0.75,0.8372093023255814,llama3,mimiciii,progress_note,PROMPT2_ICL_entailment
69,160,44,44,0,1.0,65,37,28,0.5692307692307692,0.7254901960784313,llama3,mimiciii,progress_note,PROMPT2_ICL_entailment
70,161,39,34,5,0.8717948717948718,201,85,116,0.4228855721393035,0.5695142378559465,llama3,mimiciii,progress_note,PROMPT2_ICL_entailment
71,162,16,15,1,0.9375,177,58,119,0.327683615819209,0.4856265699134803,llama3,mimiciii,progress_note,PROMPT2_ICL_entailment
72,163,20,19,1,0.95,28,19,9,0.6785714285714286,0.7916666666666667,llama3,mimiciii,progress_note,PROMPT2_ICL_entailment
73,164,21,18,3,0.8571428571428571,57,26,31,0.4561403508771929,0.5954198473282443,llama3,mimiciii,progress_note,PROMPT2_ICL_entailment
74,165,14,14,0,1.0,25,15,10,0.6,0.7499999999999999,llama3,mimiciii,progress_note,PROMPT2_ICL_entailment
75,166,22,21,1,0.9545454545454546,42,26,16,0.6190476190476191,0.7510316368638239,llama3,mimiciii,progress_note,PROMPT2_ICL_entailment
76,167,33,33,0,1.0,52,36,16,0.6923076923076923,0.8181818181818181,llama3,mimiciii,progress_note,PROMPT2_ICL_entailment
77,168,21,19,2,0.9047619047619048,182,69,113,0.3791208791208791,0.5343386998165885,llama3,mimiciii,progress_note,PROMPT2_ICL_entailment
78,169,24,23,1,0.9583333333333334,219,71,148,0.3242009132420091,0.4844978489838303,llama3,mimiciii,progress_note,PROMPT2_ICL_entailment
79,17,10,9,1,0.9,15,8,7,0.5333333333333333,0.6697674418604651,llama3,mimiciii,progress_note,PROMPT2_ICL_entailment
80,170,32,30,2,0.9375,184,63,121,0.3423913043478261,0.501592356687898,llama3,mimiciii,progress_note,PROMPT2_ICL_entailment
81,171,63,53,10,0.8412698412698413,222,88,134,0.3963963963963964,0.5388792605430387,llama3,mimiciii,progress_note,PROMPT2_ICL_entailment
82,172,21,20,1,0.9523809523809524,198,63,135,0.3181818181818182,0.4770017035775127,llama3,mimiciii,progress_note,PROMPT2_ICL_entailment
83,173,22,20,2,0.9090909090909092,172,64,108,0.3720930232558139,0.5280528052805281,llama3,mimiciii,progress_note,PROMPT2_ICL_entailment
84,174,13,11,2,0.8461538461538461,200,69,131,0.345,0.4901517597675169,llama3,mimiciii,progress_note,PROMPT2_ICL_entailment
85,175,34,30,4,0.8823529411764706,207,90,117,0.4347826086956521,0.5825242718446603,llama3,mimiciii,progress_note,PROMPT2_ICL_entailment
86,176,49,33,16,0.673469387755102,192,38,154,0.1979166666666666,0.3059282751890704,llama3,mimiciii,progress_note,PROMPT2_ICL_entailment
87,177,52,36,16,0.6923076923076923,192,77,115,0.4010416666666667,0.5078783437156468,llama3,mimiciii,progress_note,PROMPT2_ICL_entailment
88,178,15,13,2,0.8666666666666667,17,12,5,0.7058823529411765,0.7780548628428927,llama3,mimiciii,progress_note,PROMPT2_ICL_entailment
89,179,44,28,16,0.6363636363636364,197,96,101,0.4873096446700508,0.5519507186858317,llama3,mimiciii,progress_note,PROMPT2_ICL_entailment
90,18,21,20,1,0.9523809523809524,18,18,0,1.0,0.975609756097561,llama3,mimiciii,progress_note,PROMPT2_ICL_entailment
91,180,40,34,6,0.85,201,77,124,0.3830845771144278,0.5281420213839015,llama3,mimiciii,progress_note,PROMPT2_ICL_entailment
92,181,26,20,6,0.7692307692307693,208,89,119,0.4278846153846153,0.54989187519308,llama3,mimiciii,progress_note,PROMPT2_ICL_entailment
93,182,21,17,4,0.8095238095238095,214,81,133,0.3785046728971962,0.5158269338827496,llama3,mimiciii,progress_note,PROMPT2_ICL_entailment
94,183,26,22,4,0.8461538461538461,226,81,145,0.3584070796460177,0.5035320712065556,llama3,mimiciii,progress_note,PROMPT2_ICL_entailment
95,184,21,19,2,0.9047619047619048,194,76,118,0.3917525773195876,0.5467625899280576,llama3,mimiciii,progress_note,PROMPT2_ICL_entailment
96,185,33,25,8,0.7575757575757576,48,21,27,0.4375,0.554675118858954,llama3,mimiciii,progress_note,PROMPT2_ICL_entailment
97,186,21,20,1,0.9523809523809524,205,59,146,0.2878048780487804,0.4420303427608166,llama3,mimiciii,progress_note,PROMPT2_ICL_entailment
98,187,11,11,0,1.0,170,54,116,0.3176470588235294,0.4821428571428571,llama3,mimiciii,progress_note,PROMPT2_ICL_entailment
99,188,318,10,308,0.0314465408805031,202,34,168,0.1683168316831683,0.0529925187032418,llama3,mimiciii,progress_note,PROMPT2_ICL_entailment
100,189,23,21,2,0.9130434782608696,225,83,142,0.3688888888888889,0.5254748266505879,llama3,mimiciii,progress_note,PROMPT2_ICL_entailment
101,19,24,23,1,0.9583333333333334,38,33,5,0.868421052631579,0.9111644657863148,llama3,mimiciii,progress_note,PROMPT2_ICL_entailment
102,190,36,29,7,0.8055555555555556,223,101,122,0.452914798206278,0.579827773928536,llama3,mimiciii,progress_note,PROMPT2_ICL_entailment
103,191,21,19,2,0.9047619047619048,206,63,143,0.3058252427184466,0.4571319457704793,llama3,mimiciii,progress_note,PROMPT2_ICL_entailment
104,192,23,18,5,0.782608695652174,208,70,138,0.3365384615384615,0.4706761299962645,llama3,mimiciii,progress_note,PROMPT2_ICL_entailment
105,193,48,39,9,0.8125,243,88,155,0.3621399176954732,0.5009853295379899,llama3,mimiciii,progress_note,PROMPT2_ICL_entailment
106,194,29,24,5,0.8275862068965517,211,75,136,0.3554502369668246,0.4973062577704103,llama3,mimiciii,progress_note,PROMPT2_ICL_entailment
107,195,25,23,2,0.92,44,28,16,0.6363636363636364,0.7523364485981309,llama3,mimiciii,progress_note,PROMPT2_ICL_entailment
108,196,29,29,0,1.0,42,30,12,0.7142857142857143,0.8333333333333333,llama3,mimiciii,progress_note,PROMPT2_ICL_entailment
109,197,27,25,2,0.925925925925926,90,53,37,0.5888888888888889,0.7199130671013312,llama3,mimiciii,progress_note,PROMPT2_ICL_entailment
110,198,22,22,0,1.0,34,29,5,0.8529411764705882,0.9206349206349206,llama3,mimiciii,progress_note,PROMPT2_ICL_entailment
111,199,35,34,1,0.9714285714285714,52,39,13,0.75,0.846473029045643,llama3,mimiciii,progress_note,PROMPT2_ICL_entailment
112,2,15,10,5,0.6666666666666666,140,45,95,0.3214285714285714,0.4337349397590361,llama3,mimiciii,progress_note,PROMPT2_ICL_entailment
113,20,24,22,2,0.9166666666666666,33,23,10,0.696969696969697,0.7918622848200313,llama3,mimiciii,progress_note,PROMPT2_ICL_entailment
114,200,21,16,5,0.7619047619047619,164,61,103,0.3719512195121951,0.4998719590268886,llama3,mimiciii,progress_note,PROMPT2_ICL_entailment
115,201,511,324,187,0.6340508806262231,200,88,112,0.44,0.5194956635813717,llama3,mimiciii,progress_note,PROMPT2_ICL_entailment
116,202,24,17,7,0.7083333333333334,176,59,117,0.3352272727272727,0.4550816696914701,llama3,mimiciii,progress_note,PROMPT2_ICL_entailment
117,203,54,43,11,0.7962962962962963,211,91,120,0.4312796208530806,0.5595195538714521,llama3,mimiciii,progress_note,PROMPT2_ICL_entailment
118,204,24,21,3,0.875,201,64,137,0.3184079601990049,0.4669098488796249,llama3,mimiciii,progress_note,PROMPT2_ICL_entailment
119,205,26,26,0,1.0,195,72,123,0.3692307692307692,0.5393258426966292,llama3,mimiciii,progress_note,PROMPT2_ICL_entailment
120,206,35,28,7,0.8,239,122,117,0.5104602510460251,0.6232439335887612,llama3,mimiciii,progress_note,PROMPT2_ICL_entailment
121,207,33,27,6,0.8181818181818182,233,70,163,0.3004291845493562,0.4394837809557029,llama3,mimiciii,progress_note,PROMPT2_ICL_entailment
122,208,21,19,2,0.9047619047619048,229,68,161,0.296943231441048,0.4471361827305761,llama3,mimiciii,progress_note,PROMPT2_ICL_entailment
123,209,56,47,9,0.8392857142857143,205,83,122,0.4048780487804878,0.5462437863194007,llama3,mimiciii,progress_note,PROMPT2_ICL_entailment
124,21,20,16,4,0.8,217,66,151,0.304147465437788,0.4407345575959933,llama3,mimiciii,progress_note,PROMPT2_ICL_entailment
125,210,20,20,0,1.0,28,24,4,0.8571428571428571,0.923076923076923,llama3,mimiciii,progress_note,PROMPT2_ICL_entailment
126,211,20,19,1,0.95,54,41,13,0.7592592592592593,0.8439869989165765,llama3,mimiciii,progress_note,PROMPT2_ICL_entailment
127,212,16,16,0,1.0,14,10,4,0.7142857142857143,0.8333333333333333,llama3,mimiciii,progress_note,PROMPT2_ICL_entailment
128,213,31,29,2,0.935483870967742,41,29,12,0.7073170731707317,0.8055555555555556,llama3,mimiciii,progress_note,PROMPT2_ICL_entailment
129,214,23,22,1,0.9565217391304348,27,17,10,0.6296296296296297,0.7593908629441625,llama3,mimiciii,progress_note,PROMPT2_ICL_entailment
130,215,46,35,11,0.7608695652173914,66,42,24,0.6363636363636364,0.693069306930693,llama3,mimiciii,progress_note,PROMPT2_ICL_entailment
131,216,29,26,3,0.896551724137931,67,34,33,0.5074626865671642,0.6480938416422287,llama3,mimiciii,progress_note,PROMPT2_ICL_entailment
132,217,31,30,1,0.967741935483871,73,35,38,0.4794520547945205,0.6412213740458015,llama3,mimiciii,progress_note,PROMPT2_ICL_entailment
133,218,31,31,0,1.0,27,18,9,0.6666666666666666,0.8,llama3,mimiciii,progress_note,PROMPT2_ICL_entailment
134,219,20,18,2,0.9,17,10,7,0.5882352941176471,0.7114624505928854,llama3,mimiciii,progress_note,PROMPT2_ICL_entailment
135,22,25,24,1,0.96,38,23,15,0.6052631578947368,0.742434431741762,llama3,mimiciii,progress_note,PROMPT2_ICL_entailment
136,220,32,28,4,0.875,34,27,7,0.7941176470588235,0.8325991189427313,llama3,mimiciii,progress_note,PROMPT2_ICL_entailment
137,221,19,14,5,0.7368421052631579,188,67,121,0.3563829787234042,0.4804097311139564,llama3,mimiciii,progress_note,PROMPT2_ICL_entailment
138,222,14,14,0,1.0,263,87,176,0.3307984790874524,0.4971428571428571,llama3,mimiciii,progress_note,PROMPT2_ICL_entailment
139,223,20,20,0,1.0,30,22,8,0.7333333333333333,0.846153846153846,llama3,mimiciii,progress_note,PROMPT2_ICL_entailment
140,224,25,24,1,0.96,33,22,11,0.6666666666666666,0.7868852459016393,llama3,mimiciii,progress_note,PROMPT2_ICL_entailment
141,225,21,20,1,0.9523809523809524,37,25,12,0.6756756756756757,0.7905138339920947,llama3,mimiciii,progress_note,PROMPT2_ICL_entailment
142,226,23,22,1,0.9565217391304348,33,25,8,0.7575757575757576,0.8455034588777863,llama3,mimiciii,progress_note,PROMPT2_ICL_entailment
143,227,7,7,0,1.0,15,3,12,0.2,0.3333333333333333,llama3,mimiciii,progress_note,PROMPT2_ICL_entailment
144,228,7,7,0,1.0,15,3,12,0.2,0.3333333333333333,llama3,mimiciii,progress_note,PROMPT2_ICL_entailment
145,229,7,7,0,1.0,15,3,12,0.2,0.3333333333333333,llama3,mimiciii,progress_note,PROMPT2_ICL_entailment
146,23,22,21,1,0.9545454545454546,37,22,15,0.5945945945945946,0.7327517842981761,llama3,mimiciii,progress_note,PROMPT2_ICL_entailment
147,230,19,19,0,1.0,26,23,3,0.8846153846153846,0.9387755102040816,llama3,mimiciii,progress_note,PROMPT2_ICL_entailment
148,231,24,23,1,0.9583333333333334,102,57,45,0.5588235294117647,0.7059773828756059,llama3,mimiciii,progress_note,PROMPT2_ICL_entailment
149,232,23,22,1,0.9565217391304348,72,43,29,0.5972222222222222,0.735328410415857,llama3,mimiciii,progress_note,PROMPT2_ICL_entailment
150,233,27,22,5,0.8148148148148148,82,53,29,0.6463414634146342,0.7208655332302937,llama3,mimiciii,progress_note,PROMPT2_ICL_entailment
151,234,22,21,1,0.9545454545454546,42,26,16,0.6190476190476191,0.7510316368638239,llama3,mimiciii,progress_note,PROMPT2_ICL_entailment
152,24,18,14,4,0.7777777777777778,22,10,12,0.4545454545454545,0.5737704918032788,llama3,mimiciii,progress_note,PROMPT2_ICL_entailment
153,25,18,17,1,0.9444444444444444,22,11,11,0.5,0.6538461538461539,llama3,mimiciii,progress_note,PROMPT2_ICL_entailment
154,26,18,17,1,0.9444444444444444,22,11,11,0.5,0.6538461538461539,llama3,mimiciii,progress_note,PROMPT2_ICL_entailment
155,27,24,17,7,0.7083333333333334,19,13,6,0.6842105263157895,0.6960629921259843,llama3,mimiciii,progress_note,PROMPT2_ICL_entailment
156,28,46,39,7,0.8478260869565217,50,39,11,0.78,0.8125,llama3,mimiciii,progress_note,PROMPT2_ICL_entailment
157,29,26,24,2,0.9230769230769232,52,26,26,0.5,0.6486486486486487,llama3,mimiciii,progress_note,PROMPT2_ICL_entailment
158,3,422,17,405,0.0402843601895734,157,34,123,0.2165605095541401,0.0679320679320679,llama3,mimiciii,progress_note,PROMPT2_ICL_entailment
159,30,21,21,0,1.0,18,13,5,0.7222222222222222,0.8387096774193548,llama3,mimiciii,progress_note,PROMPT2_ICL_entailment
160,31,21,21,0,1.0,17,14,3,0.8235294117647058,0.9032258064516128,llama3,mimiciii,progress_note,PROMPT2_ICL_entailment
161,32,25,25,0,1.0,99,57,42,0.5757575757575758,0.7307692307692308,llama3,mimiciii,progress_note,PROMPT2_ICL_entailment
162,33,27,26,1,0.9629629629629628,65,44,21,0.676923076923077,0.7949965253648367,llama3,mimiciii,progress_note,PROMPT2_ICL_entailment
163,34,23,22,1,0.9565217391304348,71,40,31,0.5633802816901409,0.7091055600322321,llama3,mimiciii,progress_note,PROMPT2_ICL_entailment
164,35,15,14,1,0.9333333333333332,20,8,12,0.4,0.5599999999999999,llama3,mimiciii,progress_note,PROMPT2_ICL_entailment
165,36,22,21,1,0.9545454545454546,40,20,20,0.5,0.65625,llama3,mimiciii,progress_note,PROMPT2_ICL_entailment
166,37,51,41,10,0.803921568627451,199,101,98,0.507537688442211,0.6222389181066866,llama3,mimiciii,progress_note,PROMPT2_ICL_entailment
167,38,27,21,6,0.7777777777777778,158,49,109,0.310126582278481,0.4434389140271493,llama3,mimiciii,progress_note,PROMPT2_ICL_entailment
168,39,27,25,2,0.925925925925926,76,58,18,0.7631578947368421,0.8366993652625505,llama3,mimiciii,progress_note,PROMPT2_ICL_entailment
169,4,100,20,80,0.2,162,84,78,0.5185185185185185,0.2886597938144329,llama3,mimiciii,progress_note,PROMPT2_ICL_entailment
170,40,25,24,1,0.96,76,51,25,0.6710526315789473,0.7899322362052275,llama3,mimiciii,progress_note,PROMPT2_ICL_entailment
171,41,33,32,1,0.9696969696969696,78,52,26,0.6666666666666666,0.7901234567901234,llama3,mimiciii,progress_note,PROMPT2_ICL_entailment
172,42,33,33,0,1.0,78,52,26,0.6666666666666666,0.8,llama3,mimiciii,progress_note,PROMPT2_ICL_entailment
173,43,36,30,6,0.8333333333333334,79,36,43,0.4556962025316455,0.5891980360065467,llama3,mimiciii,progress_note,PROMPT2_ICL_entailment
174,44,33,33,0,1.0,96,62,34,0.6458333333333334,0.7848101265822784,llama3,mimiciii,progress_note,PROMPT2_ICL_entailment
175,45,25,24,1,0.96,82,50,32,0.6097560975609756,0.7458048477315102,llama3,mimiciii,progress_note,PROMPT2_ICL_entailment
176,46,20,18,2,0.9,36,24,12,0.6666666666666666,0.7659574468085106,llama3,mimiciii,progress_note,PROMPT2_ICL_entailment
177,47,5,5,0,1.0,10,4,6,0.4,0.5714285714285715,llama3,mimiciii,progress_note,PROMPT2_ICL_entailment
178,48,49,49,0,1.0,30,29,1,0.9666666666666668,0.983050847457627,llama3,mimiciii,progress_note,PROMPT2_ICL_entailment
179,49,59,57,2,0.9661016949152542,57,44,13,0.7719298245614035,0.858169375534645,llama3,mimiciii,progress_note,PROMPT2_ICL_entailment
180,5,26,21,5,0.8076923076923077,175,72,103,0.4114285714285714,0.5451595457003785,llama3,mimiciii,progress_note,PROMPT2_ICL_entailment
181,50,31,26,5,0.8387096774193549,116,67,49,0.5775862068965517,0.6840761829962694,llama3,mimiciii,progress_note,PROMPT2_ICL_entailment
182,51,24,19,5,0.7916666666666666,180,62,118,0.3444444444444444,0.4800325998370008,llama3,mimiciii,progress_note,PROMPT2_ICL_entailment
183,52,24,20,4,0.8333333333333334,180,61,119,0.3388888888888889,0.4818325434439179,llama3,mimiciii,progress_note,PROMPT2_ICL_entailment
184,53,21,19,2,0.9047619047619048,221,40,181,0.1809954751131221,0.3016471522127406,llama3,mimiciii,progress_note,PROMPT2_ICL_entailment
185,54,21,17,4,0.8095238095238095,131,52,79,0.3969465648854962,0.5326905694486291,llama3,mimiciii,progress_note,PROMPT2_ICL_entailment
186,55,28,24,4,0.8571428571428571,169,78,91,0.4615384615384615,0.6,llama3,mimiciii,progress_note,PROMPT2_ICL_entailment
187,56,18,15,3,0.8333333333333334,40,25,15,0.625,0.7142857142857143,llama3,mimiciii,progress_note,PROMPT2_ICL_entailment
188,57,24,23,1,0.9583333333333334,28,20,8,0.7142857142857143,0.8185053380782918,llama3,mimiciii,progress_note,PROMPT2_ICL_entailment
189,58,21,19,2,0.9047619047619048,25,23,2,0.92,0.9123173277661796,llama3,mimiciii,progress_note,PROMPT2_ICL_entailment
190,59,21,20,1,0.9523809523809524,25,23,2,0.92,0.935910478128179,llama3,mimiciii,progress_note,PROMPT2_ICL_entailment
191,6,49,37,12,0.7551020408163265,188,71,117,0.3776595744680851,0.503497843794921,llama3,mimiciii,progress_note,PROMPT2_ICL_entailment
192,60,24,20,4,0.8333333333333334,161,56,105,0.3478260869565217,0.49079754601227,llama3,mimiciii,progress_note,PROMPT2_ICL_entailment
193,61,22,20,2,0.9090909090909092,37,27,10,0.7297297297297297,0.8095952023988006,llama3,mimiciii,progress_note,PROMPT2_ICL_entailment
194,62,22,20,2,0.9090909090909092,37,26,11,0.7027027027027027,0.7926829268292683,llama3,mimiciii,progress_note,PROMPT2_ICL_entailment
195,63,29,27,2,0.9310344827586208,96,60,36,0.625,0.7479224376731303,llama3,mimiciii,progress_note,PROMPT2_ICL_entailment
196,64,4,3,1,0.75,1,1,0,1.0,0.8571428571428571,llama3,mimiciii,progress_note,PROMPT2_ICL_entailment
197,65,18,17,1,0.9444444444444444,8,8,0,1.0,0.9714285714285714,llama3,mimiciii,progress_note,PROMPT2_ICL_entailment
198,66,28,27,1,0.9642857142857144,48,36,12,0.75,0.8437499999999999,llama3,mimiciii,progress_note,PROMPT2_ICL_entailment
199,67,26,17,9,0.6538461538461539,285,112,173,0.3929824561403509,0.490911434833054,llama3,mimiciii,progress_note,PROMPT2_ICL_entailment
200,68,28,17,11,0.6071428571428571,206,79,127,0.3834951456310679,0.4700735036751837,llama3,mimiciii,progress_note,PROMPT2_ICL_entailment
201,69,39,37,2,0.9487179487179488,219,108,111,0.4931506849315068,0.6489646772228989,llama3,mimiciii,progress_note,PROMPT2_ICL_entailment
202,7,21,16,5,0.7619047619047619,187,57,130,0.3048128342245989,0.4354261160181428,llama3,mimiciii,progress_note,PROMPT2_ICL_entailment
203,70,23,17,6,0.7391304347826086,217,58,159,0.2672811059907834,0.3925940672904638,llama3,mimiciii,progress_note,PROMPT2_ICL_entailment
204,71,19,18,1,0.9473684210526316,213,71,142,0.3333333333333333,0.4931506849315068,llama3,mimiciii,progress_note,PROMPT2_ICL_entailment
205,72,10,9,1,0.9,15,9,6,0.6,0.7200000000000001,llama3,mimiciii,progress_note,PROMPT2_ICL_entailment
206,73,19,13,6,0.6842105263157895,264,80,184,0.303030303030303,0.420032310177706,llama3,mimiciii,progress_note,PROMPT2_ICL_entailment
207,74,13,11,2,0.8461538461538461,184,83,101,0.4510869565217391,0.588462777956816,llama3,mimiciii,progress_note,PROMPT2_ICL_entailment
208,75,42,40,2,0.9523809523809524,40,27,13,0.675,0.7900512070226775,llama3,mimiciii,progress_note,PROMPT2_ICL_entailment
209,76,32,31,1,0.96875,58,41,17,0.7068965517241379,0.8173633440514468,llama3,mimiciii,progress_note,PROMPT2_ICL_entailment
210,77,18,17,1,0.9444444444444444,27,24,3,0.8888888888888888,0.9158249158249158,llama3,mimiciii,progress_note,PROMPT2_ICL_entailment
211,78,21,20,1,0.9523809523809524,20,14,6,0.7,0.8069164265129684,llama3,mimiciii,progress_note,PROMPT2_ICL_entailment
212,79,24,21,3,0.875,43,22,21,0.5116279069767442,0.6457023060796646,llama3,mimiciii,progress_note,PROMPT2_ICL_entailment
213,8,35,31,4,0.8857142857142857,78,62,16,0.7948717948717948,0.8378378378378378,llama3,mimiciii,progress_note,PROMPT2_ICL_entailment
214,80,26,24,2,0.9230769230769232,21,15,6,0.7142857142857143,0.8053691275167787,llama3,mimiciii,progress_note,PROMPT2_ICL_entailment
215,81,34,30,4,0.8823529411764706,32,26,6,0.8125,0.8459869848156183,llama3,mimiciii,progress_note,PROMPT2_ICL_entailment
216,82,7,7,0,1.0,15,3,12,0.2,0.3333333333333333,llama3,mimiciii,progress_note,PROMPT2_ICL_entailment
217,83,37,32,5,0.8648648648648649,43,29,14,0.6744186046511628,0.7578603511637403,llama3,mimiciii,progress_note,PROMPT2_ICL_entailment
218,84,25,21,4,0.84,35,24,11,0.6857142857142857,0.7550561797752808,llama3,mimiciii,progress_note,PROMPT2_ICL_entailment
219,85,33,31,2,0.9393939393939394,50,35,15,0.7,0.8022181146025879,llama3,mimiciii,progress_note,PROMPT2_ICL_entailment
220,86,50,47,3,0.94,32,25,7,0.78125,0.8533042846768337,llama3,mimiciii,progress_note,PROMPT2_ICL_entailment
221,87,7,6,1,0.8571428571428571,12,2,10,0.1666666666666666,0.2790697674418604,llama3,mimiciii,progress_note,PROMPT2_ICL_entailment
222,88,32,29,3,0.90625,67,43,24,0.6417910447761194,0.7514311539620369,llama3,mimiciii,progress_note,PROMPT2_ICL_entailment
223,89,44,31,13,0.7045454545454546,199,76,123,0.3819095477386934,0.4953221906864291,llama3,mimiciii,progress_note,PROMPT2_ICL_entailment
224,9,21,17,4,0.8095238095238095,42,28,14,0.6666666666666666,0.7311827956989246,llama3,mimiciii,progress_note,PROMPT2_ICL_entailment
225,90,8,7,1,0.875,3,3,0,1.0,0.9333333333333332,llama3,mimiciii,progress_note,PROMPT2_ICL_entailment
226,91,20,19,1,0.95,79,54,25,0.6835443037974683,0.7950406819062379,llama3,mimiciii,progress_note,PROMPT2_ICL_entailment
227,92,19,16,3,0.8421052631578947,143,50,93,0.3496503496503496,0.4941321803582458,llama3,mimiciii,progress_note,PROMPT2_ICL_entailment
228,93,19,17,2,0.8947368421052632,27,16,11,0.5925925925925926,0.7129750982961991,llama3,mimiciii,progress_note,PROMPT2_ICL_entailment
229,94,31,29,2,0.935483870967742,80,43,37,0.5375,0.6827265261428963,llama3,mimiciii,progress_note,PROMPT2_ICL_entailment
230,95,26,23,3,0.8846153846153846,32,20,12,0.625,0.7324840764331211,llama3,mimiciii,progress_note,PROMPT2_ICL_entailment
231,96,12,9,3,0.75,11,3,8,0.2727272727272727,0.3999999999999999,llama3,mimiciii,progress_note,PROMPT2_ICL_entailment
232,97,12,11,1,0.9166666666666666,14,10,4,0.7142857142857143,0.8029197080291971,llama3,mimiciii,progress_note,PROMPT2_ICL_entailment
233,98,23,21,2,0.9130434782608696,24,22,2,0.9166666666666666,0.9148514851485148,llama3,mimiciii,progress_note,PROMPT2_ICL_entailment
234,99,26,23,3,0.8846153846153846,70,29,41,0.4142857142857143,0.5642978003384095,llama3,mimiciii,progress_note,PROMPT2_ICL_entailment
0,0,30,29,1,0.9666666666666668,78,46,32,0.5897435897435898,0.7325645249862712,llama3,mimiciii,progress_note,PROMPT2_entailment
1,1,13,13,0,1.0,189,59,130,0.3121693121693121,0.4758064516129032,llama3,mimiciii,progress_note,PROMPT2_entailment
2,10,38,22,16,0.5789473684210527,140,51,89,0.3642857142857142,0.4471901155838979,llama3,mimiciii,progress_note,PROMPT2_entailment
3,100,27,23,4,0.8518518518518519,77,53,24,0.6883116883116883,0.7613991255465334,llama3,mimiciii,progress_note,PROMPT2_entailment
4,101,18,18,0,1.0,36,25,11,0.6944444444444444,0.819672131147541,llama3,mimiciii,progress_note,PROMPT2_entailment
5,102,18,18,0,1.0,42,30,12,0.7142857142857143,0.8333333333333333,llama3,mimiciii,progress_note,PROMPT2_entailment
6,103,47,39,8,0.8297872340425532,204,78,126,0.3823529411764705,0.523489932885906,llama3,mimiciii,progress_note,PROMPT2_entailment
7,104,17,17,0,1.0,39,35,4,0.8974358974358975,0.945945945945946,llama3,mimiciii,progress_note,PROMPT2_entailment
8,105,14,14,0,1.0,17,13,4,0.7647058823529411,0.8666666666666666,llama3,mimiciii,progress_note,PROMPT2_entailment
9,106,18,15,3,0.8333333333333334,40,31,9,0.775,0.8031088082901554,llama3,mimiciii,progress_note,PROMPT2_entailment
10,107,21,20,1,0.9523809523809524,31,24,7,0.7741935483870968,0.8540925266903914,llama3,mimiciii,progress_note,PROMPT2_entailment
11,108,33,30,3,0.9090909090909092,68,40,28,0.5882352941176471,0.7142857142857143,llama3,mimiciii,progress_note,PROMPT2_entailment
12,109,13,13,0,1.0,176,57,119,0.3238636363636363,0.4892703862660944,llama3,mimiciii,progress_note,PROMPT2_entailment
13,11,40,27,13,0.675,141,59,82,0.4184397163120567,0.5166207232041511,llama3,mimiciii,progress_note,PROMPT2_entailment
14,110,49,36,13,0.7346938775510204,215,80,135,0.3720930232558139,0.4939965694682675,llama3,mimiciii,progress_note,PROMPT2_entailment
15,111,21,15,6,0.7142857142857143,219,80,139,0.365296803652968,0.4833836858006041,llama3,mimiciii,progress_note,PROMPT2_entailment
16,112,202,45,157,0.2227722772277227,234,44,190,0.188034188034188,0.2039344937686682,llama3,mimiciii,progress_note,PROMPT2_entailment
17,113,19,16,3,0.8421052631578947,196,75,121,0.3826530612244898,0.5262003946502959,llama3,mimiciii,progress_note,PROMPT2_entailment
18,114,21,11,10,0.5238095238095238,225,76,149,0.3377777777777778,0.4107098992876443,llama3,mimiciii,progress_note,PROMPT2_entailment
19,115,37,25,12,0.6756756756756757,280,86,194,0.3071428571428571,0.4223138872520133,llama3,mimiciii,progress_note,PROMPT2_entailment
20,116,19,18,1,0.9473684210526316,35,26,9,0.7428571428571429,0.8327402135231318,llama3,mimiciii,progress_note,PROMPT2_entailment
21,117,17,17,0,1.0,20,18,2,0.9,0.9473684210526316,llama3,mimiciii,progress_note,PROMPT2_entailment
22,118,17,17,0,1.0,23,19,4,0.8260869565217391,0.9047619047619048,llama3,mimiciii,progress_note,PROMPT2_entailment
23,119,13,12,1,0.9230769230769232,14,10,4,0.7142857142857143,0.8053691275167787,llama3,mimiciii,progress_note,PROMPT2_entailment
24,12,1,1,0,1.0,225,60,165,0.2666666666666666,0.4210526315789474,llama3,mimiciii,progress_note,PROMPT2_entailment
25,120,26,24,2,0.9230769230769232,64,39,25,0.609375,0.7341176470588235,llama3,mimiciii,progress_note,PROMPT2_entailment
26,121,12,12,0,1.0,14,8,6,0.5714285714285714,0.7272727272727273,llama3,mimiciii,progress_note,PROMPT2_entailment
27,122,29,22,7,0.7586206896551724,47,37,10,0.7872340425531915,0.7726625533934504,llama3,mimiciii,progress_note,PROMPT2_entailment
28,123,26,22,4,0.8461538461538461,50,21,29,0.42,0.5613608748481166,llama3,mimiciii,progress_note,PROMPT2_entailment
29,124,29,28,1,0.9655172413793104,65,50,15,0.7692307692307693,0.8562691131498472,llama3,mimiciii,progress_note,PROMPT2_entailment
30,125,24,22,2,0.9166666666666666,50,34,16,0.68,0.7807933194154489,llama3,mimiciii,progress_note,PROMPT2_entailment
31,126,20,17,3,0.85,27,17,10,0.6296296296296297,0.723404255319149,llama3,mimiciii,progress_note,PROMPT2_entailment
32,127,20,18,2,0.9,27,13,14,0.4814814814814814,0.6273458445040213,llama3,mimiciii,progress_note,PROMPT2_entailment
33,128,23,21,2,0.9130434782608696,37,28,9,0.7567567567567568,0.8275862068965518,llama3,mimiciii,progress_note,PROMPT2_entailment
34,129,26,18,8,0.6923076923076923,66,37,29,0.5606060606060606,0.6195348837209302,llama3,mimiciii,progress_note,PROMPT2_entailment
35,13,16,15,1,0.9375,73,44,29,0.6027397260273972,0.7337409672040022,llama3,mimiciii,progress_note,PROMPT2_entailment
36,130,17,14,3,0.8235294117647058,44,32,12,0.7272727272727273,0.7724137931034483,llama3,mimiciii,progress_note,PROMPT2_entailment
37,131,21,15,6,0.7142857142857143,202,74,128,0.3663366336633663,0.4842931937172774,llama3,mimiciii,progress_note,PROMPT2_entailment
38,132,645,130,515,0.2015503875968992,193,82,111,0.4248704663212435,0.2734034367786612,llama3,mimiciii,progress_note,PROMPT2_entailment
39,133,15,15,0,1.0,157,55,102,0.3503184713375796,0.5188679245283019,llama3,mimiciii,progress_note,PROMPT2_entailment
40,134,12,11,1,0.9166666666666666,18,9,9,0.5,0.6470588235294118,llama3,mimiciii,progress_note,PROMPT2_entailment
41,135,25,25,0,1.0,35,26,9,0.7428571428571429,0.8524590163934427,llama3,mimiciii,progress_note,PROMPT2_entailment
42,136,19,18,1,0.9473684210526316,43,30,13,0.6976744186046512,0.8035714285714286,llama3,mimiciii,progress_note,PROMPT2_entailment
43,137,15,14,1,0.9333333333333332,26,17,9,0.6538461538461539,0.7689822294022617,llama3,mimiciii,progress_note,PROMPT2_entailment
44,138,13,12,1,0.9230769230769232,45,21,24,0.4666666666666667,0.6199261992619927,llama3,mimiciii,progress_note,PROMPT2_entailment
45,139,17,15,2,0.8823529411764706,45,28,17,0.6222222222222222,0.7298001737619462,llama3,mimiciii,progress_note,PROMPT2_entailment
46,14,70,32,38,0.4571428571428571,43,4,39,0.0930232558139534,0.1545893719806763,llama3,mimiciii,progress_note,PROMPT2_entailment
47,140,18,16,2,0.8888888888888888,25,17,8,0.68,0.7705382436260623,llama3,mimiciii,progress_note,PROMPT2_entailment
48,141,20,19,1,0.95,45,25,20,0.5555555555555556,0.7011070110701108,llama3,mimiciii,progress_note,PROMPT2_entailment
49,142,28,26,2,0.9285714285714286,50,40,10,0.8,0.859504132231405,llama3,mimiciii,progress_note,PROMPT2_entailment
50,143,10,10,0,1.0,11,6,5,0.5454545454545454,0.7058823529411764,llama3,mimiciii,progress_note,PROMPT2_entailment
51,144,24,22,2,0.9166666666666666,50,33,17,0.66,0.7674418604651163,llama3,mimiciii,progress_note,PROMPT2_entailment
52,145,15,15,0,1.0,43,26,17,0.6046511627906976,0.7536231884057971,llama3,mimiciii,progress_note,PROMPT2_entailment
53,146,25,23,2,0.92,32,19,13,0.59375,0.7217175887696119,llama3,mimiciii,progress_note,PROMPT2_entailment
54,147,31,30,1,0.967741935483871,56,38,18,0.6785714285714286,0.7977606717984606,llama3,mimiciii,progress_note,PROMPT2_entailment
55,148,10,10,0,1.0,4,3,1,0.75,0.8571428571428571,llama3,mimiciii,progress_note,PROMPT2_entailment
56,149,17,17,0,1.0,29,21,8,0.7241379310344828,0.8400000000000001,llama3,mimiciii,progress_note,PROMPT2_entailment
57,15,14,10,4,0.7142857142857143,163,54,109,0.3312883435582822,0.4526404023470243,llama3,mimiciii,progress_note,PROMPT2_entailment
58,150,15,12,3,0.8,83,54,29,0.6506024096385542,0.717607973421927,llama3,mimiciii,progress_note,PROMPT2_entailment
59,151,15,14,1,0.9333333333333332,201,67,134,0.3333333333333333,0.4912280701754386,llama3,mimiciii,progress_note,PROMPT2_entailment
60,152,41,28,13,0.6829268292682927,45,3,42,0.0666666666666666,0.1214750542299349,llama3,mimiciii,progress_note,PROMPT2_entailment
61,153,26,25,1,0.9615384615384616,219,92,127,0.4200913242009132,0.5847209863988815,llama3,mimiciii,progress_note,PROMPT2_entailment
62,154,13,13,0,1.0,15,15,0,1.0,1.0,llama3,mimiciii,progress_note,PROMPT2_entailment
63,155,17,17,0,1.0,32,22,10,0.6875,0.8148148148148148,llama3,mimiciii,progress_note,PROMPT2_entailment
64,156,18,17,1,0.9444444444444444,32,23,9,0.71875,0.8162839248434238,llama3,mimiciii,progress_note,PROMPT2_entailment
65,157,16,16,0,1.0,29,22,7,0.7586206896551724,0.8627450980392156,llama3,mimiciii,progress_note,PROMPT2_entailment
66,158,25,23,2,0.92,242,92,150,0.3801652892561983,0.5380116959064328,llama3,mimiciii,progress_note,PROMPT2_entailment
67,159,13,12,1,0.9230769230769232,22,14,8,0.6363636363636364,0.7533632286995515,llama3,mimiciii,progress_note,PROMPT2_entailment
68,16,14,13,1,0.9285714285714286,28,18,10,0.6428571428571429,0.7597402597402597,llama3,mimiciii,progress_note,PROMPT2_entailment
69,160,29,28,1,0.9655172413793104,65,50,15,0.7692307692307693,0.8562691131498472,llama3,mimiciii,progress_note,PROMPT2_entailment
70,161,19,18,1,0.9473684210526316,201,83,118,0.4129353233830846,0.5751684311838305,llama3,mimiciii,progress_note,PROMPT2_entailment
71,162,18,15,3,0.8333333333333334,177,81,96,0.4576271186440678,0.5908096280087528,llama3,mimiciii,progress_note,PROMPT2_entailment
72,163,15,15,0,1.0,28,16,12,0.5714285714285714,0.7272727272727273,llama3,mimiciii,progress_note,PROMPT2_entailment
73,164,20,18,2,0.9,57,30,27,0.5263157894736842,0.6642066420664207,llama3,mimiciii,progress_note,PROMPT2_entailment
74,165,10,10,0,1.0,25,21,4,0.84,0.9130434782608696,llama3,mimiciii,progress_note,PROMPT2_entailment
75,166,20,20,0,1.0,42,30,12,0.7142857142857143,0.8333333333333333,llama3,mimiciii,progress_note,PROMPT2_entailment
76,167,21,21,0,1.0,52,28,24,0.5384615384615384,0.7000000000000001,llama3,mimiciii,progress_note,PROMPT2_entailment
77,168,19,16,3,0.8421052631578947,182,69,113,0.3791208791208791,0.5228510537532559,llama3,mimiciii,progress_note,PROMPT2_entailment
78,169,29,27,2,0.9310344827586208,219,83,136,0.3789954337899543,0.5387019230769231,llama3,mimiciii,progress_note,PROMPT2_entailment
79,17,9,8,1,0.8888888888888888,15,7,8,0.4666666666666667,0.6120218579234972,llama3,mimiciii,progress_note,PROMPT2_entailment
80,170,20,18,2,0.9,184,63,121,0.3423913043478261,0.4960629921259843,llama3,mimiciii,progress_note,PROMPT2_entailment
81,171,17,15,2,0.8823529411764706,222,72,150,0.3243243243243243,0.4743083003952569,llama3,mimiciii,progress_note,PROMPT2_entailment
82,172,18,16,2,0.8888888888888888,198,61,137,0.308080808080808,0.4575714955461791,llama3,mimiciii,progress_note,PROMPT2_entailment
83,173,21,19,2,0.9047619047619048,172,62,110,0.3604651162790697,0.5155361050328227,llama3,mimiciii,progress_note,PROMPT2_entailment
84,174,15,13,2,0.8666666666666667,200,52,148,0.26,0.4,llama3,mimiciii,progress_note,PROMPT2_entailment
85,175,21,21,0,1.0,207,60,147,0.2898550724637681,0.449438202247191,llama3,mimiciii,progress_note,PROMPT2_entailment
86,176,17,16,1,0.9411764705882352,192,81,111,0.421875,0.5826028320971004,llama3,mimiciii,progress_note,PROMPT2_entailment
87,177,17,16,1,0.9411764705882352,192,80,112,0.4166666666666667,0.5776173285198556,llama3,mimiciii,progress_note,PROMPT2_entailment
88,178,15,13,2,0.8666666666666667,17,13,4,0.7647058823529411,0.8125,llama3,mimiciii,progress_note,PROMPT2_entailment
89,179,24,22,2,0.9166666666666666,197,71,126,0.3604060913705584,0.5173898641934416,llama3,mimiciii,progress_note,PROMPT2_entailment
90,18,16,16,0,1.0,18,17,1,0.9444444444444444,0.9714285714285714,llama3,mimiciii,progress_note,PROMPT2_entailment
91,180,17,17,0,1.0,201,77,124,0.3830845771144278,0.5539568345323741,llama3,mimiciii,progress_note,PROMPT2_entailment
92,181,22,13,9,0.5909090909090909,208,54,154,0.2596153846153846,0.3607399794450154,llama3,mimiciii,progress_note,PROMPT2_entailment
93,182,19,19,0,1.0,214,85,129,0.397196261682243,0.568561872909699,llama3,mimiciii,progress_note,PROMPT2_entailment
94,183,18,16,2,0.8888888888888888,226,77,149,0.3407079646017699,0.4926029588164734,llama3,mimiciii,progress_note,PROMPT2_entailment
95,184,19,18,1,0.9473684210526316,194,60,134,0.3092783505154639,0.466321243523316,llama3,mimiciii,progress_note,PROMPT2_entailment
96,185,19,18,1,0.9473684210526316,48,29,19,0.6041666666666666,0.7378091872791519,llama3,mimiciii,progress_note,PROMPT2_entailment
97,186,16,15,1,0.9375,205,71,134,0.3463414634146341,0.5058180954642603,llama3,mimiciii,progress_note,PROMPT2_entailment
98,187,41,32,9,0.7804878048780488,170,65,105,0.3823529411764705,0.51326341764343,llama3,mimiciii,progress_note,PROMPT2_entailment
99,188,56,44,12,0.7857142857142857,202,57,145,0.2821782178217821,0.4152317880794702,llama3,mimiciii,progress_note,PROMPT2_entailment
100,189,42,35,7,0.8333333333333334,225,80,145,0.3555555555555555,0.4984423676012461,llama3,mimiciii,progress_note,PROMPT2_entailment
101,19,22,21,1,0.9545454545454546,38,29,9,0.7631578947368421,0.8481894150417828,llama3,mimiciii,progress_note,PROMPT2_entailment
102,190,40,34,6,0.85,223,72,151,0.3228699551569506,0.467979353852036,llama3,mimiciii,progress_note,PROMPT2_entailment
103,191,59,51,8,0.864406779661017,206,90,116,0.4368932038834951,0.5804248861911988,llama3,mimiciii,progress_note,PROMPT2_entailment
104,192,20,19,1,0.95,208,64,144,0.3076923076923077,0.4648318042813456,llama3,mimiciii,progress_note,PROMPT2_entailment
105,193,18,14,4,0.7777777777777778,243,75,168,0.3086419753086419,0.4419191919191919,llama3,mimiciii,progress_note,PROMPT2_entailment
106,194,18,18,0,1.0,211,64,147,0.3033175355450237,0.4654545454545454,llama3,mimiciii,progress_note,PROMPT2_entailment
107,195,19,17,2,0.8947368421052632,44,35,9,0.7954545454545454,0.8421797593772116,llama3,mimiciii,progress_note,PROMPT2_entailment
108,196,25,23,2,0.92,42,25,17,0.5952380952380952,0.7228158390949089,llama3,mimiciii,progress_note,PROMPT2_entailment
109,197,40,38,2,0.95,90,63,27,0.7,0.806060606060606,llama3,mimiciii,progress_note,PROMPT2_entailment
110,198,20,18,2,0.9,34,27,7,0.7941176470588235,0.84375,llama3,mimiciii,progress_note,PROMPT2_entailment
111,199,21,19,2,0.9047619047619048,52,30,22,0.5769230769230769,0.7045735475896167,llama3,mimiciii,progress_note,PROMPT2_entailment
112,2,15,12,3,0.8,140,62,78,0.4428571428571428,0.5701149425287356,llama3,mimiciii,progress_note,PROMPT2_entailment
113,20,15,13,2,0.8666666666666667,33,25,8,0.7575757575757576,0.8084577114427861,llama3,mimiciii,progress_note,PROMPT2_entailment
114,200,34,21,13,0.6176470588235294,164,73,91,0.4451219512195122,0.5173810327370909,llama3,mimiciii,progress_note,PROMPT2_entailment
115,201,17,16,1,0.9411764705882352,200,57,143,0.285,0.4375149916047013,llama3,mimiciii,progress_note,PROMPT2_entailment
116,202,21,16,5,0.7619047619047619,176,48,128,0.2727272727272727,0.401673640167364,llama3,mimiciii,progress_note,PROMPT2_entailment
117,203,13,11,2,0.8461538461538461,211,66,145,0.3127962085308057,0.4567474048442907,llama3,mimiciii,progress_note,PROMPT2_entailment
118,204,20,18,2,0.9,201,69,132,0.3432835820895522,0.4969987995198079,llama3,mimiciii,progress_note,PROMPT2_entailment
119,205,26,26,0,1.0,195,93,102,0.4769230769230769,0.6458333333333334,llama3,mimiciii,progress_note,PROMPT2_entailment
120,206,31,27,4,0.8709677419354839,239,102,137,0.4267782426778242,0.5728549141965679,llama3,mimiciii,progress_note,PROMPT2_entailment
121,207,14,13,1,0.9285714285714286,233,64,169,0.2746781115879828,0.4239490445859872,llama3,mimiciii,progress_note,PROMPT2_entailment
122,208,18,16,2,0.8888888888888888,229,79,150,0.3449781659388646,0.4970507274872198,llama3,mimiciii,progress_note,PROMPT2_entailment
123,209,21,20,1,0.9523809523809524,205,85,120,0.4146341463414634,0.5777400169923534,llama3,mimiciii,progress_note,PROMPT2_entailment
124,21,8,6,2,0.75,217,79,138,0.3640552995391705,0.4901758014477767,llama3,mimiciii,progress_note,PROMPT2_entailment
125,210,16,15,1,0.9375,28,23,5,0.8214285714285714,0.8756345177664975,llama3,mimiciii,progress_note,PROMPT2_entailment
126,211,19,18,1,0.9473684210526316,54,38,16,0.7037037037037037,0.807556080283353,llama3,mimiciii,progress_note,PROMPT2_entailment
127,212,16,14,2,0.875,14,11,3,0.7857142857142857,0.8279569892473119,llama3,mimiciii,progress_note,PROMPT2_entailment
128,213,22,22,0,1.0,41,34,7,0.8292682926829268,0.9066666666666668,llama3,mimiciii,progress_note,PROMPT2_entailment
129,214,20,20,0,1.0,27,22,5,0.8148148148148148,0.8979591836734693,llama3,mimiciii,progress_note,PROMPT2_entailment
130,215,21,14,7,0.6666666666666666,66,38,28,0.5757575757575758,0.6178861788617886,llama3,mimiciii,progress_note,PROMPT2_entailment
131,216,21,21,0,1.0,67,32,35,0.4776119402985074,0.6464646464646464,llama3,mimiciii,progress_note,PROMPT2_entailment
132,217,22,20,2,0.9090909090909092,73,41,32,0.5616438356164384,0.6943268416596106,llama3,mimiciii,progress_note,PROMPT2_entailment
133,218,25,25,0,1.0,27,18,9,0.6666666666666666,0.8,llama3,mimiciii,progress_note,PROMPT2_entailment
134,219,19,16,3,0.8421052631578947,17,8,9,0.4705882352941176,0.6037735849056604,llama3,mimiciii,progress_note,PROMPT2_entailment
135,22,11,11,0,1.0,38,25,13,0.6578947368421053,0.7936507936507937,llama3,mimiciii,progress_note,PROMPT2_entailment
136,220,26,23,3,0.8846153846153846,34,19,15,0.5588235294117647,0.6849529780564264,llama3,mimiciii,progress_note,PROMPT2_entailment
137,221,10,8,2,0.8,188,57,131,0.3031914893617021,0.4397299903567985,llama3,mimiciii,progress_note,PROMPT2_entailment
138,222,16,16,0,1.0,263,97,166,0.3688212927756654,0.5388888888888889,llama3,mimiciii,progress_note,PROMPT2_entailment
139,223,17,16,1,0.9411764705882352,30,22,8,0.7333333333333333,0.8243559718969555,llama3,mimiciii,progress_note,PROMPT2_entailment
140,224,21,21,0,1.0,33,23,10,0.696969696969697,0.8214285714285715,llama3,mimiciii,progress_note,PROMPT2_entailment
141,225,15,15,0,1.0,37,20,17,0.5405405405405406,0.7017543859649124,llama3,mimiciii,progress_note,PROMPT2_entailment
142,226,21,20,1,0.9523809523809524,33,25,8,0.7575757575757576,0.8438818565400843,llama3,mimiciii,progress_note,PROMPT2_entailment
143,227,31,21,10,0.6774193548387096,15,12,3,0.8,0.7336244541484714,llama3,mimiciii,progress_note,PROMPT2_entailment
144,228,31,21,10,0.6774193548387096,15,12,3,0.8,0.7336244541484714,llama3,mimiciii,progress_note,PROMPT2_entailment
145,229,31,19,12,0.6129032258064516,15,12,3,0.8,0.6940639269406392,llama3,mimiciii,progress_note,PROMPT2_entailment
146,23,17,16,1,0.9411764705882352,37,22,15,0.5945945945945946,0.7287784679089028,llama3,mimiciii,progress_note,PROMPT2_entailment
147,230,17,16,1,0.9411764705882352,26,19,7,0.7307692307692307,0.8227334235453316,llama3,mimiciii,progress_note,PROMPT2_entailment
148,231,25,25,0,1.0,102,48,54,0.4705882352941176,0.6399999999999999,llama3,mimiciii,progress_note,PROMPT2_entailment
149,232,22,19,3,0.8636363636363636,72,34,38,0.4722222222222222,0.610586011342155,llama3,mimiciii,progress_note,PROMPT2_entailment
150,233,31,18,13,0.5806451612903226,82,51,31,0.6219512195121951,0.6005888125613347,llama3,mimiciii,progress_note,PROMPT2_entailment
151,234,20,20,0,1.0,42,30,12,0.7142857142857143,0.8333333333333333,llama3,mimiciii,progress_note,PROMPT2_entailment
152,24,18,17,1,0.9444444444444444,22,16,6,0.7272727272727273,0.8217522658610271,llama3,mimiciii,progress_note,PROMPT2_entailment
153,25,13,11,2,0.8461538461538461,22,12,10,0.5454545454545454,0.6633165829145727,llama3,mimiciii,progress_note,PROMPT2_entailment
154,26,13,11,2,0.8461538461538461,22,12,10,0.5454545454545454,0.6633165829145727,llama3,mimiciii,progress_note,PROMPT2_entailment
155,27,22,17,5,0.7727272727272727,19,16,3,0.8421052631578947,0.8059259259259259,llama3,mimiciii,progress_note,PROMPT2_entailment
156,28,28,25,3,0.8928571428571429,50,40,10,0.8,0.8438818565400844,llama3,mimiciii,progress_note,PROMPT2_entailment
157,29,15,14,1,0.9333333333333332,52,31,21,0.5961538461538461,0.7275775356244761,llama3,mimiciii,progress_note,PROMPT2_entailment
158,3,21,15,6,0.7142857142857143,157,63,94,0.4012738853503185,0.5138662316476347,llama3,mimiciii,progress_note,PROMPT2_entailment
159,30,16,16,0,1.0,18,13,5,0.7222222222222222,0.8387096774193548,llama3,mimiciii,progress_note,PROMPT2_entailment
160,31,22,22,0,1.0,17,17,0,1.0,1.0,llama3,mimiciii,progress_note,PROMPT2_entailment
161,32,26,25,1,0.9615384615384616,99,62,37,0.6262626262626263,0.758502569121605,llama3,mimiciii,progress_note,PROMPT2_entailment
162,33,15,15,0,1.0,65,46,19,0.7076923076923077,0.8288288288288288,llama3,mimiciii,progress_note,PROMPT2_entailment
163,34,23,21,2,0.9130434782608696,71,40,31,0.5633802816901409,0.6968063044379926,llama3,mimiciii,progress_note,PROMPT2_entailment
164,35,8,8,0,1.0,20,13,7,0.65,0.787878787878788,llama3,mimiciii,progress_note,PROMPT2_entailment
165,36,19,18,1,0.9473684210526316,40,22,18,0.55,0.6959578207381372,llama3,mimiciii,progress_note,PROMPT2_entailment
166,37,29,27,2,0.9310344827586208,199,90,109,0.4522613065326633,0.6087936865839909,llama3,mimiciii,progress_note,PROMPT2_entailment
167,38,18,18,0,1.0,158,52,106,0.3291139240506329,0.4952380952380952,llama3,mimiciii,progress_note,PROMPT2_entailment
168,39,25,24,1,0.96,76,55,21,0.7236842105263158,0.8252578930915911,llama3,mimiciii,progress_note,PROMPT2_entailment
169,4,19,15,4,0.7894736842105263,162,74,88,0.4567901234567901,0.5787278415015641,llama3,mimiciii,progress_note,PROMPT2_entailment
170,40,26,25,1,0.9615384615384616,76,54,22,0.7105263157894737,0.8171912832929782,llama3,mimiciii,progress_note,PROMPT2_entailment
171,41,28,26,2,0.9285714285714286,78,39,39,0.5,0.65,llama3,mimiciii,progress_note,PROMPT2_entailment
172,42,27,27,0,1.0,78,50,28,0.6410256410256411,0.7812500000000001,llama3,mimiciii,progress_note,PROMPT2_entailment
173,43,24,19,5,0.7916666666666666,79,45,34,0.569620253164557,0.6625339015885316,llama3,mimiciii,progress_note,PROMPT2_entailment
174,44,26,26,0,1.0,96,62,34,0.6458333333333334,0.7848101265822784,llama3,mimiciii,progress_note,PROMPT2_entailment
175,45,27,25,2,0.925925925925926,82,49,33,0.5975609756097561,0.726356359324044,llama3,mimiciii,progress_note,PROMPT2_entailment
176,46,17,17,0,1.0,36,26,10,0.7222222222222222,0.8387096774193548,llama3,mimiciii,progress_note,PROMPT2_entailment
177,47,17,12,5,0.7058823529411765,10,2,8,0.2,0.3116883116883117,llama3,mimiciii,progress_note,PROMPT2_entailment
178,48,37,36,1,0.972972972972973,30,23,7,0.7666666666666667,0.8575867426204039,llama3,mimiciii,progress_note,PROMPT2_entailment
179,49,28,28,0,1.0,57,42,15,0.7368421052631579,0.8484848484848484,llama3,mimiciii,progress_note,PROMPT2_entailment
180,5,16,14,2,0.875,175,47,128,0.2685714285714285,0.4109931292941911,llama3,mimiciii,progress_note,PROMPT2_entailment
181,50,19,18,1,0.9473684210526316,116,64,52,0.5517241379310345,0.6973365617433414,llama3,mimiciii,progress_note,PROMPT2_entailment
182,51,21,16,5,0.7619047619047619,180,72,108,0.4,0.5245901639344264,llama3,mimiciii,progress_note,PROMPT2_entailment
183,52,20,16,4,0.8,180,71,109,0.3944444444444444,0.5283720930232558,llama3,mimiciii,progress_note,PROMPT2_entailment
184,53,18,16,2,0.8888888888888888,221,49,172,0.2217194570135746,0.3549117247623358,llama3,mimiciii,progress_note,PROMPT2_entailment
185,54,50,32,18,0.64,131,55,76,0.4198473282442748,0.5070584845865744,llama3,mimiciii,progress_note,PROMPT2_entailment
186,55,15,13,2,0.8666666666666667,169,61,108,0.3609467455621302,0.5096401028277635,llama3,mimiciii,progress_note,PROMPT2_entailment
187,56,15,12,3,0.8,40,23,17,0.575,0.6690909090909091,llama3,mimiciii,progress_note,PROMPT2_entailment
188,57,11,11,0,1.0,28,18,10,0.6428571428571429,0.782608695652174,llama3,mimiciii,progress_note,PROMPT2_entailment
189,58,18,16,2,0.8888888888888888,25,16,9,0.64,0.7441860465116279,llama3,mimiciii,progress_note,PROMPT2_entailment
190,59,18,16,2,0.8888888888888888,25,17,8,0.68,0.7705382436260623,llama3,mimiciii,progress_note,PROMPT2_entailment
191,6,15,14,1,0.9333333333333332,188,56,132,0.2978723404255319,0.4516129032258065,llama3,mimiciii,progress_note,PROMPT2_entailment
192,60,31,23,8,0.7419354838709677,161,71,90,0.4409937888198758,0.5531842818428184,llama3,mimiciii,progress_note,PROMPT2_entailment
193,61,17,15,2,0.8823529411764706,37,22,15,0.5945945945945946,0.7104413347685683,llama3,mimiciii,progress_note,PROMPT2_entailment
194,62,18,17,1,0.9444444444444444,37,30,7,0.8108108108108109,0.8725406330196751,llama3,mimiciii,progress_note,PROMPT2_entailment
195,63,23,22,1,0.9565217391304348,96,59,37,0.6145833333333334,0.7483424618045547,llama3,mimiciii,progress_note,PROMPT2_entailment
196,64,17,1,16,0.0588235294117647,1,1,0,1.0,0.1111111111111111,llama3,mimiciii,progress_note,PROMPT2_entailment
197,65,13,13,0,1.0,8,8,0,1.0,1.0,llama3,mimiciii,progress_note,PROMPT2_entailment
198,66,20,16,4,0.8,48,32,16,0.6666666666666666,0.7272727272727272,llama3,mimiciii,progress_note,PROMPT2_entailment
199,67,21,17,4,0.8095238095238095,285,95,190,0.3333333333333333,0.4722222222222222,llama3,mimiciii,progress_note,PROMPT2_entailment
200,68,16,12,4,0.75,206,70,136,0.3398058252427184,0.4677060133630289,llama3,mimiciii,progress_note,PROMPT2_entailment
201,69,19,16,3,0.8421052631578947,219,91,128,0.4155251141552511,0.5564685648767437,llama3,mimiciii,progress_note,PROMPT2_entailment
202,7,16,14,2,0.875,187,50,137,0.267379679144385,0.4095962551199532,llama3,mimiciii,progress_note,PROMPT2_entailment
203,70,21,18,3,0.8571428571428571,217,74,143,0.3410138248847926,0.4879120879120879,llama3,mimiciii,progress_note,PROMPT2_entailment
204,71,40,37,3,0.925,213,81,132,0.380281690140845,0.5389803075263017,llama3,mimiciii,progress_note,PROMPT2_entailment
205,72,10,9,1,0.9,15,9,6,0.6,0.7200000000000001,llama3,mimiciii,progress_note,PROMPT2_entailment
206,73,21,11,10,0.5238095238095238,264,71,193,0.2689393939393939,0.3554038680318543,llama3,mimiciii,progress_note,PROMPT2_entailment
207,74,12,11,1,0.9166666666666666,184,78,106,0.4239130434782608,0.5797297297297298,llama3,mimiciii,progress_note,PROMPT2_entailment
208,75,24,24,0,1.0,40,27,13,0.675,0.8059701492537313,llama3,mimiciii,progress_note,PROMPT2_entailment
209,76,27,26,1,0.9629629629629628,58,38,20,0.6551724137931034,0.7797947908445145,llama3,mimiciii,progress_note,PROMPT2_entailment
210,77,17,17,0,1.0,27,24,3,0.8888888888888888,0.9411764705882352,llama3,mimiciii,progress_note,PROMPT2_entailment
211,78,19,17,2,0.8947368421052632,20,13,7,0.65,0.7529812606473595,llama3,mimiciii,progress_note,PROMPT2_entailment
212,79,21,19,2,0.9047619047619048,43,27,16,0.627906976744186,0.7413294797687862,llama3,mimiciii,progress_note,PROMPT2_entailment
213,8,30,29,1,0.9666666666666668,78,47,31,0.6025641025641025,0.7423747276688453,llama3,mimiciii,progress_note,PROMPT2_entailment
214,80,20,18,2,0.9,21,13,8,0.6190476190476191,0.7335423197492164,llama3,mimiciii,progress_note,PROMPT2_entailment
215,81,21,20,1,0.9523809523809524,32,23,9,0.71875,0.8192341941228851,llama3,mimiciii,progress_note,PROMPT2_entailment
216,82,31,20,11,0.6451612903225806,15,12,3,0.8,0.7142857142857142,llama3,mimiciii,progress_note,PROMPT2_entailment
217,83,22,20,2,0.9090909090909092,43,34,9,0.7906976744186046,0.8457711442786069,llama3,mimiciii,progress_note,PROMPT2_entailment
218,84,21,21,0,1.0,35,23,12,0.6571428571428571,0.7931034482758621,llama3,mimiciii,progress_note,PROMPT2_entailment
219,85,20,19,1,0.95,50,27,23,0.54,0.6885906040268457,llama3,mimiciii,progress_note,PROMPT2_entailment
220,86,35,34,1,0.9714285714285714,32,25,7,0.78125,0.8660213958227202,llama3,mimiciii,progress_note,PROMPT2_entailment
221,87,11,7,4,0.6363636363636364,12,1,11,0.0833333333333333,0.1473684210526315,llama3,mimiciii,progress_note,PROMPT2_entailment
222,88,22,22,0,1.0,67,33,34,0.4925373134328358,0.66,llama3,mimiciii,progress_note,PROMPT2_entailment
223,89,16,16,0,1.0,199,64,135,0.321608040201005,0.4866920152091255,llama3,mimiciii,progress_note,PROMPT2_entailment
224,9,18,18,0,1.0,42,28,14,0.6666666666666666,0.8,llama3,mimiciii,progress_note,PROMPT2_entailment
225,90,9,9,0,1.0,3,3,0,1.0,1.0,llama3,mimiciii,progress_note,PROMPT2_entailment
226,91,20,19,1,0.95,79,53,26,0.6708860759493671,0.786411557985162,llama3,mimiciii,progress_note,PROMPT2_entailment
227,92,39,31,8,0.7948717948717948,143,56,87,0.3916083916083916,0.5247090826658606,llama3,mimiciii,progress_note,PROMPT2_entailment
228,93,17,15,2,0.8823529411764706,27,12,15,0.4444444444444444,0.5911330049261083,llama3,mimiciii,progress_note,PROMPT2_entailment
229,94,19,18,1,0.9473684210526316,80,40,40,0.5,0.6545454545454545,llama3,mimiciii,progress_note,PROMPT2_entailment
230,95,17,14,3,0.8235294117647058,32,19,13,0.59375,0.6900129701686122,llama3,mimiciii,progress_note,PROMPT2_entailment
231,96,17,16,1,0.9411764705882352,11,9,2,0.8181818181818182,0.8753799392097266,llama3,mimiciii,progress_note,PROMPT2_entailment
232,97,8,8,0,1.0,14,6,8,0.4285714285714285,0.6,llama3,mimiciii,progress_note,PROMPT2_entailment
233,98,18,18,0,1.0,24,18,6,0.75,0.8571428571428571,llama3,mimiciii,progress_note,PROMPT2_entailment
234,99,24,23,1,0.9583333333333334,70,37,33,0.5285714285714286,0.6813450760608486,llama3,mimiciii,progress_note,PROMPT2_entailment
0,0,10,10,0,1.0,6,5,1,0.8333333333333334,0.9090909090909092,llama3,medalign,nursing_note,PROMPT1_entailment
1,1,4,4,0,1.0,1,1,0,1.0,1.0,llama3,medalign,nursing_note,PROMPT1_entailment
2,10,8,8,0,1.0,5,3,2,0.6,0.7499999999999999,llama3,medalign,nursing_note,PROMPT1_entailment
3,100,11,9,2,0.8181818181818182,10,9,1,0.9,0.8571428571428572,llama3,medalign,nursing_note,PROMPT1_entailment
4,101,8,7,1,0.875,1,1,0,1.0,0.9333333333333332,llama3,medalign,nursing_note,PROMPT1_entailment
5,102,10,8,2,0.8,4,3,1,0.75,0.7741935483870969,llama3,medalign,nursing_note,PROMPT1_entailment
6,103,4,4,0,1.0,2,2,0,1.0,1.0,llama3,medalign,nursing_note,PROMPT1_entailment
7,104,18,16,2,0.8888888888888888,15,12,3,0.8,0.8421052631578948,llama3,medalign,nursing_note,PROMPT1_entailment
8,105,4,4,0,1.0,1,1,0,1.0,1.0,llama3,medalign,nursing_note,PROMPT1_entailment
9,106,6,6,0,1.0,1,1,0,1.0,1.0,llama3,medalign,nursing_note,PROMPT1_entailment
10,107,7,6,1,0.8571428571428571,4,4,0,1.0,0.923076923076923,llama3,medalign,nursing_note,PROMPT1_entailment
11,108,3,2,1,0.6666666666666666,2,2,0,1.0,0.8,llama3,medalign,nursing_note,PROMPT1_entailment
12,109,7,7,0,1.0,5,5,0,1.0,1.0,llama3,medalign,nursing_note,PROMPT1_entailment
13,11,2,2,0,1.0,1,1,0,1.0,1.0,llama3,medalign,nursing_note,PROMPT1_entailment
14,110,11,11,0,1.0,6,5,1,0.8333333333333334,0.9090909090909092,llama3,medalign,nursing_note,PROMPT1_entailment
15,111,2,2,0,1.0,1,1,0,1.0,1.0,llama3,medalign,nursing_note,PROMPT1_entailment
16,112,6,4,2,0.6666666666666666,2,2,0,1.0,0.8,llama3,medalign,nursing_note,PROMPT1_entailment
17,113,2,2,0,1.0,1,1,0,1.0,1.0,llama3,medalign,nursing_note,PROMPT1_entailment
18,114,4,4,0,1.0,1,1,0,1.0,1.0,llama3,medalign,nursing_note,PROMPT1_entailment
19,115,13,11,2,0.8461538461538461,7,5,2,0.7142857142857143,0.7746478873239436,llama3,medalign,nursing_note,PROMPT1_entailment
20,116,9,9,0,1.0,5,4,1,0.8,0.888888888888889,llama3,medalign,nursing_note,PROMPT1_entailment
21,117,12,11,1,0.9166666666666666,13,9,4,0.6923076923076923,0.7888446215139442,llama3,medalign,nursing_note,PROMPT1_entailment
22,118,4,3,1,0.75,2,2,0,1.0,0.8571428571428571,llama3,medalign,nursing_note,PROMPT1_entailment
23,119,3,3,0,1.0,2,2,0,1.0,1.0,llama3,medalign,nursing_note,PROMPT1_entailment
24,12,3,2,1,0.6666666666666666,1,1,0,1.0,0.8,llama3,medalign,nursing_note,PROMPT1_entailment
25,120,8,7,1,0.875,7,5,2,0.7142857142857143,0.7865168539325842,llama3,medalign,nursing_note,PROMPT1_entailment
26,121,4,3,1,0.75,1,1,0,1.0,0.8571428571428571,llama3,medalign,nursing_note,PROMPT1_entailment
27,122,3,2,1,0.6666666666666666,1,1,0,1.0,0.8,llama3,medalign,nursing_note,PROMPT1_entailment
28,123,5,3,2,0.6,4,4,0,1.0,0.7499999999999999,llama3,medalign,nursing_note,PROMPT1_entailment
29,124,15,14,1,0.9333333333333332,14,12,2,0.8571428571428571,0.8936170212765957,llama3,medalign,nursing_note,PROMPT1_entailment
30,125,14,12,2,0.8571428571428571,9,8,1,0.8888888888888888,0.8727272727272727,llama3,medalign,nursing_note,PROMPT1_entailment
31,126,2,1,1,0.5,2,1,1,0.5,0.5,llama3,medalign,nursing_note,PROMPT1_entailment
32,127,3,3,0,1.0,1,0,1,0.0,0.0,llama3,medalign,nursing_note,PROMPT1_entailment
33,128,5,5,0,1.0,2,2,0,1.0,1.0,llama3,medalign,nursing_note,PROMPT1_entailment
34,129,23,21,2,0.9130434782608696,20,20,0,1.0,0.9545454545454544,llama3,medalign,nursing_note,PROMPT1_entailment
35,13,8,8,0,1.0,5,4,1,0.8,0.888888888888889,llama3,medalign,nursing_note,PROMPT1_entailment
36,130,7,6,1,0.8571428571428571,2,2,0,1.0,0.923076923076923,llama3,medalign,nursing_note,PROMPT1_entailment
37,131,4,4,0,1.0,1,1,0,1.0,1.0,llama3,medalign,nursing_note,PROMPT1_entailment
38,132,6,6,0,1.0,2,2,0,1.0,1.0,llama3,medalign,nursing_note,PROMPT1_entailment
39,133,14,12,2,0.8571428571428571,14,9,5,0.6428571428571429,0.7346938775510204,llama3,medalign,nursing_note,PROMPT1_entailment
40,134,6,6,0,1.0,3,3,0,1.0,1.0,llama3,medalign,nursing_note,PROMPT1_entailment
41,135,6,5,1,0.8333333333333334,2,2,0,1.0,0.9090909090909092,llama3,medalign,nursing_note,PROMPT1_entailment
42,136,42,27,15,0.6428571428571429,51,22,29,0.4313725490196078,0.5162972620599738,llama3,medalign,nursing_note,PROMPT1_entailment
43,137,7,6,1,0.8571428571428571,6,6,0,1.0,0.923076923076923,llama3,medalign,nursing_note,PROMPT1_entailment
44,138,2,2,0,1.0,1,1,0,1.0,1.0,llama3,medalign,nursing_note,PROMPT1_entailment
45,139,5,3,2,0.6,1,1,0,1.0,0.7499999999999999,llama3,medalign,nursing_note,PROMPT1_entailment
46,14,2,2,0,1.0,1,1,0,1.0,1.0,llama3,medalign,nursing_note,PROMPT1_entailment
47,140,6,5,1,0.8333333333333334,3,3,0,1.0,0.9090909090909092,llama3,medalign,nursing_note,PROMPT1_entailment
48,141,3,3,0,1.0,1,1,0,1.0,1.0,llama3,medalign,nursing_note,PROMPT1_entailment
49,142,3,3,0,1.0,1,1,0,1.0,1.0,llama3,medalign,nursing_note,PROMPT1_entailment
50,143,2,2,0,1.0,1,1,0,1.0,1.0,llama3,medalign,nursing_note,PROMPT1_entailment
51,144,2,2,0,1.0,1,1,0,1.0,1.0,llama3,medalign,nursing_note,PROMPT1_entailment
52,145,6,6,0,1.0,4,4,0,1.0,1.0,llama3,medalign,nursing_note,PROMPT1_entailment
53,146,9,8,1,0.8888888888888888,3,3,0,1.0,0.9411764705882352,llama3,medalign,nursing_note,PROMPT1_entailment
54,147,11,10,1,0.9090909090909092,6,4,2,0.6666666666666666,0.7692307692307692,llama3,medalign,nursing_note,PROMPT1_entailment
55,148,20,20,0,1.0,7,7,0,1.0,1.0,llama3,medalign,nursing_note,PROMPT1_entailment
56,149,4,3,1,0.75,1,0,1,0.0,0.0,llama3,medalign,nursing_note,PROMPT1_entailment
57,15,6,3,3,0.5,1,1,0,1.0,0.6666666666666666,llama3,medalign,nursing_note,PROMPT1_entailment
58,150,4,3,1,0.75,1,1,0,1.0,0.8571428571428571,llama3,medalign,nursing_note,PROMPT1_entailment
59,151,8,8,0,1.0,8,7,1,0.875,0.9333333333333332,llama3,medalign,nursing_note,PROMPT1_entailment
60,152,6,6,0,1.0,4,4,0,1.0,1.0,llama3,medalign,nursing_note,PROMPT1_entailment
61,153,13,11,2,0.8461538461538461,14,9,5,0.6428571428571429,0.7306273062730628,llama3,medalign,nursing_note,PROMPT1_entailment
62,154,3,3,0,1.0,1,1,0,1.0,1.0,llama3,medalign,nursing_note,PROMPT1_entailment
63,155,14,11,3,0.7857142857142857,14,9,5,0.6428571428571429,0.7071428571428572,llama3,medalign,nursing_note,PROMPT1_entailment
64,156,7,6,1,0.8571428571428571,1,1,0,1.0,0.923076923076923,llama3,medalign,nursing_note,PROMPT1_entailment
65,157,6,5,1,0.8333333333333334,3,2,1,0.6666666666666666,0.7407407407407408,llama3,medalign,nursing_note,PROMPT1_entailment
66,158,5,4,1,0.8,1,1,0,1.0,0.888888888888889,llama3,medalign,nursing_note,PROMPT1_entailment
67,159,7,7,0,1.0,3,3,0,1.0,1.0,llama3,medalign,nursing_note,PROMPT1_entailment
68,16,10,9,1,0.9,3,2,1,0.6666666666666666,0.7659574468085106,llama3,medalign,nursing_note,PROMPT1_entailment
69,160,6,6,0,1.0,1,1,0,1.0,1.0,llama3,medalign,nursing_note,PROMPT1_entailment
70,161,5,5,0,1.0,1,1,0,1.0,1.0,llama3,medalign,nursing_note,PROMPT1_entailment
71,162,11,10,1,0.9090909090909092,8,6,2,0.75,0.821917808219178,llama3,medalign,nursing_note,PROMPT1_entailment
72,163,6,5,1,0.8333333333333334,3,3,0,1.0,0.9090909090909092,llama3,medalign,nursing_note,PROMPT1_entailment
73,164,6,6,0,1.0,2,2,0,1.0,1.0,llama3,medalign,nursing_note,PROMPT1_entailment
74,165,7,6,1,0.8571428571428571,4,3,1,0.75,0.7999999999999999,llama3,medalign,nursing_note,PROMPT1_entailment
75,166,9,8,1,0.8888888888888888,5,5,0,1.0,0.9411764705882352,llama3,medalign,nursing_note,PROMPT1_entailment
76,167,13,10,3,0.7692307692307693,2,2,0,1.0,0.8695652173913044,llama3,medalign,nursing_note,PROMPT1_entailment
77,168,5,4,1,0.8,3,3,0,1.0,0.888888888888889,llama3,medalign,nursing_note,PROMPT1_entailment
78,169,11,10,1,0.9090909090909092,9,6,3,0.6666666666666666,0.7692307692307692,llama3,medalign,nursing_note,PROMPT1_entailment
79,17,4,3,1,0.75,1,0,1,0.0,0.0,llama3,medalign,nursing_note,PROMPT1_entailment
80,170,6,5,1,0.8333333333333334,1,1,0,1.0,0.9090909090909092,llama3,medalign,nursing_note,PROMPT1_entailment
81,171,12,10,2,0.8333333333333334,7,5,2,0.7142857142857143,0.7692307692307692,llama3,medalign,nursing_note,PROMPT1_entailment
82,172,13,9,4,0.6923076923076923,12,5,7,0.4166666666666667,0.5202312138728324,llama3,medalign,nursing_note,PROMPT1_entailment
83,173,9,9,0,1.0,1,1,0,1.0,1.0,llama3,medalign,nursing_note,PROMPT1_entailment
84,174,5,5,0,1.0,1,1,0,1.0,1.0,llama3,medalign,nursing_note,PROMPT1_entailment
85,175,3,2,1,0.6666666666666666,2,2,0,1.0,0.8,llama3,medalign,nursing_note,PROMPT1_entailment
86,176,11,6,5,0.5454545454545454,3,1,2,0.3333333333333333,0.4137931034482758,llama3,medalign,nursing_note,PROMPT1_entailment
87,177,10,9,1,0.9,8,5,3,0.625,0.7377049180327869,llama3,medalign,nursing_note,PROMPT1_entailment
88,178,9,8,1,0.8888888888888888,10,7,3,0.7,0.7832167832167831,llama3,medalign,nursing_note,PROMPT1_entailment
89,179,9,8,1,0.8888888888888888,2,2,0,1.0,0.9411764705882352,llama3,medalign,nursing_note,PROMPT1_entailment
90,18,11,11,0,1.0,3,3,0,1.0,1.0,llama3,medalign,nursing_note,PROMPT1_entailment
91,180,10,9,1,0.9,4,3,1,0.75,0.8181818181818182,llama3,medalign,nursing_note,PROMPT1_entailment
92,181,10,10,0,1.0,7,7,0,1.0,1.0,llama3,medalign,nursing_note,PROMPT1_entailment
93,182,4,4,0,1.0,2,1,1,0.5,0.6666666666666666,llama3,medalign,nursing_note,PROMPT1_entailment
94,183,7,7,0,1.0,6,6,0,1.0,1.0,llama3,medalign,nursing_note,PROMPT1_entailment
95,184,11,10,1,0.9090909090909092,11,10,1,0.9090909090909092,0.9090909090909092,llama3,medalign,nursing_note,PROMPT1_entailment
96,185,6,6,0,1.0,3,3,0,1.0,1.0,llama3,medalign,nursing_note,PROMPT1_entailment
97,186,4,3,1,0.75,3,2,1,0.6666666666666666,0.7058823529411765,llama3,medalign,nursing_note,PROMPT1_entailment
98,187,3,2,1,0.6666666666666666,1,1,0,1.0,0.8,llama3,medalign,nursing_note,PROMPT1_entailment
99,188,4,4,0,1.0,3,3,0,1.0,1.0,llama3,medalign,nursing_note,PROMPT1_entailment
100,189,14,12,2,0.8571428571428571,10,9,1,0.9,0.8780487804878048,llama3,medalign,nursing_note,PROMPT1_entailment
101,19,14,13,1,0.9285714285714286,7,7,0,1.0,0.962962962962963,llama3,medalign,nursing_note,PROMPT1_entailment
102,190,4,4,0,1.0,2,2,0,1.0,1.0,llama3,medalign,nursing_note,PROMPT1_entailment
103,191,15,15,0,1.0,5,5,0,1.0,1.0,llama3,medalign,nursing_note,PROMPT1_entailment
104,192,4,4,0,1.0,1,1,0,1.0,1.0,llama3,medalign,nursing_note,PROMPT1_entailment
105,193,7,7,0,1.0,3,3,0,1.0,1.0,llama3,medalign,nursing_note,PROMPT1_entailment
106,194,5,4,1,0.8,2,1,1,0.5,0.6153846153846154,llama3,medalign,nursing_note,PROMPT1_entailment
107,195,15,13,2,0.8666666666666667,10,9,1,0.9,0.8830188679245283,llama3,medalign,nursing_note,PROMPT1_entailment
108,196,6,6,0,1.0,1,1,0,1.0,1.0,llama3,medalign,nursing_note,PROMPT1_entailment
109,197,5,3,2,0.6,1,1,0,1.0,0.7499999999999999,llama3,medalign,nursing_note,PROMPT1_entailment
110,198,20,17,3,0.85,8,6,2,0.75,0.7968749999999999,llama3,medalign,nursing_note,PROMPT1_entailment
111,199,11,8,3,0.7272727272727273,7,7,0,1.0,0.8421052631578948,llama3,medalign,nursing_note,PROMPT1_entailment
112,2,2,0,2,0.0,5,3,2,0.6,0.0,llama3,medalign,nursing_note,PROMPT1_entailment
113,20,7,7,0,1.0,2,1,1,0.5,0.6666666666666666,llama3,medalign,nursing_note,PROMPT1_entailment
114,200,4,4,0,1.0,3,3,0,1.0,1.0,llama3,medalign,nursing_note,PROMPT1_entailment
115,201,3,2,1,0.6666666666666666,1,0,1,0.0,0.0,llama3,medalign,nursing_note,PROMPT1_entailment
116,202,5,4,1,0.8,1,0,1,0.0,0.0,llama3,medalign,nursing_note,PROMPT1_entailment
117,203,5,5,0,1.0,1,1,0,1.0,1.0,llama3,medalign,nursing_note,PROMPT1_entailment
118,204,13,12,1,0.9230769230769232,9,8,1,0.8888888888888888,0.9056603773584906,llama3,medalign,nursing_note,PROMPT1_entailment
119,205,20,10,10,0.5,8,6,2,0.75,0.6,llama3,medalign,nursing_note,PROMPT1_entailment
120,206,6,6,0,1.0,4,2,2,0.5,0.6666666666666666,llama3,medalign,nursing_note,PROMPT1_entailment
121,207,11,10,1,0.9090909090909092,6,6,0,1.0,0.9523809523809524,llama3,medalign,nursing_note,PROMPT1_entailment
122,208,12,11,1,0.9166666666666666,10,8,2,0.8,0.854368932038835,llama3,medalign,nursing_note,PROMPT1_entailment
123,209,5,4,1,0.8,1,0,1,0.0,0.0,llama3,medalign,nursing_note,PROMPT1_entailment
124,21,5,5,0,1.0,1,1,0,1.0,1.0,llama3,medalign,nursing_note,PROMPT1_entailment
125,210,4,4,0,1.0,2,1,1,0.5,0.6666666666666666,llama3,medalign,nursing_note,PROMPT1_entailment
126,211,4,4,0,1.0,2,1,1,0.5,0.6666666666666666,llama3,medalign,nursing_note,PROMPT1_entailment
127,212,7,7,0,1.0,3,3,0,1.0,1.0,llama3,medalign,nursing_note,PROMPT1_entailment
128,213,12,11,1,0.9166666666666666,8,8,0,1.0,0.9565217391304348,llama3,medalign,nursing_note,PROMPT1_entailment
129,214,4,4,0,1.0,2,2,0,1.0,1.0,llama3,medalign,nursing_note,PROMPT1_entailment
130,215,3,3,0,1.0,1,1,0,1.0,1.0,llama3,medalign,nursing_note,PROMPT1_entailment
131,216,7,7,0,1.0,3,2,1,0.6666666666666666,0.8,llama3,medalign,nursing_note,PROMPT1_entailment
132,217,14,12,2,0.8571428571428571,11,4,7,0.3636363636363636,0.5106382978723404,llama3,medalign,nursing_note,PROMPT1_entailment
133,218,15,14,1,0.9333333333333332,3,2,1,0.6666666666666666,0.7777777777777778,llama3,medalign,nursing_note,PROMPT1_entailment
134,219,8,7,1,0.875,2,2,0,1.0,0.9333333333333332,llama3,medalign,nursing_note,PROMPT1_entailment
135,22,1,0,1,0.0,1,0,1,0.0,,llama3,medalign,nursing_note,PROMPT1_entailment
136,220,10,8,2,0.8,7,4,3,0.5714285714285714,0.6666666666666666,llama3,medalign,nursing_note,PROMPT1_entailment
137,221,15,15,0,1.0,23,9,14,0.391304347826087,0.5625,llama3,medalign,nursing_note,PROMPT1_entailment
138,222,7,7,0,1.0,4,4,0,1.0,1.0,llama3,medalign,nursing_note,PROMPT1_entailment
139,223,5,5,0,1.0,2,2,0,1.0,1.0,llama3,medalign,nursing_note,PROMPT1_entailment
140,224,12,9,3,0.75,4,2,2,0.5,0.6,llama3,medalign,nursing_note,PROMPT1_entailment
141,225,6,6,0,1.0,2,2,0,1.0,1.0,llama3,medalign,nursing_note,PROMPT1_entailment
142,226,13,12,1,0.9230769230769232,5,3,2,0.6,0.7272727272727274,llama3,medalign,nursing_note,PROMPT1_entailment
143,227,2,2,0,1.0,1,1,0,1.0,1.0,llama3,medalign,nursing_note,PROMPT1_entailment
144,228,18,17,1,0.9444444444444444,18,16,2,0.8888888888888888,0.9158249158249158,llama3,medalign,nursing_note,PROMPT1_entailment
145,229,12,11,1,0.9166666666666666,7,6,1,0.8571428571428571,0.8859060402684563,llama3,medalign,nursing_note,PROMPT1_entailment
146,23,24,19,5,0.7916666666666666,21,10,11,0.4761904761904761,0.5946791862284819,llama3,medalign,nursing_note,PROMPT1_entailment
147,230,3,3,0,1.0,1,1,0,1.0,1.0,llama3,medalign,nursing_note,PROMPT1_entailment
148,231,13,12,1,0.9230769230769232,13,11,2,0.8461538461538461,0.8829431438127091,llama3,medalign,nursing_note,PROMPT1_entailment
149,232,10,9,1,0.9,6,3,3,0.5,0.6428571428571429,llama3,medalign,nursing_note,PROMPT1_entailment
150,233,5,3,2,0.6,4,4,0,1.0,0.7499999999999999,llama3,medalign,nursing_note,PROMPT1_entailment
151,234,5,5,0,1.0,2,2,0,1.0,1.0,llama3,medalign,nursing_note,PROMPT1_entailment
152,235,4,4,0,1.0,1,1,0,1.0,1.0,llama3,medalign,nursing_note,PROMPT1_entailment
153,236,14,12,2,0.8571428571428571,14,10,4,0.7142857142857143,0.7792207792207793,llama3,medalign,nursing_note,PROMPT1_entailment
154,237,10,8,2,0.8,5,4,1,0.8,0.8000000000000002,llama3,medalign,nursing_note,PROMPT1_entailment
155,238,9,8,1,0.8888888888888888,4,4,0,1.0,0.9411764705882352,llama3,medalign,nursing_note,PROMPT1_entailment
156,239,11,9,2,0.8181818181818182,4,3,1,0.75,0.7826086956521738,llama3,medalign,nursing_note,PROMPT1_entailment
157,24,1,0,1,0.0,1,1,0,1.0,0.0,llama3,medalign,nursing_note,PROMPT1_entailment
158,240,2,1,1,0.5,2,1,1,0.5,0.5,llama3,medalign,nursing_note,PROMPT1_entailment
159,241,6,6,0,1.0,2,2,0,1.0,1.0,llama3,medalign,nursing_note,PROMPT1_entailment
160,242,14,13,1,0.9285714285714286,2,2,0,1.0,0.962962962962963,llama3,medalign,nursing_note,PROMPT1_entailment
161,243,17,17,0,1.0,10,10,0,1.0,1.0,llama3,medalign,nursing_note,PROMPT1_entailment
162,244,4,4,0,1.0,1,1,0,1.0,1.0,llama3,medalign,nursing_note,PROMPT1_entailment
163,245,4,4,0,1.0,1,1,0,1.0,1.0,llama3,medalign,nursing_note,PROMPT1_entailment
164,246,4,3,1,0.75,1,1,0,1.0,0.8571428571428571,llama3,medalign,nursing_note,PROMPT1_entailment
165,247,8,8,0,1.0,5,5,0,1.0,1.0,llama3,medalign,nursing_note,PROMPT1_entailment
166,248,5,5,0,1.0,1,1,0,1.0,1.0,llama3,medalign,nursing_note,PROMPT1_entailment
167,249,10,10,0,1.0,2,2,0,1.0,1.0,llama3,medalign,nursing_note,PROMPT1_entailment
168,25,38,33,5,0.868421052631579,33,20,13,0.6060606060606061,0.7138994050838291,llama3,medalign,nursing_note,PROMPT1_entailment
169,26,6,6,0,1.0,1,1,0,1.0,1.0,llama3,medalign,nursing_note,PROMPT1_entailment
170,27,9,9,0,1.0,2,2,0,1.0,1.0,llama3,medalign,nursing_note,PROMPT1_entailment
171,28,9,6,3,0.6666666666666666,4,2,2,0.5,0.5714285714285715,llama3,medalign,nursing_note,PROMPT1_entailment
172,29,8,8,0,1.0,3,3,0,1.0,1.0,llama3,medalign,nursing_note,PROMPT1_entailment
173,3,4,4,0,1.0,2,2,0,1.0,1.0,llama3,medalign,nursing_note,PROMPT1_entailment
174,30,4,2,2,0.5,1,1,0,1.0,0.6666666666666666,llama3,medalign,nursing_note,PROMPT1_entailment
175,31,2,1,1,0.5,1,1,0,1.0,0.6666666666666666,llama3,medalign,nursing_note,PROMPT1_entailment
176,32,5,5,0,1.0,2,2,0,1.0,1.0,llama3,medalign,nursing_note,PROMPT1_entailment
177,33,10,9,1,0.9,5,5,0,1.0,0.9473684210526316,llama3,medalign,nursing_note,PROMPT1_entailment
178,34,11,10,1,0.9090909090909092,4,3,1,0.75,0.821917808219178,llama3,medalign,nursing_note,PROMPT1_entailment
179,35,8,7,1,0.875,4,3,1,0.75,0.8076923076923077,llama3,medalign,nursing_note,PROMPT1_entailment
180,36,17,11,6,0.6470588235294118,5,4,1,0.8,0.7154471544715447,llama3,medalign,nursing_note,PROMPT1_entailment
181,37,9,8,1,0.8888888888888888,3,1,2,0.3333333333333333,0.4848484848484848,llama3,medalign,nursing_note,PROMPT1_entailment
182,38,14,11,3,0.7857142857142857,5,2,3,0.4,0.5301204819277109,llama3,medalign,nursing_note,PROMPT1_entailment
183,39,4,4,0,1.0,1,1,0,1.0,1.0,llama3,medalign,nursing_note,PROMPT1_entailment
184,4,7,5,2,0.7142857142857143,3,3,0,1.0,0.8333333333333333,llama3,medalign,nursing_note,PROMPT1_entailment
185,40,11,10,1,0.9090909090909092,8,6,2,0.75,0.821917808219178,llama3,medalign,nursing_note,PROMPT1_entailment
186,41,4,3,1,0.75,1,1,0,1.0,0.8571428571428571,llama3,medalign,nursing_note,PROMPT1_entailment
187,42,10,9,1,0.9,8,7,1,0.875,0.8873239436619719,llama3,medalign,nursing_note,PROMPT1_entailment
188,43,5,5,0,1.0,2,2,0,1.0,1.0,llama3,medalign,nursing_note,PROMPT1_entailment
189,44,5,5,0,1.0,1,1,0,1.0,1.0,llama3,medalign,nursing_note,PROMPT1_entailment
190,45,2,1,1,0.5,1,1,0,1.0,0.6666666666666666,llama3,medalign,nursing_note,PROMPT1_entailment
191,46,8,8,0,1.0,5,5,0,1.0,1.0,llama3,medalign,nursing_note,PROMPT1_entailment
192,47,21,20,1,0.9523809523809524,20,19,1,0.95,0.9511889862327908,llama3,medalign,nursing_note,PROMPT1_entailment
193,48,5,4,1,0.8,2,2,0,1.0,0.888888888888889,llama3,medalign,nursing_note,PROMPT1_entailment
194,49,7,5,2,0.7142857142857143,2,1,1,0.5,0.588235294117647,llama3,medalign,nursing_note,PROMPT1_entailment
195,5,13,12,1,0.9230769230769232,5,3,2,0.6,0.7272727272727274,llama3,medalign,nursing_note,PROMPT1_entailment
196,50,4,3,1,0.75,1,1,0,1.0,0.8571428571428571,llama3,medalign,nursing_note,PROMPT1_entailment
197,51,4,3,1,0.75,2,2,0,1.0,0.8571428571428571,llama3,medalign,nursing_note,PROMPT1_entailment
198,52,5,5,0,1.0,4,4,0,1.0,1.0,llama3,medalign,nursing_note,PROMPT1_entailment
199,53,4,4,0,1.0,1,1,0,1.0,1.0,llama3,medalign,nursing_note,PROMPT1_entailment
200,54,11,9,2,0.8181818181818182,7,6,1,0.8571428571428571,0.8372093023255814,llama3,medalign,nursing_note,PROMPT1_entailment
201,55,7,6,1,0.8571428571428571,2,1,1,0.5,0.631578947368421,llama3,medalign,nursing_note,PROMPT1_entailment
202,56,8,8,0,1.0,3,3,0,1.0,1.0,llama3,medalign,nursing_note,PROMPT1_entailment
203,57,10,8,2,0.8,4,2,2,0.5,0.6153846153846154,llama3,medalign,nursing_note,PROMPT1_entailment
204,58,4,4,0,1.0,1,1,0,1.0,1.0,llama3,medalign,nursing_note,PROMPT1_entailment
205,59,3,3,0,1.0,1,1,0,1.0,1.0,llama3,medalign,nursing_note,PROMPT1_entailment
206,6,6,5,1,0.8333333333333334,3,3,0,1.0,0.9090909090909092,llama3,medalign,nursing_note,PROMPT1_entailment
207,60,9,8,1,0.8888888888888888,9,6,3,0.6666666666666666,0.761904761904762,llama3,medalign,nursing_note,PROMPT1_entailment
208,61,4,3,1,0.75,1,1,0,1.0,0.8571428571428571,llama3,medalign,nursing_note,PROMPT1_entailment
209,62,14,14,0,1.0,5,5,0,1.0,1.0,llama3,medalign,nursing_note,PROMPT1_entailment
210,63,8,7,1,0.875,7,3,4,0.4285714285714285,0.5753424657534246,llama3,medalign,nursing_note,PROMPT1_entailment
211,64,2,2,0,1.0,1,0,1,0.0,0.0,llama3,medalign,nursing_note,PROMPT1_entailment
212,65,6,5,1,0.8333333333333334,2,2,0,1.0,0.9090909090909092,llama3,medalign,nursing_note,PROMPT1_entailment
213,66,6,6,0,1.0,4,4,0,1.0,1.0,llama3,medalign,nursing_note,PROMPT1_entailment
214,67,6,6,0,1.0,4,3,1,0.75,0.8571428571428571,llama3,medalign,nursing_note,PROMPT1_entailment
215,68,6,6,0,1.0,1,1,0,1.0,1.0,llama3,medalign,nursing_note,PROMPT1_entailment
216,69,7,6,1,0.8571428571428571,2,2,0,1.0,0.923076923076923,llama3,medalign,nursing_note,PROMPT1_entailment
217,7,7,7,0,1.0,1,1,0,1.0,1.0,llama3,medalign,nursing_note,PROMPT1_entailment
218,70,9,8,1,0.8888888888888888,1,0,1,0.0,0.0,llama3,medalign,nursing_note,PROMPT1_entailment
219,71,13,12,1,0.9230769230769232,1,0,1,0.0,0.0,llama3,medalign,nursing_note,PROMPT1_entailment
220,72,2,2,0,1.0,1,1,0,1.0,1.0,llama3,medalign,nursing_note,PROMPT1_entailment
221,73,5,4,1,0.8,2,2,0,1.0,0.888888888888889,llama3,medalign,nursing_note,PROMPT1_entailment
222,74,13,8,5,0.6153846153846154,5,3,2,0.6,0.6075949367088608,llama3,medalign,nursing_note,PROMPT1_entailment
223,75,2,1,1,0.5,1,1,0,1.0,0.6666666666666666,llama3,medalign,nursing_note,PROMPT1_entailment
224,76,12,11,1,0.9166666666666666,5,5,0,1.0,0.9565217391304348,llama3,medalign,nursing_note,PROMPT1_entailment
225,77,7,7,0,1.0,3,3,0,1.0,1.0,llama3,medalign,nursing_note,PROMPT1_entailment
226,78,5,4,1,0.8,3,3,0,1.0,0.888888888888889,llama3,medalign,nursing_note,PROMPT1_entailment
227,79,8,8,0,1.0,8,6,2,0.75,0.8571428571428571,llama3,medalign,nursing_note,PROMPT1_entailment
228,8,10,9,1,0.9,8,7,1,0.875,0.8873239436619719,llama3,medalign,nursing_note,PROMPT1_entailment
229,80,10,8,2,0.8,10,8,2,0.8,0.8000000000000002,llama3,medalign,nursing_note,PROMPT1_entailment
230,81,2,2,0,1.0,1,1,0,1.0,1.0,llama3,medalign,nursing_note,PROMPT1_entailment
231,82,4,4,0,1.0,3,3,0,1.0,1.0,llama3,medalign,nursing_note,PROMPT1_entailment
232,83,6,5,1,0.8333333333333334,3,0,3,0.0,0.0,llama3,medalign,nursing_note,PROMPT1_entailment
233,84,10,9,1,0.9,2,2,0,1.0,0.9473684210526316,llama3,medalign,nursing_note,PROMPT1_entailment
234,85,11,11,0,1.0,8,7,1,0.875,0.9333333333333332,llama3,medalign,nursing_note,PROMPT1_entailment
235,86,4,4,0,1.0,3,3,0,1.0,1.0,llama3,medalign,nursing_note,PROMPT1_entailment
236,87,4,3,1,0.75,2,2,0,1.0,0.8571428571428571,llama3,medalign,nursing_note,PROMPT1_entailment
237,88,10,10,0,1.0,7,7,0,1.0,1.0,llama3,medalign,nursing_note,PROMPT1_entailment
238,89,8,8,0,1.0,6,6,0,1.0,1.0,llama3,medalign,nursing_note,PROMPT1_entailment
239,9,7,7,0,1.0,2,2,0,1.0,1.0,llama3,medalign,nursing_note,PROMPT1_entailment
240,90,7,6,1,0.8571428571428571,1,1,0,1.0,0.923076923076923,llama3,medalign,nursing_note,PROMPT1_entailment
241,91,5,5,0,1.0,1,1,0,1.0,1.0,llama3,medalign,nursing_note,PROMPT1_entailment
242,92,7,6,1,0.8571428571428571,4,2,2,0.5,0.631578947368421,llama3,medalign,nursing_note,PROMPT1_entailment
243,93,4,4,0,1.0,1,1,0,1.0,1.0,llama3,medalign,nursing_note,PROMPT1_entailment
244,94,6,4,2,0.6666666666666666,2,1,1,0.5,0.5714285714285715,llama3,medalign,nursing_note,PROMPT1_entailment
245,95,3,3,0,1.0,1,1,0,1.0,1.0,llama3,medalign,nursing_note,PROMPT1_entailment
246,96,4,3,1,0.75,1,1,0,1.0,0.8571428571428571,llama3,medalign,nursing_note,PROMPT1_entailment
247,97,7,7,0,1.0,2,2,0,1.0,1.0,llama3,medalign,nursing_note,PROMPT1_entailment
248,98,11,10,1,0.9090909090909092,5,4,1,0.8,0.8510638297872342,llama3,medalign,nursing_note,PROMPT1_entailment
249,99,15,14,1,0.9333333333333332,7,4,3,0.5714285714285714,0.7088607594936709,llama3,medalign,nursing_note,PROMPT1_entailment
0,0,17,9,8,0.5294117647058824,6,5,1,0.8333333333333334,0.6474820143884893,llama3,medalign,nursing_note,PROMPT1_ICL_entailment
1,1,15,6,9,0.4,1,1,0,1.0,0.5714285714285715,llama3,medalign,nursing_note,PROMPT1_ICL_entailment
2,10,14,6,8,0.4285714285714285,5,4,1,0.8,0.5581395348837209,llama3,medalign,nursing_note,PROMPT1_ICL_entailment
3,100,14,5,9,0.3571428571428571,10,4,6,0.4,0.3773584905660378,llama3,medalign,nursing_note,PROMPT1_ICL_entailment
4,101,15,8,7,0.5333333333333333,1,0,1,0.0,0.0,llama3,medalign,nursing_note,PROMPT1_ICL_entailment
5,102,17,7,10,0.4117647058823529,4,3,1,0.75,0.5316455696202532,llama3,medalign,nursing_note,PROMPT1_ICL_entailment
6,103,11,3,8,0.2727272727272727,2,1,1,0.5,0.3529411764705882,llama3,medalign,nursing_note,PROMPT1_ICL_entailment
7,104,21,11,10,0.5238095238095238,15,5,10,0.3333333333333333,0.4074074074074073,llama3,medalign,nursing_note,PROMPT1_ICL_entailment
8,105,10,2,8,0.2,1,1,0,1.0,0.3333333333333333,llama3,medalign,nursing_note,PROMPT1_ICL_entailment
9,106,11,2,9,0.1818181818181818,1,1,0,1.0,0.3076923076923077,llama3,medalign,nursing_note,PROMPT1_ICL_entailment
10,107,16,7,9,0.4375,4,3,1,0.75,0.5526315789473685,llama3,medalign,nursing_note,PROMPT1_ICL_entailment
11,108,11,4,7,0.3636363636363636,2,2,0,1.0,0.5333333333333333,llama3,medalign,nursing_note,PROMPT1_ICL_entailment
12,109,15,7,8,0.4666666666666667,5,4,1,0.8,0.5894736842105264,llama3,medalign,nursing_note,PROMPT1_ICL_entailment
13,11,10,2,8,0.2,1,1,0,1.0,0.3333333333333333,llama3,medalign,nursing_note,PROMPT1_ICL_entailment
14,110,19,11,8,0.5789473684210527,6,3,3,0.5,0.5365853658536586,llama3,medalign,nursing_note,PROMPT1_ICL_entailment
15,111,10,2,8,0.2,1,1,0,1.0,0.3333333333333333,llama3,medalign,nursing_note,PROMPT1_ICL_entailment
16,112,12,3,9,0.25,2,2,0,1.0,0.4,llama3,medalign,nursing_note,PROMPT1_ICL_entailment
17,113,10,2,8,0.2,1,1,0,1.0,0.3333333333333333,llama3,medalign,nursing_note,PROMPT1_ICL_entailment
18,114,10,2,8,0.2,1,1,0,1.0,0.3333333333333333,llama3,medalign,nursing_note,PROMPT1_ICL_entailment
19,115,21,12,9,0.5714285714285714,7,4,3,0.5714285714285714,0.5714285714285714,llama3,medalign,nursing_note,PROMPT1_ICL_entailment
20,116,17,8,9,0.4705882352941176,5,3,2,0.6,0.5274725274725275,llama3,medalign,nursing_note,PROMPT1_ICL_entailment
21,117,19,8,11,0.4210526315789473,13,6,7,0.4615384615384615,0.4403669724770642,llama3,medalign,nursing_note,PROMPT1_ICL_entailment
22,118,10,1,9,0.1,2,1,1,0.5,0.1666666666666666,llama3,medalign,nursing_note,PROMPT1_ICL_entailment
23,119,11,3,8,0.2727272727272727,2,2,0,1.0,0.4285714285714285,llama3,medalign,nursing_note,PROMPT1_ICL_entailment
24,12,10,2,8,0.2,1,1,0,1.0,0.3333333333333333,llama3,medalign,nursing_note,PROMPT1_ICL_entailment
25,120,16,7,9,0.4375,7,5,2,0.7142857142857143,0.5426356589147286,llama3,medalign,nursing_note,PROMPT1_ICL_entailment
26,121,10,1,9,0.1,1,1,0,1.0,0.1818181818181818,llama3,medalign,nursing_note,PROMPT1_ICL_entailment
27,122,11,3,8,0.2727272727272727,1,0,1,0.0,0.0,llama3,medalign,nursing_note,PROMPT1_ICL_entailment
28,123,11,2,9,0.1818181818181818,4,0,4,0.0,0.0,llama3,medalign,nursing_note,PROMPT1_ICL_entailment
29,124,30,19,11,0.6333333333333333,14,11,3,0.7857142857142857,0.7013422818791947,llama3,medalign,nursing_note,PROMPT1_ICL_entailment
30,125,18,9,9,0.5,9,5,4,0.5555555555555556,0.5263157894736842,llama3,medalign,nursing_note,PROMPT1_ICL_entailment
31,126,11,2,9,0.1818181818181818,2,2,0,1.0,0.3076923076923077,llama3,medalign,nursing_note,PROMPT1_ICL_entailment
32,127,10,2,8,0.2,1,1,0,1.0,0.3333333333333333,llama3,medalign,nursing_note,PROMPT1_ICL_entailment
33,128,10,1,9,0.1,2,1,1,0.5,0.1666666666666666,llama3,medalign,nursing_note,PROMPT1_ICL_entailment
34,129,31,21,10,0.6774193548387096,20,18,2,0.9,0.7730061349693251,llama3,medalign,nursing_note,PROMPT1_ICL_entailment
35,13,13,3,10,0.2307692307692307,5,1,4,0.2,0.2142857142857142,llama3,medalign,nursing_note,PROMPT1_ICL_entailment
36,130,13,4,9,0.3076923076923077,2,1,1,0.5,0.380952380952381,llama3,medalign,nursing_note,PROMPT1_ICL_entailment
37,131,12,4,8,0.3333333333333333,1,1,0,1.0,0.5,llama3,medalign,nursing_note,PROMPT1_ICL_entailment
38,132,14,6,8,0.4285714285714285,2,2,0,1.0,0.6,llama3,medalign,nursing_note,PROMPT1_ICL_entailment
39,133,18,7,11,0.3888888888888889,14,6,8,0.4285714285714285,0.4077669902912621,llama3,medalign,nursing_note,PROMPT1_ICL_entailment
40,134,14,6,8,0.4285714285714285,3,2,1,0.6666666666666666,0.5217391304347826,llama3,medalign,nursing_note,PROMPT1_ICL_entailment
41,135,13,5,8,0.3846153846153846,2,1,1,0.5,0.4347826086956522,llama3,medalign,nursing_note,PROMPT1_ICL_entailment
42,136,58,33,25,0.5689655172413793,51,20,31,0.392156862745098,0.4642982764685191,llama3,medalign,nursing_note,PROMPT1_ICL_entailment
43,137,15,6,9,0.4,6,6,0,1.0,0.5714285714285715,llama3,medalign,nursing_note,PROMPT1_ICL_entailment
44,138,10,2,8,0.2,1,1,0,1.0,0.3333333333333333,llama3,medalign,nursing_note,PROMPT1_ICL_entailment
45,139,11,2,9,0.1818181818181818,1,0,1,0.0,0.0,llama3,medalign,nursing_note,PROMPT1_ICL_entailment
46,14,10,2,8,0.2,1,1,0,1.0,0.3333333333333333,llama3,medalign,nursing_note,PROMPT1_ICL_entailment
47,140,12,3,9,0.25,3,2,1,0.6666666666666666,0.3636363636363636,llama3,medalign,nursing_note,PROMPT1_ICL_entailment
48,141,10,2,8,0.2,1,1,0,1.0,0.3333333333333333,llama3,medalign,nursing_note,PROMPT1_ICL_entailment
49,142,10,1,9,0.1,1,1,0,1.0,0.1818181818181818,llama3,medalign,nursing_note,PROMPT1_ICL_entailment
50,143,10,2,8,0.2,1,1,0,1.0,0.3333333333333333,llama3,medalign,nursing_note,PROMPT1_ICL_entailment
51,144,10,3,7,0.3,1,1,0,1.0,0.4615384615384615,llama3,medalign,nursing_note,PROMPT1_ICL_entailment
52,145,13,5,8,0.3846153846153846,4,2,2,0.5,0.4347826086956522,llama3,medalign,nursing_note,PROMPT1_ICL_entailment
53,146,18,9,9,0.5,3,1,2,0.3333333333333333,0.4,llama3,medalign,nursing_note,PROMPT1_ICL_entailment
54,147,17,8,9,0.4705882352941176,6,3,3,0.5,0.4848484848484848,llama3,medalign,nursing_note,PROMPT1_ICL_entailment
55,148,18,10,8,0.5555555555555556,7,7,0,1.0,0.7142857142857143,llama3,medalign,nursing_note,PROMPT1_ICL_entailment
56,149,12,3,9,0.25,1,1,0,1.0,0.4,llama3,medalign,nursing_note,PROMPT1_ICL_entailment
57,15,11,2,9,0.1818181818181818,1,1,0,1.0,0.3076923076923077,llama3,medalign,nursing_note,PROMPT1_ICL_entailment
58,150,12,3,9,0.25,1,0,1,0.0,0.0,llama3,medalign,nursing_note,PROMPT1_ICL_entailment
59,151,15,7,8,0.4666666666666667,8,5,3,0.625,0.5343511450381679,llama3,medalign,nursing_note,PROMPT1_ICL_entailment
60,152,14,6,8,0.4285714285714285,4,4,0,1.0,0.6,llama3,medalign,nursing_note,PROMPT1_ICL_entailment
61,153,19,9,10,0.4736842105263157,14,7,7,0.5,0.4864864864864865,llama3,medalign,nursing_note,PROMPT1_ICL_entailment
62,154,10,1,9,0.1,1,1,0,1.0,0.1818181818181818,llama3,medalign,nursing_note,PROMPT1_ICL_entailment
63,155,20,9,11,0.45,14,6,8,0.4285714285714285,0.4390243902439024,llama3,medalign,nursing_note,PROMPT1_ICL_entailment
64,156,13,4,9,0.3076923076923077,1,0,1,0.0,0.0,llama3,medalign,nursing_note,PROMPT1_ICL_entailment
65,157,13,5,8,0.3846153846153846,3,1,2,0.3333333333333333,0.3571428571428571,llama3,medalign,nursing_note,PROMPT1_ICL_entailment
66,158,12,3,9,0.25,1,1,0,1.0,0.4,llama3,medalign,nursing_note,PROMPT1_ICL_entailment
67,159,12,4,8,0.3333333333333333,3,1,2,0.3333333333333333,0.3333333333333333,llama3,medalign,nursing_note,PROMPT1_ICL_entailment
68,16,15,6,9,0.4,3,0,3,0.0,0.0,llama3,medalign,nursing_note,PROMPT1_ICL_entailment
69,160,11,3,8,0.2727272727272727,1,1,0,1.0,0.4285714285714285,llama3,medalign,nursing_note,PROMPT1_ICL_entailment
70,161,12,4,8,0.3333333333333333,1,1,0,1.0,0.5,llama3,medalign,nursing_note,PROMPT1_ICL_entailment
71,162,18,9,9,0.5,8,5,3,0.625,0.5555555555555556,llama3,medalign,nursing_note,PROMPT1_ICL_entailment
72,163,12,3,9,0.25,3,2,1,0.6666666666666666,0.3636363636363636,llama3,medalign,nursing_note,PROMPT1_ICL_entailment
73,164,13,5,8,0.3846153846153846,2,2,0,1.0,0.5555555555555556,llama3,medalign,nursing_note,PROMPT1_ICL_entailment
74,165,13,4,9,0.3076923076923077,4,1,3,0.25,0.2758620689655172,llama3,medalign,nursing_note,PROMPT1_ICL_entailment
75,166,14,5,9,0.3571428571428571,5,3,2,0.6,0.4477611940298507,llama3,medalign,nursing_note,PROMPT1_ICL_entailment
76,167,18,9,9,0.5,2,1,1,0.5,0.5,llama3,medalign,nursing_note,PROMPT1_ICL_entailment
77,168,11,2,9,0.1818181818181818,3,2,1,0.6666666666666666,0.2857142857142857,llama3,medalign,nursing_note,PROMPT1_ICL_entailment
78,169,18,9,9,0.5,9,5,4,0.5555555555555556,0.5263157894736842,llama3,medalign,nursing_note,PROMPT1_ICL_entailment
79,17,11,2,9,0.1818181818181818,1,0,1,0.0,0.0,llama3,medalign,nursing_note,PROMPT1_ICL_entailment
80,170,12,3,9,0.25,1,0,1,0.0,0.0,llama3,medalign,nursing_note,PROMPT1_ICL_entailment
81,171,19,8,11,0.4210526315789473,7,2,5,0.2857142857142857,0.3404255319148936,llama3,medalign,nursing_note,PROMPT1_ICL_entailment
82,172,18,7,11,0.3888888888888889,12,3,9,0.25,0.3043478260869565,llama3,medalign,nursing_note,PROMPT1_ICL_entailment
83,173,17,9,8,0.5294117647058824,1,1,0,1.0,0.6923076923076924,llama3,medalign,nursing_note,PROMPT1_ICL_entailment
84,174,12,4,8,0.3333333333333333,1,1,0,1.0,0.5,llama3,medalign,nursing_note,PROMPT1_ICL_entailment
85,175,9,0,9,0.0,2,0,2,0.0,,llama3,medalign,nursing_note,PROMPT1_ICL_entailment
86,176,19,7,12,0.3684210526315789,3,1,2,0.3333333333333333,0.35,llama3,medalign,nursing_note,PROMPT1_ICL_entailment
87,177,16,7,9,0.4375,8,5,3,0.625,0.5147058823529411,llama3,medalign,nursing_note,PROMPT1_ICL_entailment
88,178,17,8,9,0.4705882352941176,10,7,3,0.7,0.5628140703517589,llama3,medalign,nursing_note,PROMPT1_ICL_entailment
89,179,15,6,9,0.4,2,2,0,1.0,0.5714285714285715,llama3,medalign,nursing_note,PROMPT1_ICL_entailment
90,18,18,10,8,0.5555555555555556,3,2,1,0.6666666666666666,0.606060606060606,llama3,medalign,nursing_note,PROMPT1_ICL_entailment
91,180,15,5,10,0.3333333333333333,4,1,3,0.25,0.2857142857142857,llama3,medalign,nursing_note,PROMPT1_ICL_entailment
92,181,17,8,9,0.4705882352941176,7,6,1,0.8571428571428571,0.6075949367088607,llama3,medalign,nursing_note,PROMPT1_ICL_entailment
93,182,12,3,9,0.25,2,0,2,0.0,0.0,llama3,medalign,nursing_note,PROMPT1_ICL_entailment
94,183,15,7,8,0.4666666666666667,6,5,1,0.8333333333333334,0.5982905982905983,llama3,medalign,nursing_note,PROMPT1_ICL_entailment
95,184,17,9,8,0.5294117647058824,11,6,5,0.5454545454545454,0.5373134328358209,llama3,medalign,nursing_note,PROMPT1_ICL_entailment
96,185,12,4,8,0.3333333333333333,3,2,1,0.6666666666666666,0.4444444444444444,llama3,medalign,nursing_note,PROMPT1_ICL_entailment
97,186,13,5,8,0.3846153846153846,3,2,1,0.6666666666666666,0.4878048780487804,llama3,medalign,nursing_note,PROMPT1_ICL_entailment
98,187,10,2,8,0.2,1,1,0,1.0,0.3333333333333333,llama3,medalign,nursing_note,PROMPT1_ICL_entailment
99,188,11,3,8,0.2727272727272727,3,2,1,0.6666666666666666,0.3870967741935484,llama3,medalign,nursing_note,PROMPT1_ICL_entailment
100,189,23,13,10,0.5652173913043478,10,4,6,0.4,0.4684684684684684,llama3,medalign,nursing_note,PROMPT1_ICL_entailment
101,19,20,11,9,0.55,7,5,2,0.7142857142857143,0.6214689265536724,llama3,medalign,nursing_note,PROMPT1_ICL_entailment
102,190,11,3,8,0.2727272727272727,2,1,1,0.5,0.3529411764705882,llama3,medalign,nursing_note,PROMPT1_ICL_entailment
103,191,22,14,8,0.6363636363636364,5,2,3,0.4,0.4912280701754386,llama3,medalign,nursing_note,PROMPT1_ICL_entailment
104,192,12,4,8,0.3333333333333333,1,0,1,0.0,0.0,llama3,medalign,nursing_note,PROMPT1_ICL_entailment
105,193,12,3,9,0.25,3,3,0,1.0,0.4,llama3,medalign,nursing_note,PROMPT1_ICL_entailment
106,194,11,2,9,0.1818181818181818,2,0,2,0.0,0.0,llama3,medalign,nursing_note,PROMPT1_ICL_entailment
107,195,17,7,10,0.4117647058823529,10,3,7,0.3,0.3471074380165289,llama3,medalign,nursing_note,PROMPT1_ICL_entailment
108,196,11,3,8,0.2727272727272727,1,1,0,1.0,0.4285714285714285,llama3,medalign,nursing_note,PROMPT1_ICL_entailment
109,197,11,2,9,0.1818181818181818,1,0,1,0.0,0.0,llama3,medalign,nursing_note,PROMPT1_ICL_entailment
110,198,24,14,10,0.5833333333333334,8,5,3,0.625,0.603448275862069,llama3,medalign,nursing_note,PROMPT1_ICL_entailment
111,199,24,12,12,0.5,7,7,0,1.0,0.6666666666666666,llama3,medalign,nursing_note,PROMPT1_ICL_entailment
112,2,20,9,11,0.45,5,2,3,0.4,0.4235294117647059,llama3,medalign,nursing_note,PROMPT1_ICL_entailment
113,20,15,6,9,0.4,2,1,1,0.5,0.4444444444444445,llama3,medalign,nursing_note,PROMPT1_ICL_entailment
114,200,12,5,7,0.4166666666666667,3,3,0,1.0,0.5882352941176471,llama3,medalign,nursing_note,PROMPT1_ICL_entailment
115,201,11,2,9,0.1818181818181818,1,0,1,0.0,0.0,llama3,medalign,nursing_note,PROMPT1_ICL_entailment
116,202,13,4,9,0.3076923076923077,1,0,1,0.0,0.0,llama3,medalign,nursing_note,PROMPT1_ICL_entailment
117,203,10,3,7,0.3,1,1,0,1.0,0.4615384615384615,llama3,medalign,nursing_note,PROMPT1_ICL_entailment
118,204,19,11,8,0.5789473684210527,9,6,3,0.6666666666666666,0.619718309859155,llama3,medalign,nursing_note,PROMPT1_ICL_entailment
119,205,24,9,15,0.375,8,1,7,0.125,0.1875,llama3,medalign,nursing_note,PROMPT1_ICL_entailment
120,206,11,3,8,0.2727272727272727,4,2,2,0.5,0.3529411764705882,llama3,medalign,nursing_note,PROMPT1_ICL_entailment
121,207,19,10,9,0.5263157894736842,6,5,1,0.8333333333333334,0.6451612903225806,llama3,medalign,nursing_note,PROMPT1_ICL_entailment
122,208,19,10,9,0.5263157894736842,10,5,5,0.5,0.5128205128205129,llama3,medalign,nursing_note,PROMPT1_ICL_entailment
123,209,13,4,9,0.3076923076923077,1,0,1,0.0,0.0,llama3,medalign,nursing_note,PROMPT1_ICL_entailment
124,21,12,4,8,0.3333333333333333,1,1,0,1.0,0.5,llama3,medalign,nursing_note,PROMPT1_ICL_entailment
125,210,11,2,9,0.1818181818181818,2,1,1,0.5,0.2666666666666666,llama3,medalign,nursing_note,PROMPT1_ICL_entailment
126,211,12,4,8,0.3333333333333333,2,1,1,0.5,0.4,llama3,medalign,nursing_note,PROMPT1_ICL_entailment
127,212,14,6,8,0.4285714285714285,3,3,0,1.0,0.6,llama3,medalign,nursing_note,PROMPT1_ICL_entailment
128,213,20,10,10,0.5,8,8,0,1.0,0.6666666666666666,llama3,medalign,nursing_note,PROMPT1_ICL_entailment
129,214,10,2,8,0.2,2,1,1,0.5,0.2857142857142857,llama3,medalign,nursing_note,PROMPT1_ICL_entailment
130,215,11,2,9,0.1818181818181818,1,1,0,1.0,0.3076923076923077,llama3,medalign,nursing_note,PROMPT1_ICL_entailment
131,216,14,5,9,0.3571428571428571,3,1,2,0.3333333333333333,0.3448275862068965,llama3,medalign,nursing_note,PROMPT1_ICL_entailment
132,217,18,7,11,0.3888888888888889,11,4,7,0.3636363636363636,0.3758389261744966,llama3,medalign,nursing_note,PROMPT1_ICL_entailment
133,218,23,14,9,0.6086956521739131,3,3,0,1.0,0.7567567567567568,llama3,medalign,nursing_note,PROMPT1_ICL_entailment
134,219,13,4,9,0.3076923076923077,2,2,0,1.0,0.4705882352941176,llama3,medalign,nursing_note,PROMPT1_ICL_entailment
135,22,10,2,8,0.2,1,1,0,1.0,0.3333333333333333,llama3,medalign,nursing_note,PROMPT1_ICL_entailment
136,220,17,6,11,0.3529411764705882,7,5,2,0.7142857142857143,0.4724409448818898,llama3,medalign,nursing_note,PROMPT1_ICL_entailment
137,221,17,8,9,0.4705882352941176,23,7,16,0.3043478260869565,0.3696369636963696,llama3,medalign,nursing_note,PROMPT1_ICL_entailment
138,222,13,5,8,0.3846153846153846,4,4,0,1.0,0.5555555555555556,llama3,medalign,nursing_note,PROMPT1_ICL_entailment
139,223,12,3,9,0.25,2,0,2,0.0,0.0,llama3,medalign,nursing_note,PROMPT1_ICL_entailment
140,224,20,7,13,0.35,4,0,4,0.0,0.0,llama3,medalign,nursing_note,PROMPT1_ICL_entailment
141,225,13,4,9,0.3076923076923077,2,1,1,0.5,0.380952380952381,llama3,medalign,nursing_note,PROMPT1_ICL_entailment
142,226,18,9,9,0.5,5,3,2,0.6,0.5454545454545454,llama3,medalign,nursing_note,PROMPT1_ICL_entailment
143,227,10,2,8,0.2,1,1,0,1.0,0.3333333333333333,llama3,medalign,nursing_note,PROMPT1_ICL_entailment
144,228,25,18,7,0.72,18,13,5,0.7222222222222222,0.7211093990755009,llama3,medalign,nursing_note,PROMPT1_ICL_entailment
145,229,19,6,13,0.3157894736842105,7,3,4,0.4285714285714285,0.3636363636363636,llama3,medalign,nursing_note,PROMPT1_ICL_entailment
146,23,27,11,16,0.4074074074074074,21,7,14,0.3333333333333333,0.3666666666666666,llama3,medalign,nursing_note,PROMPT1_ICL_entailment
147,230,10,1,9,0.1,1,1,0,1.0,0.1818181818181818,llama3,medalign,nursing_note,PROMPT1_ICL_entailment
148,231,19,9,10,0.4736842105263157,13,6,7,0.4615384615384615,0.4675324675324675,llama3,medalign,nursing_note,PROMPT1_ICL_entailment
149,232,15,6,9,0.4,6,2,4,0.3333333333333333,0.3636363636363636,llama3,medalign,nursing_note,PROMPT1_ICL_entailment
150,233,13,3,10,0.2307692307692307,4,3,1,0.75,0.3529411764705882,llama3,medalign,nursing_note,PROMPT1_ICL_entailment
151,234,14,6,8,0.4285714285714285,2,2,0,1.0,0.6,llama3,medalign,nursing_note,PROMPT1_ICL_entailment
152,235,10,1,9,0.1,1,0,1,0.0,0.0,llama3,medalign,nursing_note,PROMPT1_ICL_entailment
153,236,19,9,10,0.4736842105263157,14,7,7,0.5,0.4864864864864865,llama3,medalign,nursing_note,PROMPT1_ICL_entailment
154,237,18,8,10,0.4444444444444444,5,2,3,0.4,0.4210526315789474,llama3,medalign,nursing_note,PROMPT1_ICL_entailment
155,238,13,4,9,0.3076923076923077,4,2,2,0.5,0.380952380952381,llama3,medalign,nursing_note,PROMPT1_ICL_entailment
156,239,19,9,10,0.4736842105263157,4,2,2,0.5,0.4864864864864865,llama3,medalign,nursing_note,PROMPT1_ICL_entailment
157,24,9,1,8,0.1111111111111111,1,0,1,0.0,0.0,llama3,medalign,nursing_note,PROMPT1_ICL_entailment
158,240,11,2,9,0.1818181818181818,2,2,0,1.0,0.3076923076923077,llama3,medalign,nursing_note,PROMPT1_ICL_entailment
159,241,11,2,9,0.1818181818181818,2,1,1,0.5,0.2666666666666666,llama3,medalign,nursing_note,PROMPT1_ICL_entailment
160,242,21,10,11,0.4761904761904761,2,1,1,0.5,0.4878048780487805,llama3,medalign,nursing_note,PROMPT1_ICL_entailment
161,243,29,20,9,0.6896551724137931,10,9,1,0.9,0.7809110629067245,llama3,medalign,nursing_note,PROMPT1_ICL_entailment
162,244,12,5,7,0.4166666666666667,1,1,0,1.0,0.5882352941176471,llama3,medalign,nursing_note,PROMPT1_ICL_entailment
163,245,12,3,9,0.25,1,1,0,1.0,0.4,llama3,medalign,nursing_note,PROMPT1_ICL_entailment
164,246,10,2,8,0.2,1,0,1,0.0,0.0,llama3,medalign,nursing_note,PROMPT1_ICL_entailment
165,247,15,7,8,0.4666666666666667,5,5,0,1.0,0.6363636363636364,llama3,medalign,nursing_note,PROMPT1_ICL_entailment
166,248,10,1,9,0.1,1,1,0,1.0,0.1818181818181818,llama3,medalign,nursing_note,PROMPT1_ICL_entailment
167,249,14,7,7,0.5,2,1,1,0.5,0.5,llama3,medalign,nursing_note,PROMPT1_ICL_entailment
168,25,33,23,10,0.696969696969697,33,17,16,0.5151515151515151,0.5924242424242424,llama3,medalign,nursing_note,PROMPT1_ICL_entailment
169,26,13,5,8,0.3846153846153846,1,1,0,1.0,0.5555555555555556,llama3,medalign,nursing_note,PROMPT1_ICL_entailment
170,27,16,8,8,0.5,2,2,0,1.0,0.6666666666666666,llama3,medalign,nursing_note,PROMPT1_ICL_entailment
171,28,14,5,9,0.3571428571428571,4,1,3,0.25,0.2941176470588235,llama3,medalign,nursing_note,PROMPT1_ICL_entailment
172,29,12,4,8,0.3333333333333333,3,2,1,0.6666666666666666,0.4444444444444444,llama3,medalign,nursing_note,PROMPT1_ICL_entailment
173,3,10,2,8,0.2,2,1,1,0.5,0.2857142857142857,llama3,medalign,nursing_note,PROMPT1_ICL_entailment
174,30,10,1,9,0.1,1,1,0,1.0,0.1818181818181818,llama3,medalign,nursing_note,PROMPT1_ICL_entailment
175,31,10,1,9,0.1,1,1,0,1.0,0.1818181818181818,llama3,medalign,nursing_note,PROMPT1_ICL_entailment
176,32,10,1,9,0.1,2,0,2,0.0,0.0,llama3,medalign,nursing_note,PROMPT1_ICL_entailment
177,33,16,7,9,0.4375,5,2,3,0.4,0.417910447761194,llama3,medalign,nursing_note,PROMPT1_ICL_entailment
178,34,19,10,9,0.5263157894736842,4,1,3,0.25,0.3389830508474576,llama3,medalign,nursing_note,PROMPT1_ICL_entailment
179,35,15,6,9,0.4,4,2,2,0.5,0.4444444444444445,llama3,medalign,nursing_note,PROMPT1_ICL_entailment
180,36,22,9,13,0.4090909090909091,5,2,3,0.4,0.4044943820224719,llama3,medalign,nursing_note,PROMPT1_ICL_entailment
181,37,13,4,9,0.3076923076923077,3,1,2,0.3333333333333333,0.32,llama3,medalign,nursing_note,PROMPT1_ICL_entailment
182,38,22,11,11,0.5,5,3,2,0.6,0.5454545454545454,llama3,medalign,nursing_note,PROMPT1_ICL_entailment
183,39,12,4,8,0.3333333333333333,1,1,0,1.0,0.5,llama3,medalign,nursing_note,PROMPT1_ICL_entailment
184,4,11,1,10,0.0909090909090909,3,1,2,0.3333333333333333,0.1428571428571428,llama3,medalign,nursing_note,PROMPT1_ICL_entailment
185,40,17,8,9,0.4705882352941176,8,4,4,0.5,0.4848484848484848,llama3,medalign,nursing_note,PROMPT1_ICL_entailment
186,41,10,1,9,0.1,1,1,0,1.0,0.1818181818181818,llama3,medalign,nursing_note,PROMPT1_ICL_entailment
187,42,16,7,9,0.4375,8,3,5,0.375,0.4038461538461538,llama3,medalign,nursing_note,PROMPT1_ICL_entailment
188,43,12,4,8,0.3333333333333333,2,2,0,1.0,0.5,llama3,medalign,nursing_note,PROMPT1_ICL_entailment
189,44,12,6,6,0.5,1,1,0,1.0,0.6666666666666666,llama3,medalign,nursing_note,PROMPT1_ICL_entailment
190,45,10,1,9,0.1,1,1,0,1.0,0.1818181818181818,llama3,medalign,nursing_note,PROMPT1_ICL_entailment
191,46,16,7,9,0.4375,5,5,0,1.0,0.6086956521739131,llama3,medalign,nursing_note,PROMPT1_ICL_entailment
192,47,29,21,8,0.7241379310344828,20,18,2,0.9,0.8025477707006369,llama3,medalign,nursing_note,PROMPT1_ICL_entailment
193,48,11,2,9,0.1818181818181818,2,2,0,1.0,0.3076923076923077,llama3,medalign,nursing_note,PROMPT1_ICL_entailment
194,49,12,3,9,0.25,2,1,1,0.5,0.3333333333333333,llama3,medalign,nursing_note,PROMPT1_ICL_entailment
195,5,14,5,9,0.3571428571428571,5,3,2,0.6,0.4477611940298507,llama3,medalign,nursing_note,PROMPT1_ICL_entailment
196,50,10,1,9,0.1,1,0,1,0.0,0.0,llama3,medalign,nursing_note,PROMPT1_ICL_entailment
197,51,10,2,8,0.2,2,0,2,0.0,0.0,llama3,medalign,nursing_note,PROMPT1_ICL_entailment
198,52,14,6,8,0.4285714285714285,4,3,1,0.75,0.5454545454545454,llama3,medalign,nursing_note,PROMPT1_ICL_entailment
199,53,11,3,8,0.2727272727272727,1,1,0,1.0,0.4285714285714285,llama3,medalign,nursing_note,PROMPT1_ICL_entailment
200,54,20,11,9,0.55,7,3,4,0.4285714285714285,0.4817518248175182,llama3,medalign,nursing_note,PROMPT1_ICL_entailment
201,55,15,6,9,0.4,2,2,0,1.0,0.5714285714285715,llama3,medalign,nursing_note,PROMPT1_ICL_entailment
202,56,16,7,9,0.4375,3,3,0,1.0,0.6086956521739131,llama3,medalign,nursing_note,PROMPT1_ICL_entailment
203,57,15,4,11,0.2666666666666666,4,2,2,0.5,0.3478260869565218,llama3,medalign,nursing_note,PROMPT1_ICL_entailment
204,58,11,4,7,0.3636363636363636,1,1,0,1.0,0.5333333333333333,llama3,medalign,nursing_note,PROMPT1_ICL_entailment
205,59,11,4,7,0.3636363636363636,1,1,0,1.0,0.5333333333333333,llama3,medalign,nursing_note,PROMPT1_ICL_entailment
206,6,11,3,8,0.2727272727272727,3,3,0,1.0,0.4285714285714285,llama3,medalign,nursing_note,PROMPT1_ICL_entailment
207,60,16,6,10,0.375,9,6,3,0.6666666666666666,0.4800000000000001,llama3,medalign,nursing_note,PROMPT1_ICL_entailment
208,61,10,2,8,0.2,1,1,0,1.0,0.3333333333333333,llama3,medalign,nursing_note,PROMPT1_ICL_entailment
209,62,23,15,8,0.6521739130434783,5,3,2,0.6,0.6250000000000001,llama3,medalign,nursing_note,PROMPT1_ICL_entailment
210,63,16,6,10,0.375,7,3,4,0.4285714285714285,0.3999999999999999,llama3,medalign,nursing_note,PROMPT1_ICL_entailment
211,64,11,5,6,0.4545454545454545,1,1,0,1.0,0.625,llama3,medalign,nursing_note,PROMPT1_ICL_entailment
212,65,12,4,8,0.3333333333333333,2,0,2,0.0,0.0,llama3,medalign,nursing_note,PROMPT1_ICL_entailment
213,66,14,6,8,0.4285714285714285,4,4,0,1.0,0.6,llama3,medalign,nursing_note,PROMPT1_ICL_entailment
214,67,15,7,8,0.4666666666666667,4,3,1,0.75,0.5753424657534245,llama3,medalign,nursing_note,PROMPT1_ICL_entailment
215,68,14,7,7,0.5,1,1,0,1.0,0.6666666666666666,llama3,medalign,nursing_note,PROMPT1_ICL_entailment
216,69,14,5,9,0.3571428571428571,2,1,1,0.5,0.4166666666666666,llama3,medalign,nursing_note,PROMPT1_ICL_entailment
217,7,12,4,8,0.3333333333333333,1,1,0,1.0,0.5,llama3,medalign,nursing_note,PROMPT1_ICL_entailment
218,70,17,8,9,0.4705882352941176,1,0,1,0.0,0.0,llama3,medalign,nursing_note,PROMPT1_ICL_entailment
219,71,15,6,9,0.4,1,0,1,0.0,0.0,llama3,medalign,nursing_note,PROMPT1_ICL_entailment
220,72,10,2,8,0.2,1,1,0,1.0,0.3333333333333333,llama3,medalign,nursing_note,PROMPT1_ICL_entailment
221,73,11,2,9,0.1818181818181818,2,0,2,0.0,0.0,llama3,medalign,nursing_note,PROMPT1_ICL_entailment
222,74,18,6,12,0.3333333333333333,5,2,3,0.4,0.3636363636363636,llama3,medalign,nursing_note,PROMPT1_ICL_entailment
223,75,10,2,8,0.2,1,1,0,1.0,0.3333333333333333,llama3,medalign,nursing_note,PROMPT1_ICL_entailment
224,76,21,12,9,0.5714285714285714,5,3,2,0.6,0.5853658536585366,llama3,medalign,nursing_note,PROMPT1_ICL_entailment
225,77,14,4,10,0.2857142857142857,3,2,1,0.6666666666666666,0.4,llama3,medalign,nursing_note,PROMPT1_ICL_entailment
226,78,13,4,9,0.3076923076923077,3,3,0,1.0,0.4705882352941176,llama3,medalign,nursing_note,PROMPT1_ICL_entailment
227,79,15,5,10,0.3333333333333333,8,4,4,0.5,0.4,llama3,medalign,nursing_note,PROMPT1_ICL_entailment
228,8,18,9,9,0.5,8,7,1,0.875,0.6363636363636364,llama3,medalign,nursing_note,PROMPT1_ICL_entailment
229,80,17,6,11,0.3529411764705882,10,6,4,0.6,0.4444444444444445,llama3,medalign,nursing_note,PROMPT1_ICL_entailment
230,81,10,2,8,0.2,1,1,0,1.0,0.3333333333333333,llama3,medalign,nursing_note,PROMPT1_ICL_entailment
231,82,12,4,8,0.3333333333333333,3,1,2,0.3333333333333333,0.3333333333333333,llama3,medalign,nursing_note,PROMPT1_ICL_entailment
232,83,13,3,10,0.2307692307692307,3,0,3,0.0,0.0,llama3,medalign,nursing_note,PROMPT1_ICL_entailment
233,84,18,8,10,0.4444444444444444,2,0,2,0.0,0.0,llama3,medalign,nursing_note,PROMPT1_ICL_entailment
234,85,18,10,8,0.5555555555555556,8,6,2,0.75,0.6382978723404256,llama3,medalign,nursing_note,PROMPT1_ICL_entailment
235,86,12,4,8,0.3333333333333333,3,2,1,0.6666666666666666,0.4444444444444444,llama3,medalign,nursing_note,PROMPT1_ICL_entailment
236,87,12,4,8,0.3333333333333333,2,2,0,1.0,0.5,llama3,medalign,nursing_note,PROMPT1_ICL_entailment
237,88,17,9,8,0.5294117647058824,7,6,1,0.8571428571428571,0.6545454545454545,llama3,medalign,nursing_note,PROMPT1_ICL_entailment
238,89,15,7,8,0.4666666666666667,6,5,1,0.8333333333333334,0.5982905982905983,llama3,medalign,nursing_note,PROMPT1_ICL_entailment
239,9,11,3,8,0.2727272727272727,2,2,0,1.0,0.4285714285714285,llama3,medalign,nursing_note,PROMPT1_ICL_entailment
240,90,13,4,9,0.3076923076923077,1,0,1,0.0,0.0,llama3,medalign,nursing_note,PROMPT1_ICL_entailment
241,91,11,2,9,0.1818181818181818,1,1,0,1.0,0.3076923076923077,llama3,medalign,nursing_note,PROMPT1_ICL_entailment
242,92,14,3,11,0.2142857142857142,4,1,3,0.25,0.2307692307692307,llama3,medalign,nursing_note,PROMPT1_ICL_entailment
243,93,12,5,7,0.4166666666666667,1,1,0,1.0,0.5882352941176471,llama3,medalign,nursing_note,PROMPT1_ICL_entailment
244,94,12,4,8,0.3333333333333333,2,2,0,1.0,0.5,llama3,medalign,nursing_note,PROMPT1_ICL_entailment
245,95,10,1,9,0.1,1,1,0,1.0,0.1818181818181818,llama3,medalign,nursing_note,PROMPT1_ICL_entailment
246,96,10,1,9,0.1,1,0,1,0.0,0.0,llama3,medalign,nursing_note,PROMPT1_ICL_entailment
247,97,14,6,8,0.4285714285714285,2,2,0,1.0,0.6,llama3,medalign,nursing_note,PROMPT1_ICL_entailment
248,98,20,11,9,0.55,5,4,1,0.8,0.6518518518518519,llama3,medalign,nursing_note,PROMPT1_ICL_entailment
249,99,22,13,9,0.5909090909090909,7,5,2,0.7142857142857143,0.6467661691542289,llama3,medalign,nursing_note,PROMPT1_ICL_entailment
0,0,12,12,0,1.0,6,5,1,0.8333333333333334,0.9090909090909092,llama3,medalign,nursing_note,PROMPT2_ICL_entailment
1,1,13,11,2,0.8461538461538461,1,1,0,1.0,0.9166666666666666,llama3,medalign,nursing_note,PROMPT2_ICL_entailment
2,10,9,8,1,0.8888888888888888,5,3,2,0.6,0.7164179104477612,llama3,medalign,nursing_note,PROMPT2_ICL_entailment
3,100,11,11,0,1.0,10,8,2,0.8,0.888888888888889,llama3,medalign,nursing_note,PROMPT2_ICL_entailment
4,101,7,6,1,0.8571428571428571,1,1,0,1.0,0.923076923076923,llama3,medalign,nursing_note,PROMPT2_ICL_entailment
5,102,9,7,2,0.7777777777777778,4,3,1,0.75,0.7636363636363638,llama3,medalign,nursing_note,PROMPT2_ICL_entailment
6,103,4,4,0,1.0,2,2,0,1.0,1.0,llama3,medalign,nursing_note,PROMPT2_ICL_entailment
7,104,17,14,3,0.8235294117647058,15,9,6,0.6,0.6942148760330579,llama3,medalign,nursing_note,PROMPT2_ICL_entailment
8,105,4,3,1,0.75,1,1,0,1.0,0.8571428571428571,llama3,medalign,nursing_note,PROMPT2_ICL_entailment
9,106,6,5,1,0.8333333333333334,1,1,0,1.0,0.9090909090909092,llama3,medalign,nursing_note,PROMPT2_ICL_entailment
10,107,8,8,0,1.0,4,4,0,1.0,1.0,llama3,medalign,nursing_note,PROMPT2_ICL_entailment
11,108,3,2,1,0.6666666666666666,2,2,0,1.0,0.8,llama3,medalign,nursing_note,PROMPT2_ICL_entailment
12,109,11,11,0,1.0,5,5,0,1.0,1.0,llama3,medalign,nursing_note,PROMPT2_ICL_entailment
13,11,21,1,20,0.0476190476190476,1,1,0,1.0,0.0909090909090909,llama3,medalign,nursing_note,PROMPT2_ICL_entailment
14,110,18,18,0,1.0,6,4,2,0.6666666666666666,0.8,llama3,medalign,nursing_note,PROMPT2_ICL_entailment
15,111,3,2,1,0.6666666666666666,1,1,0,1.0,0.8,llama3,medalign,nursing_note,PROMPT2_ICL_entailment
16,112,7,6,1,0.8571428571428571,2,2,0,1.0,0.923076923076923,llama3,medalign,nursing_note,PROMPT2_ICL_entailment
17,113,3,2,1,0.6666666666666666,1,1,0,1.0,0.8,llama3,medalign,nursing_note,PROMPT2_ICL_entailment
18,114,1,0,1,0.0,1,1,0,1.0,0.0,llama3,medalign,nursing_note,PROMPT2_ICL_entailment
19,115,12,12,0,1.0,7,4,3,0.5714285714285714,0.7272727272727273,llama3,medalign,nursing_note,PROMPT2_ICL_entailment
20,116,12,11,1,0.9166666666666666,5,4,1,0.8,0.854368932038835,llama3,medalign,nursing_note,PROMPT2_ICL_entailment
21,117,12,10,2,0.8333333333333334,13,6,7,0.4615384615384615,0.594059405940594,llama3,medalign,nursing_note,PROMPT2_ICL_entailment
22,118,1,0,1,0.0,2,1,1,0.5,0.0,llama3,medalign,nursing_note,PROMPT2_ICL_entailment
23,119,5,5,0,1.0,2,2,0,1.0,1.0,llama3,medalign,nursing_note,PROMPT2_ICL_entailment
24,12,3,3,0,1.0,1,1,0,1.0,1.0,llama3,medalign,nursing_note,PROMPT2_ICL_entailment
25,120,13,12,1,0.9230769230769232,7,6,1,0.8571428571428571,0.888888888888889,llama3,medalign,nursing_note,PROMPT2_ICL_entailment
26,121,5,5,0,1.0,1,1,0,1.0,1.0,llama3,medalign,nursing_note,PROMPT2_ICL_entailment
27,122,4,4,0,1.0,1,1,0,1.0,1.0,llama3,medalign,nursing_note,PROMPT2_ICL_entailment
28,123,3,2,1,0.6666666666666666,4,4,0,1.0,0.8,llama3,medalign,nursing_note,PROMPT2_ICL_entailment
29,124,22,18,4,0.8181818181818182,14,11,3,0.7857142857142857,0.8016194331983806,llama3,medalign,nursing_note,PROMPT2_ICL_entailment
30,125,16,15,1,0.9375,9,8,1,0.8888888888888888,0.9125475285171102,llama3,medalign,nursing_note,PROMPT2_ICL_entailment
31,126,1,0,1,0.0,2,0,2,0.0,,llama3,medalign,nursing_note,PROMPT2_ICL_entailment
32,127,2,1,1,0.5,1,1,0,1.0,0.6666666666666666,llama3,medalign,nursing_note,PROMPT2_ICL_entailment
33,128,5,4,1,0.8,2,2,0,1.0,0.888888888888889,llama3,medalign,nursing_note,PROMPT2_ICL_entailment
34,129,28,28,0,1.0,20,19,1,0.95,0.9743589743589745,llama3,medalign,nursing_note,PROMPT2_ICL_entailment
35,13,6,6,0,1.0,5,2,3,0.4,0.5714285714285715,llama3,medalign,nursing_note,PROMPT2_ICL_entailment
36,130,7,7,0,1.0,2,2,0,1.0,1.0,llama3,medalign,nursing_note,PROMPT2_ICL_entailment
37,131,4,3,1,0.75,1,1,0,1.0,0.8571428571428571,llama3,medalign,nursing_note,PROMPT2_ICL_entailment
38,132,7,6,1,0.8571428571428571,2,2,0,1.0,0.923076923076923,llama3,medalign,nursing_note,PROMPT2_ICL_entailment
39,133,14,10,4,0.7142857142857143,14,5,9,0.3571428571428571,0.4761904761904762,llama3,medalign,nursing_note,PROMPT2_ICL_entailment
40,134,6,6,0,1.0,3,3,0,1.0,1.0,llama3,medalign,nursing_note,PROMPT2_ICL_entailment
41,135,8,8,0,1.0,2,2,0,1.0,1.0,llama3,medalign,nursing_note,PROMPT2_ICL_entailment
42,136,33,23,10,0.696969696969697,51,21,30,0.4117647058823529,0.517684887459807,llama3,medalign,nursing_note,PROMPT2_ICL_entailment
43,137,14,13,1,0.9285714285714286,6,6,0,1.0,0.962962962962963,llama3,medalign,nursing_note,PROMPT2_ICL_entailment
44,138,21,1,20,0.0476190476190476,1,1,0,1.0,0.0909090909090909,llama3,medalign,nursing_note,PROMPT2_ICL_entailment
45,139,4,3,1,0.75,1,0,1,0.0,0.0,llama3,medalign,nursing_note,PROMPT2_ICL_entailment
46,14,4,3,1,0.75,1,1,0,1.0,0.8571428571428571,llama3,medalign,nursing_note,PROMPT2_ICL_entailment
47,140,6,5,1,0.8333333333333334,3,3,0,1.0,0.9090909090909092,llama3,medalign,nursing_note,PROMPT2_ICL_entailment
48,141,4,3,1,0.75,1,1,0,1.0,0.8571428571428571,llama3,medalign,nursing_note,PROMPT2_ICL_entailment
49,142,8,2,6,0.25,1,1,0,1.0,0.4,llama3,medalign,nursing_note,PROMPT2_ICL_entailment
50,143,3,2,1,0.6666666666666666,1,1,0,1.0,0.8,llama3,medalign,nursing_note,PROMPT2_ICL_entailment
51,144,1,0,1,0.0,1,1,0,1.0,0.0,llama3,medalign,nursing_note,PROMPT2_ICL_entailment
52,145,7,7,0,1.0,4,3,1,0.75,0.8571428571428571,llama3,medalign,nursing_note,PROMPT2_ICL_entailment
53,146,17,17,0,1.0,3,3,0,1.0,1.0,llama3,medalign,nursing_note,PROMPT2_ICL_entailment
54,147,12,11,1,0.9166666666666666,6,5,1,0.8333333333333334,0.8730158730158729,llama3,medalign,nursing_note,PROMPT2_ICL_entailment
55,148,14,14,0,1.0,7,7,0,1.0,1.0,llama3,medalign,nursing_note,PROMPT2_ICL_entailment
56,149,11,9,2,0.8181818181818182,1,1,0,1.0,0.9,llama3,medalign,nursing_note,PROMPT2_ICL_entailment
57,15,6,6,0,1.0,1,1,0,1.0,1.0,llama3,medalign,nursing_note,PROMPT2_ICL_entailment
58,150,5,4,1,0.8,1,1,0,1.0,0.888888888888889,llama3,medalign,nursing_note,PROMPT2_ICL_entailment
59,151,12,12,0,1.0,8,7,1,0.875,0.9333333333333332,llama3,medalign,nursing_note,PROMPT2_ICL_entailment
60,152,9,9,0,1.0,4,4,0,1.0,1.0,llama3,medalign,nursing_note,PROMPT2_ICL_entailment
61,153,12,10,2,0.8333333333333334,14,9,5,0.6428571428571429,0.7258064516129034,llama3,medalign,nursing_note,PROMPT2_ICL_entailment
62,154,8,2,6,0.25,1,1,0,1.0,0.4,llama3,medalign,nursing_note,PROMPT2_ICL_entailment
63,155,13,10,3,0.7692307692307693,14,8,6,0.5714285714285714,0.6557377049180327,llama3,medalign,nursing_note,PROMPT2_ICL_entailment
64,156,11,10,1,0.9090909090909092,1,1,0,1.0,0.9523809523809524,llama3,medalign,nursing_note,PROMPT2_ICL_entailment
65,157,8,8,0,1.0,3,1,2,0.3333333333333333,0.5,llama3,medalign,nursing_note,PROMPT2_ICL_entailment
66,158,9,9,0,1.0,1,1,0,1.0,1.0,llama3,medalign,nursing_note,PROMPT2_ICL_entailment
67,159,7,7,0,1.0,3,3,0,1.0,1.0,llama3,medalign,nursing_note,PROMPT2_ICL_entailment
68,16,12,11,1,0.9166666666666666,3,1,2,0.3333333333333333,0.4888888888888888,llama3,medalign,nursing_note,PROMPT2_ICL_entailment
69,160,5,5,0,1.0,1,1,0,1.0,1.0,llama3,medalign,nursing_note,PROMPT2_ICL_entailment
70,161,4,4,0,1.0,1,1,0,1.0,1.0,llama3,medalign,nursing_note,PROMPT2_ICL_entailment
71,162,10,10,0,1.0,8,6,2,0.75,0.8571428571428571,llama3,medalign,nursing_note,PROMPT2_ICL_entailment
72,163,9,8,1,0.8888888888888888,3,2,1,0.6666666666666666,0.761904761904762,llama3,medalign,nursing_note,PROMPT2_ICL_entailment
73,164,8,8,0,1.0,2,2,0,1.0,1.0,llama3,medalign,nursing_note,PROMPT2_ICL_entailment
74,165,8,8,0,1.0,4,4,0,1.0,1.0,llama3,medalign,nursing_note,PROMPT2_ICL_entailment
75,166,13,12,1,0.9230769230769232,5,4,1,0.8,0.8571428571428571,llama3,medalign,nursing_note,PROMPT2_ICL_entailment
76,167,13,12,1,0.9230769230769232,2,2,0,1.0,0.96,llama3,medalign,nursing_note,PROMPT2_ICL_entailment
77,168,7,7,0,1.0,3,2,1,0.6666666666666666,0.8,llama3,medalign,nursing_note,PROMPT2_ICL_entailment
78,169,11,11,0,1.0,9,7,2,0.7777777777777778,0.8750000000000001,llama3,medalign,nursing_note,PROMPT2_ICL_entailment
79,17,4,3,1,0.75,1,0,1,0.0,0.0,llama3,medalign,nursing_note,PROMPT2_ICL_entailment
80,170,5,4,1,0.8,1,1,0,1.0,0.888888888888889,llama3,medalign,nursing_note,PROMPT2_ICL_entailment
81,171,18,13,5,0.7222222222222222,7,6,1,0.8571428571428571,0.7839195979899497,llama3,medalign,nursing_note,PROMPT2_ICL_entailment
82,172,12,8,4,0.6666666666666666,12,4,8,0.3333333333333333,0.4444444444444444,llama3,medalign,nursing_note,PROMPT2_ICL_entailment
83,173,10,10,0,1.0,1,1,0,1.0,1.0,llama3,medalign,nursing_note,PROMPT2_ICL_entailment
84,174,4,3,1,0.75,1,1,0,1.0,0.8571428571428571,llama3,medalign,nursing_note,PROMPT2_ICL_entailment
85,175,3,2,1,0.6666666666666666,2,2,0,1.0,0.8,llama3,medalign,nursing_note,PROMPT2_ICL_entailment
86,176,12,8,4,0.6666666666666666,3,3,0,1.0,0.8,llama3,medalign,nursing_note,PROMPT2_ICL_entailment
87,177,9,8,1,0.8888888888888888,8,4,4,0.5,0.64,llama3,medalign,nursing_note,PROMPT2_ICL_entailment
88,178,11,10,1,0.9090909090909092,10,7,3,0.7,0.7909604519774012,llama3,medalign,nursing_note,PROMPT2_ICL_entailment
89,179,9,9,0,1.0,2,1,1,0.5,0.6666666666666666,llama3,medalign,nursing_note,PROMPT2_ICL_entailment
90,18,16,15,1,0.9375,3,3,0,1.0,0.967741935483871,llama3,medalign,nursing_note,PROMPT2_ICL_entailment
91,180,11,10,1,0.9090909090909092,4,3,1,0.75,0.821917808219178,llama3,medalign,nursing_note,PROMPT2_ICL_entailment
92,181,11,11,0,1.0,7,7,0,1.0,1.0,llama3,medalign,nursing_note,PROMPT2_ICL_entailment
93,182,1,0,1,0.0,2,0,2,0.0,,llama3,medalign,nursing_note,PROMPT2_ICL_entailment
94,183,9,9,0,1.0,6,6,0,1.0,1.0,llama3,medalign,nursing_note,PROMPT2_ICL_entailment
95,184,10,10,0,1.0,11,8,3,0.7272727272727273,0.8421052631578948,llama3,medalign,nursing_note,PROMPT2_ICL_entailment
96,185,5,5,0,1.0,3,3,0,1.0,1.0,llama3,medalign,nursing_note,PROMPT2_ICL_entailment
97,186,5,5,0,1.0,3,3,0,1.0,1.0,llama3,medalign,nursing_note,PROMPT2_ICL_entailment
98,187,1,1,0,1.0,1,0,1,0.0,0.0,llama3,medalign,nursing_note,PROMPT2_ICL_entailment
99,188,3,3,0,1.0,3,3,0,1.0,1.0,llama3,medalign,nursing_note,PROMPT2_ICL_entailment
100,189,14,13,1,0.9285714285714286,10,7,3,0.7,0.7982456140350878,llama3,medalign,nursing_note,PROMPT2_ICL_entailment
101,19,16,15,1,0.9375,7,7,0,1.0,0.967741935483871,llama3,medalign,nursing_note,PROMPT2_ICL_entailment
102,190,5,5,0,1.0,2,2,0,1.0,1.0,llama3,medalign,nursing_note,PROMPT2_ICL_entailment
103,191,17,17,0,1.0,5,3,2,0.6,0.7499999999999999,llama3,medalign,nursing_note,PROMPT2_ICL_entailment
104,192,4,4,0,1.0,1,1,0,1.0,1.0,llama3,medalign,nursing_note,PROMPT2_ICL_entailment
105,193,7,7,0,1.0,3,3,0,1.0,1.0,llama3,medalign,nursing_note,PROMPT2_ICL_entailment
106,194,5,4,1,0.8,2,2,0,1.0,0.888888888888889,llama3,medalign,nursing_note,PROMPT2_ICL_entailment
107,195,14,13,1,0.9285714285714286,10,6,4,0.6,0.7289719626168225,llama3,medalign,nursing_note,PROMPT2_ICL_entailment
108,196,5,5,0,1.0,1,1,0,1.0,1.0,llama3,medalign,nursing_note,PROMPT2_ICL_entailment
109,197,5,4,1,0.8,1,1,0,1.0,0.888888888888889,llama3,medalign,nursing_note,PROMPT2_ICL_entailment
110,198,16,14,2,0.875,8,6,2,0.75,0.8076923076923077,llama3,medalign,nursing_note,PROMPT2_ICL_entailment
111,199,16,12,4,0.75,7,7,0,1.0,0.8571428571428571,llama3,medalign,nursing_note,PROMPT2_ICL_entailment
112,2,15,10,5,0.6666666666666666,5,5,0,1.0,0.8,llama3,medalign,nursing_note,PROMPT2_ICL_entailment
113,20,9,9,0,1.0,2,1,1,0.5,0.6666666666666666,llama3,medalign,nursing_note,PROMPT2_ICL_entailment
114,200,4,4,0,1.0,3,3,0,1.0,1.0,llama3,medalign,nursing_note,PROMPT2_ICL_entailment
115,201,5,4,1,0.8,1,0,1,0.0,0.0,llama3,medalign,nursing_note,PROMPT2_ICL_entailment
116,202,8,7,1,0.875,1,1,0,1.0,0.9333333333333332,llama3,medalign,nursing_note,PROMPT2_ICL_entailment
117,203,5,5,0,1.0,1,1,0,1.0,1.0,llama3,medalign,nursing_note,PROMPT2_ICL_entailment
118,204,16,15,1,0.9375,9,5,4,0.5555555555555556,0.6976744186046512,llama3,medalign,nursing_note,PROMPT2_ICL_entailment
119,205,23,14,9,0.6086956521739131,8,5,3,0.625,0.6167400881057269,llama3,medalign,nursing_note,PROMPT2_ICL_entailment
120,206,7,5,2,0.7142857142857143,4,4,0,1.0,0.8333333333333333,llama3,medalign,nursing_note,PROMPT2_ICL_entailment
121,207,13,12,1,0.9230769230769232,6,6,0,1.0,0.96,llama3,medalign,nursing_note,PROMPT2_ICL_entailment
122,208,12,12,0,1.0,10,8,2,0.8,0.888888888888889,llama3,medalign,nursing_note,PROMPT2_ICL_entailment
123,209,5,5,0,1.0,1,1,0,1.0,1.0,llama3,medalign,nursing_note,PROMPT2_ICL_entailment
124,21,6,6,0,1.0,1,1,0,1.0,1.0,llama3,medalign,nursing_note,PROMPT2_ICL_entailment
125,210,7,5,2,0.7142857142857143,2,1,1,0.5,0.588235294117647,llama3,medalign,nursing_note,PROMPT2_ICL_entailment
126,211,5,5,0,1.0,2,2,0,1.0,1.0,llama3,medalign,nursing_note,PROMPT2_ICL_entailment
127,212,7,7,0,1.0,3,3,0,1.0,1.0,llama3,medalign,nursing_note,PROMPT2_ICL_entailment
128,213,13,13,0,1.0,8,8,0,1.0,1.0,llama3,medalign,nursing_note,PROMPT2_ICL_entailment
129,214,4,4,0,1.0,2,2,0,1.0,1.0,llama3,medalign,nursing_note,PROMPT2_ICL_entailment
130,215,3,2,1,0.6666666666666666,1,1,0,1.0,0.8,llama3,medalign,nursing_note,PROMPT2_ICL_entailment
131,216,7,6,1,0.8571428571428571,3,3,0,1.0,0.923076923076923,llama3,medalign,nursing_note,PROMPT2_ICL_entailment
132,217,15,12,3,0.8,11,6,5,0.5454545454545454,0.6486486486486486,llama3,medalign,nursing_note,PROMPT2_ICL_entailment
133,218,12,12,0,1.0,3,2,1,0.6666666666666666,0.8,llama3,medalign,nursing_note,PROMPT2_ICL_entailment
134,219,9,9,0,1.0,2,2,0,1.0,1.0,llama3,medalign,nursing_note,PROMPT2_ICL_entailment
135,22,1,0,1,0.0,1,1,0,1.0,0.0,llama3,medalign,nursing_note,PROMPT2_ICL_entailment
136,220,10,9,1,0.9,7,5,2,0.7142857142857143,0.7964601769911505,llama3,medalign,nursing_note,PROMPT2_ICL_entailment
137,221,15,15,0,1.0,23,11,12,0.4782608695652174,0.6470588235294118,llama3,medalign,nursing_note,PROMPT2_ICL_entailment
138,222,9,9,0,1.0,4,4,0,1.0,1.0,llama3,medalign,nursing_note,PROMPT2_ICL_entailment
139,223,6,6,0,1.0,2,1,1,0.5,0.6666666666666666,llama3,medalign,nursing_note,PROMPT2_ICL_entailment
140,228,26,24,2,0.9230769230769232,14,11,3,0.7857142857142857,0.8488745980707394,llama3,medalign,nursing_note,PROMPT2_ICL_entailment
141,229,14,13,1,0.9285714285714286,7,6,1,0.8571428571428571,0.8914285714285715,llama3,medalign,nursing_note,PROMPT2_ICL_entailment
142,23,22,16,6,0.7272727272727273,21,7,14,0.3333333333333333,0.4571428571428572,llama3,medalign,nursing_note,PROMPT2_ICL_entailment
143,230,3,2,1,0.6666666666666666,1,1,0,1.0,0.8,llama3,medalign,nursing_note,PROMPT2_ICL_entailment
144,231,13,11,2,0.8461538461538461,13,7,6,0.5384615384615384,0.6581196581196581,llama3,medalign,nursing_note,PROMPT2_ICL_entailment
145,232,12,11,1,0.9166666666666666,6,5,1,0.8333333333333334,0.8730158730158729,llama3,medalign,nursing_note,PROMPT2_ICL_entailment
146,233,5,3,2,0.6,4,1,3,0.25,0.3529411764705882,llama3,medalign,nursing_note,PROMPT2_ICL_entailment
147,234,11,11,0,1.0,2,2,0,1.0,1.0,llama3,medalign,nursing_note,PROMPT2_ICL_entailment
148,235,1,0,1,0.0,1,0,1,0.0,,llama3,medalign,nursing_note,PROMPT2_ICL_entailment
149,236,15,12,3,0.8,14,9,5,0.6428571428571429,0.7128712871287128,llama3,medalign,nursing_note,PROMPT2_ICL_entailment
150,237,12,10,2,0.8333333333333334,5,4,1,0.8,0.816326530612245,llama3,medalign,nursing_note,PROMPT2_ICL_entailment
151,238,10,10,0,1.0,4,4,0,1.0,1.0,llama3,medalign,nursing_note,PROMPT2_ICL_entailment
152,239,12,11,1,0.9166666666666666,4,4,0,1.0,0.9565217391304348,llama3,medalign,nursing_note,PROMPT2_ICL_entailment
153,24,1,0,1,0.0,1,0,1,0.0,,llama3,medalign,nursing_note,PROMPT2_ICL_entailment
154,240,1,0,1,0.0,2,0,2,0.0,,llama3,medalign,nursing_note,PROMPT2_ICL_entailment
155,241,6,6,0,1.0,2,2,0,1.0,1.0,llama3,medalign,nursing_note,PROMPT2_ICL_entailment
156,242,14,13,1,0.9285714285714286,2,1,1,0.5,0.65,llama3,medalign,nursing_note,PROMPT2_ICL_entailment
157,243,24,24,0,1.0,10,10,0,1.0,1.0,llama3,medalign,nursing_note,PROMPT2_ICL_entailment
158,244,4,4,0,1.0,1,1,0,1.0,1.0,llama3,medalign,nursing_note,PROMPT2_ICL_entailment
159,245,5,4,1,0.8,1,1,0,1.0,0.888888888888889,llama3,medalign,nursing_note,PROMPT2_ICL_entailment
160,246,3,3,0,1.0,1,1,0,1.0,1.0,llama3,medalign,nursing_note,PROMPT2_ICL_entailment
161,247,9,9,0,1.0,5,5,0,1.0,1.0,llama3,medalign,nursing_note,PROMPT2_ICL_entailment
162,248,4,4,0,1.0,1,1,0,1.0,1.0,llama3,medalign,nursing_note,PROMPT2_ICL_entailment
163,249,12,12,0,1.0,2,1,1,0.5,0.6666666666666666,llama3,medalign,nursing_note,PROMPT2_ICL_entailment
164,25,39,34,5,0.8717948717948718,33,19,14,0.5757575757575758,0.6935050993022008,llama3,medalign,nursing_note,PROMPT2_ICL_entailment
165,26,7,7,0,1.0,1,1,0,1.0,1.0,llama3,medalign,nursing_note,PROMPT2_ICL_entailment
166,27,16,16,0,1.0,2,1,1,0.5,0.6666666666666666,llama3,medalign,nursing_note,PROMPT2_ICL_entailment
167,28,10,8,2,0.8,4,3,1,0.75,0.7741935483870969,llama3,medalign,nursing_note,PROMPT2_ICL_entailment
168,29,7,7,0,1.0,3,3,0,1.0,1.0,llama3,medalign,nursing_note,PROMPT2_ICL_entailment
169,3,4,4,0,1.0,2,2,0,1.0,1.0,llama3,medalign,nursing_note,PROMPT2_ICL_entailment
170,30,6,6,0,1.0,1,1,0,1.0,1.0,llama3,medalign,nursing_note,PROMPT2_ICL_entailment
171,31,1,0,1,0.0,1,0,1,0.0,,llama3,medalign,nursing_note,PROMPT2_ICL_entailment
172,32,5,4,1,0.8,2,2,0,1.0,0.888888888888889,llama3,medalign,nursing_note,PROMPT2_ICL_entailment
173,33,11,10,1,0.9090909090909092,5,4,1,0.8,0.8510638297872342,llama3,medalign,nursing_note,PROMPT2_ICL_entailment
174,34,10,9,1,0.9,4,0,4,0.0,0.0,llama3,medalign,nursing_note,PROMPT2_ICL_entailment
175,35,9,8,1,0.8888888888888888,4,2,2,0.5,0.64,llama3,medalign,nursing_note,PROMPT2_ICL_entailment
176,36,20,14,6,0.7,5,2,3,0.4,0.509090909090909,llama3,medalign,nursing_note,PROMPT2_ICL_entailment
177,37,9,9,0,1.0,3,2,1,0.6666666666666666,0.8,llama3,medalign,nursing_note,PROMPT2_ICL_entailment
178,38,16,11,5,0.6875,5,2,3,0.4,0.5057471264367817,llama3,medalign,nursing_note,PROMPT2_ICL_entailment
179,39,4,4,0,1.0,1,1,0,1.0,1.0,llama3,medalign,nursing_note,PROMPT2_ICL_entailment
180,4,5,4,1,0.8,3,1,2,0.3333333333333333,0.4705882352941176,llama3,medalign,nursing_note,PROMPT2_ICL_entailment
181,40,11,10,1,0.9090909090909092,8,6,2,0.75,0.821917808219178,llama3,medalign,nursing_note,PROMPT2_ICL_entailment
182,41,3,2,1,0.6666666666666666,1,1,0,1.0,0.8,llama3,medalign,nursing_note,PROMPT2_ICL_entailment
183,42,10,10,0,1.0,8,4,4,0.5,0.6666666666666666,llama3,medalign,nursing_note,PROMPT2_ICL_entailment
184,43,6,6,0,1.0,2,2,0,1.0,1.0,llama3,medalign,nursing_note,PROMPT2_ICL_entailment
185,44,6,6,0,1.0,1,1,0,1.0,1.0,llama3,medalign,nursing_note,PROMPT2_ICL_entailment
186,45,1,0,1,0.0,1,0,1,0.0,,llama3,medalign,nursing_note,PROMPT2_ICL_entailment
187,46,11,11,0,1.0,5,5,0,1.0,1.0,llama3,medalign,nursing_note,PROMPT2_ICL_entailment
188,47,23,22,1,0.9565217391304348,18,16,2,0.8888888888888888,0.9214659685863874,llama3,medalign,nursing_note,PROMPT2_ICL_entailment
189,5,14,13,1,0.9285714285714286,5,4,1,0.8,0.859504132231405,llama3,medalign,nursing_note,PROMPT2_ICL_entailment
190,54,10,8,2,0.8,5,4,1,0.8,0.8000000000000002,llama3,medalign,nursing_note,PROMPT2_ICL_entailment
191,55,9,8,1,0.8888888888888888,2,2,0,1.0,0.9411764705882352,llama3,medalign,nursing_note,PROMPT2_ICL_entailment
192,56,9,9,0,1.0,3,3,0,1.0,1.0,llama3,medalign,nursing_note,PROMPT2_ICL_entailment
193,57,11,7,4,0.6363636363636364,4,4,0,1.0,0.7777777777777778,llama3,medalign,nursing_note,PROMPT2_ICL_entailment
194,58,5,5,0,1.0,1,1,0,1.0,1.0,llama3,medalign,nursing_note,PROMPT2_ICL_entailment
195,59,4,4,0,1.0,1,1,0,1.0,1.0,llama3,medalign,nursing_note,PROMPT2_ICL_entailment
196,6,4,4,0,1.0,3,3,0,1.0,1.0,llama3,medalign,nursing_note,PROMPT2_ICL_entailment
197,60,14,13,1,0.9285714285714286,9,4,5,0.4444444444444444,0.6011560693641618,llama3,medalign,nursing_note,PROMPT2_ICL_entailment
198,61,3,2,1,0.6666666666666666,1,1,0,1.0,0.8,llama3,medalign,nursing_note,PROMPT2_ICL_entailment
199,62,16,16,0,1.0,5,4,1,0.8,0.888888888888889,llama3,medalign,nursing_note,PROMPT2_ICL_entailment
200,63,12,9,3,0.75,7,2,5,0.2857142857142857,0.4137931034482759,llama3,medalign,nursing_note,PROMPT2_ICL_entailment
201,64,1,0,1,0.0,1,0,1,0.0,,llama3,medalign,nursing_note,PROMPT2_ICL_entailment
202,65,4,4,0,1.0,2,2,0,1.0,1.0,llama3,medalign,nursing_note,PROMPT2_ICL_entailment
203,66,7,7,0,1.0,4,4,0,1.0,1.0,llama3,medalign,nursing_note,PROMPT2_ICL_entailment
204,67,7,7,0,1.0,4,3,1,0.75,0.8571428571428571,llama3,medalign,nursing_note,PROMPT2_ICL_entailment
205,68,7,7,0,1.0,1,1,0,1.0,1.0,llama3,medalign,nursing_note,PROMPT2_ICL_entailment
206,69,13,13,0,1.0,2,2,0,1.0,1.0,llama3,medalign,nursing_note,PROMPT2_ICL_entailment
207,7,7,7,0,1.0,1,1,0,1.0,1.0,llama3,medalign,nursing_note,PROMPT2_ICL_entailment
208,70,11,11,0,1.0,1,1,0,1.0,1.0,llama3,medalign,nursing_note,PROMPT2_ICL_entailment
209,71,15,15,0,1.0,1,1,0,1.0,1.0,llama3,medalign,nursing_note,PROMPT2_ICL_entailment
210,72,4,3,1,0.75,1,1,0,1.0,0.8571428571428571,llama3,medalign,nursing_note,PROMPT2_ICL_entailment
211,73,4,4,0,1.0,2,1,1,0.5,0.6666666666666666,llama3,medalign,nursing_note,PROMPT2_ICL_entailment
212,74,11,9,2,0.8181818181818182,5,3,2,0.6,0.6923076923076923,llama3,medalign,nursing_note,PROMPT2_ICL_entailment
213,75,1,0,1,0.0,1,0,1,0.0,,llama3,medalign,nursing_note,PROMPT2_ICL_entailment
214,76,14,13,1,0.9285714285714286,5,3,2,0.6,0.7289719626168225,llama3,medalign,nursing_note,PROMPT2_ICL_entailment
215,77,7,5,2,0.7142857142857143,3,3,0,1.0,0.8333333333333333,llama3,medalign,nursing_note,PROMPT2_ICL_entailment
216,78,8,7,1,0.875,3,3,0,1.0,0.9333333333333332,llama3,medalign,nursing_note,PROMPT2_ICL_entailment
217,79,9,9,0,1.0,8,3,5,0.375,0.5454545454545454,llama3,medalign,nursing_note,PROMPT2_ICL_entailment
218,8,13,10,3,0.7692307692307693,8,7,1,0.875,0.8187134502923977,llama3,medalign,nursing_note,PROMPT2_ICL_entailment
219,80,12,11,1,0.9166666666666666,10,7,3,0.7,0.7938144329896907,llama3,medalign,nursing_note,PROMPT2_ICL_entailment
220,81,3,2,1,0.6666666666666666,1,1,0,1.0,0.8,llama3,medalign,nursing_note,PROMPT2_ICL_entailment
221,82,4,3,1,0.75,3,3,0,1.0,0.8571428571428571,llama3,medalign,nursing_note,PROMPT2_ICL_entailment
222,83,8,7,1,0.875,3,1,2,0.3333333333333333,0.4827586206896551,llama3,medalign,nursing_note,PROMPT2_ICL_entailment
223,84,13,12,1,0.9230769230769232,2,2,0,1.0,0.96,llama3,medalign,nursing_note,PROMPT2_ICL_entailment
224,85,12,11,1,0.9166666666666666,8,6,2,0.75,0.8250000000000001,llama3,medalign,nursing_note,PROMPT2_ICL_entailment
225,86,4,4,0,1.0,3,3,0,1.0,1.0,llama3,medalign,nursing_note,PROMPT2_ICL_entailment
226,87,4,3,1,0.75,2,2,0,1.0,0.8571428571428571,llama3,medalign,nursing_note,PROMPT2_ICL_entailment
227,88,14,14,0,1.0,7,6,1,0.8571428571428571,0.923076923076923,llama3,medalign,nursing_note,PROMPT2_ICL_entailment
228,89,9,9,0,1.0,6,6,0,1.0,1.0,llama3,medalign,nursing_note,PROMPT2_ICL_entailment
229,9,5,5,0,1.0,2,2,0,1.0,1.0,llama3,medalign,nursing_note,PROMPT2_ICL_entailment
230,90,6,6,0,1.0,1,1,0,1.0,1.0,llama3,medalign,nursing_note,PROMPT2_ICL_entailment
231,91,4,4,0,1.0,1,0,1,0.0,0.0,llama3,medalign,nursing_note,PROMPT2_ICL_entailment
232,92,6,6,0,1.0,4,2,2,0.5,0.6666666666666666,llama3,medalign,nursing_note,PROMPT2_ICL_entailment
233,93,4,4,0,1.0,1,1,0,1.0,1.0,llama3,medalign,nursing_note,PROMPT2_ICL_entailment
234,94,6,6,0,1.0,2,1,1,0.5,0.6666666666666666,llama3,medalign,nursing_note,PROMPT2_ICL_entailment
235,95,1,0,1,0.0,1,1,0,1.0,0.0,llama3,medalign,nursing_note,PROMPT2_ICL_entailment
236,96,3,1,2,0.3333333333333333,1,1,0,1.0,0.5,llama3,medalign,nursing_note,PROMPT2_ICL_entailment
237,97,7,7,0,1.0,2,2,0,1.0,1.0,llama3,medalign,nursing_note,PROMPT2_ICL_entailment
238,98,16,16,0,1.0,5,5,0,1.0,1.0,llama3,medalign,nursing_note,PROMPT2_ICL_entailment
239,99,13,13,0,1.0,7,4,3,0.5714285714285714,0.7272727272727273,llama3,medalign,nursing_note,PROMPT2_ICL_entailment
0,0,11,11,0,1.0,6,6,0,1.0,1.0,llama3,medalign,nursing_note,PROMPT2_entailment
1,1,10,10,0,1.0,1,1,0,1.0,1.0,llama3,medalign,nursing_note,PROMPT2_entailment
2,10,8,8,0,1.0,5,4,1,0.8,0.888888888888889,llama3,medalign,nursing_note,PROMPT2_entailment
3,100,11,10,1,0.9090909090909092,10,5,5,0.5,0.6451612903225806,llama3,medalign,nursing_note,PROMPT2_entailment
4,101,7,7,0,1.0,1,1,0,1.0,1.0,llama3,medalign,nursing_note,PROMPT2_entailment
5,102,9,8,1,0.8888888888888888,4,3,1,0.75,0.8135593220338982,llama3,medalign,nursing_note,PROMPT2_entailment
6,103,4,4,0,1.0,2,2,0,1.0,1.0,llama3,medalign,nursing_note,PROMPT2_entailment
7,104,13,11,2,0.8461538461538461,15,10,5,0.6666666666666666,0.7457627118644068,llama3,medalign,nursing_note,PROMPT2_entailment
8,105,4,3,1,0.75,1,1,0,1.0,0.8571428571428571,llama3,medalign,nursing_note,PROMPT2_entailment
9,106,4,3,1,0.75,1,1,0,1.0,0.8571428571428571,llama3,medalign,nursing_note,PROMPT2_entailment
10,107,8,8,0,1.0,4,4,0,1.0,1.0,llama3,medalign,nursing_note,PROMPT2_entailment
11,108,3,2,1,0.6666666666666666,2,2,0,1.0,0.8,llama3,medalign,nursing_note,PROMPT2_entailment
12,109,10,10,0,1.0,5,4,1,0.8,0.888888888888889,llama3,medalign,nursing_note,PROMPT2_entailment
13,11,1,0,1,0.0,1,1,0,1.0,0.0,llama3,medalign,nursing_note,PROMPT2_entailment
14,110,12,10,2,0.8333333333333334,6,4,2,0.6666666666666666,0.7407407407407408,llama3,medalign,nursing_note,PROMPT2_entailment
15,111,1,0,1,0.0,1,1,0,1.0,0.0,llama3,medalign,nursing_note,PROMPT2_entailment
16,112,7,6,1,0.8571428571428571,2,2,0,1.0,0.923076923076923,llama3,medalign,nursing_note,PROMPT2_entailment
17,113,1,0,1,0.0,1,1,0,1.0,0.0,llama3,medalign,nursing_note,PROMPT2_entailment
18,117,12,10,2,0.8333333333333334,10,6,4,0.6,0.6976744186046512,llama3,medalign,nursing_note,PROMPT2_entailment
19,118,5,4,1,0.8,2,2,0,1.0,0.888888888888889,llama3,medalign,nursing_note,PROMPT2_entailment
20,119,5,5,0,1.0,2,2,0,1.0,1.0,llama3,medalign,nursing_note,PROMPT2_entailment
21,12,4,4,0,1.0,1,1,0,1.0,1.0,llama3,medalign,nursing_note,PROMPT2_entailment
22,120,12,12,0,1.0,7,6,1,0.8571428571428571,0.923076923076923,llama3,medalign,nursing_note,PROMPT2_entailment
23,121,3,3,0,1.0,1,1,0,1.0,1.0,llama3,medalign,nursing_note,PROMPT2_entailment
24,122,4,3,1,0.75,1,1,0,1.0,0.8571428571428571,llama3,medalign,nursing_note,PROMPT2_entailment
25,123,5,4,1,0.8,4,3,1,0.75,0.7741935483870969,llama3,medalign,nursing_note,PROMPT2_entailment
26,124,13,12,1,0.9230769230769232,14,10,4,0.7142857142857143,0.8053691275167787,llama3,medalign,nursing_note,PROMPT2_entailment
27,125,10,10,0,1.0,9,8,1,0.8888888888888888,0.9411764705882352,llama3,medalign,nursing_note,PROMPT2_entailment
28,126,3,2,1,0.6666666666666666,2,1,1,0.5,0.5714285714285715,llama3,medalign,nursing_note,PROMPT2_entailment
29,127,4,3,1,0.75,1,1,0,1.0,0.8571428571428571,llama3,medalign,nursing_note,PROMPT2_entailment
30,128,5,4,1,0.8,2,2,0,1.0,0.888888888888889,llama3,medalign,nursing_note,PROMPT2_entailment
31,129,20,19,1,0.95,20,17,3,0.85,0.8972222222222223,llama3,medalign,nursing_note,PROMPT2_entailment
32,13,7,7,0,1.0,5,5,0,1.0,1.0,llama3,medalign,nursing_note,PROMPT2_entailment
33,130,7,7,0,1.0,2,2,0,1.0,1.0,llama3,medalign,nursing_note,PROMPT2_entailment
34,131,4,3,1,0.75,1,1,0,1.0,0.8571428571428571,llama3,medalign,nursing_note,PROMPT2_entailment
35,132,5,4,1,0.8,2,2,0,1.0,0.888888888888889,llama3,medalign,nursing_note,PROMPT2_entailment
36,133,11,8,3,0.7272727272727273,14,7,7,0.5,0.5925925925925926,llama3,medalign,nursing_note,PROMPT2_entailment
37,134,6,6,0,1.0,3,3,0,1.0,1.0,llama3,medalign,nursing_note,PROMPT2_entailment
38,135,9,9,0,1.0,2,2,0,1.0,1.0,llama3,medalign,nursing_note,PROMPT2_entailment
39,136,36,22,14,0.6111111111111112,51,23,28,0.4509803921568627,0.5189743589743591,llama3,medalign,nursing_note,PROMPT2_entailment
40,137,15,15,0,1.0,6,6,0,1.0,1.0,llama3,medalign,nursing_note,PROMPT2_entailment
41,138,1,0,1,0.0,1,1,0,1.0,0.0,llama3,medalign,nursing_note,PROMPT2_entailment
42,139,5,4,1,0.8,1,1,0,1.0,0.888888888888889,llama3,medalign,nursing_note,PROMPT2_entailment
43,14,1,0,1,0.0,1,1,0,1.0,0.0,llama3,medalign,nursing_note,PROMPT2_entailment
44,140,6,5,1,0.8333333333333334,3,3,0,1.0,0.9090909090909092,llama3,medalign,nursing_note,PROMPT2_entailment
45,141,4,3,1,0.75,1,1,0,1.0,0.8571428571428571,llama3,medalign,nursing_note,PROMPT2_entailment
46,142,4,3,1,0.75,1,1,0,1.0,0.8571428571428571,llama3,medalign,nursing_note,PROMPT2_entailment
47,143,1,0,1,0.0,1,1,0,1.0,0.0,llama3,medalign,nursing_note,PROMPT2_entailment
48,144,1,0,1,0.0,1,1,0,1.0,0.0,llama3,medalign,nursing_note,PROMPT2_entailment
49,145,5,5,0,1.0,4,4,0,1.0,1.0,llama3,medalign,nursing_note,PROMPT2_entailment
50,146,10,10,0,1.0,3,2,1,0.6666666666666666,0.8,llama3,medalign,nursing_note,PROMPT2_entailment
51,147,12,12,0,1.0,6,4,2,0.6666666666666666,0.8,llama3,medalign,nursing_note,PROMPT2_entailment
52,148,21,21,0,1.0,7,7,0,1.0,1.0,llama3,medalign,nursing_note,PROMPT2_entailment
53,149,10,10,0,1.0,1,0,1,0.0,0.0,llama3,medalign,nursing_note,PROMPT2_entailment
54,15,7,5,2,0.7142857142857143,1,1,0,1.0,0.8333333333333333,llama3,medalign,nursing_note,PROMPT2_entailment
55,150,6,5,1,0.8333333333333334,1,1,0,1.0,0.9090909090909092,llama3,medalign,nursing_note,PROMPT2_entailment
56,151,10,10,0,1.0,8,7,1,0.875,0.9333333333333332,llama3,medalign,nursing_note,PROMPT2_entailment
57,152,6,6,0,1.0,4,4,0,1.0,1.0,llama3,medalign,nursing_note,PROMPT2_entailment
58,153,13,11,2,0.8461538461538461,14,11,3,0.7857142857142857,0.8148148148148148,llama3,medalign,nursing_note,PROMPT2_entailment
59,154,4,2,2,0.5,1,1,0,1.0,0.6666666666666666,llama3,medalign,nursing_note,PROMPT2_entailment
60,155,14,11,3,0.7857142857142857,14,7,7,0.5,0.6111111111111112,llama3,medalign,nursing_note,PROMPT2_entailment
61,156,7,6,1,0.8571428571428571,1,1,0,1.0,0.923076923076923,llama3,medalign,nursing_note,PROMPT2_entailment
62,157,8,7,1,0.875,3,1,2,0.3333333333333333,0.4827586206896551,llama3,medalign,nursing_note,PROMPT2_entailment
63,158,7,7,0,1.0,1,1,0,1.0,1.0,llama3,medalign,nursing_note,PROMPT2_entailment
64,159,7,7,0,1.0,3,2,1,0.6666666666666666,0.8,llama3,medalign,nursing_note,PROMPT2_entailment
65,16,11,11,0,1.0,3,2,1,0.6666666666666666,0.8,llama3,medalign,nursing_note,PROMPT2_entailment
66,160,6,6,0,1.0,1,1,0,1.0,1.0,llama3,medalign,nursing_note,PROMPT2_entailment
67,161,6,5,1,0.8333333333333334,1,1,0,1.0,0.9090909090909092,llama3,medalign,nursing_note,PROMPT2_entailment
68,162,11,11,0,1.0,8,7,1,0.875,0.9333333333333332,llama3,medalign,nursing_note,PROMPT2_entailment
69,163,7,6,1,0.8571428571428571,3,3,0,1.0,0.923076923076923,llama3,medalign,nursing_note,PROMPT2_entailment
70,164,8,8,0,1.0,2,2,0,1.0,1.0,llama3,medalign,nursing_note,PROMPT2_entailment
71,165,7,6,1,0.8571428571428571,4,3,1,0.75,0.7999999999999999,llama3,medalign,nursing_note,PROMPT2_entailment
72,166,11,10,1,0.9090909090909092,5,5,0,1.0,0.9523809523809524,llama3,medalign,nursing_note,PROMPT2_entailment
73,167,12,11,1,0.9166666666666666,2,2,0,1.0,0.9565217391304348,llama3,medalign,nursing_note,PROMPT2_entailment
74,168,7,6,1,0.8571428571428571,3,3,0,1.0,0.923076923076923,llama3,medalign,nursing_note,PROMPT2_entailment
75,169,11,10,1,0.9090909090909092,9,7,2,0.7777777777777778,0.8383233532934132,llama3,medalign,nursing_note,PROMPT2_entailment
76,17,5,4,1,0.8,1,0,1,0.0,0.0,llama3,medalign,nursing_note,PROMPT2_entailment
77,170,6,6,0,1.0,1,0,1,0.0,0.0,llama3,medalign,nursing_note,PROMPT2_entailment
78,171,14,11,3,0.7857142857142857,7,5,2,0.7142857142857143,0.7482993197278911,llama3,medalign,nursing_note,PROMPT2_entailment
79,172,13,9,4,0.6923076923076923,12,6,6,0.5,0.5806451612903226,llama3,medalign,nursing_note,PROMPT2_entailment
80,173,10,10,0,1.0,1,1,0,1.0,1.0,llama3,medalign,nursing_note,PROMPT2_entailment
81,174,6,5,1,0.8333333333333334,1,1,0,1.0,0.9090909090909092,llama3,medalign,nursing_note,PROMPT2_entailment
82,175,3,2,1,0.6666666666666666,2,2,0,1.0,0.8,llama3,medalign,nursing_note,PROMPT2_entailment
83,176,11,8,3,0.7272727272727273,3,0,3,0.0,0.0,llama3,medalign,nursing_note,PROMPT2_entailment
84,177,8,7,1,0.875,8,5,3,0.625,0.7291666666666666,llama3,medalign,nursing_note,PROMPT2_entailment
85,178,8,7,1,0.875,10,6,4,0.6,0.711864406779661,llama3,medalign,nursing_note,PROMPT2_entailment
86,179,7,7,0,1.0,2,0,2,0.0,0.0,llama3,medalign,nursing_note,PROMPT2_entailment
87,18,11,11,0,1.0,3,3,0,1.0,1.0,llama3,medalign,nursing_note,PROMPT2_entailment
88,180,10,10,0,1.0,4,2,2,0.5,0.6666666666666666,llama3,medalign,nursing_note,PROMPT2_entailment
89,181,9,9,0,1.0,7,7,0,1.0,1.0,llama3,medalign,nursing_note,PROMPT2_entailment
90,182,5,5,0,1.0,2,1,1,0.5,0.6666666666666666,llama3,medalign,nursing_note,PROMPT2_entailment
91,183,8,8,0,1.0,6,6,0,1.0,1.0,llama3,medalign,nursing_note,PROMPT2_entailment
92,184,11,11,0,1.0,11,9,2,0.8181818181818182,0.9,llama3,medalign,nursing_note,PROMPT2_entailment
93,185,5,4,1,0.8,3,3,0,1.0,0.888888888888889,llama3,medalign,nursing_note,PROMPT2_entailment
94,186,6,6,0,1.0,3,3,0,1.0,1.0,llama3,medalign,nursing_note,PROMPT2_entailment
95,187,3,1,2,0.3333333333333333,1,1,0,1.0,0.5,llama3,medalign,nursing_note,PROMPT2_entailment
96,188,4,3,1,0.75,3,3,0,1.0,0.8571428571428571,llama3,medalign,nursing_note,PROMPT2_entailment
97,189,12,11,1,0.9166666666666666,10,7,3,0.7,0.7938144329896907,llama3,medalign,nursing_note,PROMPT2_entailment
98,19,16,16,0,1.0,7,7,0,1.0,1.0,llama3,medalign,nursing_note,PROMPT2_entailment
99,190,5,5,0,1.0,2,2,0,1.0,1.0,llama3,medalign,nursing_note,PROMPT2_entailment
100,191,15,15,0,1.0,5,4,1,0.8,0.888888888888889,llama3,medalign,nursing_note,PROMPT2_entailment
101,192,4,4,0,1.0,1,1,0,1.0,1.0,llama3,medalign,nursing_note,PROMPT2_entailment
102,193,7,6,1,0.8571428571428571,3,3,0,1.0,0.923076923076923,llama3,medalign,nursing_note,PROMPT2_entailment
103,194,5,4,1,0.8,2,2,0,1.0,0.888888888888889,llama3,medalign,nursing_note,PROMPT2_entailment
104,195,14,13,1,0.9285714285714286,10,7,3,0.7,0.7982456140350878,llama3,medalign,nursing_note,PROMPT2_entailment
105,196,6,6,0,1.0,1,1,0,1.0,1.0,llama3,medalign,nursing_note,PROMPT2_entailment
106,197,5,4,1,0.8,1,1,0,1.0,0.888888888888889,llama3,medalign,nursing_note,PROMPT2_entailment
107,198,20,18,2,0.9,8,7,1,0.875,0.8873239436619719,llama3,medalign,nursing_note,PROMPT2_entailment
108,199,12,11,1,0.9166666666666666,7,7,0,1.0,0.9565217391304348,llama3,medalign,nursing_note,PROMPT2_entailment
109,2,13,9,4,0.6923076923076923,5,3,2,0.6,0.6428571428571429,llama3,medalign,nursing_note,PROMPT2_entailment
110,20,8,8,0,1.0,2,1,1,0.5,0.6666666666666666,llama3,medalign,nursing_note,PROMPT2_entailment
111,200,6,6,0,1.0,3,3,0,1.0,1.0,llama3,medalign,nursing_note,PROMPT2_entailment
112,201,5,4,1,0.8,1,0,1,0.0,0.0,llama3,medalign,nursing_note,PROMPT2_entailment
113,202,6,5,1,0.8333333333333334,1,1,0,1.0,0.9090909090909092,llama3,medalign,nursing_note,PROMPT2_entailment
114,203,5,5,0,1.0,1,1,0,1.0,1.0,llama3,medalign,nursing_note,PROMPT2_entailment
115,204,13,13,0,1.0,9,4,5,0.4444444444444444,0.6153846153846153,llama3,medalign,nursing_note,PROMPT2_entailment
116,205,22,11,11,0.5,8,3,5,0.375,0.4285714285714285,llama3,medalign,nursing_note,PROMPT2_entailment
117,206,6,5,1,0.8333333333333334,4,4,0,1.0,0.9090909090909092,llama3,medalign,nursing_note,PROMPT2_entailment
118,207,11,11,0,1.0,6,6,0,1.0,1.0,llama3,medalign,nursing_note,PROMPT2_entailment
119,208,12,12,0,1.0,10,8,2,0.8,0.888888888888889,llama3,medalign,nursing_note,PROMPT2_entailment
120,209,5,5,0,1.0,1,1,0,1.0,1.0,llama3,medalign,nursing_note,PROMPT2_entailment
121,21,5,5,0,1.0,1,1,0,1.0,1.0,llama3,medalign,nursing_note,PROMPT2_entailment
122,210,6,4,2,0.6666666666666666,2,1,1,0.5,0.5714285714285715,llama3,medalign,nursing_note,PROMPT2_entailment
123,211,5,5,0,1.0,2,2,0,1.0,1.0,llama3,medalign,nursing_note,PROMPT2_entailment
124,212,7,7,0,1.0,3,3,0,1.0,1.0,llama3,medalign,nursing_note,PROMPT2_entailment
125,213,12,12,0,1.0,8,8,0,1.0,1.0,llama3,medalign,nursing_note,PROMPT2_entailment
126,214,5,5,0,1.0,2,2,0,1.0,1.0,llama3,medalign,nursing_note,PROMPT2_entailment
127,215,9,7,2,0.7777777777777778,1,1,0,1.0,0.8750000000000001,llama3,medalign,nursing_note,PROMPT2_entailment
128,216,6,6,0,1.0,3,3,0,1.0,1.0,llama3,medalign,nursing_note,PROMPT2_entailment
129,217,15,12,3,0.8,11,5,6,0.4545454545454545,0.5797101449275363,llama3,medalign,nursing_note,PROMPT2_entailment
130,218,12,12,0,1.0,3,3,0,1.0,1.0,llama3,medalign,nursing_note,PROMPT2_entailment
131,219,8,6,2,0.75,2,2,0,1.0,0.8571428571428571,llama3,medalign,nursing_note,PROMPT2_entailment
132,22,1,0,1,0.0,1,0,1,0.0,,llama3,medalign,nursing_note,PROMPT2_entailment
133,220,11,11,0,1.0,7,4,3,0.5714285714285714,0.7272727272727273,llama3,medalign,nursing_note,PROMPT2_entailment
134,221,10,10,0,1.0,23,16,7,0.6956521739130435,0.8205128205128205,llama3,medalign,nursing_note,PROMPT2_entailment
135,222,7,7,0,1.0,4,4,0,1.0,1.0,llama3,medalign,nursing_note,PROMPT2_entailment
136,223,6,6,0,1.0,2,2,0,1.0,1.0,llama3,medalign,nursing_note,PROMPT2_entailment
137,224,12,10,2,0.8333333333333334,4,2,2,0.5,0.625,llama3,medalign,nursing_note,PROMPT2_entailment
138,225,7,7,0,1.0,2,2,0,1.0,1.0,llama3,medalign,nursing_note,PROMPT2_entailment
139,226,11,11,0,1.0,5,3,2,0.6,0.7499999999999999,llama3,medalign,nursing_note,PROMPT2_entailment
140,227,1,0,1,0.0,1,1,0,1.0,0.0,llama3,medalign,nursing_note,PROMPT2_entailment
141,228,18,17,1,0.9444444444444444,18,12,6,0.6666666666666666,0.7816091954022987,llama3,medalign,nursing_note,PROMPT2_entailment
142,229,7,2,5,0.2857142857142857,7,2,5,0.2857142857142857,0.2857142857142857,llama3,medalign,nursing_note,PROMPT2_entailment
143,23,19,14,5,0.7368421052631579,21,8,13,0.3809523809523809,0.5022421524663676,llama3,medalign,nursing_note,PROMPT2_entailment
144,230,4,3,1,0.75,1,1,0,1.0,0.8571428571428571,llama3,medalign,nursing_note,PROMPT2_entailment
145,231,13,11,2,0.8461538461538461,13,7,6,0.5384615384615384,0.6581196581196581,llama3,medalign,nursing_note,PROMPT2_entailment
146,232,11,11,0,1.0,6,5,1,0.8333333333333334,0.9090909090909092,llama3,medalign,nursing_note,PROMPT2_entailment
147,233,5,3,2,0.6,4,3,1,0.75,0.6666666666666665,llama3,medalign,nursing_note,PROMPT2_entailment
148,234,8,8,0,1.0,2,2,0,1.0,1.0,llama3,medalign,nursing_note,PROMPT2_entailment
149,235,13,7,6,0.5384615384615384,1,1,0,1.0,0.7000000000000001,llama3,medalign,nursing_note,PROMPT2_entailment
150,236,13,12,1,0.9230769230769232,14,9,5,0.6428571428571429,0.7578947368421053,llama3,medalign,nursing_note,PROMPT2_entailment
151,237,12,11,1,0.9166666666666666,5,5,0,1.0,0.9565217391304348,llama3,medalign,nursing_note,PROMPT2_entailment
152,238,10,10,0,1.0,4,4,0,1.0,1.0,llama3,medalign,nursing_note,PROMPT2_entailment
153,239,10,9,1,0.9,4,3,1,0.75,0.8181818181818182,llama3,medalign,nursing_note,PROMPT2_entailment
154,24,1,1,0,1.0,1,0,1,0.0,0.0,llama3,medalign,nursing_note,PROMPT2_entailment
155,240,3,2,1,0.6666666666666666,2,1,1,0.5,0.5714285714285715,llama3,medalign,nursing_note,PROMPT2_entailment
156,241,5,4,1,0.8,2,2,0,1.0,0.888888888888889,llama3,medalign,nursing_note,PROMPT2_entailment
157,242,14,13,1,0.9285714285714286,2,1,1,0.5,0.65,llama3,medalign,nursing_note,PROMPT2_entailment
158,243,22,22,0,1.0,10,9,1,0.9,0.9473684210526316,llama3,medalign,nursing_note,PROMPT2_entailment
159,244,5,5,0,1.0,1,1,0,1.0,1.0,llama3,medalign,nursing_note,PROMPT2_entailment
160,245,9,8,1,0.8888888888888888,1,1,0,1.0,0.9411764705882352,llama3,medalign,nursing_note,PROMPT2_entailment
161,246,4,4,0,1.0,1,1,0,1.0,1.0,llama3,medalign,nursing_note,PROMPT2_entailment
162,247,8,8,0,1.0,5,5,0,1.0,1.0,llama3,medalign,nursing_note,PROMPT2_entailment
163,248,5,5,0,1.0,1,1,0,1.0,1.0,llama3,medalign,nursing_note,PROMPT2_entailment
164,249,8,8,0,1.0,2,1,1,0.5,0.6666666666666666,llama3,medalign,nursing_note,PROMPT2_entailment
165,25,39,29,10,0.7435897435897436,33,22,11,0.6666666666666666,0.7030303030303031,llama3,medalign,nursing_note,PROMPT2_entailment
166,26,5,5,0,1.0,1,1,0,1.0,1.0,llama3,medalign,nursing_note,PROMPT2_entailment
167,27,13,13,0,1.0,2,2,0,1.0,1.0,llama3,medalign,nursing_note,PROMPT2_entailment
168,28,10,9,1,0.9,4,3,1,0.75,0.8181818181818182,llama3,medalign,nursing_note,PROMPT2_entailment
169,29,7,7,0,1.0,3,3,0,1.0,1.0,llama3,medalign,nursing_note,PROMPT2_entailment
170,3,7,7,0,1.0,2,2,0,1.0,1.0,llama3,medalign,nursing_note,PROMPT2_entailment
171,30,4,4,0,1.0,1,1,0,1.0,1.0,llama3,medalign,nursing_note,PROMPT2_entailment
172,31,2,1,1,0.5,1,1,0,1.0,0.6666666666666666,llama3,medalign,nursing_note,PROMPT2_entailment
173,32,5,5,0,1.0,2,2,0,1.0,1.0,llama3,medalign,nursing_note,PROMPT2_entailment
174,33,12,12,0,1.0,5,5,0,1.0,1.0,llama3,medalign,nursing_note,PROMPT2_entailment
175,34,11,9,2,0.8181818181818182,4,2,2,0.5,0.6206896551724137,llama3,medalign,nursing_note,PROMPT2_entailment
176,35,8,8,0,1.0,4,3,1,0.75,0.8571428571428571,llama3,medalign,nursing_note,PROMPT2_entailment
177,36,16,11,5,0.6875,5,3,2,0.6,0.6407766990291262,llama3,medalign,nursing_note,PROMPT2_entailment
178,37,12,12,0,1.0,3,2,1,0.6666666666666666,0.8,llama3,medalign,nursing_note,PROMPT2_entailment
179,38,14,12,2,0.8571428571428571,5,3,2,0.6,0.7058823529411764,llama3,medalign,nursing_note,PROMPT2_entailment
180,39,4,4,0,1.0,1,1,0,1.0,1.0,llama3,medalign,nursing_note,PROMPT2_entailment
181,4,5,3,2,0.6,3,3,0,1.0,0.7499999999999999,llama3,medalign,nursing_note,PROMPT2_entailment
182,40,11,11,0,1.0,8,3,5,0.375,0.5454545454545454,llama3,medalign,nursing_note,PROMPT2_entailment
183,41,4,3,1,0.75,1,1,0,1.0,0.8571428571428571,llama3,medalign,nursing_note,PROMPT2_entailment
184,42,10,10,0,1.0,8,3,5,0.375,0.5454545454545454,llama3,medalign,nursing_note,PROMPT2_entailment
185,43,7,7,0,1.0,2,2,0,1.0,1.0,llama3,medalign,nursing_note,PROMPT2_entailment
186,44,6,6,0,1.0,1,1,0,1.0,1.0,llama3,medalign,nursing_note,PROMPT2_entailment
187,45,1,0,1,0.0,1,0,1,0.0,,llama3,medalign,nursing_note,PROMPT2_entailment
188,46,9,9,0,1.0,5,5,0,1.0,1.0,llama3,medalign,nursing_note,PROMPT2_entailment
189,47,20,20,0,1.0,20,19,1,0.95,0.9743589743589745,llama3,medalign,nursing_note,PROMPT2_entailment
190,48,6,6,0,1.0,2,2,0,1.0,1.0,llama3,medalign,nursing_note,PROMPT2_entailment
191,49,6,3,3,0.5,2,1,1,0.5,0.5,llama3,medalign,nursing_note,PROMPT2_entailment
192,5,15,15,0,1.0,5,4,1,0.8,0.888888888888889,llama3,medalign,nursing_note,PROMPT2_entailment
193,50,4,3,1,0.75,1,0,1,0.0,0.0,llama3,medalign,nursing_note,PROMPT2_entailment
194,51,4,4,0,1.0,2,2,0,1.0,1.0,llama3,medalign,nursing_note,PROMPT2_entailment
195,52,7,7,0,1.0,4,3,1,0.75,0.8571428571428571,llama3,medalign,nursing_note,PROMPT2_entailment
196,53,4,3,1,0.75,1,1,0,1.0,0.8571428571428571,llama3,medalign,nursing_note,PROMPT2_entailment
197,54,10,10,0,1.0,7,6,1,0.8571428571428571,0.923076923076923,llama3,medalign,nursing_note,PROMPT2_entailment
198,55,7,6,1,0.8571428571428571,2,2,0,1.0,0.923076923076923,llama3,medalign,nursing_note,PROMPT2_entailment
199,56,9,8,1,0.8888888888888888,3,3,0,1.0,0.9411764705882352,llama3,medalign,nursing_note,PROMPT2_entailment
200,57,9,5,4,0.5555555555555556,4,2,2,0.5,0.5263157894736842,llama3,medalign,nursing_note,PROMPT2_entailment
201,58,6,6,0,1.0,1,1,0,1.0,1.0,llama3,medalign,nursing_note,PROMPT2_entailment
202,59,4,4,0,1.0,1,1,0,1.0,1.0,llama3,medalign,nursing_note,PROMPT2_entailment
203,6,4,4,0,1.0,3,3,0,1.0,1.0,llama3,medalign,nursing_note,PROMPT2_entailment
204,60,10,9,1,0.9,9,7,2,0.7777777777777778,0.8344370860927153,llama3,medalign,nursing_note,PROMPT2_entailment
205,61,4,3,1,0.75,1,1,0,1.0,0.8571428571428571,llama3,medalign,nursing_note,PROMPT2_entailment
206,62,15,14,1,0.9333333333333332,5,3,2,0.6,0.7304347826086957,llama3,medalign,nursing_note,PROMPT2_entailment
207,63,10,9,1,0.9,7,3,4,0.4285714285714285,0.5806451612903225,llama3,medalign,nursing_note,PROMPT2_entailment
208,64,4,2,2,0.5,1,0,1,0.0,0.0,llama3,medalign,nursing_note,PROMPT2_entailment
209,65,5,5,0,1.0,2,2,0,1.0,1.0,llama3,medalign,nursing_note,PROMPT2_entailment
210,66,7,7,0,1.0,4,4,0,1.0,1.0,llama3,medalign,nursing_note,PROMPT2_entailment
211,67,6,6,0,1.0,4,3,1,0.75,0.8571428571428571,llama3,medalign,nursing_note,PROMPT2_entailment
212,68,6,6,0,1.0,1,1,0,1.0,1.0,llama3,medalign,nursing_note,PROMPT2_entailment
213,69,10,10,0,1.0,2,2,0,1.0,1.0,llama3,medalign,nursing_note,PROMPT2_entailment
214,7,7,7,0,1.0,1,1,0,1.0,1.0,llama3,medalign,nursing_note,PROMPT2_entailment
215,70,11,11,0,1.0,1,1,0,1.0,1.0,llama3,medalign,nursing_note,PROMPT2_entailment
216,71,13,13,0,1.0,1,1,0,1.0,1.0,llama3,medalign,nursing_note,PROMPT2_entailment
217,72,1,0,1,0.0,1,1,0,1.0,0.0,llama3,medalign,nursing_note,PROMPT2_entailment
218,73,5,5,0,1.0,2,2,0,1.0,1.0,llama3,medalign,nursing_note,PROMPT2_entailment
219,74,12,6,6,0.5,5,3,2,0.6,0.5454545454545454,llama3,medalign,nursing_note,PROMPT2_entailment
220,75,3,2,1,0.6666666666666666,1,1,0,1.0,0.8,llama3,medalign,nursing_note,PROMPT2_entailment
221,76,14,13,1,0.9285714285714286,5,4,1,0.8,0.859504132231405,llama3,medalign,nursing_note,PROMPT2_entailment
222,77,6,6,0,1.0,3,3,0,1.0,1.0,llama3,medalign,nursing_note,PROMPT2_entailment
223,78,7,6,1,0.8571428571428571,3,3,0,1.0,0.923076923076923,llama3,medalign,nursing_note,PROMPT2_entailment
224,79,8,8,0,1.0,8,4,4,0.5,0.6666666666666666,llama3,medalign,nursing_note,PROMPT2_entailment
225,8,10,9,1,0.9,8,7,1,0.875,0.8873239436619719,llama3,medalign,nursing_note,PROMPT2_entailment
226,80,11,11,0,1.0,10,8,2,0.8,0.888888888888889,llama3,medalign,nursing_note,PROMPT2_entailment
227,81,1,0,1,0.0,1,1,0,1.0,0.0,llama3,medalign,nursing_note,PROMPT2_entailment
228,82,4,3,1,0.75,3,3,0,1.0,0.8571428571428571,llama3,medalign,nursing_note,PROMPT2_entailment
229,83,5,4,1,0.8,3,1,2,0.3333333333333333,0.4705882352941176,llama3,medalign,nursing_note,PROMPT2_entailment
230,84,10,9,1,0.9,2,1,1,0.5,0.6428571428571429,llama3,medalign,nursing_note,PROMPT2_entailment
231,85,12,12,0,1.0,8,6,2,0.75,0.8571428571428571,llama3,medalign,nursing_note,PROMPT2_entailment
232,86,4,4,0,1.0,3,3,0,1.0,1.0,llama3,medalign,nursing_note,PROMPT2_entailment
233,87,4,3,1,0.75,2,2,0,1.0,0.8571428571428571,llama3,medalign,nursing_note,PROMPT2_entailment
234,88,12,12,0,1.0,7,6,1,0.8571428571428571,0.923076923076923,llama3,medalign,nursing_note,PROMPT2_entailment
235,89,9,9,0,1.0,6,6,0,1.0,1.0,llama3,medalign,nursing_note,PROMPT2_entailment
236,9,6,5,1,0.8333333333333334,2,2,0,1.0,0.9090909090909092,llama3,medalign,nursing_note,PROMPT2_entailment
237,98,15,15,0,1.0,2,2,0,1.0,1.0,llama3,medalign,nursing_note,PROMPT2_entailment
238,99,13,13,0,1.0,7,5,2,0.7142857142857143,0.8333333333333333,llama3,medalign,nursing_note,PROMPT2_entailment
0,0,34,29,5,0.8529411764705882,71,37,34,0.5211267605633803,0.6469701537533916,llama3,medalign,progress_note,PROMPT1_entailment
1,1,33,33,0,1.0,47,35,12,0.7446808510638298,0.8536585365853657,llama3,medalign,progress_note,PROMPT1_entailment
2,10,28,25,3,0.8928571428571429,48,37,11,0.7708333333333334,0.8273703041144902,llama3,medalign,progress_note,PROMPT1_entailment
3,100,37,37,0,1.0,43,31,12,0.7209302325581395,0.8378378378378378,llama3,medalign,progress_note,PROMPT1_entailment
4,101,37,35,2,0.945945945945946,73,50,23,0.684931506849315,0.7945516458569807,llama3,medalign,progress_note,PROMPT1_entailment
5,102,16,16,0,1.0,13,11,2,0.8461538461538461,0.9166666666666666,llama3,medalign,progress_note,PROMPT1_entailment
6,11,23,22,1,0.9565217391304348,38,29,9,0.7631578947368421,0.8489687292082502,llama3,medalign,progress_note,PROMPT1_entailment
7,12,27,26,1,0.9629629629629628,46,27,19,0.5869565217391305,0.7293506493506494,llama3,medalign,progress_note,PROMPT1_entailment
8,13,41,40,1,0.975609756097561,68,42,26,0.6176470588235294,0.7564160288158487,llama3,medalign,progress_note,PROMPT1_entailment
9,14,14,13,1,0.9285714285714286,13,10,3,0.7692307692307693,0.8414239482200646,llama3,medalign,progress_note,PROMPT1_entailment
10,15,14,12,2,0.8571428571428571,19,11,8,0.5789473684210527,0.6910994764397905,llama3,medalign,progress_note,PROMPT1_entailment
11,16,38,33,5,0.868421052631579,78,46,32,0.5897435897435898,0.7024525682554373,llama3,medalign,progress_note,PROMPT1_entailment
12,17,28,27,1,0.9642857142857144,33,29,4,0.8787878787878788,0.919553728714034,llama3,medalign,progress_note,PROMPT1_entailment
13,18,40,40,0,1.0,59,33,26,0.559322033898305,0.717391304347826,llama3,medalign,progress_note,PROMPT1_entailment
14,19,37,35,2,0.945945945945946,57,37,20,0.6491228070175439,0.7699167657550536,llama3,medalign,progress_note,PROMPT1_entailment
15,2,25,21,4,0.84,54,36,18,0.6666666666666666,0.743362831858407,llama3,medalign,progress_note,PROMPT1_entailment
16,20,30,30,0,1.0,31,31,0,1.0,1.0,llama3,medalign,progress_note,PROMPT1_entailment
17,21,24,21,3,0.875,31,25,6,0.8064516129032258,0.8393285371702637,llama3,medalign,progress_note,PROMPT1_entailment
18,22,35,30,5,0.8571428571428571,63,40,23,0.6349206349206349,0.7294832826747719,llama3,medalign,progress_note,PROMPT1_entailment
19,23,44,39,5,0.8863636363636364,35,25,10,0.7142857142857143,0.7910750507099391,llama3,medalign,progress_note,PROMPT1_entailment
20,24,31,30,1,0.967741935483871,42,35,7,0.8333333333333334,0.8955223880597015,llama3,medalign,progress_note,PROMPT1_entailment
21,25,17,17,0,1.0,26,22,4,0.8461538461538461,0.9166666666666666,llama3,medalign,progress_note,PROMPT1_entailment
22,26,32,31,1,0.96875,24,21,3,0.875,0.9194915254237288,llama3,medalign,progress_note,PROMPT1_entailment
23,27,44,44,0,1.0,81,54,27,0.6666666666666666,0.8,llama3,medalign,progress_note,PROMPT1_entailment
24,28,36,36,0,1.0,38,29,9,0.7631578947368421,0.8656716417910448,llama3,medalign,progress_note,PROMPT1_entailment
25,29,46,46,0,1.0,99,59,40,0.5959595959595959,0.7468354430379746,llama3,medalign,progress_note,PROMPT1_entailment
26,3,31,31,0,1.0,56,40,16,0.7142857142857143,0.8333333333333333,llama3,medalign,progress_note,PROMPT1_entailment
27,30,26,26,0,1.0,54,28,26,0.5185185185185185,0.6829268292682926,llama3,medalign,progress_note,PROMPT1_entailment
28,31,32,32,0,1.0,38,31,7,0.8157894736842105,0.898550724637681,llama3,medalign,progress_note,PROMPT1_entailment
29,32,32,29,3,0.90625,45,35,10,0.7777777777777778,0.8371134020618558,llama3,medalign,progress_note,PROMPT1_entailment
30,33,26,26,0,1.0,33,26,7,0.7878787878787878,0.8813559322033898,llama3,medalign,progress_note,PROMPT1_entailment
31,34,28,28,0,1.0,30,23,7,0.7666666666666667,0.8679245283018869,llama3,medalign,progress_note,PROMPT1_entailment
32,35,40,40,0,1.0,57,32,25,0.5614035087719298,0.7191011235955056,llama3,medalign,progress_note,PROMPT1_entailment
33,36,41,39,2,0.951219512195122,29,17,12,0.5862068965517241,0.7253829321663018,llama3,medalign,progress_note,PROMPT1_entailment
34,37,25,18,7,0.72,19,7,12,0.3684210526315789,0.4874274661508703,llama3,medalign,progress_note,PROMPT1_entailment
35,38,36,35,1,0.9722222222222222,63,48,15,0.7619047619047619,0.8543096872616323,llama3,medalign,progress_note,PROMPT1_entailment
36,39,27,24,3,0.8888888888888888,43,36,7,0.8372093023255814,0.8622754491017963,llama3,medalign,progress_note,PROMPT1_entailment
37,4,20,18,2,0.9,65,37,28,0.5692307692307692,0.6973821989528796,llama3,medalign,progress_note,PROMPT1_entailment
38,40,23,23,0,1.0,31,21,10,0.6774193548387096,0.8076923076923077,llama3,medalign,progress_note,PROMPT1_entailment
39,41,39,39,0,1.0,69,56,13,0.8115942028985508,0.896,llama3,medalign,progress_note,PROMPT1_entailment
40,42,25,23,2,0.92,32,25,7,0.78125,0.8449669360764145,llama3,medalign,progress_note,PROMPT1_entailment
41,43,22,21,1,0.9545454545454546,23,21,2,0.9130434782608696,0.9333333333333332,llama3,medalign,progress_note,PROMPT1_entailment
42,44,26,25,1,0.9615384615384616,92,62,30,0.6739130434782609,0.792433537832311,llama3,medalign,progress_note,PROMPT1_entailment
43,45,16,14,2,0.875,15,12,3,0.8,0.8358208955223881,llama3,medalign,progress_note,PROMPT1_entailment
44,46,19,19,0,1.0,50,25,25,0.5,0.6666666666666666,llama3,medalign,progress_note,PROMPT1_entailment
45,47,34,28,6,0.8235294117647058,42,34,8,0.8095238095238095,0.8164665523156089,llama3,medalign,progress_note,PROMPT1_entailment
46,48,19,19,0,1.0,56,34,22,0.6071428571428571,0.7555555555555554,llama3,medalign,progress_note,PROMPT1_entailment
47,49,27,25,2,0.925925925925926,58,36,22,0.6206896551724138,0.7431874483897606,llama3,medalign,progress_note,PROMPT1_entailment
48,5,84,58,26,0.6904761904761905,69,57,12,0.8260869565217391,0.7522184300341297,llama3,medalign,progress_note,PROMPT1_entailment
49,50,35,33,2,0.9428571428571428,68,42,26,0.6176470588235294,0.7463651050080776,llama3,medalign,progress_note,PROMPT1_entailment
50,51,44,42,2,0.9545454545454546,47,25,22,0.5319148936170213,0.683148991541965,llama3,medalign,progress_note,PROMPT1_entailment
51,52,16,16,0,1.0,19,15,4,0.7894736842105263,0.8823529411764706,llama3,medalign,progress_note,PROMPT1_entailment
52,53,24,24,0,1.0,54,36,18,0.6666666666666666,0.8,llama3,medalign,progress_note,PROMPT1_entailment
53,54,23,20,3,0.8695652173913043,24,18,6,0.75,0.8053691275167786,llama3,medalign,progress_note,PROMPT1_entailment
54,55,21,21,0,1.0,23,19,4,0.8260869565217391,0.9047619047619048,llama3,medalign,progress_note,PROMPT1_entailment
55,56,29,29,0,1.0,25,17,8,0.68,0.8095238095238095,llama3,medalign,progress_note,PROMPT1_entailment
56,57,12,11,1,0.9166666666666666,4,3,1,0.75,0.8250000000000001,llama3,medalign,progress_note,PROMPT1_entailment
57,58,15,14,1,0.9333333333333332,13,9,4,0.6923076923076923,0.7949526813880127,llama3,medalign,progress_note,PROMPT1_entailment
58,59,55,53,2,0.9636363636363636,35,25,10,0.7142857142857143,0.8204334365325078,llama3,medalign,progress_note,PROMPT1_entailment
59,6,32,32,0,1.0,59,30,29,0.5084745762711864,0.6741573033707865,llama3,medalign,progress_note,PROMPT1_entailment
60,60,30,28,2,0.9333333333333332,56,30,26,0.5357142857142857,0.6807131280388978,llama3,medalign,progress_note,PROMPT1_entailment
61,61,19,17,2,0.8947368421052632,25,17,8,0.68,0.7727272727272727,llama3,medalign,progress_note,PROMPT1_entailment
62,62,25,25,0,1.0,32,25,7,0.78125,0.8771929824561403,llama3,medalign,progress_note,PROMPT1_entailment
63,63,16,16,0,1.0,10,9,1,0.9,0.9473684210526316,llama3,medalign,progress_note,PROMPT1_entailment
64,64,34,32,2,0.9411764705882352,69,37,32,0.5362318840579711,0.6832083092902481,llama3,medalign,progress_note,PROMPT1_entailment
65,65,39,27,12,0.6923076923076923,104,59,45,0.5673076923076923,0.6236054022313564,llama3,medalign,progress_note,PROMPT1_entailment
66,66,46,39,7,0.8478260869565217,87,68,19,0.7816091954022989,0.8133721821806471,llama3,medalign,progress_note,PROMPT1_entailment
67,67,22,21,1,0.9545454545454546,18,13,5,0.7222222222222222,0.822289156626506,llama3,medalign,progress_note,PROMPT1_entailment
68,68,12,12,0,1.0,11,10,1,0.9090909090909092,0.9523809523809524,llama3,medalign,progress_note,PROMPT1_entailment
69,69,36,36,0,1.0,68,45,23,0.6617647058823529,0.7964601769911505,llama3,medalign,progress_note,PROMPT1_entailment
70,7,27,21,6,0.7777777777777778,37,31,6,0.8378378378378378,0.8066914498141263,llama3,medalign,progress_note,PROMPT1_entailment
71,70,35,32,3,0.9142857142857144,69,39,30,0.5652173913043478,0.6985726280436608,llama3,medalign,progress_note,PROMPT1_entailment
72,71,41,37,4,0.902439024390244,48,37,11,0.7708333333333334,0.8314606741573034,llama3,medalign,progress_note,PROMPT1_entailment
73,72,35,34,1,0.9714285714285714,69,57,12,0.8260869565217391,0.8928818244644091,llama3,medalign,progress_note,PROMPT1_entailment
74,73,36,30,6,0.8333333333333334,90,55,35,0.6111111111111112,0.7051282051282051,llama3,medalign,progress_note,PROMPT1_entailment
75,74,20,19,1,0.95,22,20,2,0.9090909090909092,0.9290953545232272,llama3,medalign,progress_note,PROMPT1_entailment
76,75,34,33,1,0.9705882352941176,49,33,16,0.673469387755102,0.7951807228915663,llama3,medalign,progress_note,PROMPT1_entailment
77,76,39,38,1,0.9743589743589745,77,49,28,0.6363636363636364,0.7698986975397973,llama3,medalign,progress_note,PROMPT1_entailment
78,77,42,42,0,1.0,38,30,8,0.7894736842105263,0.8823529411764706,llama3,medalign,progress_note,PROMPT1_entailment
79,78,26,25,1,0.9615384615384616,54,36,18,0.6666666666666666,0.7874015748031495,llama3,medalign,progress_note,PROMPT1_entailment
80,79,41,24,17,0.5853658536585366,64,44,20,0.6875,0.6323353293413173,llama3,medalign,progress_note,PROMPT1_entailment
81,8,22,22,0,1.0,31,19,12,0.6129032258064516,0.76,llama3,medalign,progress_note,PROMPT1_entailment
82,80,38,37,1,0.9736842105263158,66,39,27,0.5909090909090909,0.735474006116208,llama3,medalign,progress_note,PROMPT1_entailment
83,81,13,12,1,0.9230769230769232,12,9,3,0.75,0.8275862068965517,llama3,medalign,progress_note,PROMPT1_entailment
84,82,16,16,0,1.0,13,9,4,0.6923076923076923,0.8181818181818181,llama3,medalign,progress_note,PROMPT1_entailment
85,83,12,12,0,1.0,8,7,1,0.875,0.9333333333333332,llama3,medalign,progress_note,PROMPT1_entailment
86,84,24,21,3,0.875,23,14,9,0.6086956521739131,0.717948717948718,llama3,medalign,progress_note,PROMPT1_entailment
87,85,26,24,2,0.9230769230769232,63,33,30,0.5238095238095238,0.6683544303797468,llama3,medalign,progress_note,PROMPT1_entailment
88,86,31,30,1,0.967741935483871,75,60,15,0.8,0.8759124087591241,llama3,medalign,progress_note,PROMPT1_entailment
89,87,36,33,3,0.9166666666666666,87,63,24,0.7241379310344828,0.8091068301225919,llama3,medalign,progress_note,PROMPT1_entailment
90,88,40,36,4,0.9,84,55,29,0.6547619047619048,0.7580398162327718,llama3,medalign,progress_note,PROMPT1_entailment
91,89,27,27,0,1.0,41,31,10,0.7560975609756098,0.8611111111111112,llama3,medalign,progress_note,PROMPT1_entailment
92,9,31,30,1,0.967741935483871,68,35,33,0.5147058823529411,0.6719999999999999,llama3,medalign,progress_note,PROMPT1_entailment
93,90,18,17,1,0.9444444444444444,24,17,7,0.7083333333333334,0.8095238095238096,llama3,medalign,progress_note,PROMPT1_entailment
94,91,21,21,0,1.0,45,31,14,0.6888888888888889,0.8157894736842105,llama3,medalign,progress_note,PROMPT1_entailment
95,92,18,15,3,0.8333333333333334,17,17,0,1.0,0.9090909090909092,llama3,medalign,progress_note,PROMPT1_entailment
96,93,19,17,2,0.8947368421052632,25,17,8,0.68,0.7727272727272727,llama3,medalign,progress_note,PROMPT1_entailment
97,94,16,14,2,0.875,33,22,11,0.6666666666666666,0.7567567567567567,llama3,medalign,progress_note,PROMPT1_entailment
98,95,31,29,2,0.935483870967742,41,29,12,0.7073170731707317,0.8055555555555556,llama3,medalign,progress_note,PROMPT1_entailment
99,96,69,66,3,0.9565217391304348,48,36,12,0.75,0.8407643312101911,llama3,medalign,progress_note,PROMPT1_entailment
100,97,46,41,5,0.8913043478260869,37,31,6,0.8378378378378378,0.8637444784233775,llama3,medalign,progress_note,PROMPT1_entailment
101,98,35,30,5,0.8571428571428571,55,31,24,0.5636363636363636,0.680073126142596,llama3,medalign,progress_note,PROMPT1_entailment
102,99,38,32,6,0.8421052631578947,73,63,10,0.863013698630137,0.852431289640592,llama3,medalign,progress_note,PROMPT1_entailment
0,0,58,45,13,0.7758620689655172,71,40,31,0.5633802816901409,0.6527651858567544,llama3,medalign,progress_note,PROMPT1_ICL_entailment
1,1,37,37,0,1.0,47,32,15,0.6808510638297872,0.810126582278481,llama3,medalign,progress_note,PROMPT1_ICL_entailment
2,10,41,31,10,0.7560975609756098,48,33,15,0.6875,0.720168954593453,llama3,medalign,progress_note,PROMPT1_ICL_entailment
3,100,44,43,1,0.9772727272727272,43,32,11,0.7441860465116279,0.8449493398833282,llama3,medalign,progress_note,PROMPT1_ICL_entailment
4,101,57,55,2,0.9649122807017544,73,50,23,0.684931506849315,0.8011653313911143,llama3,medalign,progress_note,PROMPT1_ICL_entailment
5,102,42,31,11,0.7380952380952381,13,3,10,0.2307692307692307,0.3516068052930056,llama3,medalign,progress_note,PROMPT1_ICL_entailment
6,11,23,22,1,0.9565217391304348,38,26,12,0.6842105263157895,0.797768479776848,llama3,medalign,progress_note,PROMPT1_ICL_entailment
7,12,41,39,2,0.951219512195122,46,32,14,0.6956521739130435,0.8036059240180297,llama3,medalign,progress_note,PROMPT1_ICL_entailment
8,13,51,47,4,0.9215686274509804,68,50,18,0.7352941176470589,0.8179603202227637,llama3,medalign,progress_note,PROMPT1_ICL_entailment
9,14,21,13,8,0.6190476190476191,13,5,8,0.3846153846153846,0.4744525547445256,llama3,medalign,progress_note,PROMPT1_ICL_entailment
10,15,25,17,8,0.68,19,12,7,0.631578947368421,0.6548956661316213,llama3,medalign,progress_note,PROMPT1_ICL_entailment
11,16,51,39,12,0.7647058823529411,78,40,38,0.5128205128205128,0.613931523022432,llama3,medalign,progress_note,PROMPT1_ICL_entailment
12,17,41,39,2,0.951219512195122,33,29,4,0.8787878787878788,0.9135702746365104,llama3,medalign,progress_note,PROMPT1_ICL_entailment
13,18,59,56,3,0.9491525423728814,59,48,11,0.8135593220338984,0.8761408083441982,llama3,medalign,progress_note,PROMPT1_ICL_entailment
14,19,48,44,4,0.9166666666666666,57,39,18,0.6842105263157895,0.7835616438356164,llama3,medalign,progress_note,PROMPT1_ICL_entailment
15,2,57,41,16,0.7192982456140351,54,39,15,0.7222222222222222,0.7207572684246112,llama3,medalign,progress_note,PROMPT1_ICL_entailment
16,20,34,27,7,0.7941176470588235,31,27,4,0.8709677419354839,0.8307692307692308,llama3,medalign,progress_note,PROMPT1_ICL_entailment
17,21,35,32,3,0.9142857142857144,31,23,8,0.7419354838709677,0.8191430161380077,llama3,medalign,progress_note,PROMPT1_ICL_entailment
18,22,47,39,8,0.8297872340425532,63,25,38,0.3968253968253968,0.5368942731277534,llama3,medalign,progress_note,PROMPT1_ICL_entailment
19,23,33,29,4,0.8787878787878788,35,24,11,0.6857142857142857,0.7703375760929718,llama3,medalign,progress_note,PROMPT1_ICL_entailment
20,24,40,39,1,0.975,42,31,11,0.7380952380952381,0.8401667824878387,llama3,medalign,progress_note,PROMPT1_ICL_entailment
21,25,27,24,3,0.8888888888888888,26,23,3,0.8846153846153846,0.8867469879518072,llama3,medalign,progress_note,PROMPT1_ICL_entailment
22,26,40,29,11,0.725,24,21,3,0.875,0.79296875,llama3,medalign,progress_note,PROMPT1_ICL_entailment
23,27,55,53,2,0.9636363636363636,81,45,36,0.5555555555555556,0.7047872340425532,llama3,medalign,progress_note,PROMPT1_ICL_entailment
24,28,39,36,3,0.9230769230769232,38,28,10,0.7368421052631579,0.8195121951219513,llama3,medalign,progress_note,PROMPT1_ICL_entailment
25,29,51,46,5,0.9019607843137256,99,64,35,0.6464646464646465,0.7531337938091585,llama3,medalign,progress_note,PROMPT1_ICL_entailment
26,3,35,30,5,0.8571428571428571,56,35,21,0.625,0.7228915662650602,llama3,medalign,progress_note,PROMPT1_ICL_entailment
27,30,47,42,5,0.8936170212765957,54,37,17,0.6851851851851852,0.7756426254055403,llama3,medalign,progress_note,PROMPT1_ICL_entailment
28,31,37,28,9,0.7567567567567568,38,30,8,0.7894736842105263,0.7727690892364306,llama3,medalign,progress_note,PROMPT1_ICL_entailment
29,32,58,53,5,0.913793103448276,45,40,5,0.8888888888888888,0.9011689691817216,llama3,medalign,progress_note,PROMPT1_ICL_entailment
30,33,30,21,9,0.7,33,23,10,0.696969696969697,0.6984815618221257,llama3,medalign,progress_note,PROMPT1_ICL_entailment
31,34,37,28,9,0.7567567567567568,30,23,7,0.7666666666666667,0.7616794795978711,llama3,medalign,progress_note,PROMPT1_ICL_entailment
32,35,29,26,3,0.896551724137931,57,31,26,0.543859649122807,0.6770264594708106,llama3,medalign,progress_note,PROMPT1_ICL_entailment
33,36,26,18,8,0.6923076923076923,29,16,13,0.5517241379310345,0.6140724946695095,llama3,medalign,progress_note,PROMPT1_ICL_entailment
34,37,21,13,8,0.6190476190476191,19,9,10,0.4736842105263157,0.536697247706422,llama3,medalign,progress_note,PROMPT1_ICL_entailment
35,38,82,63,19,0.7682926829268293,63,44,19,0.6984126984126984,0.7316880031674806,llama3,medalign,progress_note,PROMPT1_ICL_entailment
36,39,34,31,3,0.9117647058823528,43,39,4,0.9069767441860463,0.9093644227153064,llama3,medalign,progress_note,PROMPT1_ICL_entailment
37,4,49,45,4,0.9183673469387756,65,31,34,0.4769230769230769,0.6278127812781279,llama3,medalign,progress_note,PROMPT1_ICL_entailment
38,40,25,23,2,0.92,31,18,13,0.5806451612903226,0.71195184866724,llama3,medalign,progress_note,PROMPT1_ICL_entailment
39,41,58,55,3,0.9482758620689656,69,53,16,0.7681159420289855,0.8487407191730965,llama3,medalign,progress_note,PROMPT1_ICL_entailment
40,42,31,24,7,0.7741935483870968,32,25,7,0.78125,0.7777057679844459,llama3,medalign,progress_note,PROMPT1_ICL_entailment
41,43,35,25,10,0.7142857142857143,23,19,4,0.8260869565217391,0.7661290322580645,llama3,medalign,progress_note,PROMPT1_ICL_entailment
42,44,49,43,6,0.8775510204081632,92,47,45,0.5108695652173914,0.6457900623102731,llama3,medalign,progress_note,PROMPT1_ICL_entailment
43,45,27,19,8,0.7037037037037037,15,10,5,0.6666666666666666,0.6846846846846847,llama3,medalign,progress_note,PROMPT1_ICL_entailment
44,46,46,44,2,0.9565217391304348,50,29,21,0.58,0.7221279003961516,llama3,medalign,progress_note,PROMPT1_ICL_entailment
45,47,55,44,11,0.8,42,30,12,0.7142857142857143,0.7547169811320756,llama3,medalign,progress_note,PROMPT1_ICL_entailment
46,48,44,33,11,0.75,56,37,19,0.6607142857142857,0.7025316455696203,llama3,medalign,progress_note,PROMPT1_ICL_entailment
47,49,90,81,9,0.9,58,28,30,0.4827586206896552,0.628428927680798,llama3,medalign,progress_note,PROMPT1_ICL_entailment
48,5,47,35,12,0.7446808510638298,69,33,36,0.4782608695652174,0.5824508320726173,llama3,medalign,progress_note,PROMPT1_ICL_entailment
49,50,37,33,4,0.8918918918918919,68,36,32,0.5294117647058824,0.6644295302013422,llama3,medalign,progress_note,PROMPT1_ICL_entailment
50,51,58,55,3,0.9482758620689656,47,37,10,0.7872340425531915,0.860283238216022,llama3,medalign,progress_note,PROMPT1_ICL_entailment
51,52,23,14,9,0.6086956521739131,19,11,8,0.5789473684210527,0.5934489402697496,llama3,medalign,progress_note,PROMPT1_ICL_entailment
52,53,35,26,9,0.7428571428571429,54,30,24,0.5555555555555556,0.6356968215158925,llama3,medalign,progress_note,PROMPT1_ICL_entailment
53,54,36,21,15,0.5833333333333334,24,13,11,0.5416666666666666,0.5617283950617283,llama3,medalign,progress_note,PROMPT1_ICL_entailment
54,55,31,22,9,0.7096774193548387,23,19,4,0.8260869565217391,0.7634703196347032,llama3,medalign,progress_note,PROMPT1_ICL_entailment
55,56,33,24,9,0.7272727272727273,25,15,10,0.6,0.6575342465753425,llama3,medalign,progress_note,PROMPT1_ICL_entailment
56,57,21,12,9,0.5714285714285714,4,4,0,1.0,0.7272727272727273,llama3,medalign,progress_note,PROMPT1_ICL_entailment
57,58,343,334,9,0.9737609329446064,13,8,5,0.6153846153846154,0.7541631385831218,llama3,medalign,progress_note,PROMPT1_ICL_entailment
58,59,65,56,9,0.8615384615384616,35,26,9,0.7428571428571429,0.7978082191780822,llama3,medalign,progress_note,PROMPT1_ICL_entailment
59,6,61,57,4,0.9344262295081968,59,48,11,0.8135593220338984,0.8698140200286123,llama3,medalign,progress_note,PROMPT1_ICL_entailment
60,60,33,30,3,0.9090909090909092,56,24,32,0.4285714285714285,0.5825242718446602,llama3,medalign,progress_note,PROMPT1_ICL_entailment
61,61,33,21,12,0.6363636363636364,25,15,10,0.6,0.6176470588235293,llama3,medalign,progress_note,PROMPT1_ICL_entailment
62,62,32,23,9,0.71875,32,20,12,0.625,0.6686046511627907,llama3,medalign,progress_note,PROMPT1_ICL_entailment
63,63,29,21,8,0.7241379310344828,10,6,4,0.6,0.65625,llama3,medalign,progress_note,PROMPT1_ICL_entailment
64,64,48,41,7,0.8541666666666666,68,47,21,0.6911764705882353,0.7640761300555114,llama3,medalign,progress_note,PROMPT1_ICL_entailment
65,65,325,30,295,0.0923076923076923,104,70,34,0.6730769230769231,0.1623502126014689,llama3,medalign,progress_note,PROMPT1_ICL_entailment
66,66,58,51,7,0.8793103448275862,87,55,32,0.632183908045977,0.7355447751409466,llama3,medalign,progress_note,PROMPT1_ICL_entailment
67,67,24,21,3,0.875,18,16,2,0.8888888888888888,0.8818897637795274,llama3,medalign,progress_note,PROMPT1_ICL_entailment
68,68,21,13,8,0.6190476190476191,11,9,2,0.8181818181818182,0.7048192771084337,llama3,medalign,progress_note,PROMPT1_ICL_entailment
69,69,50,48,2,0.96,68,59,9,0.8676470588235294,0.9114901834567106,llama3,medalign,progress_note,PROMPT1_ICL_entailment
70,7,38,30,8,0.7894736842105263,37,28,9,0.7567567567567568,0.7727690892364306,llama3,medalign,progress_note,PROMPT1_ICL_entailment
71,70,41,31,10,0.7560975609756098,69,23,46,0.3333333333333333,0.4626865671641791,llama3,medalign,progress_note,PROMPT1_ICL_entailment
72,71,69,64,5,0.927536231884058,48,43,5,0.8958333333333334,0.9114091737042556,llama3,medalign,progress_note,PROMPT1_ICL_entailment
73,72,32,26,6,0.8125,69,27,42,0.391304347826087,0.5282167042889391,llama3,medalign,progress_note,PROMPT1_ICL_entailment
74,73,40,36,4,0.9,90,45,45,0.5,0.6428571428571429,llama3,medalign,progress_note,PROMPT1_ICL_entailment
75,74,36,27,9,0.75,22,21,1,0.9545454545454546,0.84,llama3,medalign,progress_note,PROMPT1_ICL_entailment
76,75,53,50,3,0.9433962264150944,49,34,15,0.6938775510204082,0.799623706491063,llama3,medalign,progress_note,PROMPT1_ICL_entailment
77,76,60,54,6,0.9,77,48,29,0.6233766233766234,0.7365728900255754,llama3,medalign,progress_note,PROMPT1_ICL_entailment
78,77,39,39,0,1.0,38,26,12,0.6842105263157895,0.8125000000000001,llama3,medalign,progress_note,PROMPT1_ICL_entailment
79,78,38,30,8,0.7894736842105263,54,31,23,0.5740740740740741,0.6647605432451751,llama3,medalign,progress_note,PROMPT1_ICL_entailment
80,79,541,261,280,0.4824399260628466,64,28,36,0.4375,0.4588722843149566,llama3,medalign,progress_note,PROMPT1_ICL_entailment
81,8,36,35,1,0.9722222222222222,31,20,11,0.6451612903225806,0.7756232686980609,llama3,medalign,progress_note,PROMPT1_ICL_entailment
82,80,31,29,2,0.935483870967742,66,35,31,0.5303030303030303,0.6768922974324774,llama3,medalign,progress_note,PROMPT1_ICL_entailment
83,81,20,11,9,0.55,12,9,3,0.75,0.6346153846153847,llama3,medalign,progress_note,PROMPT1_ICL_entailment
84,82,21,13,8,0.6190476190476191,13,6,7,0.4615384615384615,0.5288135593220339,llama3,medalign,progress_note,PROMPT1_ICL_entailment
85,83,22,14,8,0.6363636363636364,8,6,2,0.75,0.6885245901639345,llama3,medalign,progress_note,PROMPT1_ICL_entailment
86,84,30,16,14,0.5333333333333333,23,12,11,0.5217391304347826,0.5274725274725275,llama3,medalign,progress_note,PROMPT1_ICL_entailment
87,85,752,606,146,0.8058510638297872,63,16,47,0.2539682539682539,0.3862178848834893,llama3,medalign,progress_note,PROMPT1_ICL_entailment
88,86,36,33,3,0.9166666666666666,75,31,44,0.4133333333333333,0.5697577276524645,llama3,medalign,progress_note,PROMPT1_ICL_entailment
89,87,33,29,4,0.8787878787878788,87,43,44,0.4942528735632184,0.632673769660071,llama3,medalign,progress_note,PROMPT1_ICL_entailment
90,88,56,47,9,0.8392857142857143,84,64,20,0.7619047619047619,0.7987254381306425,llama3,medalign,progress_note,PROMPT1_ICL_entailment
91,89,38,37,1,0.9736842105263158,41,28,13,0.6829268292682927,0.8027896164277413,llama3,medalign,progress_note,PROMPT1_ICL_entailment
92,9,28,26,2,0.9285714285714286,68,37,31,0.5441176470588235,0.6861626248216832,llama3,medalign,progress_note,PROMPT1_ICL_entailment
93,90,23,14,9,0.6086956521739131,24,12,12,0.5,0.5490196078431373,llama3,medalign,progress_note,PROMPT1_ICL_entailment
94,91,33,33,0,1.0,45,33,12,0.7333333333333333,0.846153846153846,llama3,medalign,progress_note,PROMPT1_ICL_entailment
95,92,24,12,12,0.5,17,11,6,0.6470588235294118,0.5641025641025642,llama3,medalign,progress_note,PROMPT1_ICL_entailment
96,93,28,15,13,0.5357142857142857,25,12,13,0.48,0.5063291139240507,llama3,medalign,progress_note,PROMPT1_ICL_entailment
97,94,39,29,10,0.7435897435897436,33,22,11,0.6666666666666666,0.7030303030303031,llama3,medalign,progress_note,PROMPT1_ICL_entailment
98,95,27,24,3,0.8888888888888888,41,32,9,0.7804878048780488,0.8311688311688312,llama3,medalign,progress_note,PROMPT1_ICL_entailment
99,96,60,55,5,0.9166666666666666,48,39,9,0.8125,0.8614457831325302,llama3,medalign,progress_note,PROMPT1_ICL_entailment
100,97,41,40,1,0.975609756097561,37,31,6,0.8378378378378378,0.901490367139222,llama3,medalign,progress_note,PROMPT1_ICL_entailment
101,98,53,34,19,0.6415094339622641,55,45,10,0.8181818181818182,0.719153936545241,llama3,medalign,progress_note,PROMPT1_ICL_entailment
102,99,47,39,8,0.8297872340425532,73,35,38,0.4794520547945205,0.6077471059661621,llama3,medalign,progress_note,PROMPT1_ICL_entailment
0,0,25,23,2,0.92,71,43,28,0.6056338028169014,0.7304283604135893,llama3,medalign,progress_note,PROMPT2_ICL_entailment
1,1,29,29,0,1.0,47,28,19,0.5957446808510638,0.7466666666666666,llama3,medalign,progress_note,PROMPT2_ICL_entailment
2,10,28,24,4,0.8571428571428571,48,31,17,0.6458333333333334,0.7366336633663367,llama3,medalign,progress_note,PROMPT2_ICL_entailment
3,100,43,42,1,0.9767441860465116,43,32,11,0.7441860465116279,0.8447517284726587,llama3,medalign,progress_note,PROMPT2_ICL_entailment
4,101,33,31,2,0.9393939393939394,73,39,34,0.5342465753424658,0.6811267605633803,llama3,medalign,progress_note,PROMPT2_ICL_entailment
5,102,16,16,0,1.0,13,9,4,0.6923076923076923,0.8181818181818181,llama3,medalign,progress_note,PROMPT2_ICL_entailment
6,11,24,23,1,0.9583333333333334,38,26,12,0.6842105263157895,0.7983978638184247,llama3,medalign,progress_note,PROMPT2_ICL_entailment
7,12,29,28,1,0.9655172413793104,46,24,22,0.5217391304347826,0.6774193548387096,llama3,medalign,progress_note,PROMPT2_ICL_entailment
8,13,43,42,1,0.9767441860465116,68,41,27,0.6029411764705882,0.7456159341848884,llama3,medalign,progress_note,PROMPT2_ICL_entailment
9,14,18,18,0,1.0,13,5,8,0.3846153846153846,0.5555555555555556,llama3,medalign,progress_note,PROMPT2_ICL_entailment
10,15,16,16,0,1.0,19,11,8,0.5789473684210527,0.7333333333333334,llama3,medalign,progress_note,PROMPT2_ICL_entailment
11,16,33,31,2,0.9393939393939394,78,36,42,0.4615384615384615,0.6189683860232945,llama3,medalign,progress_note,PROMPT2_ICL_entailment
12,17,35,35,0,1.0,33,28,5,0.8484848484848485,0.9180327868852458,llama3,medalign,progress_note,PROMPT2_ICL_entailment
13,18,26,26,0,1.0,59,45,14,0.7627118644067796,0.8653846153846153,llama3,medalign,progress_note,PROMPT2_ICL_entailment
14,19,36,32,4,0.8888888888888888,57,34,23,0.5964912280701754,0.7139107611548556,llama3,medalign,progress_note,PROMPT2_ICL_entailment
15,2,34,29,5,0.8529411764705882,54,37,17,0.6851851851851852,0.759915014164306,llama3,medalign,progress_note,PROMPT2_ICL_entailment
16,20,29,29,0,1.0,31,28,3,0.9032258064516128,0.9491525423728812,llama3,medalign,progress_note,PROMPT2_ICL_entailment
17,21,31,28,3,0.9032258064516128,31,24,7,0.7741935483870968,0.8337468982630273,llama3,medalign,progress_note,PROMPT2_ICL_entailment
18,22,16,15,1,0.9375,63,24,39,0.3809523809523809,0.5417607223476297,llama3,medalign,progress_note,PROMPT2_ICL_entailment
19,23,21,18,3,0.8571428571428571,35,20,15,0.5714285714285714,0.6857142857142857,llama3,medalign,progress_note,PROMPT2_ICL_entailment
20,24,29,29,0,1.0,42,27,15,0.6428571428571429,0.782608695652174,llama3,medalign,progress_note,PROMPT2_ICL_entailment
21,25,25,24,1,0.96,26,21,5,0.8076923076923077,0.877284595300261,llama3,medalign,progress_note,PROMPT2_ICL_entailment
22,26,28,28,0,1.0,24,20,4,0.8333333333333334,0.9090909090909092,llama3,medalign,progress_note,PROMPT2_ICL_entailment
23,27,41,40,1,0.975609756097561,81,35,46,0.4320987654320987,0.5989304812834224,llama3,medalign,progress_note,PROMPT2_ICL_entailment
24,28,35,35,0,1.0,38,25,13,0.6578947368421053,0.7936507936507937,llama3,medalign,progress_note,PROMPT2_ICL_entailment
25,29,47,46,1,0.9787234042553192,99,58,41,0.5858585858585859,0.7329670329670328,llama3,medalign,progress_note,PROMPT2_ICL_entailment
26,3,28,27,1,0.9642857142857144,56,42,14,0.75,0.8437499999999999,llama3,medalign,progress_note,PROMPT2_ICL_entailment
27,30,21,19,2,0.9047619047619048,54,31,23,0.5740740740740741,0.7024448419797258,llama3,medalign,progress_note,PROMPT2_ICL_entailment
28,31,33,31,2,0.9393939393939394,38,31,7,0.8157894736842105,0.8732394366197183,llama3,medalign,progress_note,PROMPT2_ICL_entailment
29,32,35,34,1,0.9714285714285714,45,33,12,0.7333333333333333,0.8357541899441341,llama3,medalign,progress_note,PROMPT2_ICL_entailment
30,33,23,23,0,1.0,33,24,9,0.7272727272727273,0.8421052631578948,llama3,medalign,progress_note,PROMPT2_ICL_entailment
31,34,37,37,0,1.0,30,25,5,0.8333333333333334,0.9090909090909092,llama3,medalign,progress_note,PROMPT2_ICL_entailment
32,35,24,23,1,0.9583333333333334,57,40,17,0.7017543859649122,0.8102157639806252,llama3,medalign,progress_note,PROMPT2_ICL_entailment
33,36,15,14,1,0.9333333333333332,29,18,11,0.6206896551724138,0.7455621301775148,llama3,medalign,progress_note,PROMPT2_ICL_entailment
34,37,23,19,4,0.8260869565217391,19,7,12,0.3684210526315789,0.5095785440613027,llama3,medalign,progress_note,PROMPT2_ICL_entailment
35,38,31,29,2,0.935483870967742,63,38,25,0.6031746031746031,0.7334442595673876,llama3,medalign,progress_note,PROMPT2_ICL_entailment
36,39,31,27,4,0.8709677419354839,43,33,10,0.7674418604651163,0.8159340659340659,llama3,medalign,progress_note,PROMPT2_ICL_entailment
37,4,46,46,0,1.0,65,43,22,0.6615384615384615,0.7962962962962964,llama3,medalign,progress_note,PROMPT2_ICL_entailment
38,40,19,19,0,1.0,31,18,13,0.5806451612903226,0.7346938775510204,llama3,medalign,progress_note,PROMPT2_ICL_entailment
39,41,36,34,2,0.9444444444444444,69,48,21,0.6956521739130435,0.8011782032400588,llama3,medalign,progress_note,PROMPT2_ICL_entailment
40,42,30,25,5,0.8333333333333334,32,25,7,0.78125,0.8064516129032259,llama3,medalign,progress_note,PROMPT2_ICL_entailment
41,43,28,28,0,1.0,23,19,4,0.8260869565217391,0.9047619047619048,llama3,medalign,progress_note,PROMPT2_ICL_entailment
42,44,31,29,2,0.935483870967742,92,34,58,0.3695652173913043,0.5298226759806555,llama3,medalign,progress_note,PROMPT2_ICL_entailment
43,45,23,23,0,1.0,15,11,4,0.7333333333333333,0.846153846153846,llama3,medalign,progress_note,PROMPT2_ICL_entailment
44,46,26,26,0,1.0,50,31,19,0.62,0.7654320987654321,llama3,medalign,progress_note,PROMPT2_ICL_entailment
45,47,29,28,1,0.9655172413793104,42,28,14,0.6666666666666666,0.7887323943661971,llama3,medalign,progress_note,PROMPT2_ICL_entailment
46,48,23,22,1,0.9565217391304348,56,33,23,0.5892857142857143,0.7292817679558011,llama3,medalign,progress_note,PROMPT2_ICL_entailment
47,49,23,23,0,1.0,58,28,30,0.4827586206896552,0.6511627906976745,llama3,medalign,progress_note,PROMPT2_ICL_entailment
48,5,48,40,8,0.8333333333333334,69,47,22,0.6811594202898551,0.7496012759170655,llama3,medalign,progress_note,PROMPT2_ICL_entailment
49,50,42,41,1,0.9761904761904762,68,47,21,0.6911764705882353,0.8093238135237295,llama3,medalign,progress_note,PROMPT2_ICL_entailment
50,51,59,59,0,1.0,47,39,8,0.8297872340425532,0.9069767441860463,llama3,medalign,progress_note,PROMPT2_ICL_entailment
51,52,19,19,0,1.0,19,12,7,0.631578947368421,0.7741935483870968,llama3,medalign,progress_note,PROMPT2_ICL_entailment
52,53,33,32,1,0.9696969696969696,54,39,15,0.7222222222222222,0.8278606965174129,llama3,medalign,progress_note,PROMPT2_ICL_entailment
53,54,17,17,0,1.0,24,14,10,0.5833333333333334,0.7368421052631579,llama3,medalign,progress_note,PROMPT2_ICL_entailment
54,55,29,26,3,0.896551724137931,23,20,3,0.8695652173913043,0.8828522920203735,llama3,medalign,progress_note,PROMPT2_ICL_entailment
55,56,24,24,0,1.0,25,14,11,0.56,0.717948717948718,llama3,medalign,progress_note,PROMPT2_ICL_entailment
56,57,14,13,1,0.9285714285714286,4,4,0,1.0,0.962962962962963,llama3,medalign,progress_note,PROMPT2_ICL_entailment
57,58,18,16,2,0.8888888888888888,13,8,5,0.6153846153846154,0.7272727272727274,llama3,medalign,progress_note,PROMPT2_ICL_entailment
58,59,21,21,0,1.0,35,28,7,0.8,0.888888888888889,llama3,medalign,progress_note,PROMPT2_ICL_entailment
59,6,47,47,0,1.0,59,47,12,0.7966101694915254,0.8867924528301886,llama3,medalign,progress_note,PROMPT2_ICL_entailment
60,60,25,25,0,1.0,56,23,33,0.4107142857142857,0.5822784810126582,llama3,medalign,progress_note,PROMPT2_ICL_entailment
61,61,22,18,4,0.8181818181818182,25,18,7,0.72,0.7659574468085107,llama3,medalign,progress_note,PROMPT2_ICL_entailment
62,62,28,25,3,0.8928571428571429,32,22,10,0.6875,0.7768361581920904,llama3,medalign,progress_note,PROMPT2_ICL_entailment
63,63,23,23,0,1.0,10,8,2,0.8,0.888888888888889,llama3,medalign,progress_note,PROMPT2_ICL_entailment
64,64,31,29,2,0.935483870967742,69,38,31,0.5507246376811594,0.6932997798049702,llama3,medalign,progress_note,PROMPT2_ICL_entailment
65,65,21,11,10,0.5238095238095238,104,41,63,0.3942307692307692,0.4498753117206983,llama3,medalign,progress_note,PROMPT2_ICL_entailment
66,66,34,32,2,0.9411764705882352,87,71,16,0.8160919540229885,0.8741823778376299,llama3,medalign,progress_note,PROMPT2_ICL_entailment
67,67,23,22,1,0.9565217391304348,18,13,5,0.7222222222222222,0.823021582733813,llama3,medalign,progress_note,PROMPT2_ICL_entailment
68,68,16,16,0,1.0,11,8,3,0.7272727272727273,0.8421052631578948,llama3,medalign,progress_note,PROMPT2_ICL_entailment
69,69,31,31,0,1.0,68,36,32,0.5294117647058824,0.6923076923076924,llama3,medalign,progress_note,PROMPT2_ICL_entailment
70,7,24,20,4,0.8333333333333334,37,24,13,0.6486486486486487,0.729483282674772,llama3,medalign,progress_note,PROMPT2_ICL_entailment
71,70,26,23,3,0.8846153846153846,69,41,28,0.5942028985507246,0.7108933283075762,llama3,medalign,progress_note,PROMPT2_ICL_entailment
72,71,51,49,2,0.9607843137254902,48,28,20,0.5833333333333334,0.7259259259259259,llama3,medalign,progress_note,PROMPT2_ICL_entailment
73,72,27,26,1,0.9629629629629628,69,35,34,0.5072463768115942,0.6644760861628333,llama3,medalign,progress_note,PROMPT2_ICL_entailment
74,73,28,24,4,0.8571428571428571,90,40,50,0.4444444444444444,0.5853658536585367,llama3,medalign,progress_note,PROMPT2_ICL_entailment
75,74,22,21,1,0.9545454545454546,22,20,2,0.9090909090909092,0.9312638580931264,llama3,medalign,progress_note,PROMPT2_ICL_entailment
76,75,35,35,0,1.0,49,27,22,0.5510204081632653,0.7105263157894737,llama3,medalign,progress_note,PROMPT2_ICL_entailment
77,76,19,19,0,1.0,77,40,37,0.5194805194805194,0.6837606837606837,llama3,medalign,progress_note,PROMPT2_ICL_entailment
78,77,39,39,0,1.0,38,30,8,0.7894736842105263,0.8823529411764706,llama3,medalign,progress_note,PROMPT2_ICL_entailment
79,78,29,29,0,1.0,54,30,24,0.5555555555555556,0.7142857142857143,llama3,medalign,progress_note,PROMPT2_ICL_entailment
80,79,49,34,15,0.6938775510204082,64,55,9,0.859375,0.7678094847053993,llama3,medalign,progress_note,PROMPT2_ICL_entailment
81,8,31,28,3,0.9032258064516128,31,19,12,0.6129032258064516,0.730267673301304,llama3,medalign,progress_note,PROMPT2_ICL_entailment
82,80,22,20,2,0.9090909090909092,66,24,42,0.3636363636363636,0.5194805194805195,llama3,medalign,progress_note,PROMPT2_ICL_entailment
83,81,18,16,2,0.8888888888888888,12,9,3,0.75,0.8135593220338982,llama3,medalign,progress_note,PROMPT2_ICL_entailment
84,82,18,18,0,1.0,13,5,8,0.3846153846153846,0.5555555555555556,llama3,medalign,progress_note,PROMPT2_ICL_entailment
85,83,15,15,0,1.0,8,7,1,0.875,0.9333333333333332,llama3,medalign,progress_note,PROMPT2_ICL_entailment
86,84,21,20,1,0.9523809523809524,23,17,6,0.7391304347826086,0.832313341493268,llama3,medalign,progress_note,PROMPT2_ICL_entailment
87,85,19,18,1,0.9473684210526316,63,36,27,0.5714285714285714,0.7128712871287128,llama3,medalign,progress_note,PROMPT2_ICL_entailment
88,86,22,22,0,1.0,75,39,36,0.52,0.6842105263157895,llama3,medalign,progress_note,PROMPT2_ICL_entailment
89,87,21,19,2,0.9047619047619048,87,50,37,0.5747126436781609,0.7029226785053645,llama3,medalign,progress_note,PROMPT2_ICL_entailment
90,88,33,28,5,0.8484848484848485,84,44,40,0.5238095238095238,0.647739221871714,llama3,medalign,progress_note,PROMPT2_ICL_entailment
91,89,27,26,1,0.9629629629629628,41,30,11,0.7317073170731707,0.8315565031982941,llama3,medalign,progress_note,PROMPT2_ICL_entailment
92,9,21,21,0,1.0,68,32,36,0.4705882352941176,0.6399999999999999,llama3,medalign,progress_note,PROMPT2_ICL_entailment
93,90,21,21,0,1.0,24,15,9,0.625,0.7692307692307693,llama3,medalign,progress_note,PROMPT2_ICL_entailment
94,91,27,27,0,1.0,45,30,15,0.6666666666666666,0.8,llama3,medalign,progress_note,PROMPT2_ICL_entailment
95,92,26,21,5,0.8076923076923077,17,13,4,0.7647058823529411,0.7856115107913669,llama3,medalign,progress_note,PROMPT2_ICL_entailment
96,93,28,24,4,0.8571428571428571,25,17,8,0.68,0.758364312267658,llama3,medalign,progress_note,PROMPT2_ICL_entailment
97,94,27,26,1,0.9629629629629628,33,24,9,0.7272727272727273,0.8286852589641435,llama3,medalign,progress_note,PROMPT2_ICL_entailment
98,95,41,37,4,0.902439024390244,41,32,9,0.7804878048780488,0.8370448921880523,llama3,medalign,progress_note,PROMPT2_ICL_entailment
99,96,48,45,3,0.9375,48,31,17,0.6458333333333334,0.7648026315789473,llama3,medalign,progress_note,PROMPT2_ICL_entailment
100,97,53,49,4,0.9245283018867924,37,29,8,0.7837837837837838,0.8483582089552238,llama3,medalign,progress_note,PROMPT2_ICL_entailment
101,98,32,25,7,0.78125,55,35,20,0.6363636363636364,0.7014028056112225,llama3,medalign,progress_note,PROMPT2_ICL_entailment
102,99,48,43,5,0.8958333333333334,73,58,15,0.7945205479452054,0.8421408070234677,llama3,medalign,progress_note,PROMPT2_ICL_entailment
0,0,37,32,5,0.8648648648648649,71,50,21,0.704225352112676,0.7763221737020863,llama3,medalign,progress_note,PROMPT2_entailment
1,1,16,15,1,0.9375,47,27,20,0.574468085106383,0.7124010554089709,llama3,medalign,progress_note,PROMPT2_entailment
2,10,21,18,3,0.8571428571428571,48,28,20,0.5833333333333334,0.6942148760330579,llama3,medalign,progress_note,PROMPT2_entailment
3,100,31,31,0,1.0,43,24,19,0.5581395348837209,0.7164179104477612,llama3,medalign,progress_note,PROMPT2_entailment
4,101,21,19,2,0.9047619047619048,73,30,43,0.410958904109589,0.5651958353991076,llama3,medalign,progress_note,PROMPT2_entailment
5,102,17,17,0,1.0,13,6,7,0.4615384615384615,0.631578947368421,llama3,medalign,progress_note,PROMPT2_entailment
6,11,27,27,0,1.0,38,28,10,0.7368421052631579,0.8484848484848484,llama3,medalign,progress_note,PROMPT2_entailment
7,12,17,17,0,1.0,46,30,16,0.6521739130434783,0.7894736842105263,llama3,medalign,progress_note,PROMPT2_entailment
8,13,20,20,0,1.0,68,36,32,0.5294117647058824,0.6923076923076924,llama3,medalign,progress_note,PROMPT2_entailment
9,14,13,13,0,1.0,13,8,5,0.6153846153846154,0.761904761904762,llama3,medalign,progress_note,PROMPT2_entailment
10,15,18,18,0,1.0,19,12,7,0.631578947368421,0.7741935483870968,llama3,medalign,progress_note,PROMPT2_entailment
11,16,21,18,3,0.8571428571428571,78,41,37,0.5256410256410257,0.6516556291390728,llama3,medalign,progress_note,PROMPT2_entailment
12,17,29,29,0,1.0,33,28,5,0.8484848484848485,0.9180327868852458,llama3,medalign,progress_note,PROMPT2_entailment
13,18,20,19,1,0.95,59,46,13,0.7796610169491526,0.8564429201371877,llama3,medalign,progress_note,PROMPT2_entailment
14,19,24,20,4,0.8333333333333334,57,37,20,0.6491228070175439,0.7297830374753452,llama3,medalign,progress_note,PROMPT2_entailment
15,2,30,23,7,0.7666666666666667,54,42,12,0.7777777777777778,0.7721822541966427,llama3,medalign,progress_note,PROMPT2_entailment
16,20,25,25,0,1.0,31,30,1,0.967741935483871,0.9836065573770492,llama3,medalign,progress_note,PROMPT2_entailment
17,21,35,30,5,0.8571428571428571,31,23,8,0.7419354838709677,0.7953890489913545,llama3,medalign,progress_note,PROMPT2_entailment
18,22,13,13,0,1.0,63,30,33,0.4761904761904761,0.6451612903225806,llama3,medalign,progress_note,PROMPT2_entailment
19,23,18,15,3,0.8333333333333334,35,18,17,0.5142857142857142,0.6360424028268551,llama3,medalign,progress_note,PROMPT2_entailment
20,24,23,23,0,1.0,42,30,12,0.7142857142857143,0.8333333333333333,llama3,medalign,progress_note,PROMPT2_entailment
21,25,20,20,0,1.0,26,22,4,0.8461538461538461,0.9166666666666666,llama3,medalign,progress_note,PROMPT2_entailment
22,26,10,10,0,1.0,24,21,3,0.875,0.9333333333333332,llama3,medalign,progress_note,PROMPT2_entailment
23,27,25,23,2,0.92,81,31,50,0.382716049382716,0.5405610310841547,llama3,medalign,progress_note,PROMPT2_entailment
24,28,16,16,0,1.0,38,25,13,0.6578947368421053,0.7936507936507937,llama3,medalign,progress_note,PROMPT2_entailment
25,29,18,16,2,0.8888888888888888,99,37,62,0.3737373737373737,0.5262222222222223,llama3,medalign,progress_note,PROMPT2_entailment
26,3,20,19,1,0.95,56,31,25,0.5535714285714286,0.6995249406175772,llama3,medalign,progress_note,PROMPT2_entailment
27,30,19,19,0,1.0,54,39,15,0.7222222222222222,0.8387096774193548,llama3,medalign,progress_note,PROMPT2_entailment
28,31,28,28,0,1.0,38,32,6,0.8421052631578947,0.9142857142857144,llama3,medalign,progress_note,PROMPT2_entailment
29,32,35,33,2,0.9428571428571428,45,29,16,0.6444444444444445,0.7656,llama3,medalign,progress_note,PROMPT2_entailment
30,33,18,18,0,1.0,33,24,9,0.7272727272727273,0.8421052631578948,llama3,medalign,progress_note,PROMPT2_entailment
31,34,24,24,0,1.0,30,23,7,0.7666666666666667,0.8679245283018869,llama3,medalign,progress_note,PROMPT2_entailment
32,35,17,17,0,1.0,57,42,15,0.7368421052631579,0.8484848484848484,llama3,medalign,progress_note,PROMPT2_entailment
33,36,16,16,0,1.0,29,19,10,0.6551724137931034,0.7916666666666666,llama3,medalign,progress_note,PROMPT2_entailment
34,37,15,12,3,0.8,19,8,11,0.4210526315789473,0.5517241379310345,llama3,medalign,progress_note,PROMPT2_entailment
35,38,49,46,3,0.9387755102040816,63,51,12,0.8095238095238095,0.8693718732629239,llama3,medalign,progress_note,PROMPT2_entailment
36,39,21,19,2,0.9047619047619048,43,32,11,0.7441860465116279,0.816655473472129,llama3,medalign,progress_note,PROMPT2_entailment
37,4,18,18,0,1.0,65,26,39,0.4,0.5714285714285715,llama3,medalign,progress_note,PROMPT2_entailment
38,40,14,14,0,1.0,31,18,13,0.5806451612903226,0.7346938775510204,llama3,medalign,progress_note,PROMPT2_entailment
39,41,26,25,1,0.9615384615384616,69,32,37,0.463768115942029,0.6257332811888933,llama3,medalign,progress_note,PROMPT2_entailment
40,42,21,19,2,0.9047619047619048,32,23,9,0.71875,0.8010999083409717,llama3,medalign,progress_note,PROMPT2_entailment
41,43,20,20,0,1.0,23,19,4,0.8260869565217391,0.9047619047619048,llama3,medalign,progress_note,PROMPT2_entailment
42,44,24,23,1,0.9583333333333334,92,41,51,0.4456521739130434,0.6083870967741934,llama3,medalign,progress_note,PROMPT2_entailment
43,45,19,19,0,1.0,15,12,3,0.8,0.888888888888889,llama3,medalign,progress_note,PROMPT2_entailment
44,46,61,61,0,1.0,50,37,13,0.74,0.8505747126436781,llama3,medalign,progress_note,PROMPT2_entailment
45,47,23,21,2,0.9130434782608696,42,22,20,0.5238095238095238,0.6657060518731989,llama3,medalign,progress_note,PROMPT2_entailment
46,48,29,26,3,0.896551724137931,56,39,17,0.6964285714285714,0.7839195979899497,llama3,medalign,progress_note,PROMPT2_entailment
47,49,16,16,0,1.0,58,25,33,0.4310344827586206,0.6024096385542169,llama3,medalign,progress_note,PROMPT2_entailment
48,5,31,28,3,0.9032258064516128,69,44,25,0.6376811594202898,0.7475728155339806,llama3,medalign,progress_note,PROMPT2_entailment
49,50,30,28,2,0.9333333333333332,68,38,30,0.5588235294117647,0.6990801576872536,llama3,medalign,progress_note,PROMPT2_entailment
50,51,22,21,1,0.9545454545454546,47,35,12,0.7446808510638298,0.8366533864541833,llama3,medalign,progress_note,PROMPT2_entailment
51,52,19,19,0,1.0,19,12,7,0.631578947368421,0.7741935483870968,llama3,medalign,progress_note,PROMPT2_entailment
52,53,23,23,0,1.0,54,30,24,0.5555555555555556,0.7142857142857143,llama3,medalign,progress_note,PROMPT2_entailment
53,54,12,11,1,0.9166666666666666,24,12,12,0.5,0.6470588235294118,llama3,medalign,progress_note,PROMPT2_entailment
54,55,19,19,0,1.0,23,20,3,0.8695652173913043,0.9302325581395348,llama3,medalign,progress_note,PROMPT2_entailment
55,56,22,22,0,1.0,25,15,10,0.6,0.7499999999999999,llama3,medalign,progress_note,PROMPT2_entailment
56,57,12,10,2,0.8333333333333334,4,4,0,1.0,0.9090909090909092,llama3,medalign,progress_note,PROMPT2_entailment
57,58,15,15,0,1.0,13,7,6,0.5384615384615384,0.7000000000000001,llama3,medalign,progress_note,PROMPT2_entailment
58,59,16,16,0,1.0,35,21,14,0.6,0.7499999999999999,llama3,medalign,progress_note,PROMPT2_entailment
59,6,24,24,0,1.0,59,39,20,0.6610169491525424,0.7959183673469388,llama3,medalign,progress_note,PROMPT2_entailment
60,60,20,19,1,0.95,56,24,32,0.4285714285714285,0.5906735751295336,llama3,medalign,progress_note,PROMPT2_entailment
61,61,18,17,1,0.9444444444444444,25,17,8,0.68,0.7906976744186047,llama3,medalign,progress_note,PROMPT2_entailment
62,62,19,19,0,1.0,32,22,10,0.6875,0.8148148148148148,llama3,medalign,progress_note,PROMPT2_entailment
63,63,21,20,1,0.9523809523809524,10,7,3,0.7,0.8069164265129684,llama3,medalign,progress_note,PROMPT2_entailment
64,64,23,22,1,0.9565217391304348,69,33,36,0.4782608695652174,0.6376811594202898,llama3,medalign,progress_note,PROMPT2_entailment
65,65,283,156,127,0.5512367491166078,104,41,63,0.3942307692307692,0.4596974161785316,llama3,medalign,progress_note,PROMPT2_entailment
66,66,36,34,2,0.9444444444444444,87,66,21,0.7586206896551724,0.8413948256467941,llama3,medalign,progress_note,PROMPT2_entailment
67,67,14,14,0,1.0,18,14,4,0.7777777777777778,0.8750000000000001,llama3,medalign,progress_note,PROMPT2_entailment
68,68,12,12,0,1.0,11,4,7,0.3636363636363636,0.5333333333333333,llama3,medalign,progress_note,PROMPT2_entailment
69,69,26,23,3,0.8846153846153846,68,29,39,0.4264705882352941,0.5754961173425367,llama3,medalign,progress_note,PROMPT2_entailment
70,7,26,23,3,0.8846153846153846,37,26,11,0.7027027027027027,0.7832351015062213,llama3,medalign,progress_note,PROMPT2_entailment
71,70,14,11,3,0.7857142857142857,69,28,41,0.4057971014492754,0.5351867940920939,llama3,medalign,progress_note,PROMPT2_entailment
72,71,12,12,0,1.0,48,29,19,0.6041666666666666,0.7532467532467533,llama3,medalign,progress_note,PROMPT2_entailment
73,72,29,27,2,0.9310344827586208,69,32,37,0.463768115942029,0.6191329272662129,llama3,medalign,progress_note,PROMPT2_entailment
74,73,21,21,0,1.0,90,44,46,0.4888888888888889,0.6567164179104478,llama3,medalign,progress_note,PROMPT2_entailment
75,74,18,18,0,1.0,22,20,2,0.9090909090909092,0.9523809523809524,llama3,medalign,progress_note,PROMPT2_entailment
76,75,28,28,0,1.0,49,29,20,0.5918367346938775,0.7435897435897436,llama3,medalign,progress_note,PROMPT2_entailment
77,76,39,35,4,0.8974358974358975,77,45,32,0.5844155844155844,0.7078651685393258,llama3,medalign,progress_note,PROMPT2_entailment
78,77,27,26,1,0.9629629629629628,38,29,9,0.7631578947368421,0.8514963297571994,llama3,medalign,progress_note,PROMPT2_entailment
79,78,18,18,0,1.0,54,32,22,0.5925925925925926,0.7441860465116279,llama3,medalign,progress_note,PROMPT2_entailment
80,79,39,24,15,0.6153846153846154,64,42,22,0.65625,0.6351606805293005,llama3,medalign,progress_note,PROMPT2_entailment
81,8,14,14,0,1.0,31,17,14,0.5483870967741935,0.7083333333333333,llama3,medalign,progress_note,PROMPT2_entailment
82,80,28,28,0,1.0,66,27,39,0.4090909090909091,0.5806451612903226,llama3,medalign,progress_note,PROMPT2_entailment
83,81,12,12,0,1.0,12,5,7,0.4166666666666667,0.5882352941176471,llama3,medalign,progress_note,PROMPT2_entailment
84,82,13,13,0,1.0,13,8,5,0.6153846153846154,0.761904761904762,llama3,medalign,progress_note,PROMPT2_entailment
85,83,13,13,0,1.0,8,6,2,0.75,0.8571428571428571,llama3,medalign,progress_note,PROMPT2_entailment
86,84,18,16,2,0.8888888888888888,23,16,7,0.6956521739130435,0.7804878048780488,llama3,medalign,progress_note,PROMPT2_entailment
87,85,16,13,3,0.8125,63,33,30,0.5238095238095238,0.6369710467706015,llama3,medalign,progress_note,PROMPT2_entailment
88,86,20,19,1,0.95,75,42,33,0.56,0.704635761589404,llama3,medalign,progress_note,PROMPT2_entailment
89,87,31,30,1,0.967741935483871,87,43,44,0.4942528735632184,0.6543241186913519,llama3,medalign,progress_note,PROMPT2_entailment
90,88,23,22,1,0.9565217391304348,84,53,31,0.6309523809523809,0.7603521356374308,llama3,medalign,progress_note,PROMPT2_entailment
91,89,22,21,1,0.9545454545454546,41,23,18,0.5609756097560976,0.7066569129480614,llama3,medalign,progress_note,PROMPT2_entailment
92,9,19,18,1,0.9473684210526316,68,27,41,0.3970588235294117,0.5595854922279793,llama3,medalign,progress_note,PROMPT2_entailment
93,90,15,15,0,1.0,24,16,8,0.6666666666666666,0.8,llama3,medalign,progress_note,PROMPT2_entailment
94,91,15,15,0,1.0,45,32,13,0.7111111111111111,0.8311688311688311,llama3,medalign,progress_note,PROMPT2_entailment
95,92,17,17,0,1.0,17,15,2,0.8823529411764706,0.9375,llama3,medalign,progress_note,PROMPT2_entailment
96,93,18,18,0,1.0,25,17,8,0.68,0.8095238095238095,llama3,medalign,progress_note,PROMPT2_entailment
97,94,13,13,0,1.0,33,17,16,0.5151515151515151,0.6799999999999999,llama3,medalign,progress_note,PROMPT2_entailment
98,95,21,21,0,1.0,41,27,14,0.6585365853658537,0.7941176470588235,llama3,medalign,progress_note,PROMPT2_entailment
99,96,29,28,1,0.9655172413793104,48,29,19,0.6041666666666666,0.7432494279176202,llama3,medalign,progress_note,PROMPT2_entailment
100,97,21,21,0,1.0,37,20,17,0.5405405405405406,0.7017543859649124,llama3,medalign,progress_note,PROMPT2_entailment
101,98,29,23,6,0.7931034482758621,55,37,18,0.6727272727272727,0.7279726261762189,llama3,medalign,progress_note,PROMPT2_entailment
102,99,21,20,1,0.9523809523809524,73,45,28,0.6164383561643836,0.7484407484407484,llama3,medalign,progress_note,PROMPT2_entailment
0,0,11,11,0,1.0,9,6,3,0.6666666666666666,0.8,gemini,coral,pdac,PROMPT1_entailment
1,1,13,11,2,0.8461538461538461,9,8,1,0.8888888888888888,0.8669950738916256,gemini,coral,pdac,PROMPT1_entailment
2,10,12,11,1,0.9166666666666666,11,7,4,0.6363636363636364,0.7512195121951218,gemini,coral,pdac,PROMPT1_entailment
3,100,12,11,1,0.9166666666666666,11,10,1,0.9090909090909092,0.9128630705394192,gemini,coral,pdac,PROMPT1_entailment
4,101,22,16,6,0.7272727272727273,11,10,1,0.9090909090909092,0.8080808080808082,gemini,coral,pdac,PROMPT1_entailment
5,102,27,24,3,0.8888888888888888,27,19,8,0.7037037037037037,0.7855297157622738,gemini,coral,pdac,PROMPT1_entailment
6,103,1,0,1,0.0,15,0,15,0.0,,gemini,coral,pdac,PROMPT1_entailment
7,104,11,7,4,0.6363636363636364,12,10,2,0.8333333333333334,0.7216494845360825,gemini,coral,pdac,PROMPT1_entailment
8,105,25,9,16,0.36,33,18,15,0.5454545454545454,0.4337349397590361,gemini,coral,pdac,PROMPT1_entailment
9,106,17,17,0,1.0,10,10,0,1.0,1.0,gemini,coral,pdac,PROMPT1_entailment
10,107,11,10,1,0.9090909090909092,10,10,0,1.0,0.9523809523809524,gemini,coral,pdac,PROMPT1_entailment
11,108,12,12,0,1.0,10,10,0,1.0,1.0,gemini,coral,pdac,PROMPT1_entailment
12,109,28,23,5,0.8214285714285714,34,17,17,0.5,0.6216216216216216,gemini,coral,pdac,PROMPT1_entailment
13,11,20,12,8,0.6,10,10,0,1.0,0.7499999999999999,gemini,coral,pdac,PROMPT1_entailment
14,110,10,9,1,0.9,4,4,0,1.0,0.9473684210526316,gemini,coral,pdac,PROMPT1_entailment
15,111,12,12,0,1.0,3,3,0,1.0,1.0,gemini,coral,pdac,PROMPT1_entailment
16,112,8,5,3,0.625,9,6,3,0.6666666666666666,0.6451612903225806,gemini,coral,pdac,PROMPT1_entailment
17,113,8,8,0,1.0,6,5,1,0.8333333333333334,0.9090909090909092,gemini,coral,pdac,PROMPT1_entailment
18,114,14,13,1,0.9285714285714286,9,7,2,0.7777777777777778,0.8465116279069766,gemini,coral,pdac,PROMPT1_entailment
19,115,18,17,1,0.9444444444444444,7,7,0,1.0,0.9714285714285714,gemini,coral,pdac,PROMPT1_entailment
20,116,6,5,1,0.8333333333333334,2,2,0,1.0,0.9090909090909092,gemini,coral,pdac,PROMPT1_entailment
21,117,12,10,2,0.8333333333333334,8,7,1,0.875,0.8536585365853658,gemini,coral,pdac,PROMPT1_entailment
22,118,15,14,1,0.9333333333333332,9,8,1,0.8888888888888888,0.9105691056910568,gemini,coral,pdac,PROMPT1_entailment
23,119,17,10,7,0.5882352941176471,12,10,2,0.8333333333333334,0.6896551724137931,gemini,coral,pdac,PROMPT1_entailment
24,12,27,18,9,0.6666666666666666,10,10,0,1.0,0.8,gemini,coral,pdac,PROMPT1_entailment
25,120,17,13,4,0.7647058823529411,13,11,2,0.8461538461538461,0.8033707865168538,gemini,coral,pdac,PROMPT1_entailment
26,121,2,2,0,1.0,12,8,4,0.6666666666666666,0.8,gemini,coral,pdac,PROMPT1_entailment
27,122,53,30,23,0.5660377358490566,45,27,18,0.6,0.5825242718446602,gemini,coral,pdac,PROMPT1_entailment
28,123,14,13,1,0.9285714285714286,10,8,2,0.8,0.859504132231405,gemini,coral,pdac,PROMPT1_entailment
29,124,6,5,1,0.8333333333333334,3,2,1,0.6666666666666666,0.7407407407407408,gemini,coral,pdac,PROMPT1_entailment
30,125,10,8,2,0.8,8,8,0,1.0,0.888888888888889,gemini,coral,pdac,PROMPT1_entailment
31,126,15,14,1,0.9333333333333332,10,10,0,1.0,0.9655172413793104,gemini,coral,pdac,PROMPT1_entailment
32,127,38,24,14,0.631578947368421,30,17,13,0.5666666666666667,0.5973645680819911,gemini,coral,pdac,PROMPT1_entailment
33,128,46,37,9,0.8043478260869565,35,31,4,0.8857142857142857,0.8430723998529952,gemini,coral,pdac,PROMPT1_entailment
34,129,15,11,4,0.7333333333333333,11,10,1,0.9090909090909092,0.8118081180811808,gemini,coral,pdac,PROMPT1_entailment
35,13,20,16,4,0.8,13,11,2,0.8461538461538461,0.8224299065420562,gemini,coral,pdac,PROMPT1_entailment
36,130,17,12,5,0.7058823529411765,12,11,1,0.9166666666666666,0.797583081570997,gemini,coral,pdac,PROMPT1_entailment
37,131,19,15,4,0.7894736842105263,12,6,6,0.5,0.6122448979591837,gemini,coral,pdac,PROMPT1_entailment
38,132,14,9,5,0.6428571428571429,10,9,1,0.9,0.75,gemini,coral,pdac,PROMPT1_entailment
39,133,14,12,2,0.8571428571428571,7,6,1,0.8571428571428571,0.8571428571428571,gemini,coral,pdac,PROMPT1_entailment
40,134,7,6,1,0.8571428571428571,15,13,2,0.8666666666666667,0.861878453038674,gemini,coral,pdac,PROMPT1_entailment
41,135,17,15,2,0.8823529411764706,9,9,0,1.0,0.9375,gemini,coral,pdac,PROMPT1_entailment
42,136,17,14,3,0.8235294117647058,7,4,3,0.5714285714285714,0.6746987951807228,gemini,coral,pdac,PROMPT1_entailment
43,137,14,12,2,0.8571428571428571,10,7,3,0.7,0.7706422018348624,gemini,coral,pdac,PROMPT1_entailment
44,138,17,15,2,0.8823529411764706,25,18,7,0.72,0.7929515418502202,gemini,coral,pdac,PROMPT1_entailment
45,139,62,25,37,0.4032258064516129,62,51,11,0.8225806451612904,0.5411714770797962,gemini,coral,pdac,PROMPT1_entailment
46,14,10,10,0,1.0,10,10,0,1.0,1.0,gemini,coral,pdac,PROMPT1_entailment
47,140,15,11,4,0.7333333333333333,8,7,1,0.875,0.7979274611398963,gemini,coral,pdac,PROMPT1_entailment
48,141,15,13,2,0.8666666666666667,11,7,4,0.6363636363636364,0.7338709677419355,gemini,coral,pdac,PROMPT1_entailment
49,142,11,9,2,0.8181818181818182,11,10,1,0.9090909090909092,0.861244019138756,gemini,coral,pdac,PROMPT1_entailment
50,143,14,9,5,0.6428571428571429,9,7,2,0.7777777777777778,0.7039106145251396,gemini,coral,pdac,PROMPT1_entailment
51,144,30,22,8,0.7333333333333333,12,9,3,0.75,0.7415730337078651,gemini,coral,pdac,PROMPT1_entailment
52,145,10,9,1,0.9,10,10,0,1.0,0.9473684210526316,gemini,coral,pdac,PROMPT1_entailment
53,146,8,7,1,0.875,7,6,1,0.8571428571428571,0.8659793814432989,gemini,coral,pdac,PROMPT1_entailment
54,147,10,7,3,0.7,12,12,0,1.0,0.8235294117647058,gemini,coral,pdac,PROMPT1_entailment
55,148,41,29,12,0.7073170731707317,25,13,12,0.52,0.5993640699523053,gemini,coral,pdac,PROMPT1_entailment
56,149,8,8,0,1.0,7,5,2,0.7142857142857143,0.8333333333333333,gemini,coral,pdac,PROMPT1_entailment
57,15,12,12,0,1.0,10,10,0,1.0,1.0,gemini,coral,pdac,PROMPT1_entailment
58,150,9,8,1,0.8888888888888888,8,8,0,1.0,0.9411764705882352,gemini,coral,pdac,PROMPT1_entailment
59,151,18,18,0,1.0,10,9,1,0.9,0.9473684210526316,gemini,coral,pdac,PROMPT1_entailment
60,152,16,14,2,0.875,11,10,1,0.9090909090909092,0.8917197452229298,gemini,coral,pdac,PROMPT1_entailment
61,153,26,20,6,0.7692307692307693,30,7,23,0.2333333333333333,0.3580562659846547,gemini,coral,pdac,PROMPT1_entailment
62,154,27,19,8,0.7037037037037037,15,13,2,0.8666666666666667,0.7767295597484277,gemini,coral,pdac,PROMPT1_entailment
63,155,51,36,15,0.7058823529411765,47,39,8,0.8297872340425532,0.762836185819071,gemini,coral,pdac,PROMPT1_entailment
64,156,15,15,0,1.0,10,10,0,1.0,1.0,gemini,coral,pdac,PROMPT1_entailment
65,157,11,11,0,1.0,14,10,4,0.7142857142857143,0.8333333333333333,gemini,coral,pdac,PROMPT1_entailment
66,158,9,7,2,0.7777777777777778,10,9,1,0.9,0.8344370860927153,gemini,coral,pdac,PROMPT1_entailment
67,159,13,13,0,1.0,4,3,1,0.75,0.8571428571428571,gemini,coral,pdac,PROMPT1_entailment
68,16,39,31,8,0.7948717948717948,31,22,9,0.7096774193548387,0.7498625618471687,gemini,coral,pdac,PROMPT1_entailment
69,160,10,10,0,1.0,9,9,0,1.0,1.0,gemini,coral,pdac,PROMPT1_entailment
70,161,13,13,0,1.0,9,6,3,0.6666666666666666,0.8,gemini,coral,pdac,PROMPT1_entailment
71,162,16,14,2,0.875,10,9,1,0.9,0.8873239436619719,gemini,coral,pdac,PROMPT1_entailment
72,163,15,8,7,0.5333333333333333,13,9,4,0.6923076923076923,0.6025104602510459,gemini,coral,pdac,PROMPT1_entailment
73,164,52,35,17,0.6730769230769231,36,30,6,0.8333333333333334,0.74468085106383,gemini,coral,pdac,PROMPT1_entailment
74,165,11,9,2,0.8181818181818182,10,7,3,0.7,0.7544910179640719,gemini,coral,pdac,PROMPT1_entailment
75,166,18,15,3,0.8333333333333334,11,9,2,0.8181818181818182,0.8256880733944955,gemini,coral,pdac,PROMPT1_entailment
76,167,11,10,1,0.9090909090909092,8,7,1,0.875,0.8917197452229298,gemini,coral,pdac,PROMPT1_entailment
77,168,10,8,2,0.8,6,5,1,0.8333333333333334,0.816326530612245,gemini,coral,pdac,PROMPT1_entailment
78,169,9,9,0,1.0,7,5,2,0.7142857142857143,0.8333333333333333,gemini,coral,pdac,PROMPT1_entailment
79,17,12,12,0,1.0,5,5,0,1.0,1.0,gemini,coral,pdac,PROMPT1_entailment
80,170,29,22,7,0.7586206896551724,16,13,3,0.8125,0.784636488340192,gemini,coral,pdac,PROMPT1_entailment
81,171,17,13,4,0.7647058823529411,13,10,3,0.7692307692307693,0.7669616519174042,gemini,coral,pdac,PROMPT1_entailment
82,172,22,19,3,0.8636363636363636,10,7,3,0.7,0.7732558139534884,gemini,coral,pdac,PROMPT1_entailment
83,173,30,26,4,0.8666666666666667,22,15,7,0.6818181818181818,0.7632093933463797,gemini,coral,pdac,PROMPT1_entailment
84,174,6,5,1,0.8333333333333334,11,10,1,0.9090909090909092,0.8695652173913043,gemini,coral,pdac,PROMPT1_entailment
85,175,40,10,30,0.25,28,16,12,0.5714285714285714,0.3478260869565217,gemini,coral,pdac,PROMPT1_entailment
86,176,17,14,3,0.8235294117647058,10,10,0,1.0,0.9032258064516128,gemini,coral,pdac,PROMPT1_entailment
87,177,11,11,0,1.0,10,10,0,1.0,1.0,gemini,coral,pdac,PROMPT1_entailment
88,178,39,19,20,0.4871794871794871,36,29,7,0.8055555555555556,0.6071625344352617,gemini,coral,pdac,PROMPT1_entailment
89,179,12,11,1,0.9166666666666666,9,8,1,0.8888888888888888,0.9025641025641026,gemini,coral,pdac,PROMPT1_entailment
90,18,9,9,0,1.0,15,12,3,0.8,0.888888888888889,gemini,coral,pdac,PROMPT1_entailment
91,180,10,8,2,0.8,5,5,0,1.0,0.888888888888889,gemini,coral,pdac,PROMPT1_entailment
92,181,7,7,0,1.0,10,8,2,0.8,0.888888888888889,gemini,coral,pdac,PROMPT1_entailment
93,182,13,13,0,1.0,8,8,0,1.0,1.0,gemini,coral,pdac,PROMPT1_entailment
94,183,16,12,4,0.75,10,9,1,0.9,0.8181818181818182,gemini,coral,pdac,PROMPT1_entailment
95,184,8,5,3,0.625,9,8,1,0.8888888888888888,0.7339449541284404,gemini,coral,pdac,PROMPT1_entailment
96,185,18,15,3,0.8333333333333334,22,16,6,0.7272727272727273,0.7766990291262137,gemini,coral,pdac,PROMPT1_entailment
97,186,51,32,19,0.6274509803921569,32,18,14,0.5625,0.5932028836251286,gemini,coral,pdac,PROMPT1_entailment
98,187,60,47,13,0.7833333333333333,34,30,4,0.8823529411764706,0.8298999411418482,gemini,coral,pdac,PROMPT1_entailment
99,188,32,26,6,0.8125,8,8,0,1.0,0.896551724137931,gemini,coral,pdac,PROMPT1_entailment
100,189,17,12,5,0.7058823529411765,5,5,0,1.0,0.8275862068965517,gemini,coral,pdac,PROMPT1_entailment
101,19,38,26,12,0.6842105263157895,21,18,3,0.8571428571428571,0.7609756097560976,gemini,coral,pdac,PROMPT1_entailment
102,190,10,9,1,0.9,17,9,8,0.5294117647058824,0.6666666666666667,gemini,coral,pdac,PROMPT1_entailment
103,191,55,39,16,0.7090909090909091,15,14,1,0.9333333333333332,0.8059040590405904,gemini,coral,pdac,PROMPT1_entailment
104,192,22,14,8,0.6363636363636364,12,11,1,0.9166666666666666,0.7512195121951218,gemini,coral,pdac,PROMPT1_entailment
105,193,9,7,2,0.7777777777777778,10,9,1,0.9,0.8344370860927153,gemini,coral,pdac,PROMPT1_entailment
106,194,8,8,0,1.0,11,10,1,0.9090909090909092,0.9523809523809524,gemini,coral,pdac,PROMPT1_entailment
107,195,9,7,2,0.7777777777777778,7,7,0,1.0,0.8750000000000001,gemini,coral,pdac,PROMPT1_entailment
108,196,12,10,2,0.8333333333333334,8,7,1,0.875,0.8536585365853658,gemini,coral,pdac,PROMPT1_entailment
109,197,32,27,5,0.84375,9,8,1,0.8888888888888888,0.8657314629258517,gemini,coral,pdac,PROMPT1_entailment
110,198,15,14,1,0.9333333333333332,12,11,1,0.9166666666666666,0.9249249249249248,gemini,coral,pdac,PROMPT1_entailment
111,199,13,13,0,1.0,9,9,0,1.0,1.0,gemini,coral,pdac,PROMPT1_entailment
112,2,9,6,3,0.6666666666666666,14,11,3,0.7857142857142857,0.721311475409836,gemini,coral,pdac,PROMPT1_entailment
113,20,16,13,3,0.8125,18,14,4,0.7777777777777778,0.7947598253275109,gemini,coral,pdac,PROMPT1_entailment
114,200,16,12,4,0.75,16,15,1,0.9375,0.8333333333333334,gemini,coral,pdac,PROMPT1_entailment
115,201,7,7,0,1.0,10,8,2,0.8,0.888888888888889,gemini,coral,pdac,PROMPT1_entailment
116,202,6,6,0,1.0,10,10,0,1.0,1.0,gemini,coral,pdac,PROMPT1_entailment
117,203,38,21,17,0.5526315789473685,31,25,6,0.8064516129032258,0.6558400999375391,gemini,coral,pdac,PROMPT1_entailment
118,204,33,14,19,0.4242424242424242,14,10,4,0.7142857142857143,0.532319391634981,gemini,coral,pdac,PROMPT1_entailment
119,205,10,5,5,0.5,7,6,1,0.8571428571428571,0.631578947368421,gemini,coral,pdac,PROMPT1_entailment
120,206,11,9,2,0.8181818181818182,9,7,2,0.7777777777777778,0.7974683544303799,gemini,coral,pdac,PROMPT1_entailment
121,207,18,15,3,0.8333333333333334,8,6,2,0.75,0.7894736842105262,gemini,coral,pdac,PROMPT1_entailment
122,208,9,9,0,1.0,8,8,0,1.0,1.0,gemini,coral,pdac,PROMPT1_entailment
123,209,18,17,1,0.9444444444444444,9,9,0,1.0,0.9714285714285714,gemini,coral,pdac,PROMPT1_entailment
124,21,10,9,1,0.9,10,10,0,1.0,0.9473684210526316,gemini,coral,pdac,PROMPT1_entailment
125,210,17,16,1,0.9411764705882352,9,9,0,1.0,0.9696969696969696,gemini,coral,pdac,PROMPT1_entailment
126,211,11,8,3,0.7272727272727273,8,6,2,0.75,0.7384615384615384,gemini,coral,pdac,PROMPT1_entailment
127,212,14,13,1,0.9285714285714286,17,16,1,0.9411764705882352,0.9348314606741572,gemini,coral,pdac,PROMPT1_entailment
128,213,13,11,2,0.8461538461538461,11,8,3,0.7272727272727273,0.7822222222222223,gemini,coral,pdac,PROMPT1_entailment
129,214,15,13,2,0.8666666666666667,18,13,5,0.7222222222222222,0.7878787878787877,gemini,coral,pdac,PROMPT1_entailment
130,215,23,7,16,0.3043478260869565,12,9,3,0.75,0.4329896907216495,gemini,coral,pdac,PROMPT1_entailment
131,216,34,25,9,0.7352941176470589,33,27,6,0.8181818181818182,0.774526678141136,gemini,coral,pdac,PROMPT1_entailment
132,217,21,21,0,1.0,19,17,2,0.8947368421052632,0.9444444444444444,gemini,coral,pdac,PROMPT1_entailment
133,218,11,10,1,0.9090909090909092,11,9,2,0.8181818181818182,0.861244019138756,gemini,coral,pdac,PROMPT1_entailment
134,219,19,16,3,0.8421052631578947,8,8,0,1.0,0.9142857142857144,gemini,coral,pdac,PROMPT1_entailment
135,22,31,15,16,0.4838709677419355,17,14,3,0.8235294117647058,0.6095791001451379,gemini,coral,pdac,PROMPT1_entailment
136,220,13,11,2,0.8461538461538461,11,11,0,1.0,0.9166666666666666,gemini,coral,pdac,PROMPT1_entailment
137,221,10,9,1,0.9,12,9,3,0.75,0.8181818181818182,gemini,coral,pdac,PROMPT1_entailment
138,222,18,12,6,0.6666666666666666,11,9,2,0.8181818181818182,0.7346938775510203,gemini,coral,pdac,PROMPT1_entailment
139,223,53,43,10,0.8113207547169812,37,32,5,0.8648648648648649,0.8372376026772133,gemini,coral,pdac,PROMPT1_entailment
140,224,14,8,6,0.5714285714285714,8,7,1,0.875,0.691358024691358,gemini,coral,pdac,PROMPT1_entailment
141,225,17,13,4,0.7647058823529411,13,9,4,0.6923076923076923,0.7267080745341614,gemini,coral,pdac,PROMPT1_entailment
142,226,9,9,0,1.0,11,10,1,0.9090909090909092,0.9523809523809524,gemini,coral,pdac,PROMPT1_entailment
143,227,13,9,4,0.6923076923076923,10,8,2,0.8,0.7422680412371134,gemini,coral,pdac,PROMPT1_entailment
144,228,16,16,0,1.0,9,9,0,1.0,1.0,gemini,coral,pdac,PROMPT1_entailment
145,229,15,14,1,0.9333333333333332,9,9,0,1.0,0.9655172413793104,gemini,coral,pdac,PROMPT1_entailment
146,23,16,16,0,1.0,12,11,1,0.9166666666666666,0.9565217391304348,gemini,coral,pdac,PROMPT1_entailment
147,230,11,10,1,0.9090909090909092,8,7,1,0.875,0.8917197452229298,gemini,coral,pdac,PROMPT1_entailment
148,24,10,9,1,0.9,9,8,1,0.8888888888888888,0.8944099378881988,gemini,coral,pdac,PROMPT1_entailment
149,25,12,10,2,0.8333333333333334,11,10,1,0.9090909090909092,0.8695652173913043,gemini,coral,pdac,PROMPT1_entailment
150,26,13,12,1,0.9230769230769232,11,11,0,1.0,0.96,gemini,coral,pdac,PROMPT1_entailment
151,27,17,14,3,0.8235294117647058,12,11,1,0.9166666666666666,0.8676056338028169,gemini,coral,pdac,PROMPT1_entailment
152,28,8,8,0,1.0,13,13,0,1.0,1.0,gemini,coral,pdac,PROMPT1_entailment
153,29,14,11,3,0.7857142857142857,9,6,3,0.6666666666666666,0.721311475409836,gemini,coral,pdac,PROMPT1_entailment
154,3,17,14,3,0.8235294117647058,8,8,0,1.0,0.9032258064516128,gemini,coral,pdac,PROMPT1_entailment
155,30,27,24,3,0.8888888888888888,11,10,1,0.9090909090909092,0.8988764044943819,gemini,coral,pdac,PROMPT1_entailment
156,31,21,19,2,0.9047619047619048,11,10,1,0.9090909090909092,0.9069212410501194,gemini,coral,pdac,PROMPT1_entailment
157,32,19,15,4,0.7894736842105263,11,8,3,0.7272727272727273,0.7570977917981072,gemini,coral,pdac,PROMPT1_entailment
158,33,36,11,25,0.3055555555555556,24,19,5,0.7916666666666666,0.4409282700421941,gemini,coral,pdac,PROMPT1_entailment
159,34,11,10,1,0.9090909090909092,10,10,0,1.0,0.9523809523809524,gemini,coral,pdac,PROMPT1_entailment
160,35,10,10,0,1.0,10,9,1,0.9,0.9473684210526316,gemini,coral,pdac,PROMPT1_entailment
161,36,32,30,2,0.9375,44,35,9,0.7954545454545454,0.860655737704918,gemini,coral,pdac,PROMPT1_entailment
162,37,25,21,4,0.84,9,8,1,0.8888888888888888,0.8637532133676092,gemini,coral,pdac,PROMPT1_entailment
163,38,20,13,7,0.65,13,10,3,0.7692307692307693,0.7046070460704607,gemini,coral,pdac,PROMPT1_entailment
164,39,9,8,1,0.8888888888888888,10,9,1,0.9,0.8944099378881988,gemini,coral,pdac,PROMPT1_entailment
165,4,29,21,8,0.7241379310344828,15,9,6,0.6,0.65625,gemini,coral,pdac,PROMPT1_entailment
166,40,13,7,6,0.5384615384615384,10,6,4,0.6,0.5675675675675675,gemini,coral,pdac,PROMPT1_entailment
167,41,22,20,2,0.9090909090909092,8,5,3,0.625,0.7407407407407406,gemini,coral,pdac,PROMPT1_entailment
168,42,18,18,0,1.0,11,9,2,0.8181818181818182,0.9,gemini,coral,pdac,PROMPT1_entailment
169,43,9,9,0,1.0,13,10,3,0.7692307692307693,0.8695652173913044,gemini,coral,pdac,PROMPT1_entailment
170,44,7,6,1,0.8571428571428571,11,10,1,0.9090909090909092,0.8823529411764706,gemini,coral,pdac,PROMPT1_entailment
171,45,10,8,2,0.8,10,8,2,0.8,0.8000000000000002,gemini,coral,pdac,PROMPT1_entailment
172,46,16,11,5,0.6875,11,10,1,0.9090909090909092,0.7829181494661921,gemini,coral,pdac,PROMPT1_entailment
173,47,36,29,7,0.8055555555555556,39,27,12,0.6923076923076923,0.7446504992867332,gemini,coral,pdac,PROMPT1_entailment
174,48,11,4,7,0.3636363636363636,10,9,1,0.9,0.5179856115107914,gemini,coral,pdac,PROMPT1_entailment
175,49,12,12,0,1.0,10,7,3,0.7,0.8235294117647058,gemini,coral,pdac,PROMPT1_entailment
176,5,11,10,1,0.9090909090909092,10,8,2,0.8,0.8510638297872342,gemini,coral,pdac,PROMPT1_entailment
177,50,13,10,3,0.7692307692307693,10,8,2,0.8,0.7843137254901961,gemini,coral,pdac,PROMPT1_entailment
178,51,21,12,9,0.5714285714285714,12,11,1,0.9166666666666666,0.7039999999999998,gemini,coral,pdac,PROMPT1_entailment
179,52,11,10,1,0.9090909090909092,10,10,0,1.0,0.9523809523809524,gemini,coral,pdac,PROMPT1_entailment
180,53,13,10,3,0.7692307692307693,8,8,0,1.0,0.8695652173913044,gemini,coral,pdac,PROMPT1_entailment
181,54,7,2,5,0.2857142857142857,2,2,0,1.0,0.4444444444444445,gemini,coral,pdac,PROMPT1_entailment
182,55,14,14,0,1.0,10,7,3,0.7,0.8235294117647058,gemini,coral,pdac,PROMPT1_entailment
183,56,5,5,0,1.0,8,5,3,0.625,0.7692307692307693,gemini,coral,pdac,PROMPT1_entailment
184,57,43,32,11,0.7441860465116279,13,10,3,0.7692307692307693,0.7565011820330969,gemini,coral,pdac,PROMPT1_entailment
185,58,12,8,4,0.6666666666666666,10,10,0,1.0,0.8,gemini,coral,pdac,PROMPT1_entailment
186,59,32,18,14,0.5625,21,14,7,0.6666666666666666,0.6101694915254238,gemini,coral,pdac,PROMPT1_entailment
187,6,16,11,5,0.6875,12,9,3,0.75,0.717391304347826,gemini,coral,pdac,PROMPT1_entailment
188,60,20,15,5,0.75,13,11,2,0.8461538461538461,0.7951807228915662,gemini,coral,pdac,PROMPT1_entailment
189,61,11,9,2,0.8181818181818182,7,7,0,1.0,0.9,gemini,coral,pdac,PROMPT1_entailment
190,62,14,12,2,0.8571428571428571,11,10,1,0.9090909090909092,0.8823529411764706,gemini,coral,pdac,PROMPT1_entailment
191,63,11,9,2,0.8181818181818182,10,10,0,1.0,0.9,gemini,coral,pdac,PROMPT1_entailment
192,64,15,14,1,0.9333333333333332,12,12,0,1.0,0.9655172413793104,gemini,coral,pdac,PROMPT1_entailment
193,65,28,21,7,0.75,9,8,1,0.8888888888888888,0.8135593220338982,gemini,coral,pdac,PROMPT1_entailment
194,66,14,13,1,0.9285714285714286,12,11,1,0.9166666666666666,0.9225806451612902,gemini,coral,pdac,PROMPT1_entailment
195,67,8,7,1,0.875,1,1,0,1.0,0.9333333333333332,gemini,coral,pdac,PROMPT1_entailment
196,68,10,9,1,0.9,11,9,2,0.8181818181818182,0.8571428571428572,gemini,coral,pdac,PROMPT1_entailment
197,69,11,10,1,0.9090909090909092,10,10,0,1.0,0.9523809523809524,gemini,coral,pdac,PROMPT1_entailment
198,7,8,7,1,0.875,11,8,3,0.7272727272727273,0.7943262411347517,gemini,coral,pdac,PROMPT1_entailment
199,70,21,19,2,0.9047619047619048,15,13,2,0.8666666666666667,0.8853046594982079,gemini,coral,pdac,PROMPT1_entailment
200,71,11,9,2,0.8181818181818182,9,4,5,0.4444444444444444,0.5760000000000001,gemini,coral,pdac,PROMPT1_entailment
201,72,10,7,3,0.7,13,9,4,0.6923076923076923,0.6961325966850829,gemini,coral,pdac,PROMPT1_entailment
202,73,72,16,56,0.2222222222222222,154,79,75,0.512987012987013,0.310107948969578,gemini,coral,pdac,PROMPT1_entailment
203,74,24,19,5,0.7916666666666666,8,8,0,1.0,0.8837209302325582,gemini,coral,pdac,PROMPT1_entailment
204,75,15,14,1,0.9333333333333332,7,6,1,0.8571428571428571,0.8936170212765957,gemini,coral,pdac,PROMPT1_entailment
205,76,7,7,0,1.0,7,7,0,1.0,1.0,gemini,coral,pdac,PROMPT1_entailment
206,77,25,24,1,0.96,8,8,0,1.0,0.979591836734694,gemini,coral,pdac,PROMPT1_entailment
207,78,10,7,3,0.7,8,7,1,0.875,0.7777777777777777,gemini,coral,pdac,PROMPT1_entailment
208,79,16,14,2,0.875,11,11,0,1.0,0.9333333333333332,gemini,coral,pdac,PROMPT1_entailment
209,8,11,11,0,1.0,2,2,0,1.0,1.0,gemini,coral,pdac,PROMPT1_entailment
210,80,13,13,0,1.0,9,8,1,0.8888888888888888,0.9411764705882352,gemini,coral,pdac,PROMPT1_entailment
211,81,17,16,1,0.9411764705882352,6,5,1,0.8333333333333334,0.8839779005524863,gemini,coral,pdac,PROMPT1_entailment
212,82,19,18,1,0.9473684210526316,4,3,1,0.75,0.8372093023255814,gemini,coral,pdac,PROMPT1_entailment
213,83,10,9,1,0.9,11,8,3,0.7272727272727273,0.8044692737430167,gemini,coral,pdac,PROMPT1_entailment
214,84,9,6,3,0.6666666666666666,11,5,6,0.4545454545454545,0.5405405405405405,gemini,coral,pdac,PROMPT1_entailment
215,85,40,20,20,0.5,35,25,10,0.7142857142857143,0.588235294117647,gemini,coral,pdac,PROMPT1_entailment
216,86,12,8,4,0.6666666666666666,10,8,2,0.8,0.7272727272727272,gemini,coral,pdac,PROMPT1_entailment
217,87,21,15,6,0.7142857142857143,7,6,1,0.8571428571428571,0.7792207792207793,gemini,coral,pdac,PROMPT1_entailment
218,88,14,9,5,0.6428571428571429,8,8,0,1.0,0.782608695652174,gemini,coral,pdac,PROMPT1_entailment
219,89,16,13,3,0.8125,10,9,1,0.9,0.854014598540146,gemini,coral,pdac,PROMPT1_entailment
220,9,7,6,1,0.8571428571428571,12,10,2,0.8333333333333334,0.8450704225352113,gemini,coral,pdac,PROMPT1_entailment
221,90,14,12,2,0.8571428571428571,9,9,0,1.0,0.923076923076923,gemini,coral,pdac,PROMPT1_entailment
222,91,14,12,2,0.8571428571428571,10,7,3,0.7,0.7706422018348624,gemini,coral,pdac,PROMPT1_entailment
223,92,13,7,6,0.5384615384615384,10,7,3,0.7,0.608695652173913,gemini,coral,pdac,PROMPT1_entailment
224,93,11,10,1,0.9090909090909092,9,5,4,0.5555555555555556,0.6896551724137931,gemini,coral,pdac,PROMPT1_entailment
225,94,10,9,1,0.9,7,4,3,0.5714285714285714,0.6990291262135921,gemini,coral,pdac,PROMPT1_entailment
226,95,18,13,5,0.7222222222222222,8,8,0,1.0,0.8387096774193548,gemini,coral,pdac,PROMPT1_entailment
227,96,10,9,1,0.9,4,3,1,0.75,0.8181818181818182,gemini,coral,pdac,PROMPT1_entailment
228,97,22,21,1,0.9545454545454546,8,8,0,1.0,0.9767441860465116,gemini,coral,pdac,PROMPT1_entailment
229,98,17,15,2,0.8823529411764706,9,9,0,1.0,0.9375,gemini,coral,pdac,PROMPT1_entailment
230,99,14,12,2,0.8571428571428571,9,9,0,1.0,0.923076923076923,gemini,coral,pdac,PROMPT1_entailment
0,0,17,16,1,0.9411764705882352,9,9,0,1.0,0.9696969696969696,gemini,coral,pdac,PROMPT1_ICL_entailment
1,1,15,14,1,0.9333333333333332,9,7,2,0.7777777777777778,0.8484848484848485,gemini,coral,pdac,PROMPT1_ICL_entailment
2,10,27,24,3,0.8888888888888888,11,9,2,0.8181818181818182,0.8520710059171598,gemini,coral,pdac,PROMPT1_ICL_entailment
3,100,5,0,5,0.0,11,2,9,0.1818181818181818,0.0,gemini,coral,pdac,PROMPT1_ICL_entailment
4,101,16,16,0,1.0,11,10,1,0.9090909090909092,0.9523809523809524,gemini,coral,pdac,PROMPT1_ICL_entailment
5,102,37,37,0,1.0,27,23,4,0.8518518518518519,0.92,gemini,coral,pdac,PROMPT1_ICL_entailment
6,103,1,0,1,0.0,15,2,13,0.1333333333333333,0.0,gemini,coral,pdac,PROMPT1_ICL_entailment
7,104,44,35,9,0.7954545454545454,12,10,2,0.8333333333333334,0.8139534883720929,gemini,coral,pdac,PROMPT1_ICL_entailment
8,105,37,21,16,0.5675675675675675,33,17,16,0.5151515151515151,0.540090771558245,gemini,coral,pdac,PROMPT1_ICL_entailment
9,106,2,1,1,0.5,10,2,8,0.2,0.2857142857142857,gemini,coral,pdac,PROMPT1_ICL_entailment
10,107,10,10,0,1.0,10,10,0,1.0,1.0,gemini,coral,pdac,PROMPT1_ICL_entailment
11,108,16,15,1,0.9375,10,10,0,1.0,0.967741935483871,gemini,coral,pdac,PROMPT1_ICL_entailment
12,109,36,36,0,1.0,34,31,3,0.9117647058823528,0.953846153846154,gemini,coral,pdac,PROMPT1_ICL_entailment
13,11,18,17,1,0.9444444444444444,10,9,1,0.9,0.9216867469879516,gemini,coral,pdac,PROMPT1_ICL_entailment
14,110,21,18,3,0.8571428571428571,4,4,0,1.0,0.923076923076923,gemini,coral,pdac,PROMPT1_ICL_entailment
15,111,10,10,0,1.0,3,3,0,1.0,1.0,gemini,coral,pdac,PROMPT1_ICL_entailment
16,112,14,14,0,1.0,9,7,2,0.7777777777777778,0.8750000000000001,gemini,coral,pdac,PROMPT1_ICL_entailment
17,113,18,16,2,0.8888888888888888,6,6,0,1.0,0.9411764705882352,gemini,coral,pdac,PROMPT1_ICL_entailment
18,114,13,13,0,1.0,9,9,0,1.0,1.0,gemini,coral,pdac,PROMPT1_ICL_entailment
19,115,10,10,0,1.0,7,7,0,1.0,1.0,gemini,coral,pdac,PROMPT1_ICL_entailment
20,116,6,5,1,0.8333333333333334,2,2,0,1.0,0.9090909090909092,gemini,coral,pdac,PROMPT1_ICL_entailment
21,117,18,17,1,0.9444444444444444,8,7,1,0.875,0.9083969465648856,gemini,coral,pdac,PROMPT1_ICL_entailment
22,118,19,18,1,0.9473684210526316,9,9,0,1.0,0.972972972972973,gemini,coral,pdac,PROMPT1_ICL_entailment
23,119,16,11,5,0.6875,12,11,1,0.9166666666666666,0.7857142857142857,gemini,coral,pdac,PROMPT1_ICL_entailment
24,12,22,20,2,0.9090909090909092,10,9,1,0.9,0.9045226130653266,gemini,coral,pdac,PROMPT1_ICL_entailment
25,120,33,25,8,0.7575757575757576,13,11,2,0.8461538461538461,0.7994186046511628,gemini,coral,pdac,PROMPT1_ICL_entailment
26,121,23,18,5,0.782608695652174,12,10,2,0.8333333333333334,0.8071748878923767,gemini,coral,pdac,PROMPT1_ICL_entailment
27,122,33,28,5,0.8484848484848485,45,23,22,0.5111111111111111,0.6379395740465577,gemini,coral,pdac,PROMPT1_ICL_entailment
28,123,17,16,1,0.9411764705882352,10,10,0,1.0,0.9696969696969696,gemini,coral,pdac,PROMPT1_ICL_entailment
29,124,8,6,2,0.75,3,3,0,1.0,0.8571428571428571,gemini,coral,pdac,PROMPT1_ICL_entailment
30,125,18,18,0,1.0,8,8,0,1.0,1.0,gemini,coral,pdac,PROMPT1_ICL_entailment
31,126,16,16,0,1.0,10,8,2,0.8,0.888888888888889,gemini,coral,pdac,PROMPT1_ICL_entailment
32,127,30,24,6,0.8,30,12,18,0.4,0.5333333333333333,gemini,coral,pdac,PROMPT1_ICL_entailment
33,128,15,11,4,0.7333333333333333,35,7,28,0.2,0.3142857142857143,gemini,coral,pdac,PROMPT1_ICL_entailment
34,129,13,12,1,0.9230769230769232,11,10,1,0.9090909090909092,0.9160305343511452,gemini,coral,pdac,PROMPT1_ICL_entailment
35,13,32,27,5,0.84375,13,10,3,0.7692307692307693,0.804769001490313,gemini,coral,pdac,PROMPT1_ICL_entailment
36,130,23,19,4,0.8260869565217391,12,9,3,0.75,0.786206896551724,gemini,coral,pdac,PROMPT1_ICL_entailment
37,131,11,11,0,1.0,12,7,5,0.5833333333333334,0.7368421052631579,gemini,coral,pdac,PROMPT1_ICL_entailment
38,132,16,14,2,0.875,10,9,1,0.9,0.8873239436619719,gemini,coral,pdac,PROMPT1_ICL_entailment
39,133,23,22,1,0.9565217391304348,7,7,0,1.0,0.9777777777777776,gemini,coral,pdac,PROMPT1_ICL_entailment
40,134,1,0,1,0.0,15,0,15,0.0,,gemini,coral,pdac,PROMPT1_ICL_entailment
41,135,27,24,3,0.8888888888888888,9,9,0,1.0,0.9411764705882352,gemini,coral,pdac,PROMPT1_ICL_entailment
42,136,28,28,0,1.0,7,4,3,0.5714285714285714,0.7272727272727273,gemini,coral,pdac,PROMPT1_ICL_entailment
43,137,20,19,1,0.95,10,8,2,0.8,0.8685714285714285,gemini,coral,pdac,PROMPT1_ICL_entailment
44,138,37,28,9,0.7567567567567568,25,18,7,0.72,0.7379209370424598,gemini,coral,pdac,PROMPT1_ICL_entailment
45,139,59,39,20,0.6610169491525424,62,41,21,0.6612903225806451,0.6611536076080216,gemini,coral,pdac,PROMPT1_ICL_entailment
46,14,14,13,1,0.9285714285714286,10,10,0,1.0,0.962962962962963,gemini,coral,pdac,PROMPT1_ICL_entailment
47,140,15,11,4,0.7333333333333333,8,8,0,1.0,0.846153846153846,gemini,coral,pdac,PROMPT1_ICL_entailment
48,141,21,20,1,0.9523809523809524,11,7,4,0.6363636363636364,0.762942779291553,gemini,coral,pdac,PROMPT1_ICL_entailment
49,142,26,19,7,0.7307692307692307,11,10,1,0.9090909090909092,0.8102345415778252,gemini,coral,pdac,PROMPT1_ICL_entailment
50,143,16,15,1,0.9375,9,8,1,0.8888888888888888,0.9125475285171102,gemini,coral,pdac,PROMPT1_ICL_entailment
51,144,27,22,5,0.8148148148148148,12,10,2,0.8333333333333334,0.8239700374531835,gemini,coral,pdac,PROMPT1_ICL_entailment
52,145,16,15,1,0.9375,10,9,1,0.9,0.9183673469387756,gemini,coral,pdac,PROMPT1_ICL_entailment
53,146,11,9,2,0.8181818181818182,7,6,1,0.8571428571428571,0.8372093023255814,gemini,coral,pdac,PROMPT1_ICL_entailment
54,147,19,15,4,0.7894736842105263,12,12,0,1.0,0.8823529411764706,gemini,coral,pdac,PROMPT1_ICL_entailment
55,148,24,16,8,0.6666666666666666,25,14,11,0.56,0.6086956521739131,gemini,coral,pdac,PROMPT1_ICL_entailment
56,149,17,17,0,1.0,7,7,0,1.0,1.0,gemini,coral,pdac,PROMPT1_ICL_entailment
57,15,10,10,0,1.0,10,10,0,1.0,1.0,gemini,coral,pdac,PROMPT1_ICL_entailment
58,150,13,13,0,1.0,8,8,0,1.0,1.0,gemini,coral,pdac,PROMPT1_ICL_entailment
59,151,22,22,0,1.0,10,9,1,0.9,0.9473684210526316,gemini,coral,pdac,PROMPT1_ICL_entailment
60,152,17,17,0,1.0,11,10,1,0.9090909090909092,0.9523809523809524,gemini,coral,pdac,PROMPT1_ICL_entailment
61,153,43,27,16,0.627906976744186,30,14,16,0.4666666666666667,0.5354107648725213,gemini,coral,pdac,PROMPT1_ICL_entailment
62,154,29,23,6,0.7931034482758621,15,11,4,0.7333333333333333,0.7620481927710843,gemini,coral,pdac,PROMPT1_ICL_entailment
63,155,91,71,20,0.7802197802197802,47,32,15,0.6808510638297872,0.7271563450152024,gemini,coral,pdac,PROMPT1_ICL_entailment
64,156,16,15,1,0.9375,10,10,0,1.0,0.967741935483871,gemini,coral,pdac,PROMPT1_ICL_entailment
65,157,21,19,2,0.9047619047619048,14,12,2,0.8571428571428571,0.8803088803088803,gemini,coral,pdac,PROMPT1_ICL_entailment
66,158,12,12,0,1.0,10,7,3,0.7,0.8235294117647058,gemini,coral,pdac,PROMPT1_ICL_entailment
67,159,18,17,1,0.9444444444444444,4,4,0,1.0,0.9714285714285714,gemini,coral,pdac,PROMPT1_ICL_entailment
68,16,39,33,6,0.8461538461538461,31,19,12,0.6129032258064516,0.7108843537414966,gemini,coral,pdac,PROMPT1_ICL_entailment
69,160,19,15,4,0.7894736842105263,9,9,0,1.0,0.8823529411764706,gemini,coral,pdac,PROMPT1_ICL_entailment
70,161,16,16,0,1.0,9,8,1,0.8888888888888888,0.9411764705882352,gemini,coral,pdac,PROMPT1_ICL_entailment
71,162,18,16,2,0.8888888888888888,10,10,0,1.0,0.9411764705882352,gemini,coral,pdac,PROMPT1_ICL_entailment
72,163,28,23,5,0.8214285714285714,13,11,2,0.8461538461538461,0.8336079077429984,gemini,coral,pdac,PROMPT1_ICL_entailment
73,164,39,36,3,0.9230769230769232,36,19,17,0.5277777777777778,0.6715758468335787,gemini,coral,pdac,PROMPT1_ICL_entailment
74,165,39,22,17,0.5641025641025641,10,9,1,0.9,0.6935201401050787,gemini,coral,pdac,PROMPT1_ICL_entailment
75,166,15,15,0,1.0,11,7,4,0.6363636363636364,0.7777777777777778,gemini,coral,pdac,PROMPT1_ICL_entailment
76,167,12,10,2,0.8333333333333334,8,7,1,0.875,0.8536585365853658,gemini,coral,pdac,PROMPT1_ICL_entailment
77,168,13,12,1,0.9230769230769232,6,5,1,0.8333333333333334,0.8759124087591241,gemini,coral,pdac,PROMPT1_ICL_entailment
78,169,12,12,0,1.0,7,6,1,0.8571428571428571,0.923076923076923,gemini,coral,pdac,PROMPT1_ICL_entailment
79,17,10,10,0,1.0,5,5,0,1.0,1.0,gemini,coral,pdac,PROMPT1_ICL_entailment
80,170,41,30,11,0.7317073170731707,16,13,3,0.8125,0.769990128331688,gemini,coral,pdac,PROMPT1_ICL_entailment
81,171,22,17,5,0.7727272727272727,13,11,2,0.8461538461538461,0.8077753779697625,gemini,coral,pdac,PROMPT1_ICL_entailment
82,172,20,18,2,0.9,10,10,0,1.0,0.9473684210526316,gemini,coral,pdac,PROMPT1_ICL_entailment
83,173,20,18,2,0.9,22,13,9,0.5909090909090909,0.7134146341463415,gemini,coral,pdac,PROMPT1_ICL_entailment
84,174,31,19,12,0.6129032258064516,11,9,2,0.8181818181818182,0.7008196721311475,gemini,coral,pdac,PROMPT1_ICL_entailment
85,175,28,10,18,0.3571428571428571,28,9,19,0.3214285714285714,0.3383458646616541,gemini,coral,pdac,PROMPT1_ICL_entailment
86,176,14,14,0,1.0,10,10,0,1.0,1.0,gemini,coral,pdac,PROMPT1_ICL_entailment
87,177,15,15,0,1.0,10,10,0,1.0,1.0,gemini,coral,pdac,PROMPT1_ICL_entailment
88,178,39,27,12,0.6923076923076923,36,33,3,0.9166666666666666,0.7888446215139442,gemini,coral,pdac,PROMPT1_ICL_entailment
89,179,8,6,2,0.75,9,6,3,0.6666666666666666,0.7058823529411765,gemini,coral,pdac,PROMPT1_ICL_entailment
90,18,22,19,3,0.8636363636363636,15,12,3,0.8,0.8306010928961749,gemini,coral,pdac,PROMPT1_ICL_entailment
91,180,15,13,2,0.8666666666666667,5,5,0,1.0,0.9285714285714286,gemini,coral,pdac,PROMPT1_ICL_entailment
92,181,22,22,0,1.0,10,9,1,0.9,0.9473684210526316,gemini,coral,pdac,PROMPT1_ICL_entailment
93,182,18,17,1,0.9444444444444444,8,7,1,0.875,0.9083969465648856,gemini,coral,pdac,PROMPT1_ICL_entailment
94,183,19,15,4,0.7894736842105263,10,8,2,0.8,0.794701986754967,gemini,coral,pdac,PROMPT1_ICL_entailment
95,184,23,8,15,0.3478260869565217,9,6,3,0.6666666666666666,0.4571428571428571,gemini,coral,pdac,PROMPT1_ICL_entailment
96,185,1,0,1,0.0,22,2,20,0.0909090909090909,0.0,gemini,coral,pdac,PROMPT1_ICL_entailment
97,186,31,26,5,0.8387096774193549,32,13,19,0.40625,0.5473684210526316,gemini,coral,pdac,PROMPT1_ICL_entailment
98,187,63,46,17,0.7301587301587301,34,28,6,0.8235294117647058,0.7740384615384616,gemini,coral,pdac,PROMPT1_ICL_entailment
99,188,22,20,2,0.9090909090909092,8,8,0,1.0,0.9523809523809524,gemini,coral,pdac,PROMPT1_ICL_entailment
100,189,23,21,2,0.9130434782608696,5,5,0,1.0,0.9545454545454544,gemini,coral,pdac,PROMPT1_ICL_entailment
101,19,58,50,8,0.8620689655172413,21,14,7,0.6666666666666666,0.7518796992481203,gemini,coral,pdac,PROMPT1_ICL_entailment
102,190,41,37,4,0.902439024390244,17,11,6,0.6470588235294118,0.7537037037037038,gemini,coral,pdac,PROMPT1_ICL_entailment
103,191,38,35,3,0.9210526315789472,15,11,4,0.7333333333333333,0.816542948038176,gemini,coral,pdac,PROMPT1_ICL_entailment
104,192,31,23,8,0.7419354838709677,12,11,1,0.9166666666666666,0.8200972447325768,gemini,coral,pdac,PROMPT1_ICL_entailment
105,193,17,15,2,0.8823529411764706,10,10,0,1.0,0.9375,gemini,coral,pdac,PROMPT1_ICL_entailment
106,194,12,11,1,0.9166666666666666,11,9,2,0.8181818181818182,0.8646288209606987,gemini,coral,pdac,PROMPT1_ICL_entailment
107,195,14,13,1,0.9285714285714286,7,3,4,0.4285714285714285,0.5864661654135338,gemini,coral,pdac,PROMPT1_ICL_entailment
108,196,17,17,0,1.0,8,7,1,0.875,0.9333333333333332,gemini,coral,pdac,PROMPT1_ICL_entailment
109,197,25,20,5,0.8,9,5,4,0.5555555555555556,0.6557377049180328,gemini,coral,pdac,PROMPT1_ICL_entailment
110,198,9,9,0,1.0,12,5,7,0.4166666666666667,0.5882352941176471,gemini,coral,pdac,PROMPT1_ICL_entailment
111,199,29,27,2,0.9310344827586208,9,9,0,1.0,0.9642857142857144,gemini,coral,pdac,PROMPT1_ICL_entailment
112,2,29,23,6,0.7931034482758621,14,12,2,0.8571428571428571,0.8238805970149252,gemini,coral,pdac,PROMPT1_ICL_entailment
113,20,30,22,8,0.7333333333333333,18,14,4,0.7777777777777778,0.7549019607843137,gemini,coral,pdac,PROMPT1_ICL_entailment
114,200,34,29,5,0.8529411764705882,16,15,1,0.9375,0.8932238193018479,gemini,coral,pdac,PROMPT1_ICL_entailment
115,201,12,11,1,0.9166666666666666,10,10,0,1.0,0.9565217391304348,gemini,coral,pdac,PROMPT1_ICL_entailment
116,202,15,15,0,1.0,10,10,0,1.0,1.0,gemini,coral,pdac,PROMPT1_ICL_entailment
117,203,34,29,5,0.8529411764705882,31,24,7,0.7741935483870968,0.8116618075801749,gemini,coral,pdac,PROMPT1_ICL_entailment
118,204,21,17,4,0.8095238095238095,14,11,3,0.7857142857142857,0.7974413646055437,gemini,coral,pdac,PROMPT1_ICL_entailment
119,205,20,17,3,0.85,7,5,2,0.7142857142857143,0.776255707762557,gemini,coral,pdac,PROMPT1_ICL_entailment
120,206,11,8,3,0.7272727272727273,9,7,2,0.7777777777777778,0.7516778523489932,gemini,coral,pdac,PROMPT1_ICL_entailment
121,207,10,7,3,0.7,8,6,2,0.75,0.7241379310344827,gemini,coral,pdac,PROMPT1_ICL_entailment
122,208,8,7,1,0.875,8,7,1,0.875,0.875,gemini,coral,pdac,PROMPT1_ICL_entailment
123,209,34,31,3,0.9117647058823528,9,9,0,1.0,0.953846153846154,gemini,coral,pdac,PROMPT1_ICL_entailment
124,21,11,10,1,0.9090909090909092,10,10,0,1.0,0.9523809523809524,gemini,coral,pdac,PROMPT1_ICL_entailment
125,210,24,19,5,0.7916666666666666,9,8,1,0.8888888888888888,0.837465564738292,gemini,coral,pdac,PROMPT1_ICL_entailment
126,211,21,18,3,0.8571428571428571,8,5,3,0.625,0.7228915662650602,gemini,coral,pdac,PROMPT1_ICL_entailment
127,212,24,23,1,0.9583333333333334,17,17,0,1.0,0.9787234042553192,gemini,coral,pdac,PROMPT1_ICL_entailment
128,213,18,18,0,1.0,11,11,0,1.0,1.0,gemini,coral,pdac,PROMPT1_ICL_entailment
129,214,26,25,1,0.9615384615384616,18,11,7,0.6111111111111112,0.7472826086956521,gemini,coral,pdac,PROMPT1_ICL_entailment
130,215,20,10,10,0.5,12,6,6,0.5,0.5,gemini,coral,pdac,PROMPT1_ICL_entailment
131,216,14,10,4,0.7142857142857143,33,8,25,0.2424242424242424,0.3619909502262444,gemini,coral,pdac,PROMPT1_ICL_entailment
132,217,28,26,2,0.9285714285714286,19,14,5,0.7368421052631579,0.8216704288939053,gemini,coral,pdac,PROMPT1_ICL_entailment
133,218,26,25,1,0.9615384615384616,11,8,3,0.7272727272727273,0.8281573498964805,gemini,coral,pdac,PROMPT1_ICL_entailment
134,219,18,17,1,0.9444444444444444,8,6,2,0.75,0.8360655737704917,gemini,coral,pdac,PROMPT1_ICL_entailment
135,22,34,27,7,0.7941176470588235,17,15,2,0.8823529411764706,0.8359133126934986,gemini,coral,pdac,PROMPT1_ICL_entailment
136,220,29,23,6,0.7931034482758621,11,11,0,1.0,0.8846153846153846,gemini,coral,pdac,PROMPT1_ICL_entailment
137,221,17,16,1,0.9411764705882352,12,10,2,0.8333333333333334,0.8839779005524863,gemini,coral,pdac,PROMPT1_ICL_entailment
138,222,12,10,2,0.8333333333333334,11,11,0,1.0,0.9090909090909092,gemini,coral,pdac,PROMPT1_ICL_entailment
139,223,101,84,17,0.8316831683168316,37,34,3,0.918918918918919,0.8731274839498624,gemini,coral,pdac,PROMPT1_ICL_entailment
140,224,27,17,10,0.6296296296296297,8,8,0,1.0,0.7727272727272727,gemini,coral,pdac,PROMPT1_ICL_entailment
141,225,27,26,1,0.9629629629629628,13,11,2,0.8461538461538461,0.9007874015748032,gemini,coral,pdac,PROMPT1_ICL_entailment
142,226,20,19,1,0.95,11,10,1,0.9090909090909092,0.9290953545232272,gemini,coral,pdac,PROMPT1_ICL_entailment
143,227,23,18,5,0.782608695652174,10,10,0,1.0,0.878048780487805,gemini,coral,pdac,PROMPT1_ICL_entailment
144,228,21,21,0,1.0,9,9,0,1.0,1.0,gemini,coral,pdac,PROMPT1_ICL_entailment
145,229,22,22,0,1.0,9,8,1,0.8888888888888888,0.9411764705882352,gemini,coral,pdac,PROMPT1_ICL_entailment
146,23,19,16,3,0.8421052631578947,12,9,3,0.75,0.7933884297520661,gemini,coral,pdac,PROMPT1_ICL_entailment
147,230,18,15,3,0.8333333333333334,8,8,0,1.0,0.9090909090909092,gemini,coral,pdac,PROMPT1_ICL_entailment
148,24,15,15,0,1.0,9,8,1,0.8888888888888888,0.9411764705882352,gemini,coral,pdac,PROMPT1_ICL_entailment
149,25,19,17,2,0.8947368421052632,11,9,2,0.8181818181818182,0.8547486033519553,gemini,coral,pdac,PROMPT1_ICL_entailment
150,26,17,17,0,1.0,11,11,0,1.0,1.0,gemini,coral,pdac,PROMPT1_ICL_entailment
151,27,37,29,8,0.7837837837837838,12,10,2,0.8333333333333334,0.8077994428969358,gemini,coral,pdac,PROMPT1_ICL_entailment
152,28,39,37,2,0.9487179487179488,13,12,1,0.9230769230769232,0.9357218124341412,gemini,coral,pdac,PROMPT1_ICL_entailment
153,29,36,32,4,0.8888888888888888,9,7,2,0.7777777777777778,0.8296296296296296,gemini,coral,pdac,PROMPT1_ICL_entailment
154,3,16,13,3,0.8125,8,7,1,0.875,0.8425925925925926,gemini,coral,pdac,PROMPT1_ICL_entailment
155,30,31,24,7,0.7741935483870968,11,7,4,0.6363636363636364,0.6985446985446985,gemini,coral,pdac,PROMPT1_ICL_entailment
156,31,36,23,13,0.6388888888888888,11,11,0,1.0,0.7796610169491525,gemini,coral,pdac,PROMPT1_ICL_entailment
157,32,27,22,5,0.8148148148148148,11,6,5,0.5454545454545454,0.6534653465346534,gemini,coral,pdac,PROMPT1_ICL_entailment
158,33,23,16,7,0.6956521739130435,24,9,15,0.375,0.4873096446700508,gemini,coral,pdac,PROMPT1_ICL_entailment
159,34,9,9,0,1.0,10,9,1,0.9,0.9473684210526316,gemini,coral,pdac,PROMPT1_ICL_entailment
160,35,15,13,2,0.8666666666666667,10,10,0,1.0,0.9285714285714286,gemini,coral,pdac,PROMPT1_ICL_entailment
161,36,36,35,1,0.9722222222222222,44,36,8,0.8181818181818182,0.8885754583921016,gemini,coral,pdac,PROMPT1_ICL_entailment
162,37,26,21,5,0.8076923076923077,9,8,1,0.8888888888888888,0.8463476070528968,gemini,coral,pdac,PROMPT1_ICL_entailment
163,38,35,27,8,0.7714285714285715,13,10,3,0.7692307692307693,0.7703281027104139,gemini,coral,pdac,PROMPT1_ICL_entailment
164,39,14,12,2,0.8571428571428571,10,8,2,0.8,0.8275862068965518,gemini,coral,pdac,PROMPT1_ICL_entailment
165,4,28,27,1,0.9642857142857144,15,10,5,0.6666666666666666,0.7883211678832116,gemini,coral,pdac,PROMPT1_ICL_entailment
166,40,18,15,3,0.8333333333333334,10,9,1,0.9,0.8653846153846153,gemini,coral,pdac,PROMPT1_ICL_entailment
167,41,22,19,3,0.8636363636363636,8,6,2,0.75,0.8028169014084506,gemini,coral,pdac,PROMPT1_ICL_entailment
168,42,34,33,1,0.9705882352941176,11,9,2,0.8181818181818182,0.8878923766816144,gemini,coral,pdac,PROMPT1_ICL_entailment
169,43,31,30,1,0.967741935483871,13,9,4,0.6923076923076923,0.8071748878923767,gemini,coral,pdac,PROMPT1_ICL_entailment
170,44,14,13,1,0.9285714285714286,11,9,2,0.8181818181818182,0.8698884758364314,gemini,coral,pdac,PROMPT1_ICL_entailment
171,45,23,23,0,1.0,10,10,0,1.0,1.0,gemini,coral,pdac,PROMPT1_ICL_entailment
172,46,26,19,7,0.7307692307692307,11,9,2,0.8181818181818182,0.7720090293453725,gemini,coral,pdac,PROMPT1_ICL_entailment
173,47,35,34,1,0.9714285714285714,39,14,25,0.358974358974359,0.5242290748898678,gemini,coral,pdac,PROMPT1_ICL_entailment
174,48,13,7,6,0.5384615384615384,10,7,3,0.7,0.608695652173913,gemini,coral,pdac,PROMPT1_ICL_entailment
175,49,17,15,2,0.8823529411764706,10,8,2,0.8,0.8391608391608392,gemini,coral,pdac,PROMPT1_ICL_entailment
176,5,15,15,0,1.0,10,8,2,0.8,0.888888888888889,gemini,coral,pdac,PROMPT1_ICL_entailment
177,50,16,16,0,1.0,10,7,3,0.7,0.8235294117647058,gemini,coral,pdac,PROMPT1_ICL_entailment
178,51,13,11,2,0.8461538461538461,12,7,5,0.5833333333333334,0.6905829596412556,gemini,coral,pdac,PROMPT1_ICL_entailment
179,52,17,16,1,0.9411764705882352,10,6,4,0.6,0.7328244274809161,gemini,coral,pdac,PROMPT1_ICL_entailment
180,53,14,13,1,0.9285714285714286,8,8,0,1.0,0.962962962962963,gemini,coral,pdac,PROMPT1_ICL_entailment
181,54,9,8,1,0.8888888888888888,2,2,0,1.0,0.9411764705882352,gemini,coral,pdac,PROMPT1_ICL_entailment
182,55,23,23,0,1.0,10,9,1,0.9,0.9473684210526316,gemini,coral,pdac,PROMPT1_ICL_entailment
183,56,26,22,4,0.8461538461538461,8,6,2,0.75,0.7951807228915662,gemini,coral,pdac,PROMPT1_ICL_entailment
184,57,54,37,17,0.6851851851851852,13,9,4,0.6923076923076923,0.688728024819028,gemini,coral,pdac,PROMPT1_ICL_entailment
185,58,42,38,4,0.9047619047619048,10,10,0,1.0,0.95,gemini,coral,pdac,PROMPT1_ICL_entailment
186,59,35,26,9,0.7428571428571429,21,12,9,0.5714285714285714,0.6459627329192547,gemini,coral,pdac,PROMPT1_ICL_entailment
187,6,21,19,2,0.9047619047619048,12,9,3,0.75,0.8201438848920864,gemini,coral,pdac,PROMPT1_ICL_entailment
188,60,37,35,2,0.945945945945946,13,7,6,0.5384615384615384,0.6862745098039216,gemini,coral,pdac,PROMPT1_ICL_entailment
189,61,18,17,1,0.9444444444444444,7,7,0,1.0,0.9714285714285714,gemini,coral,pdac,PROMPT1_ICL_entailment
190,62,21,14,7,0.6666666666666666,11,9,2,0.8181818181818182,0.7346938775510203,gemini,coral,pdac,PROMPT1_ICL_entailment
191,63,11,11,0,1.0,10,9,1,0.9,0.9473684210526316,gemini,coral,pdac,PROMPT1_ICL_entailment
192,64,19,18,1,0.9473684210526316,12,11,1,0.9166666666666666,0.9317647058823528,gemini,coral,pdac,PROMPT1_ICL_entailment
193,65,25,22,3,0.88,9,9,0,1.0,0.9361702127659576,gemini,coral,pdac,PROMPT1_ICL_entailment
194,66,27,23,4,0.8518518518518519,12,6,6,0.5,0.6301369863013698,gemini,coral,pdac,PROMPT1_ICL_entailment
195,67,12,12,0,1.0,1,1,0,1.0,1.0,gemini,coral,pdac,PROMPT1_ICL_entailment
196,68,18,16,2,0.8888888888888888,11,10,1,0.9090909090909092,0.8988764044943819,gemini,coral,pdac,PROMPT1_ICL_entailment
197,69,24,22,2,0.9166666666666666,10,10,0,1.0,0.9565217391304348,gemini,coral,pdac,PROMPT1_ICL_entailment
198,7,18,16,2,0.8888888888888888,11,10,1,0.9090909090909092,0.8988764044943819,gemini,coral,pdac,PROMPT1_ICL_entailment
199,70,35,35,0,1.0,15,11,4,0.7333333333333333,0.846153846153846,gemini,coral,pdac,PROMPT1_ICL_entailment
200,71,44,33,11,0.75,9,9,0,1.0,0.8571428571428571,gemini,coral,pdac,PROMPT1_ICL_entailment
201,72,17,16,1,0.9411764705882352,13,9,4,0.6923076923076923,0.7977839335180056,gemini,coral,pdac,PROMPT1_ICL_entailment
202,73,12,3,9,0.25,154,5,149,0.0324675324675324,0.057471264367816,gemini,coral,pdac,PROMPT1_ICL_entailment
203,74,26,22,4,0.8461538461538461,8,8,0,1.0,0.9166666666666666,gemini,coral,pdac,PROMPT1_ICL_entailment
204,75,21,16,5,0.7619047619047619,7,6,1,0.8571428571428571,0.8067226890756302,gemini,coral,pdac,PROMPT1_ICL_entailment
205,76,11,10,1,0.9090909090909092,7,6,1,0.8571428571428571,0.8823529411764706,gemini,coral,pdac,PROMPT1_ICL_entailment
206,77,23,18,5,0.782608695652174,8,7,1,0.875,0.8262295081967214,gemini,coral,pdac,PROMPT1_ICL_entailment
207,78,8,5,3,0.625,8,6,2,0.75,0.6818181818181818,gemini,coral,pdac,PROMPT1_ICL_entailment
208,79,20,19,1,0.95,11,10,1,0.9090909090909092,0.9290953545232272,gemini,coral,pdac,PROMPT1_ICL_entailment
209,8,11,11,0,1.0,2,2,0,1.0,1.0,gemini,coral,pdac,PROMPT1_ICL_entailment
210,80,27,24,3,0.8888888888888888,9,6,3,0.6666666666666666,0.761904761904762,gemini,coral,pdac,PROMPT1_ICL_entailment
211,81,18,17,1,0.9444444444444444,6,5,1,0.8333333333333334,0.8854166666666667,gemini,coral,pdac,PROMPT1_ICL_entailment
212,82,24,24,0,1.0,4,3,1,0.75,0.8571428571428571,gemini,coral,pdac,PROMPT1_ICL_entailment
213,83,36,26,10,0.7222222222222222,11,7,4,0.6363636363636364,0.6765799256505576,gemini,coral,pdac,PROMPT1_ICL_entailment
214,84,28,23,5,0.8214285714285714,11,8,3,0.7272727272727273,0.7714884696016772,gemini,coral,pdac,PROMPT1_ICL_entailment
215,85,37,24,13,0.6486486486486487,35,29,6,0.8285714285714286,0.7276529012023,gemini,coral,pdac,PROMPT1_ICL_entailment
216,86,13,11,2,0.8461538461538461,10,9,1,0.9,0.8722466960352422,gemini,coral,pdac,PROMPT1_ICL_entailment
217,87,31,22,9,0.7096774193548387,7,7,0,1.0,0.8301886792452831,gemini,coral,pdac,PROMPT1_ICL_entailment
218,88,15,14,1,0.9333333333333332,8,5,3,0.625,0.7486631016042781,gemini,coral,pdac,PROMPT1_ICL_entailment
219,89,19,16,3,0.8421052631578947,10,9,1,0.9,0.8700906344410877,gemini,coral,pdac,PROMPT1_ICL_entailment
220,9,10,9,1,0.9,12,10,2,0.8333333333333334,0.8653846153846153,gemini,coral,pdac,PROMPT1_ICL_entailment
221,90,19,14,5,0.7368421052631579,9,6,3,0.6666666666666666,0.7,gemini,coral,pdac,PROMPT1_ICL_entailment
222,91,18,18,0,1.0,10,10,0,1.0,1.0,gemini,coral,pdac,PROMPT1_ICL_entailment
223,92,23,17,6,0.7391304347826086,10,10,0,1.0,0.85,gemini,coral,pdac,PROMPT1_ICL_entailment
224,93,15,15,0,1.0,9,8,1,0.8888888888888888,0.9411764705882352,gemini,coral,pdac,PROMPT1_ICL_entailment
225,94,16,12,4,0.75,7,7,0,1.0,0.8571428571428571,gemini,coral,pdac,PROMPT1_ICL_entailment
226,95,18,15,3,0.8333333333333334,8,8,0,1.0,0.9090909090909092,gemini,coral,pdac,PROMPT1_ICL_entailment
227,96,11,11,0,1.0,4,3,1,0.75,0.8571428571428571,gemini,coral,pdac,PROMPT1_ICL_entailment
228,97,15,13,2,0.8666666666666667,8,8,0,1.0,0.9285714285714286,gemini,coral,pdac,PROMPT1_ICL_entailment
229,98,29,28,1,0.9655172413793104,9,9,0,1.0,0.9824561403508772,gemini,coral,pdac,PROMPT1_ICL_entailment
230,99,22,20,2,0.9090909090909092,9,9,0,1.0,0.9523809523809524,gemini,coral,pdac,PROMPT1_ICL_entailment
0,0,26,23,3,0.8846153846153846,9,9,0,1.0,0.9387755102040816,gemini,coral,pdac,PROMPT2_ICL_entailment
1,1,23,21,2,0.9130434782608696,9,9,0,1.0,0.9545454545454544,gemini,coral,pdac,PROMPT2_ICL_entailment
2,10,36,32,4,0.8888888888888888,11,8,3,0.7272727272727273,0.7999999999999999,gemini,coral,pdac,PROMPT2_ICL_entailment
3,100,18,14,4,0.7777777777777778,11,10,1,0.9090909090909092,0.8383233532934132,gemini,coral,pdac,PROMPT2_ICL_entailment
4,101,16,13,3,0.8125,11,10,1,0.9090909090909092,0.858085808580858,gemini,coral,pdac,PROMPT2_ICL_entailment
5,102,48,45,3,0.9375,27,18,9,0.6666666666666666,0.7792207792207793,gemini,coral,pdac,PROMPT2_ICL_entailment
6,103,1,0,1,0.0,15,0,15,0.0,,gemini,coral,pdac,PROMPT2_ICL_entailment
7,104,45,36,9,0.8,12,12,0,1.0,0.888888888888889,gemini,coral,pdac,PROMPT2_ICL_entailment
8,105,26,16,10,0.6153846153846154,33,8,25,0.2424242424242424,0.3478260869565217,gemini,coral,pdac,PROMPT2_ICL_entailment
9,106,15,14,1,0.9333333333333332,10,10,0,1.0,0.9655172413793104,gemini,coral,pdac,PROMPT2_ICL_entailment
10,107,11,11,0,1.0,10,10,0,1.0,1.0,gemini,coral,pdac,PROMPT2_ICL_entailment
11,108,17,16,1,0.9411764705882352,10,10,0,1.0,0.9696969696969696,gemini,coral,pdac,PROMPT2_ICL_entailment
12,109,63,43,20,0.6825396825396826,34,29,5,0.8529411764705882,0.7582851930678018,gemini,coral,pdac,PROMPT2_ICL_entailment
13,11,21,14,7,0.6666666666666666,10,9,1,0.9,0.7659574468085106,gemini,coral,pdac,PROMPT2_ICL_entailment
14,110,21,20,1,0.9523809523809524,4,4,0,1.0,0.975609756097561,gemini,coral,pdac,PROMPT2_ICL_entailment
15,111,16,15,1,0.9375,3,3,0,1.0,0.967741935483871,gemini,coral,pdac,PROMPT2_ICL_entailment
16,112,22,18,4,0.8181818181818182,9,9,0,1.0,0.9,gemini,coral,pdac,PROMPT2_ICL_entailment
17,113,23,18,5,0.782608695652174,6,6,0,1.0,0.878048780487805,gemini,coral,pdac,PROMPT2_ICL_entailment
18,114,19,19,0,1.0,9,9,0,1.0,1.0,gemini,coral,pdac,PROMPT2_ICL_entailment
19,115,16,14,2,0.875,7,7,0,1.0,0.9333333333333332,gemini,coral,pdac,PROMPT2_ICL_entailment
20,116,8,7,1,0.875,2,2,0,1.0,0.9333333333333332,gemini,coral,pdac,PROMPT2_ICL_entailment
21,117,29,27,2,0.9310344827586208,8,7,1,0.875,0.9021479713603818,gemini,coral,pdac,PROMPT2_ICL_entailment
22,118,33,33,0,1.0,9,9,0,1.0,1.0,gemini,coral,pdac,PROMPT2_ICL_entailment
23,119,21,17,4,0.8095238095238095,12,10,2,0.8333333333333334,0.8212560386473431,gemini,coral,pdac,PROMPT2_ICL_entailment
24,12,23,18,5,0.782608695652174,10,9,1,0.9,0.8372093023255814,gemini,coral,pdac,PROMPT2_ICL_entailment
25,120,59,46,13,0.7796610169491526,13,11,2,0.8461538461538461,0.8115477145148356,gemini,coral,pdac,PROMPT2_ICL_entailment
26,121,29,27,2,0.9310344827586208,12,8,4,0.6666666666666666,0.776978417266187,gemini,coral,pdac,PROMPT2_ICL_entailment
27,122,48,40,8,0.8333333333333334,45,32,13,0.7111111111111111,0.7673860911270984,gemini,coral,pdac,PROMPT2_ICL_entailment
28,123,30,25,5,0.8333333333333334,10,8,2,0.8,0.816326530612245,gemini,coral,pdac,PROMPT2_ICL_entailment
29,124,8,8,0,1.0,3,3,0,1.0,1.0,gemini,coral,pdac,PROMPT2_ICL_entailment
30,125,26,24,2,0.9230769230769232,8,8,0,1.0,0.96,gemini,coral,pdac,PROMPT2_ICL_entailment
31,126,23,22,1,0.9565217391304348,10,9,1,0.9,0.9274004683840747,gemini,coral,pdac,PROMPT2_ICL_entailment
32,127,37,28,9,0.7567567567567568,30,10,20,0.3333333333333333,0.4628099173553718,gemini,coral,pdac,PROMPT2_ICL_entailment
33,128,54,43,11,0.7962962962962963,35,25,10,0.7142857142857143,0.7530647985989493,gemini,coral,pdac,PROMPT2_ICL_entailment
34,129,17,15,2,0.8823529411764706,11,11,0,1.0,0.9375,gemini,coral,pdac,PROMPT2_ICL_entailment
35,13,42,38,4,0.9047619047619048,13,11,2,0.8461538461538461,0.8744769874476986,gemini,coral,pdac,PROMPT2_ICL_entailment
36,130,27,24,3,0.8888888888888888,12,9,3,0.75,0.8135593220338982,gemini,coral,pdac,PROMPT2_ICL_entailment
37,131,25,22,3,0.88,12,6,6,0.5,0.6376811594202899,gemini,coral,pdac,PROMPT2_ICL_entailment
38,132,12,10,2,0.8333333333333334,10,8,2,0.8,0.816326530612245,gemini,coral,pdac,PROMPT2_ICL_entailment
39,133,28,27,1,0.9642857142857144,7,7,0,1.0,0.9818181818181818,gemini,coral,pdac,PROMPT2_ICL_entailment
40,134,1,0,1,0.0,15,0,15,0.0,,gemini,coral,pdac,PROMPT2_ICL_entailment
41,135,29,23,6,0.7931034482758621,9,8,1,0.8888888888888888,0.8382687927107061,gemini,coral,pdac,PROMPT2_ICL_entailment
42,136,43,32,11,0.7441860465116279,7,4,3,0.5714285714285714,0.6464646464646464,gemini,coral,pdac,PROMPT2_ICL_entailment
43,137,31,28,3,0.9032258064516128,10,9,1,0.9,0.9016100178890876,gemini,coral,pdac,PROMPT2_ICL_entailment
44,138,44,30,14,0.6818181818181818,25,17,8,0.68,0.6809078771695594,gemini,coral,pdac,PROMPT2_ICL_entailment
45,139,83,61,22,0.7349397590361446,62,40,22,0.6451612903225806,0.6871303858068148,gemini,coral,pdac,PROMPT2_ICL_entailment
46,14,14,13,1,0.9285714285714286,10,10,0,1.0,0.962962962962963,gemini,coral,pdac,PROMPT2_ICL_entailment
47,140,26,20,6,0.7692307692307693,8,8,0,1.0,0.8695652173913044,gemini,coral,pdac,PROMPT2_ICL_entailment
48,141,26,23,3,0.8846153846153846,11,8,3,0.7272727272727273,0.7982646420824295,gemini,coral,pdac,PROMPT2_ICL_entailment
49,142,15,12,3,0.8,11,8,3,0.7272727272727273,0.761904761904762,gemini,coral,pdac,PROMPT2_ICL_entailment
50,143,18,17,1,0.9444444444444444,9,8,1,0.8888888888888888,0.9158249158249158,gemini,coral,pdac,PROMPT2_ICL_entailment
51,144,25,23,2,0.92,12,9,3,0.75,0.8263473053892216,gemini,coral,pdac,PROMPT2_ICL_entailment
52,145,25,24,1,0.96,10,10,0,1.0,0.979591836734694,gemini,coral,pdac,PROMPT2_ICL_entailment
53,146,19,16,3,0.8421052631578947,7,6,1,0.8571428571428571,0.8495575221238938,gemini,coral,pdac,PROMPT2_ICL_entailment
54,147,18,15,3,0.8333333333333334,12,11,1,0.9166666666666666,0.8730158730158729,gemini,coral,pdac,PROMPT2_ICL_entailment
55,148,56,48,8,0.8571428571428571,25,20,5,0.8,0.8275862068965518,gemini,coral,pdac,PROMPT2_ICL_entailment
56,149,21,17,4,0.8095238095238095,7,5,2,0.7142857142857143,0.7589285714285714,gemini,coral,pdac,PROMPT2_ICL_entailment
57,15,11,11,0,1.0,10,10,0,1.0,1.0,gemini,coral,pdac,PROMPT2_ICL_entailment
58,150,25,20,5,0.8,8,8,0,1.0,0.888888888888889,gemini,coral,pdac,PROMPT2_ICL_entailment
59,151,24,23,1,0.9583333333333334,10,9,1,0.9,0.9282511210762332,gemini,coral,pdac,PROMPT2_ICL_entailment
60,152,22,22,0,1.0,11,9,2,0.8181818181818182,0.9,gemini,coral,pdac,PROMPT2_ICL_entailment
61,153,47,29,18,0.6170212765957447,30,17,13,0.5666666666666667,0.5907729179149191,gemini,coral,pdac,PROMPT2_ICL_entailment
62,154,37,28,9,0.7567567567567568,15,14,1,0.9333333333333332,0.835820895522388,gemini,coral,pdac,PROMPT2_ICL_entailment
63,155,48,42,6,0.875,47,36,11,0.7659574468085106,0.8168557536466775,gemini,coral,pdac,PROMPT2_ICL_entailment
64,156,25,23,2,0.92,10,10,0,1.0,0.9583333333333334,gemini,coral,pdac,PROMPT2_ICL_entailment
65,157,22,15,7,0.6818181818181818,14,9,5,0.6428571428571429,0.6617647058823529,gemini,coral,pdac,PROMPT2_ICL_entailment
66,158,19,17,2,0.8947368421052632,10,8,2,0.8,0.84472049689441,gemini,coral,pdac,PROMPT2_ICL_entailment
67,159,20,18,2,0.9,4,3,1,0.75,0.8181818181818182,gemini,coral,pdac,PROMPT2_ICL_entailment
68,16,65,52,13,0.8,31,24,7,0.7741935483870968,0.7868852459016393,gemini,coral,pdac,PROMPT2_ICL_entailment
69,160,26,17,9,0.6538461538461539,9,9,0,1.0,0.7906976744186047,gemini,coral,pdac,PROMPT2_ICL_entailment
70,161,27,26,1,0.9629629629629628,9,8,1,0.8888888888888888,0.9244444444444444,gemini,coral,pdac,PROMPT2_ICL_entailment
71,162,21,20,1,0.9523809523809524,10,10,0,1.0,0.975609756097561,gemini,coral,pdac,PROMPT2_ICL_entailment
72,163,24,20,4,0.8333333333333334,13,10,3,0.7692307692307693,0.8,gemini,coral,pdac,PROMPT2_ICL_entailment
73,164,49,44,5,0.8979591836734694,36,31,5,0.8611111111111112,0.8791492104415082,gemini,coral,pdac,PROMPT2_ICL_entailment
74,165,32,25,7,0.78125,10,9,1,0.9,0.8364312267657993,gemini,coral,pdac,PROMPT2_ICL_entailment
75,166,24,22,2,0.9166666666666666,11,6,5,0.5454545454545454,0.6839378238341969,gemini,coral,pdac,PROMPT2_ICL_entailment
76,167,20,17,3,0.85,8,7,1,0.875,0.8623188405797101,gemini,coral,pdac,PROMPT2_ICL_entailment
77,168,14,13,1,0.9285714285714286,6,6,0,1.0,0.962962962962963,gemini,coral,pdac,PROMPT2_ICL_entailment
78,169,15,15,0,1.0,7,7,0,1.0,1.0,gemini,coral,pdac,PROMPT2_ICL_entailment
79,17,16,16,0,1.0,5,5,0,1.0,1.0,gemini,coral,pdac,PROMPT2_ICL_entailment
80,170,51,39,12,0.7647058823529411,16,12,4,0.75,0.7572815533980582,gemini,coral,pdac,PROMPT2_ICL_entailment
81,171,37,27,10,0.7297297297297297,13,11,2,0.8461538461538461,0.783641160949868,gemini,coral,pdac,PROMPT2_ICL_entailment
82,172,22,15,7,0.6818181818181818,10,8,2,0.8,0.7361963190184048,gemini,coral,pdac,PROMPT2_ICL_entailment
83,173,51,40,11,0.7843137254901961,22,13,9,0.5909090909090909,0.6740116655865198,gemini,coral,pdac,PROMPT2_ICL_entailment
84,174,36,27,9,0.75,11,9,2,0.8181818181818182,0.7826086956521738,gemini,coral,pdac,PROMPT2_ICL_entailment
85,175,1,0,1,0.0,28,3,25,0.1071428571428571,0.0,gemini,coral,pdac,PROMPT2_ICL_entailment
86,176,15,15,0,1.0,10,10,0,1.0,1.0,gemini,coral,pdac,PROMPT2_ICL_entailment
87,177,16,16,0,1.0,10,10,0,1.0,1.0,gemini,coral,pdac,PROMPT2_ICL_entailment
88,178,76,40,36,0.5263157894736842,36,33,3,0.9166666666666666,0.668693009118541,gemini,coral,pdac,PROMPT2_ICL_entailment
89,179,13,12,1,0.9230769230769232,9,6,3,0.6666666666666666,0.7741935483870968,gemini,coral,pdac,PROMPT2_ICL_entailment
90,18,38,36,2,0.9473684210526316,15,6,9,0.4,0.5625,gemini,coral,pdac,PROMPT2_ICL_entailment
91,180,17,17,0,1.0,5,5,0,1.0,1.0,gemini,coral,pdac,PROMPT2_ICL_entailment
92,181,25,25,0,1.0,10,9,1,0.9,0.9473684210526316,gemini,coral,pdac,PROMPT2_ICL_entailment
93,182,24,22,2,0.9166666666666666,8,7,1,0.875,0.8953488372093024,gemini,coral,pdac,PROMPT2_ICL_entailment
94,183,31,27,4,0.8709677419354839,10,7,3,0.7,0.7761806981519507,gemini,coral,pdac,PROMPT2_ICL_entailment
95,184,19,11,8,0.5789473684210527,9,9,0,1.0,0.7333333333333334,gemini,coral,pdac,PROMPT2_ICL_entailment
96,185,30,26,4,0.8666666666666667,22,14,8,0.6363636363636364,0.7338709677419355,gemini,coral,pdac,PROMPT2_ICL_entailment
97,186,42,30,12,0.7142857142857143,32,17,15,0.53125,0.6093189964157705,gemini,coral,pdac,PROMPT2_ICL_entailment
98,187,78,49,29,0.6282051282051282,34,24,10,0.7058823529411765,0.6647823629169022,gemini,coral,pdac,PROMPT2_ICL_entailment
99,188,29,26,3,0.896551724137931,8,8,0,1.0,0.9454545454545454,gemini,coral,pdac,PROMPT2_ICL_entailment
100,189,25,22,3,0.88,5,5,0,1.0,0.9361702127659576,gemini,coral,pdac,PROMPT2_ICL_entailment
101,19,53,41,12,0.7735849056603774,21,15,6,0.7142857142857143,0.7427536231884059,gemini,coral,pdac,PROMPT2_ICL_entailment
102,190,61,55,6,0.9016393442622952,17,8,9,0.4705882352941176,0.6184118060435699,gemini,coral,pdac,PROMPT2_ICL_entailment
103,191,1,0,1,0.0,15,1,14,0.0666666666666666,0.0,gemini,coral,pdac,PROMPT2_ICL_entailment
104,192,49,41,8,0.8367346938775511,12,10,2,0.8333333333333334,0.8350305498981672,gemini,coral,pdac,PROMPT2_ICL_entailment
105,193,21,20,1,0.9523809523809524,10,10,0,1.0,0.975609756097561,gemini,coral,pdac,PROMPT2_ICL_entailment
106,194,19,15,4,0.7894736842105263,11,10,1,0.9090909090909092,0.8450704225352113,gemini,coral,pdac,PROMPT2_ICL_entailment
107,195,13,12,1,0.9230769230769232,7,6,1,0.8571428571428571,0.888888888888889,gemini,coral,pdac,PROMPT2_ICL_entailment
108,196,15,10,5,0.6666666666666666,8,4,4,0.5,0.5714285714285715,gemini,coral,pdac,PROMPT2_ICL_entailment
109,197,52,46,6,0.8846153846153846,9,7,2,0.7777777777777778,0.8277634961439589,gemini,coral,pdac,PROMPT2_ICL_entailment
110,198,30,25,5,0.8333333333333334,12,10,2,0.8333333333333334,0.8333333333333334,gemini,coral,pdac,PROMPT2_ICL_entailment
111,199,36,36,0,1.0,9,9,0,1.0,1.0,gemini,coral,pdac,PROMPT2_ICL_entailment
112,2,1,0,1,0.0,14,1,13,0.0714285714285714,0.0,gemini,coral,pdac,PROMPT2_ICL_entailment
113,20,33,21,12,0.6363636363636364,18,12,6,0.6666666666666666,0.6511627906976744,gemini,coral,pdac,PROMPT2_ICL_entailment
114,200,54,44,10,0.8148148148148148,16,13,3,0.8125,0.813655761024182,gemini,coral,pdac,PROMPT2_ICL_entailment
115,201,12,12,0,1.0,10,10,0,1.0,1.0,gemini,coral,pdac,PROMPT2_ICL_entailment
116,202,15,14,1,0.9333333333333332,10,10,0,1.0,0.9655172413793104,gemini,coral,pdac,PROMPT2_ICL_entailment
117,203,72,55,17,0.7638888888888888,31,23,8,0.7419354838709677,0.7527521570961023,gemini,coral,pdac,PROMPT2_ICL_entailment
118,204,34,28,6,0.8235294117647058,14,8,6,0.5714285714285714,0.6746987951807228,gemini,coral,pdac,PROMPT2_ICL_entailment
119,205,31,28,3,0.9032258064516128,7,5,2,0.7142857142857143,0.7977207977207977,gemini,coral,pdac,PROMPT2_ICL_entailment
120,206,23,20,3,0.8695652173913043,9,9,0,1.0,0.9302325581395348,gemini,coral,pdac,PROMPT2_ICL_entailment
121,207,17,13,4,0.7647058823529411,8,7,1,0.875,0.8161434977578476,gemini,coral,pdac,PROMPT2_ICL_entailment
122,208,18,16,2,0.8888888888888888,8,7,1,0.875,0.8818897637795274,gemini,coral,pdac,PROMPT2_ICL_entailment
123,209,38,36,2,0.9473684210526316,9,8,1,0.8888888888888888,0.9171974522292994,gemini,coral,pdac,PROMPT2_ICL_entailment
124,21,11,11,0,1.0,10,10,0,1.0,1.0,gemini,coral,pdac,PROMPT2_ICL_entailment
125,210,34,29,5,0.8529411764705882,9,9,0,1.0,0.9206349206349206,gemini,coral,pdac,PROMPT2_ICL_entailment
126,211,32,29,3,0.90625,8,8,0,1.0,0.9508196721311476,gemini,coral,pdac,PROMPT2_ICL_entailment
127,212,33,30,3,0.9090909090909092,17,15,2,0.8823529411764706,0.8955223880597014,gemini,coral,pdac,PROMPT2_ICL_entailment
128,213,29,25,4,0.8620689655172413,11,11,0,1.0,0.925925925925926,gemini,coral,pdac,PROMPT2_ICL_entailment
129,214,30,24,6,0.8,18,12,6,0.6666666666666666,0.7272727272727272,gemini,coral,pdac,PROMPT2_ICL_entailment
130,215,1,0,1,0.0,12,1,11,0.0833333333333333,0.0,gemini,coral,pdac,PROMPT2_ICL_entailment
131,216,53,43,10,0.8113207547169812,33,26,7,0.7878787878787878,0.7994279585269932,gemini,coral,pdac,PROMPT2_ICL_entailment
132,217,41,39,2,0.951219512195122,19,11,8,0.5789473684210527,0.7197986577181208,gemini,coral,pdac,PROMPT2_ICL_entailment
133,218,42,40,2,0.9523809523809524,11,8,3,0.7272727272727273,0.8247422680412371,gemini,coral,pdac,PROMPT2_ICL_entailment
134,219,19,17,2,0.8947368421052632,8,6,2,0.75,0.816,gemini,coral,pdac,PROMPT2_ICL_entailment
135,22,35,25,10,0.7142857142857143,17,14,3,0.8235294117647058,0.7650273224043717,gemini,coral,pdac,PROMPT2_ICL_entailment
136,220,36,29,7,0.8055555555555556,11,9,2,0.8181818181818182,0.8118195956454123,gemini,coral,pdac,PROMPT2_ICL_entailment
137,221,19,14,5,0.7368421052631579,12,7,5,0.5833333333333334,0.6511627906976745,gemini,coral,pdac,PROMPT2_ICL_entailment
138,222,15,11,4,0.7333333333333333,11,9,2,0.8181818181818182,0.7734375,gemini,coral,pdac,PROMPT2_ICL_entailment
139,223,90,68,22,0.7555555555555555,37,30,7,0.8108108108108109,0.7822085889570553,gemini,coral,pdac,PROMPT2_ICL_entailment
140,224,29,24,5,0.8275862068965517,8,7,1,0.875,0.8506329113924052,gemini,coral,pdac,PROMPT2_ICL_entailment
141,225,24,22,2,0.9166666666666666,13,10,3,0.7692307692307693,0.8365019011406845,gemini,coral,pdac,PROMPT2_ICL_entailment
142,226,20,19,1,0.95,11,9,2,0.8181818181818182,0.879177377892031,gemini,coral,pdac,PROMPT2_ICL_entailment
143,227,17,14,3,0.8235294117647058,10,8,2,0.8,0.8115942028985507,gemini,coral,pdac,PROMPT2_ICL_entailment
144,228,24,23,1,0.9583333333333334,9,9,0,1.0,0.9787234042553192,gemini,coral,pdac,PROMPT2_ICL_entailment
145,229,23,22,1,0.9565217391304348,9,8,1,0.8888888888888888,0.9214659685863874,gemini,coral,pdac,PROMPT2_ICL_entailment
146,23,28,24,4,0.8571428571428571,12,9,3,0.75,0.7999999999999999,gemini,coral,pdac,PROMPT2_ICL_entailment
147,230,21,20,1,0.9523809523809524,8,8,0,1.0,0.975609756097561,gemini,coral,pdac,PROMPT2_ICL_entailment
148,24,19,18,1,0.9473684210526316,9,7,2,0.7777777777777778,0.8542372881355932,gemini,coral,pdac,PROMPT2_ICL_entailment
149,25,34,26,8,0.7647058823529411,11,9,2,0.8181818181818182,0.7905405405405405,gemini,coral,pdac,PROMPT2_ICL_entailment
150,26,17,17,0,1.0,11,11,0,1.0,1.0,gemini,coral,pdac,PROMPT2_ICL_entailment
151,27,42,33,9,0.7857142857142857,12,10,2,0.8333333333333334,0.8088235294117647,gemini,coral,pdac,PROMPT2_ICL_entailment
152,28,46,45,1,0.9782608695652174,13,11,2,0.8461538461538461,0.9074243813015582,gemini,coral,pdac,PROMPT2_ICL_entailment
153,29,46,39,7,0.8478260869565217,9,5,4,0.5555555555555556,0.6712564543889845,gemini,coral,pdac,PROMPT2_ICL_entailment
154,3,22,19,3,0.8636363636363636,8,8,0,1.0,0.9268292682926828,gemini,coral,pdac,PROMPT2_ICL_entailment
155,30,46,43,3,0.9347826086956522,11,10,1,0.9090909090909092,0.9217577706323686,gemini,coral,pdac,PROMPT2_ICL_entailment
156,31,39,27,12,0.6923076923076923,11,11,0,1.0,0.8181818181818181,gemini,coral,pdac,PROMPT2_ICL_entailment
157,32,1,0,1,0.0,11,1,10,0.0909090909090909,0.0,gemini,coral,pdac,PROMPT2_ICL_entailment
158,33,22,10,12,0.4545454545454545,24,9,15,0.375,0.410958904109589,gemini,coral,pdac,PROMPT2_ICL_entailment
159,34,11,11,0,1.0,10,10,0,1.0,1.0,gemini,coral,pdac,PROMPT2_ICL_entailment
160,35,17,17,0,1.0,10,10,0,1.0,1.0,gemini,coral,pdac,PROMPT2_ICL_entailment
161,36,47,46,1,0.9787234042553192,44,36,8,0.8181818181818182,0.891280947255113,gemini,coral,pdac,PROMPT2_ICL_entailment
162,37,33,28,5,0.8484848484848485,9,7,2,0.7777777777777778,0.8115942028985507,gemini,coral,pdac,PROMPT2_ICL_entailment
163,38,31,23,8,0.7419354838709677,13,9,4,0.6923076923076923,0.7162629757785467,gemini,coral,pdac,PROMPT2_ICL_entailment
164,39,24,23,1,0.9583333333333334,10,9,1,0.9,0.9282511210762332,gemini,coral,pdac,PROMPT2_ICL_entailment
165,4,40,33,7,0.825,15,10,5,0.6666666666666666,0.7374301675977653,gemini,coral,pdac,PROMPT2_ICL_entailment
166,40,15,12,3,0.8,10,6,4,0.6,0.6857142857142857,gemini,coral,pdac,PROMPT2_ICL_entailment
167,41,27,22,5,0.8148148148148148,8,8,0,1.0,0.8979591836734693,gemini,coral,pdac,PROMPT2_ICL_entailment
168,42,35,31,4,0.8857142857142857,11,9,2,0.8181818181818182,0.850609756097561,gemini,coral,pdac,PROMPT2_ICL_entailment
169,43,44,44,0,1.0,13,10,3,0.7692307692307693,0.8695652173913044,gemini,coral,pdac,PROMPT2_ICL_entailment
170,44,26,22,4,0.8461538461538461,11,11,0,1.0,0.9166666666666666,gemini,coral,pdac,PROMPT2_ICL_entailment
171,45,28,28,0,1.0,10,10,0,1.0,1.0,gemini,coral,pdac,PROMPT2_ICL_entailment
172,46,26,22,4,0.8461538461538461,11,10,1,0.9090909090909092,0.8764940239043824,gemini,coral,pdac,PROMPT2_ICL_entailment
173,47,37,33,4,0.8918918918918919,39,20,19,0.5128205128205128,0.651208682782437,gemini,coral,pdac,PROMPT2_ICL_entailment
174,48,13,8,5,0.6153846153846154,10,6,4,0.6,0.6075949367088608,gemini,coral,pdac,PROMPT2_ICL_entailment
175,49,20,18,2,0.9,10,8,2,0.8,0.8470588235294118,gemini,coral,pdac,PROMPT2_ICL_entailment
176,5,14,13,1,0.9285714285714286,10,7,3,0.7,0.7982456140350878,gemini,coral,pdac,PROMPT2_ICL_entailment
177,50,20,19,1,0.95,10,9,1,0.9,0.9243243243243242,gemini,coral,pdac,PROMPT2_ICL_entailment
178,51,17,10,7,0.5882352941176471,12,7,5,0.5833333333333334,0.5857740585774059,gemini,coral,pdac,PROMPT2_ICL_entailment
179,52,31,26,5,0.8387096774193549,10,10,0,1.0,0.912280701754386,gemini,coral,pdac,PROMPT2_ICL_entailment
180,53,16,14,2,0.875,8,8,0,1.0,0.9333333333333332,gemini,coral,pdac,PROMPT2_ICL_entailment
181,54,6,6,0,1.0,2,2,0,1.0,1.0,gemini,coral,pdac,PROMPT2_ICL_entailment
182,55,50,49,1,0.98,10,8,2,0.8,0.8808988764044944,gemini,coral,pdac,PROMPT2_ICL_entailment
183,56,32,29,3,0.90625,8,7,1,0.875,0.8903508771929824,gemini,coral,pdac,PROMPT2_ICL_entailment
184,57,87,56,31,0.6436781609195402,13,10,3,0.7692307692307693,0.7008760951188986,gemini,coral,pdac,PROMPT2_ICL_entailment
185,58,48,43,5,0.8958333333333334,10,10,0,1.0,0.945054945054945,gemini,coral,pdac,PROMPT2_ICL_entailment
186,59,41,34,7,0.8292682926829268,21,13,8,0.6190476190476191,0.7089013632718525,gemini,coral,pdac,PROMPT2_ICL_entailment
187,6,23,19,4,0.8260869565217391,12,9,3,0.75,0.786206896551724,gemini,coral,pdac,PROMPT2_ICL_entailment
188,60,36,35,1,0.9722222222222222,13,9,4,0.6923076923076923,0.8087291399229781,gemini,coral,pdac,PROMPT2_ICL_entailment
189,61,24,23,1,0.9583333333333334,7,7,0,1.0,0.9787234042553192,gemini,coral,pdac,PROMPT2_ICL_entailment
190,62,26,17,9,0.6538461538461539,11,10,1,0.9090909090909092,0.7606263982102908,gemini,coral,pdac,PROMPT2_ICL_entailment
191,63,14,14,0,1.0,10,10,0,1.0,1.0,gemini,coral,pdac,PROMPT2_ICL_entailment
192,64,23,21,2,0.9130434782608696,12,12,0,1.0,0.9545454545454544,gemini,coral,pdac,PROMPT2_ICL_entailment
193,65,43,39,4,0.9069767441860463,9,8,1,0.8888888888888888,0.897841726618705,gemini,coral,pdac,PROMPT2_ICL_entailment
194,66,33,31,2,0.9393939393939394,12,9,3,0.75,0.8340807174887893,gemini,coral,pdac,PROMPT2_ICL_entailment
195,67,15,13,2,0.8666666666666667,1,1,0,1.0,0.9285714285714286,gemini,coral,pdac,PROMPT2_ICL_entailment
196,68,30,30,0,1.0,11,10,1,0.9090909090909092,0.9523809523809524,gemini,coral,pdac,PROMPT2_ICL_entailment
197,69,32,31,1,0.96875,10,10,0,1.0,0.984126984126984,gemini,coral,pdac,PROMPT2_ICL_entailment
198,7,18,16,2,0.8888888888888888,11,9,2,0.8181818181818182,0.8520710059171598,gemini,coral,pdac,PROMPT2_ICL_entailment
199,70,43,38,5,0.8837209302325582,15,15,0,1.0,0.9382716049382716,gemini,coral,pdac,PROMPT2_ICL_entailment
200,71,44,15,29,0.3409090909090909,9,9,0,1.0,0.5084745762711864,gemini,coral,pdac,PROMPT2_ICL_entailment
201,72,24,20,4,0.8333333333333334,13,9,4,0.6923076923076923,0.7563025210084034,gemini,coral,pdac,PROMPT2_ICL_entailment
202,73,145,40,105,0.2758620689655172,154,81,73,0.525974025974026,0.3619100809829656,gemini,coral,pdac,PROMPT2_ICL_entailment
203,74,28,19,9,0.6785714285714286,8,8,0,1.0,0.8085106382978724,gemini,coral,pdac,PROMPT2_ICL_entailment
204,75,28,24,4,0.8571428571428571,7,6,1,0.8571428571428571,0.8571428571428571,gemini,coral,pdac,PROMPT2_ICL_entailment
205,76,13,12,1,0.9230769230769232,7,6,1,0.8571428571428571,0.888888888888889,gemini,coral,pdac,PROMPT2_ICL_entailment
206,77,43,32,11,0.7441860465116279,8,8,0,1.0,0.8533333333333333,gemini,coral,pdac,PROMPT2_ICL_entailment
207,78,19,17,2,0.8947368421052632,8,7,1,0.875,0.8847583643122676,gemini,coral,pdac,PROMPT2_ICL_entailment
208,79,39,36,3,0.9230769230769232,11,9,2,0.8181818181818182,0.8674698795180724,gemini,coral,pdac,PROMPT2_ICL_entailment
209,8,14,14,0,1.0,2,2,0,1.0,1.0,gemini,coral,pdac,PROMPT2_ICL_entailment
210,80,38,37,1,0.9736842105263158,9,5,4,0.5555555555555556,0.7074569789674953,gemini,coral,pdac,PROMPT2_ICL_entailment
211,81,22,19,3,0.8636363636363636,6,4,2,0.6666666666666666,0.7524752475247524,gemini,coral,pdac,PROMPT2_ICL_entailment
212,82,42,41,1,0.9761904761904762,4,4,0,1.0,0.9879518072289156,gemini,coral,pdac,PROMPT2_ICL_entailment
213,83,35,31,4,0.8857142857142857,11,4,7,0.3636363636363636,0.5155925155925155,gemini,coral,pdac,PROMPT2_ICL_entailment
214,84,34,25,9,0.7352941176470589,11,8,3,0.7272727272727273,0.7312614259597806,gemini,coral,pdac,PROMPT2_ICL_entailment
215,85,49,40,9,0.8163265306122449,35,26,9,0.7428571428571429,0.7778608825729245,gemini,coral,pdac,PROMPT2_ICL_entailment
216,86,21,20,1,0.9523809523809524,10,8,2,0.8,0.8695652173913043,gemini,coral,pdac,PROMPT2_ICL_entailment
217,87,44,32,12,0.7272727272727273,7,7,0,1.0,0.8421052631578948,gemini,coral,pdac,PROMPT2_ICL_entailment
218,88,25,23,2,0.92,8,7,1,0.875,0.8969359331476324,gemini,coral,pdac,PROMPT2_ICL_entailment
219,89,27,19,8,0.7037037037037037,10,9,1,0.9,0.7898383371824482,gemini,coral,pdac,PROMPT2_ICL_entailment
220,9,19,19,0,1.0,12,8,4,0.6666666666666666,0.8,gemini,coral,pdac,PROMPT2_ICL_entailment
221,90,29,25,4,0.8620689655172413,9,9,0,1.0,0.925925925925926,gemini,coral,pdac,PROMPT2_ICL_entailment
222,91,27,27,0,1.0,10,10,0,1.0,1.0,gemini,coral,pdac,PROMPT2_ICL_entailment
223,92,28,27,1,0.9642857142857144,10,10,0,1.0,0.9818181818181818,gemini,coral,pdac,PROMPT2_ICL_entailment
224,93,22,19,3,0.8636363636363636,9,7,2,0.7777777777777778,0.8184615384615385,gemini,coral,pdac,PROMPT2_ICL_entailment
225,94,31,22,9,0.7096774193548387,7,7,0,1.0,0.8301886792452831,gemini,coral,pdac,PROMPT2_ICL_entailment
226,95,27,22,5,0.8148148148148148,8,7,1,0.875,0.843835616438356,gemini,coral,pdac,PROMPT2_ICL_entailment
227,96,17,16,1,0.9411764705882352,4,4,0,1.0,0.9696969696969696,gemini,coral,pdac,PROMPT2_ICL_entailment
228,97,24,20,4,0.8333333333333334,8,8,0,1.0,0.9090909090909092,gemini,coral,pdac,PROMPT2_ICL_entailment
229,98,36,34,2,0.9444444444444444,9,8,1,0.8888888888888888,0.9158249158249158,gemini,coral,pdac,PROMPT2_ICL_entailment
230,99,27,25,2,0.925925925925926,9,9,0,1.0,0.9615384615384616,gemini,coral,pdac,PROMPT2_ICL_entailment
0,0,17,17,0,1.0,9,9,0,1.0,1.0,gemini,coral,pdac,PROMPT2_entailment
1,1,19,17,2,0.8947368421052632,9,9,0,1.0,0.9444444444444444,gemini,coral,pdac,PROMPT2_entailment
2,10,19,19,0,1.0,11,7,4,0.6363636363636364,0.7777777777777778,gemini,coral,pdac,PROMPT2_entailment
3,100,17,13,4,0.7647058823529411,11,10,1,0.9090909090909092,0.8306709265175718,gemini,coral,pdac,PROMPT2_entailment
4,101,15,5,10,0.3333333333333333,11,10,1,0.9090909090909092,0.4878048780487804,gemini,coral,pdac,PROMPT2_entailment
5,102,25,23,2,0.92,27,19,8,0.7037037037037037,0.7974452554744527,gemini,coral,pdac,PROMPT2_entailment
6,103,29,22,7,0.7586206896551724,15,10,5,0.6666666666666666,0.7096774193548386,gemini,coral,pdac,PROMPT2_entailment
7,104,22,19,3,0.8636363636363636,12,11,1,0.9166666666666666,0.8893617021276595,gemini,coral,pdac,PROMPT2_entailment
8,105,32,18,14,0.5625,33,14,19,0.4242424242424242,0.4836852207293666,gemini,coral,pdac,PROMPT2_entailment
9,106,14,13,1,0.9285714285714286,10,10,0,1.0,0.962962962962963,gemini,coral,pdac,PROMPT2_entailment
10,107,11,10,1,0.9090909090909092,10,10,0,1.0,0.9523809523809524,gemini,coral,pdac,PROMPT2_entailment
11,108,18,17,1,0.9444444444444444,10,10,0,1.0,0.9714285714285714,gemini,coral,pdac,PROMPT2_entailment
12,109,28,21,7,0.75,34,28,6,0.8235294117647058,0.7850467289719627,gemini,coral,pdac,PROMPT2_entailment
13,11,20,12,8,0.6,10,8,2,0.8,0.6857142857142857,gemini,coral,pdac,PROMPT2_entailment
14,110,7,7,0,1.0,4,4,0,1.0,1.0,gemini,coral,pdac,PROMPT2_entailment
15,111,12,11,1,0.9166666666666666,3,3,0,1.0,0.9565217391304348,gemini,coral,pdac,PROMPT2_entailment
16,112,17,15,2,0.8823529411764706,9,9,0,1.0,0.9375,gemini,coral,pdac,PROMPT2_entailment
17,113,14,10,4,0.7142857142857143,6,5,1,0.8333333333333334,0.7692307692307692,gemini,coral,pdac,PROMPT2_entailment
18,114,14,13,1,0.9285714285714286,9,9,0,1.0,0.962962962962963,gemini,coral,pdac,PROMPT2_entailment
19,115,17,16,1,0.9411764705882352,7,7,0,1.0,0.9696969696969696,gemini,coral,pdac,PROMPT2_entailment
20,116,7,7,0,1.0,2,2,0,1.0,1.0,gemini,coral,pdac,PROMPT2_entailment
21,117,24,23,1,0.9583333333333334,8,7,1,0.875,0.9147727272727272,gemini,coral,pdac,PROMPT2_entailment
22,118,26,25,1,0.9615384615384616,9,9,0,1.0,0.9803921568627452,gemini,coral,pdac,PROMPT2_entailment
23,119,20,13,7,0.65,12,10,2,0.8333333333333334,0.7303370786516855,gemini,coral,pdac,PROMPT2_entailment
24,12,24,19,5,0.7916666666666666,10,10,0,1.0,0.8837209302325582,gemini,coral,pdac,PROMPT2_entailment
25,120,16,12,4,0.75,13,11,2,0.8461538461538461,0.7951807228915662,gemini,coral,pdac,PROMPT2_entailment
26,121,26,21,5,0.8076923076923077,12,10,2,0.8333333333333334,0.8203125000000001,gemini,coral,pdac,PROMPT2_entailment
27,122,50,45,5,0.9,45,32,13,0.7111111111111111,0.7944827586206896,gemini,coral,pdac,PROMPT2_entailment
28,123,21,20,1,0.9523809523809524,10,7,3,0.7,0.8069164265129684,gemini,coral,pdac,PROMPT2_entailment
29,124,5,5,0,1.0,3,3,0,1.0,1.0,gemini,coral,pdac,PROMPT2_entailment
30,125,21,20,1,0.9523809523809524,8,7,1,0.875,0.9120521172638436,gemini,coral,pdac,PROMPT2_entailment
31,126,16,16,0,1.0,10,9,1,0.9,0.9473684210526316,gemini,coral,pdac,PROMPT2_entailment
32,127,31,22,9,0.7096774193548387,30,10,20,0.3333333333333333,0.4536082474226804,gemini,coral,pdac,PROMPT2_entailment
33,128,34,32,2,0.9411764705882352,35,23,12,0.6571428571428571,0.7739221871713985,gemini,coral,pdac,PROMPT2_entailment
34,129,15,13,2,0.8666666666666667,11,8,3,0.7272727272727273,0.790874524714829,gemini,coral,pdac,PROMPT2_entailment
35,13,19,17,2,0.8947368421052632,13,8,5,0.6153846153846154,0.7292225201072386,gemini,coral,pdac,PROMPT2_entailment
36,130,22,19,3,0.8636363636363636,12,6,6,0.5,0.6333333333333333,gemini,coral,pdac,PROMPT2_entailment
37,131,18,17,1,0.9444444444444444,12,6,6,0.5,0.6538461538461539,gemini,coral,pdac,PROMPT2_entailment
38,132,13,12,1,0.9230769230769232,10,9,1,0.9,0.9113924050632912,gemini,coral,pdac,PROMPT2_entailment
39,133,17,15,2,0.8823529411764706,7,6,1,0.8571428571428571,0.8695652173913043,gemini,coral,pdac,PROMPT2_entailment
40,134,28,25,3,0.8928571428571429,15,9,6,0.6,0.7177033492822966,gemini,coral,pdac,PROMPT2_entailment
41,135,24,20,4,0.8333333333333334,9,8,1,0.8888888888888888,0.8602150537634408,gemini,coral,pdac,PROMPT2_entailment
42,136,37,31,6,0.8378378378378378,7,2,5,0.2857142857142857,0.4261168384879725,gemini,coral,pdac,PROMPT2_entailment
43,137,27,21,6,0.7777777777777778,10,9,1,0.9,0.8344370860927153,gemini,coral,pdac,PROMPT2_entailment
44,138,30,25,5,0.8333333333333334,25,15,10,0.6,0.6976744186046512,gemini,coral,pdac,PROMPT2_entailment
45,139,96,65,31,0.6770833333333334,62,43,19,0.6935483870967742,0.6852169649423879,gemini,coral,pdac,PROMPT2_entailment
46,14,13,12,1,0.9230769230769232,10,10,0,1.0,0.96,gemini,coral,pdac,PROMPT2_entailment
47,140,22,20,2,0.9090909090909092,8,7,1,0.875,0.8917197452229298,gemini,coral,pdac,PROMPT2_entailment
48,141,24,20,4,0.8333333333333334,11,9,2,0.8181818181818182,0.8256880733944955,gemini,coral,pdac,PROMPT2_entailment
49,142,15,9,6,0.6,11,8,3,0.7272727272727273,0.6575342465753425,gemini,coral,pdac,PROMPT2_entailment
50,143,15,13,2,0.8666666666666667,9,8,1,0.8888888888888888,0.8776371308016878,gemini,coral,pdac,PROMPT2_entailment
51,144,14,12,2,0.8571428571428571,12,9,3,0.75,0.7999999999999999,gemini,coral,pdac,PROMPT2_entailment
52,145,19,18,1,0.9473684210526316,10,8,2,0.8,0.8674698795180723,gemini,coral,pdac,PROMPT2_entailment
53,146,12,12,0,1.0,7,5,2,0.7142857142857143,0.8333333333333333,gemini,coral,pdac,PROMPT2_entailment
54,147,15,14,1,0.9333333333333332,12,11,1,0.9166666666666666,0.9249249249249248,gemini,coral,pdac,PROMPT2_entailment
55,148,36,29,7,0.8055555555555556,25,13,12,0.52,0.6320201173512154,gemini,coral,pdac,PROMPT2_entailment
56,149,20,19,1,0.95,7,5,2,0.7142857142857143,0.8154506437768242,gemini,coral,pdac,PROMPT2_entailment
57,15,11,11,0,1.0,10,10,0,1.0,1.0,gemini,coral,pdac,PROMPT2_entailment
58,150,20,19,1,0.95,8,8,0,1.0,0.9743589743589745,gemini,coral,pdac,PROMPT2_entailment
59,151,21,21,0,1.0,10,9,1,0.9,0.9473684210526316,gemini,coral,pdac,PROMPT2_entailment
60,152,19,19,0,1.0,11,8,3,0.7272727272727273,0.8421052631578948,gemini,coral,pdac,PROMPT2_entailment
61,153,36,26,10,0.7222222222222222,30,15,15,0.5,0.5909090909090908,gemini,coral,pdac,PROMPT2_entailment
62,154,34,28,6,0.8235294117647058,15,13,2,0.8666666666666667,0.8445475638051044,gemini,coral,pdac,PROMPT2_entailment
63,155,35,33,2,0.9428571428571428,47,22,25,0.4680851063829787,0.6255924170616114,gemini,coral,pdac,PROMPT2_entailment
64,156,18,16,2,0.8888888888888888,10,9,1,0.9,0.8944099378881988,gemini,coral,pdac,PROMPT2_entailment
65,157,17,15,2,0.8823529411764706,14,7,7,0.5,0.6382978723404256,gemini,coral,pdac,PROMPT2_entailment
66,158,12,12,0,1.0,10,7,3,0.7,0.8235294117647058,gemini,coral,pdac,PROMPT2_entailment
67,159,19,18,1,0.9473684210526316,4,4,0,1.0,0.972972972972973,gemini,coral,pdac,PROMPT2_entailment
68,16,45,37,8,0.8222222222222222,31,25,6,0.8064516129032258,0.8142605633802816,gemini,coral,pdac,PROMPT2_entailment
69,160,15,14,1,0.9333333333333332,9,8,1,0.8888888888888888,0.9105691056910568,gemini,coral,pdac,PROMPT2_entailment
70,161,18,17,1,0.9444444444444444,9,8,1,0.8888888888888888,0.9158249158249158,gemini,coral,pdac,PROMPT2_entailment
71,162,21,19,2,0.9047619047619048,10,10,0,1.0,0.95,gemini,coral,pdac,PROMPT2_entailment
72,163,25,19,6,0.76,13,10,3,0.7692307692307693,0.7645875251509054,gemini,coral,pdac,PROMPT2_entailment
73,164,41,33,8,0.8048780487804879,36,30,6,0.8333333333333334,0.8188585607940447,gemini,coral,pdac,PROMPT2_entailment
74,165,27,18,9,0.6666666666666666,10,6,4,0.6,0.631578947368421,gemini,coral,pdac,PROMPT2_entailment
75,166,14,14,0,1.0,11,5,6,0.4545454545454545,0.625,gemini,coral,pdac,PROMPT2_entailment
76,167,15,14,1,0.9333333333333332,8,7,1,0.875,0.9032258064516128,gemini,coral,pdac,PROMPT2_entailment
77,168,12,11,1,0.9166666666666666,6,6,0,1.0,0.9565217391304348,gemini,coral,pdac,PROMPT2_entailment
78,169,10,10,0,1.0,7,7,0,1.0,1.0,gemini,coral,pdac,PROMPT2_entailment
79,17,12,12,0,1.0,5,5,0,1.0,1.0,gemini,coral,pdac,PROMPT2_entailment
80,170,38,27,11,0.7105263157894737,16,13,3,0.8125,0.7580993520518359,gemini,coral,pdac,PROMPT2_entailment
81,171,21,17,4,0.8095238095238095,13,7,6,0.5384615384615384,0.6467391304347826,gemini,coral,pdac,PROMPT2_entailment
82,172,18,10,8,0.5555555555555556,10,9,1,0.9,0.6870229007633587,gemini,coral,pdac,PROMPT2_entailment
83,173,34,25,9,0.7352941176470589,22,14,8,0.6363636363636364,0.6822612085769981,gemini,coral,pdac,PROMPT2_entailment
84,174,32,26,6,0.8125,11,9,2,0.8181818181818182,0.8153310104529616,gemini,coral,pdac,PROMPT2_entailment
85,175,1,0,1,0.0,28,3,25,0.1071428571428571,0.0,gemini,coral,pdac,PROMPT2_entailment
86,176,15,15,0,1.0,10,10,0,1.0,1.0,gemini,coral,pdac,PROMPT2_entailment
87,177,16,16,0,1.0,10,10,0,1.0,1.0,gemini,coral,pdac,PROMPT2_entailment
88,178,52,29,23,0.5576923076923077,36,28,8,0.7777777777777778,0.6496,gemini,coral,pdac,PROMPT2_entailment
89,179,10,9,1,0.9,9,7,2,0.7777777777777778,0.8344370860927153,gemini,coral,pdac,PROMPT2_entailment
90,18,22,21,1,0.9545454545454546,15,9,6,0.6,0.7368421052631579,gemini,coral,pdac,PROMPT2_entailment
91,180,12,12,0,1.0,5,4,1,0.8,0.888888888888889,gemini,coral,pdac,PROMPT2_entailment
92,181,22,22,0,1.0,10,8,2,0.8,0.888888888888889,gemini,coral,pdac,PROMPT2_entailment
93,182,19,18,1,0.9473684210526316,8,6,2,0.75,0.8372093023255814,gemini,coral,pdac,PROMPT2_entailment
94,183,18,16,2,0.8888888888888888,10,6,4,0.6,0.7164179104477612,gemini,coral,pdac,PROMPT2_entailment
95,184,13,9,4,0.6923076923076923,9,6,3,0.6666666666666666,0.6792452830188679,gemini,coral,pdac,PROMPT2_entailment
96,185,1,0,1,0.0,22,2,20,0.0909090909090909,0.0,gemini,coral,pdac,PROMPT2_entailment
97,186,26,21,5,0.8076923076923077,32,13,19,0.40625,0.5405940594059406,gemini,coral,pdac,PROMPT2_entailment
98,187,65,50,15,0.7692307692307693,34,27,7,0.7941176470588235,0.7814761215629523,gemini,coral,pdac,PROMPT2_entailment
99,188,21,19,2,0.9047619047619048,8,8,0,1.0,0.95,gemini,coral,pdac,PROMPT2_entailment
100,189,21,14,7,0.6666666666666666,5,5,0,1.0,0.8,gemini,coral,pdac,PROMPT2_entailment
101,19,24,15,9,0.625,21,10,11,0.4761904761904761,0.5405405405405405,gemini,coral,pdac,PROMPT2_entailment
102,190,41,34,7,0.8292682926829268,17,8,9,0.4705882352941176,0.6004415011037527,gemini,coral,pdac,PROMPT2_entailment
103,191,52,50,2,0.9615384615384616,15,12,3,0.8,0.8733624454148472,gemini,coral,pdac,PROMPT2_entailment
104,192,36,31,5,0.8611111111111112,12,10,2,0.8333333333333334,0.8469945355191256,gemini,coral,pdac,PROMPT2_entailment
105,193,21,18,3,0.8571428571428571,10,8,2,0.8,0.8275862068965518,gemini,coral,pdac,PROMPT2_entailment
106,194,15,12,3,0.8,11,10,1,0.9090909090909092,0.8510638297872342,gemini,coral,pdac,PROMPT2_entailment
107,195,10,10,0,1.0,7,4,3,0.5714285714285714,0.7272727272727273,gemini,coral,pdac,PROMPT2_entailment
108,196,17,15,2,0.8823529411764706,8,7,1,0.875,0.8786610878661087,gemini,coral,pdac,PROMPT2_entailment
109,197,33,32,1,0.9696969696969696,9,8,1,0.8888888888888888,0.927536231884058,gemini,coral,pdac,PROMPT2_entailment
110,198,10,8,2,0.8,12,7,5,0.5833333333333334,0.674698795180723,gemini,coral,pdac,PROMPT2_entailment
111,199,28,28,0,1.0,9,9,0,1.0,1.0,gemini,coral,pdac,PROMPT2_entailment
112,2,18,15,3,0.8333333333333334,14,12,2,0.8571428571428571,0.8450704225352113,gemini,coral,pdac,PROMPT2_entailment
113,20,1,0,1,0.0,18,0,18,0.0,,gemini,coral,pdac,PROMPT2_entailment
114,200,37,28,9,0.7567567567567568,16,11,5,0.6875,0.7204678362573099,gemini,coral,pdac,PROMPT2_entailment
115,201,12,11,1,0.9166666666666666,10,10,0,1.0,0.9565217391304348,gemini,coral,pdac,PROMPT2_entailment
116,202,16,16,0,1.0,10,10,0,1.0,1.0,gemini,coral,pdac,PROMPT2_entailment
117,203,34,30,4,0.8823529411764706,31,26,5,0.8387096774193549,0.8599779492833516,gemini,coral,pdac,PROMPT2_entailment
118,204,23,18,5,0.782608695652174,14,8,6,0.5714285714285714,0.6605504587155963,gemini,coral,pdac,PROMPT2_entailment
119,205,17,14,3,0.8235294117647058,7,6,1,0.8571428571428571,0.84,gemini,coral,pdac,PROMPT2_entailment
120,206,18,14,4,0.7777777777777778,9,9,0,1.0,0.8750000000000001,gemini,coral,pdac,PROMPT2_entailment
121,207,18,10,8,0.5555555555555556,8,5,3,0.625,0.5882352941176471,gemini,coral,pdac,PROMPT2_entailment
122,208,9,9,0,1.0,8,6,2,0.75,0.8571428571428571,gemini,coral,pdac,PROMPT2_entailment
123,209,24,21,3,0.875,9,9,0,1.0,0.9333333333333332,gemini,coral,pdac,PROMPT2_entailment
124,21,10,10,0,1.0,10,10,0,1.0,1.0,gemini,coral,pdac,PROMPT2_entailment
125,210,26,23,3,0.8846153846153846,9,8,1,0.8888888888888888,0.8867469879518072,gemini,coral,pdac,PROMPT2_entailment
126,211,21,20,1,0.9523809523809524,8,6,2,0.75,0.8391608391608391,gemini,coral,pdac,PROMPT2_entailment
127,212,28,26,2,0.9285714285714286,17,16,1,0.9411764705882352,0.9348314606741572,gemini,coral,pdac,PROMPT2_entailment
128,213,20,17,3,0.85,11,9,2,0.8181818181818182,0.8337874659400545,gemini,coral,pdac,PROMPT2_entailment
129,214,30,27,3,0.9,18,12,6,0.6666666666666666,0.7659574468085106,gemini,coral,pdac,PROMPT2_entailment
130,215,18,11,7,0.6111111111111112,12,7,5,0.5833333333333334,0.5968992248062015,gemini,coral,pdac,PROMPT2_entailment
131,216,35,28,7,0.8,33,29,4,0.8787878787878788,0.8375451263537907,gemini,coral,pdac,PROMPT2_entailment
132,217,35,32,3,0.9142857142857144,19,10,9,0.5263157894736842,0.6680584551148225,gemini,coral,pdac,PROMPT2_entailment
133,218,21,21,0,1.0,11,9,2,0.8181818181818182,0.9,gemini,coral,pdac,PROMPT2_entailment
134,219,14,10,4,0.7142857142857143,8,6,2,0.75,0.7317073170731706,gemini,coral,pdac,PROMPT2_entailment
135,22,29,19,10,0.6551724137931034,17,15,2,0.8823529411764706,0.7519788918205805,gemini,coral,pdac,PROMPT2_entailment
136,220,30,27,3,0.9,11,8,3,0.7272727272727273,0.8044692737430167,gemini,coral,pdac,PROMPT2_entailment
137,221,12,12,0,1.0,12,8,4,0.6666666666666666,0.8,gemini,coral,pdac,PROMPT2_entailment
138,222,26,16,10,0.6153846153846154,11,11,0,1.0,0.761904761904762,gemini,coral,pdac,PROMPT2_entailment
139,223,76,66,10,0.868421052631579,37,31,6,0.8378378378378378,0.8528553563984994,gemini,coral,pdac,PROMPT2_entailment
140,224,26,14,12,0.5384615384615384,8,7,1,0.875,0.6666666666666667,gemini,coral,pdac,PROMPT2_entailment
141,225,14,11,3,0.7857142857142857,13,6,7,0.4615384615384615,0.5814977973568282,gemini,coral,pdac,PROMPT2_entailment
142,226,19,18,1,0.9473684210526316,11,9,2,0.8181818181818182,0.8780487804878049,gemini,coral,pdac,PROMPT2_entailment
143,227,14,12,2,0.8571428571428571,10,8,2,0.8,0.8275862068965518,gemini,coral,pdac,PROMPT2_entailment
144,228,19,19,0,1.0,9,9,0,1.0,1.0,gemini,coral,pdac,PROMPT2_entailment
145,229,20,16,4,0.8,9,7,2,0.7777777777777778,0.7887323943661971,gemini,coral,pdac,PROMPT2_entailment
146,23,23,22,1,0.9565217391304348,12,9,3,0.75,0.8407643312101911,gemini,coral,pdac,PROMPT2_entailment
147,230,20,18,2,0.9,8,8,0,1.0,0.9473684210526316,gemini,coral,pdac,PROMPT2_entailment
148,24,17,17,0,1.0,9,7,2,0.7777777777777778,0.8750000000000001,gemini,coral,pdac,PROMPT2_entailment
149,25,16,14,2,0.875,11,9,2,0.8181818181818182,0.8456375838926175,gemini,coral,pdac,PROMPT2_entailment
150,26,14,13,1,0.9285714285714286,11,11,0,1.0,0.962962962962963,gemini,coral,pdac,PROMPT2_entailment
151,27,22,20,2,0.9090909090909092,12,10,2,0.8333333333333334,0.8695652173913043,gemini,coral,pdac,PROMPT2_entailment
152,28,43,39,4,0.9069767441860463,13,13,0,1.0,0.951219512195122,gemini,coral,pdac,PROMPT2_entailment
153,29,32,23,9,0.71875,9,6,3,0.6666666666666666,0.6917293233082707,gemini,coral,pdac,PROMPT2_entailment
154,3,24,20,4,0.8333333333333334,8,6,2,0.75,0.7894736842105262,gemini,coral,pdac,PROMPT2_entailment
155,30,43,34,9,0.7906976744186046,11,8,3,0.7272727272727273,0.7576601671309192,gemini,coral,pdac,PROMPT2_entailment
156,31,33,20,13,0.6060606060606061,11,11,0,1.0,0.7547169811320755,gemini,coral,pdac,PROMPT2_entailment
157,32,29,25,4,0.8620689655172413,11,5,6,0.4545454545454545,0.5952380952380951,gemini,coral,pdac,PROMPT2_entailment
158,33,29,18,11,0.6206896551724138,24,12,12,0.5,0.5538461538461539,gemini,coral,pdac,PROMPT2_entailment
159,34,10,10,0,1.0,10,10,0,1.0,1.0,gemini,coral,pdac,PROMPT2_entailment
160,35,15,14,1,0.9333333333333332,10,10,0,1.0,0.9655172413793104,gemini,coral,pdac,PROMPT2_entailment
161,36,36,32,4,0.8888888888888888,44,37,7,0.8409090909090909,0.8642335766423359,gemini,coral,pdac,PROMPT2_entailment
162,37,28,25,3,0.8928571428571429,9,8,1,0.8888888888888888,0.89086859688196,gemini,coral,pdac,PROMPT2_entailment
163,38,20,18,2,0.9,13,7,6,0.5384615384615384,0.6737967914438503,gemini,coral,pdac,PROMPT2_entailment
164,39,21,20,1,0.9523809523809524,10,9,1,0.9,0.9254498714652956,gemini,coral,pdac,PROMPT2_entailment
165,4,20,19,1,0.95,15,10,5,0.6666666666666666,0.7835051546391752,gemini,coral,pdac,PROMPT2_entailment
166,40,20,16,4,0.8,10,8,2,0.8,0.8000000000000002,gemini,coral,pdac,PROMPT2_entailment
167,41,22,21,1,0.9545454545454546,8,8,0,1.0,0.9767441860465116,gemini,coral,pdac,PROMPT2_entailment
168,42,30,27,3,0.9,11,11,0,1.0,0.9473684210526316,gemini,coral,pdac,PROMPT2_entailment
169,43,33,31,2,0.9393939393939394,13,9,4,0.6923076923076923,0.7971428571428573,gemini,coral,pdac,PROMPT2_entailment
170,44,20,19,1,0.95,11,10,1,0.9090909090909092,0.9290953545232272,gemini,coral,pdac,PROMPT2_entailment
171,45,24,24,0,1.0,10,10,0,1.0,1.0,gemini,coral,pdac,PROMPT2_entailment
172,46,24,17,7,0.7083333333333334,11,10,1,0.9090909090909092,0.7962529274004684,gemini,coral,pdac,PROMPT2_entailment
173,47,38,30,8,0.7894736842105263,39,24,15,0.6153846153846154,0.69164265129683,gemini,coral,pdac,PROMPT2_entailment
174,48,13,4,9,0.3076923076923077,10,7,3,0.7,0.4274809160305344,gemini,coral,pdac,PROMPT2_entailment
175,49,20,17,3,0.85,10,7,3,0.7,0.767741935483871,gemini,coral,pdac,PROMPT2_entailment
176,5,14,12,2,0.8571428571428571,10,8,2,0.8,0.8275862068965518,gemini,coral,pdac,PROMPT2_entailment
177,50,13,13,0,1.0,10,8,2,0.8,0.888888888888889,gemini,coral,pdac,PROMPT2_entailment
178,51,16,9,7,0.5625,12,9,3,0.75,0.6428571428571429,gemini,coral,pdac,PROMPT2_entailment
179,52,26,22,4,0.8461538461538461,10,10,0,1.0,0.9166666666666666,gemini,coral,pdac,PROMPT2_entailment
180,53,17,15,2,0.8823529411764706,8,8,0,1.0,0.9375,gemini,coral,pdac,PROMPT2_entailment
181,54,5,5,0,1.0,2,2,0,1.0,1.0,gemini,coral,pdac,PROMPT2_entailment
182,55,26,26,0,1.0,10,8,2,0.8,0.888888888888889,gemini,coral,pdac,PROMPT2_entailment
183,56,29,26,3,0.896551724137931,8,5,3,0.625,0.7365439093484418,gemini,coral,pdac,PROMPT2_entailment
184,57,54,31,23,0.5740740740740741,13,7,6,0.5384615384615384,0.5556978233034571,gemini,coral,pdac,PROMPT2_entailment
185,58,51,41,10,0.803921568627451,10,9,1,0.9,0.8492520138089759,gemini,coral,pdac,PROMPT2_entailment
186,59,38,29,9,0.7631578947368421,21,12,9,0.5714285714285714,0.6535211267605633,gemini,coral,pdac,PROMPT2_entailment
187,6,19,16,3,0.8421052631578947,12,10,2,0.8333333333333334,0.8376963350785339,gemini,coral,pdac,PROMPT2_entailment
188,60,37,29,8,0.7837837837837838,13,6,7,0.4615384615384615,0.5809682804674458,gemini,coral,pdac,PROMPT2_entailment
189,61,16,14,2,0.875,7,6,1,0.8571428571428571,0.8659793814432989,gemini,coral,pdac,PROMPT2_entailment
190,62,24,18,6,0.75,11,9,2,0.8181818181818182,0.7826086956521738,gemini,coral,pdac,PROMPT2_entailment
191,63,13,12,1,0.9230769230769232,10,8,2,0.8,0.8571428571428571,gemini,coral,pdac,PROMPT2_entailment
192,64,21,18,3,0.8571428571428571,12,12,0,1.0,0.923076923076923,gemini,coral,pdac,PROMPT2_entailment
193,65,21,15,6,0.7142857142857143,9,7,2,0.7777777777777778,0.7446808510638298,gemini,coral,pdac,PROMPT2_entailment
194,66,27,23,4,0.8518518518518519,12,8,4,0.6666666666666666,0.7479674796747967,gemini,coral,pdac,PROMPT2_entailment
195,67,10,10,0,1.0,1,1,0,1.0,1.0,gemini,coral,pdac,PROMPT2_entailment
196,68,23,20,3,0.8695652173913043,11,10,1,0.9090909090909092,0.888888888888889,gemini,coral,pdac,PROMPT2_entailment
197,69,26,26,0,1.0,10,10,0,1.0,1.0,gemini,coral,pdac,PROMPT2_entailment
198,7,18,14,4,0.7777777777777778,11,9,2,0.8181818181818182,0.7974683544303799,gemini,coral,pdac,PROMPT2_entailment
199,70,31,30,1,0.967741935483871,15,14,1,0.9333333333333332,0.9502262443438916,gemini,coral,pdac,PROMPT2_entailment
200,71,11,9,2,0.8181818181818182,9,7,2,0.7777777777777778,0.7974683544303799,gemini,coral,pdac,PROMPT2_entailment
201,72,26,24,2,0.9230769230769232,13,9,4,0.6923076923076923,0.7912087912087913,gemini,coral,pdac,PROMPT2_entailment
202,73,168,27,141,0.1607142857142857,154,77,77,0.5,0.2432432432432432,gemini,coral,pdac,PROMPT2_entailment
203,74,30,22,8,0.7333333333333333,8,8,0,1.0,0.846153846153846,gemini,coral,pdac,PROMPT2_entailment
204,75,18,17,1,0.9444444444444444,7,5,2,0.7142857142857143,0.813397129186603,gemini,coral,pdac,PROMPT2_entailment
205,76,14,11,3,0.7857142857142857,7,6,1,0.8571428571428571,0.8198757763975155,gemini,coral,pdac,PROMPT2_entailment
206,77,27,25,2,0.925925925925926,8,8,0,1.0,0.9615384615384616,gemini,coral,pdac,PROMPT2_entailment
207,78,13,13,0,1.0,8,5,3,0.625,0.7692307692307693,gemini,coral,pdac,PROMPT2_entailment
208,79,20,16,4,0.8,11,8,3,0.7272727272727273,0.761904761904762,gemini,coral,pdac,PROMPT2_entailment
209,8,1,0,1,0.0,2,1,1,0.5,0.0,gemini,coral,pdac,PROMPT2_entailment
210,80,23,21,2,0.9130434782608696,9,8,1,0.8888888888888888,0.900804289544236,gemini,coral,pdac,PROMPT2_entailment
211,81,19,19,0,1.0,6,5,1,0.8333333333333334,0.9090909090909092,gemini,coral,pdac,PROMPT2_entailment
212,82,36,35,1,0.9722222222222222,4,4,0,1.0,0.9859154929577464,gemini,coral,pdac,PROMPT2_entailment
213,83,26,21,5,0.8076923076923077,11,4,7,0.3636363636363636,0.5014925373134329,gemini,coral,pdac,PROMPT2_entailment
214,84,23,17,6,0.7391304347826086,11,8,3,0.7272727272727273,0.7331536388140162,gemini,coral,pdac,PROMPT2_entailment
215,85,42,31,11,0.7380952380952381,35,28,7,0.8,0.7678018575851393,gemini,coral,pdac,PROMPT2_entailment
216,86,26,19,7,0.7307692307692307,10,9,1,0.9,0.8066037735849056,gemini,coral,pdac,PROMPT2_entailment
217,87,31,20,11,0.6451612903225806,7,7,0,1.0,0.7843137254901961,gemini,coral,pdac,PROMPT2_entailment
218,88,15,12,3,0.8,8,5,3,0.625,0.7017543859649122,gemini,coral,pdac,PROMPT2_entailment
219,89,27,18,9,0.6666666666666666,10,8,2,0.8,0.7272727272727272,gemini,coral,pdac,PROMPT2_entailment
220,9,19,18,1,0.9473684210526316,12,9,3,0.75,0.8372093023255814,gemini,coral,pdac,PROMPT2_entailment
221,90,25,20,5,0.8,9,9,0,1.0,0.888888888888889,gemini,coral,pdac,PROMPT2_entailment
222,91,19,19,0,1.0,10,7,3,0.7,0.8235294117647058,gemini,coral,pdac,PROMPT2_entailment
223,92,27,22,5,0.8148148148148148,10,9,1,0.9,0.855291576673866,gemini,coral,pdac,PROMPT2_entailment
224,93,23,21,2,0.9130434782608696,9,6,3,0.6666666666666666,0.7706422018348623,gemini,coral,pdac,PROMPT2_entailment
225,94,15,14,1,0.9333333333333332,7,6,1,0.8571428571428571,0.8936170212765957,gemini,coral,pdac,PROMPT2_entailment
226,95,18,17,1,0.9444444444444444,8,5,3,0.625,0.752212389380531,gemini,coral,pdac,PROMPT2_entailment
227,96,10,8,2,0.8,4,4,0,1.0,0.888888888888889,gemini,coral,pdac,PROMPT2_entailment
228,97,19,17,2,0.8947368421052632,8,8,0,1.0,0.9444444444444444,gemini,coral,pdac,PROMPT2_entailment
229,98,22,19,3,0.8636363636363636,9,6,3,0.6666666666666666,0.7524752475247524,gemini,coral,pdac,PROMPT2_entailment
230,99,22,20,2,0.9090909090909092,9,9,0,1.0,0.9523809523809524,gemini,coral,pdac,PROMPT2_entailment
0,0,7,7,0,1.0,10,10,0,1.0,1.0,gemini,coral,breastca,PROMPT1_entailment
1,1,11,11,0,1.0,12,10,2,0.8333333333333334,0.9090909090909092,gemini,coral,breastca,PROMPT1_entailment
2,10,13,11,2,0.8461538461538461,10,9,1,0.9,0.8722466960352422,gemini,coral,breastca,PROMPT1_entailment
3,100,31,21,10,0.6774193548387096,26,21,5,0.8076923076923077,0.7368421052631579,gemini,coral,breastca,PROMPT1_entailment
4,101,35,30,5,0.8571428571428571,18,15,3,0.8333333333333334,0.8450704225352113,gemini,coral,breastca,PROMPT1_entailment
5,102,8,8,0,1.0,7,6,1,0.8571428571428571,0.923076923076923,gemini,coral,breastca,PROMPT1_entailment
6,103,23,23,0,1.0,10,9,1,0.9,0.9473684210526316,gemini,coral,breastca,PROMPT1_entailment
7,104,55,38,17,0.6909090909090909,26,18,8,0.6923076923076923,0.6916076845298281,gemini,coral,breastca,PROMPT1_entailment
8,105,18,17,1,0.9444444444444444,15,13,2,0.8666666666666667,0.9038854805725972,gemini,coral,breastca,PROMPT1_entailment
9,106,15,11,4,0.7333333333333333,9,9,0,1.0,0.846153846153846,gemini,coral,breastca,PROMPT1_entailment
10,107,16,12,4,0.75,9,9,0,1.0,0.8571428571428571,gemini,coral,breastca,PROMPT1_entailment
11,108,15,14,1,0.9333333333333332,11,10,1,0.9090909090909092,0.9210526315789476,gemini,coral,breastca,PROMPT1_entailment
12,109,21,20,1,0.9523809523809524,11,11,0,1.0,0.975609756097561,gemini,coral,breastca,PROMPT1_entailment
13,11,9,8,1,0.8888888888888888,3,3,0,1.0,0.9411764705882352,gemini,coral,breastca,PROMPT1_entailment
14,110,13,12,1,0.9230769230769232,11,10,1,0.9090909090909092,0.9160305343511452,gemini,coral,breastca,PROMPT1_entailment
15,111,16,12,4,0.75,10,9,1,0.9,0.8181818181818182,gemini,coral,breastca,PROMPT1_entailment
16,112,15,15,0,1.0,10,9,1,0.9,0.9473684210526316,gemini,coral,breastca,PROMPT1_entailment
17,113,22,22,0,1.0,49,26,23,0.5306122448979592,0.6933333333333334,gemini,coral,breastca,PROMPT1_entailment
18,114,50,30,20,0.6,21,15,6,0.7142857142857143,0.6521739130434783,gemini,coral,breastca,PROMPT1_entailment
19,115,17,12,5,0.7058823529411765,9,7,2,0.7777777777777778,0.7400881057268723,gemini,coral,breastca,PROMPT1_entailment
20,116,20,17,3,0.85,14,13,1,0.9285714285714286,0.8875502008032129,gemini,coral,breastca,PROMPT1_entailment
21,117,4,3,1,0.75,2,1,1,0.5,0.6,gemini,coral,breastca,PROMPT1_entailment
22,118,20,18,2,0.9,19,11,8,0.5789473684210527,0.7046263345195731,gemini,coral,breastca,PROMPT1_entailment
23,119,13,11,2,0.8461538461538461,10,9,1,0.9,0.8722466960352422,gemini,coral,breastca,PROMPT1_entailment
24,12,13,12,1,0.9230769230769232,10,10,0,1.0,0.96,gemini,coral,breastca,PROMPT1_entailment
25,120,15,13,2,0.8666666666666667,9,8,1,0.8888888888888888,0.8776371308016878,gemini,coral,breastca,PROMPT1_entailment
26,121,19,12,7,0.631578947368421,10,9,1,0.9,0.7422680412371133,gemini,coral,breastca,PROMPT1_entailment
27,122,20,20,0,1.0,9,8,1,0.8888888888888888,0.9411764705882352,gemini,coral,breastca,PROMPT1_entailment
28,123,13,12,1,0.9230769230769232,8,8,0,1.0,0.96,gemini,coral,breastca,PROMPT1_entailment
29,124,11,11,0,1.0,10,10,0,1.0,1.0,gemini,coral,breastca,PROMPT1_entailment
30,125,24,20,4,0.8333333333333334,11,9,2,0.8181818181818182,0.8256880733944955,gemini,coral,breastca,PROMPT1_entailment
31,126,12,10,2,0.8333333333333334,10,9,1,0.9,0.8653846153846153,gemini,coral,breastca,PROMPT1_entailment
32,127,15,13,2,0.8666666666666667,10,10,0,1.0,0.9285714285714286,gemini,coral,breastca,PROMPT1_entailment
33,128,27,24,3,0.8888888888888888,11,10,1,0.9090909090909092,0.8988764044943819,gemini,coral,breastca,PROMPT1_entailment
34,129,18,18,0,1.0,11,9,2,0.8181818181818182,0.9,gemini,coral,breastca,PROMPT1_entailment
35,13,28,22,6,0.7857142857142857,10,9,1,0.9,0.8389830508474577,gemini,coral,breastca,PROMPT1_entailment
36,130,8,7,1,0.875,7,5,2,0.7142857142857143,0.7865168539325842,gemini,coral,breastca,PROMPT1_entailment
37,131,39,37,2,0.9487179487179488,10,8,2,0.8,0.8680351906158358,gemini,coral,breastca,PROMPT1_entailment
38,132,15,15,0,1.0,8,8,0,1.0,1.0,gemini,coral,breastca,PROMPT1_entailment
39,133,28,21,7,0.75,29,20,9,0.6896551724137931,0.718562874251497,gemini,coral,breastca,PROMPT1_entailment
40,134,4,1,3,0.25,11,7,4,0.6363636363636364,0.358974358974359,gemini,coral,breastca,PROMPT1_entailment
41,135,29,18,11,0.6206896551724138,16,14,2,0.875,0.7262247838616716,gemini,coral,breastca,PROMPT1_entailment
42,136,19,15,4,0.7894736842105263,10,9,1,0.9,0.8411214953271027,gemini,coral,breastca,PROMPT1_entailment
43,137,15,14,1,0.9333333333333332,10,10,0,1.0,0.9655172413793104,gemini,coral,breastca,PROMPT1_entailment
44,138,13,13,0,1.0,10,10,0,1.0,1.0,gemini,coral,breastca,PROMPT1_entailment
45,139,13,12,1,0.9230769230769232,11,8,3,0.7272727272727273,0.8135593220338984,gemini,coral,breastca,PROMPT1_entailment
46,14,51,34,17,0.6666666666666666,59,22,37,0.3728813559322034,0.4782608695652173,gemini,coral,breastca,PROMPT1_entailment
47,140,18,16,2,0.8888888888888888,9,8,1,0.8888888888888888,0.8888888888888888,gemini,coral,breastca,PROMPT1_entailment
48,141,10,7,3,0.7,11,10,1,0.9090909090909092,0.7909604519774012,gemini,coral,breastca,PROMPT1_entailment
49,142,11,10,1,0.9090909090909092,10,10,0,1.0,0.9523809523809524,gemini,coral,breastca,PROMPT1_entailment
50,143,12,6,6,0.5,10,6,4,0.6,0.5454545454545454,gemini,coral,breastca,PROMPT1_entailment
51,144,16,14,2,0.875,5,3,2,0.6,0.711864406779661,gemini,coral,breastca,PROMPT1_entailment
52,145,12,11,1,0.9166666666666666,5,4,1,0.8,0.854368932038835,gemini,coral,breastca,PROMPT1_entailment
53,146,20,18,2,0.9,9,8,1,0.8888888888888888,0.8944099378881988,gemini,coral,breastca,PROMPT1_entailment
54,147,21,16,5,0.7619047619047619,5,5,0,1.0,0.8648648648648648,gemini,coral,breastca,PROMPT1_entailment
55,148,27,20,7,0.7407407407407407,4,2,2,0.5,0.5970149253731343,gemini,coral,breastca,PROMPT1_entailment
56,149,12,11,1,0.9166666666666666,1,1,0,1.0,0.9565217391304348,gemini,coral,breastca,PROMPT1_entailment
57,15,42,18,24,0.4285714285714285,16,6,10,0.375,0.3999999999999999,gemini,coral,breastca,PROMPT1_entailment
58,150,10,9,1,0.9,2,2,0,1.0,0.9473684210526316,gemini,coral,breastca,PROMPT1_entailment
59,151,12,11,1,0.9166666666666666,9,9,0,1.0,0.9565217391304348,gemini,coral,breastca,PROMPT1_entailment
60,152,17,15,2,0.8823529411764706,16,15,1,0.9375,0.9090909090909092,gemini,coral,breastca,PROMPT1_entailment
61,153,12,10,2,0.8333333333333334,1,1,0,1.0,0.9090909090909092,gemini,coral,breastca,PROMPT1_entailment
62,154,18,17,1,0.9444444444444444,10,9,1,0.9,0.9216867469879516,gemini,coral,breastca,PROMPT1_entailment
63,155,11,11,0,1.0,9,9,0,1.0,1.0,gemini,coral,breastca,PROMPT1_entailment
64,156,18,18,0,1.0,8,8,0,1.0,1.0,gemini,coral,breastca,PROMPT1_entailment
65,157,18,16,2,0.8888888888888888,9,9,0,1.0,0.9411764705882352,gemini,coral,breastca,PROMPT1_entailment
66,158,11,9,2,0.8181818181818182,16,15,1,0.9375,0.8737864077669902,gemini,coral,breastca,PROMPT1_entailment
67,159,6,6,0,1.0,29,21,8,0.7241379310344828,0.8400000000000001,gemini,coral,breastca,PROMPT1_entailment
68,16,18,16,2,0.8888888888888888,10,8,2,0.8,0.8421052631578948,gemini,coral,breastca,PROMPT1_entailment
69,160,45,31,14,0.6888888888888889,18,13,5,0.7222222222222222,0.705161854768154,gemini,coral,breastca,PROMPT1_entailment
70,161,8,8,0,1.0,11,10,1,0.9090909090909092,0.9523809523809524,gemini,coral,breastca,PROMPT1_entailment
71,162,21,14,7,0.6666666666666666,16,13,3,0.8125,0.7323943661971831,gemini,coral,breastca,PROMPT1_entailment
72,163,11,9,2,0.8181818181818182,11,10,1,0.9090909090909092,0.861244019138756,gemini,coral,breastca,PROMPT1_entailment
73,164,11,11,0,1.0,8,6,2,0.75,0.8571428571428571,gemini,coral,breastca,PROMPT1_entailment
74,165,11,11,0,1.0,12,11,1,0.9166666666666666,0.9565217391304348,gemini,coral,breastca,PROMPT1_entailment
75,166,13,13,0,1.0,10,7,3,0.7,0.8235294117647058,gemini,coral,breastca,PROMPT1_entailment
76,167,11,7,4,0.6363636363636364,7,6,1,0.8571428571428571,0.7304347826086957,gemini,coral,breastca,PROMPT1_entailment
77,168,11,7,4,0.6363636363636364,7,6,1,0.8571428571428571,0.7304347826086957,gemini,coral,breastca,PROMPT1_entailment
78,169,11,11,0,1.0,11,8,3,0.7272727272727273,0.8421052631578948,gemini,coral,breastca,PROMPT1_entailment
79,17,10,9,1,0.9,3,3,0,1.0,0.9473684210526316,gemini,coral,breastca,PROMPT1_entailment
80,170,13,13,0,1.0,10,10,0,1.0,1.0,gemini,coral,breastca,PROMPT1_entailment
81,171,14,14,0,1.0,9,7,2,0.7777777777777778,0.8750000000000001,gemini,coral,breastca,PROMPT1_entailment
82,172,96,73,23,0.7604166666666666,32,22,10,0.6875,0.7221223021582733,gemini,coral,breastca,PROMPT1_entailment
83,173,11,10,1,0.9090909090909092,11,9,2,0.8181818181818182,0.861244019138756,gemini,coral,breastca,PROMPT1_entailment
84,174,11,10,1,0.9090909090909092,7,7,0,1.0,0.9523809523809524,gemini,coral,breastca,PROMPT1_entailment
85,175,12,8,4,0.6666666666666666,10,8,2,0.8,0.7272727272727272,gemini,coral,breastca,PROMPT1_entailment
86,176,10,10,0,1.0,10,10,0,1.0,1.0,gemini,coral,breastca,PROMPT1_entailment
87,177,11,10,1,0.9090909090909092,9,9,0,1.0,0.9523809523809524,gemini,coral,breastca,PROMPT1_entailment
88,178,19,14,5,0.7368421052631579,10,8,2,0.8,0.7671232876712328,gemini,coral,breastca,PROMPT1_entailment
89,179,12,11,1,0.9166666666666666,9,9,0,1.0,0.9565217391304348,gemini,coral,breastca,PROMPT1_entailment
90,18,14,13,1,0.9285714285714286,8,8,0,1.0,0.962962962962963,gemini,coral,breastca,PROMPT1_entailment
91,180,15,14,1,0.9333333333333332,10,10,0,1.0,0.9655172413793104,gemini,coral,breastca,PROMPT1_entailment
92,181,6,6,0,1.0,9,8,1,0.8888888888888888,0.9411764705882352,gemini,coral,breastca,PROMPT1_entailment
93,182,12,12,0,1.0,9,6,3,0.6666666666666666,0.8,gemini,coral,breastca,PROMPT1_entailment
94,183,13,13,0,1.0,10,9,1,0.9,0.9473684210526316,gemini,coral,breastca,PROMPT1_entailment
95,184,30,23,7,0.7666666666666667,9,9,0,1.0,0.8679245283018869,gemini,coral,breastca,PROMPT1_entailment
96,185,14,13,1,0.9285714285714286,10,9,1,0.9,0.9140625,gemini,coral,breastca,PROMPT1_entailment
97,186,13,9,4,0.6923076923076923,5,4,1,0.8,0.7422680412371134,gemini,coral,breastca,PROMPT1_entailment
98,187,51,44,7,0.8627450980392157,26,14,12,0.5384615384615384,0.6630785791173305,gemini,coral,breastca,PROMPT1_entailment
99,188,16,16,0,1.0,9,9,0,1.0,1.0,gemini,coral,breastca,PROMPT1_entailment
100,189,14,13,1,0.9285714285714286,9,9,0,1.0,0.962962962962963,gemini,coral,breastca,PROMPT1_entailment
101,19,11,10,1,0.9090909090909092,8,8,0,1.0,0.9523809523809524,gemini,coral,breastca,PROMPT1_entailment
102,190,24,9,15,0.375,34,18,16,0.5294117647058824,0.4390243902439025,gemini,coral,breastca,PROMPT1_entailment
103,191,63,30,33,0.4761904761904761,14,12,2,0.8571428571428571,0.6122448979591837,gemini,coral,breastca,PROMPT1_entailment
104,192,12,12,0,1.0,12,9,3,0.75,0.8571428571428571,gemini,coral,breastca,PROMPT1_entailment
105,193,7,6,1,0.8571428571428571,2,2,0,1.0,0.923076923076923,gemini,coral,breastca,PROMPT1_entailment
106,194,24,22,2,0.9166666666666666,15,12,3,0.8,0.854368932038835,gemini,coral,breastca,PROMPT1_entailment
107,195,15,15,0,1.0,13,13,0,1.0,1.0,gemini,coral,breastca,PROMPT1_entailment
108,196,35,23,12,0.6571428571428571,30,20,10,0.6666666666666666,0.6618705035971223,gemini,coral,breastca,PROMPT1_entailment
109,197,28,23,5,0.8214285714285714,14,10,4,0.7142857142857143,0.7641196013289038,gemini,coral,breastca,PROMPT1_entailment
110,198,12,10,2,0.8333333333333334,11,8,3,0.7272727272727273,0.7766990291262137,gemini,coral,breastca,PROMPT1_entailment
111,199,7,7,0,1.0,2,2,0,1.0,1.0,gemini,coral,breastca,PROMPT1_entailment
112,2,14,9,5,0.6428571428571429,10,9,1,0.9,0.75,gemini,coral,breastca,PROMPT1_entailment
113,20,16,8,8,0.5,17,11,6,0.6470588235294118,0.5641025641025642,gemini,coral,breastca,PROMPT1_entailment
114,200,34,30,4,0.8823529411764706,15,14,1,0.9333333333333332,0.9071274298056156,gemini,coral,breastca,PROMPT1_entailment
115,201,1,0,1,0.0,26,0,26,0.0,,gemini,coral,breastca,PROMPT1_entailment
116,202,23,19,4,0.8260869565217391,17,15,2,0.8823529411764706,0.8532934131736526,gemini,coral,breastca,PROMPT1_entailment
117,203,75,50,25,0.6666666666666666,27,22,5,0.8148148148148148,0.7333333333333333,gemini,coral,breastca,PROMPT1_entailment
118,204,9,6,3,0.6666666666666666,11,6,5,0.5454545454545454,0.6,gemini,coral,breastca,PROMPT1_entailment
119,205,17,16,1,0.9411764705882352,11,11,0,1.0,0.9696969696969696,gemini,coral,breastca,PROMPT1_entailment
120,206,9,9,0,1.0,4,4,0,1.0,1.0,gemini,coral,breastca,PROMPT1_entailment
121,207,14,12,2,0.8571428571428571,12,7,5,0.5833333333333334,0.6942148760330579,gemini,coral,breastca,PROMPT1_entailment
122,208,10,10,0,1.0,9,9,0,1.0,1.0,gemini,coral,breastca,PROMPT1_entailment
123,209,13,9,4,0.6923076923076923,11,10,1,0.9090909090909092,0.7860262008733625,gemini,coral,breastca,PROMPT1_entailment
124,21,45,23,22,0.5111111111111111,27,15,12,0.5555555555555556,0.5324074074074074,gemini,coral,breastca,PROMPT1_entailment
125,210,31,22,9,0.7096774193548387,13,9,4,0.6923076923076923,0.7008849557522124,gemini,coral,breastca,PROMPT1_entailment
126,211,23,18,5,0.782608695652174,11,7,4,0.6363636363636364,0.701949860724234,gemini,coral,breastca,PROMPT1_entailment
127,212,17,14,3,0.8235294117647058,9,7,2,0.7777777777777778,0.7999999999999999,gemini,coral,breastca,PROMPT1_entailment
128,213,10,9,1,0.9,11,7,4,0.6363636363636364,0.7455621301775148,gemini,coral,breastca,PROMPT1_entailment
129,214,24,10,14,0.4166666666666667,28,21,7,0.75,0.5357142857142857,gemini,coral,breastca,PROMPT1_entailment
130,215,59,32,27,0.5423728813559322,37,27,10,0.7297297297297297,0.6222542311847318,gemini,coral,breastca,PROMPT1_entailment
131,216,37,34,3,0.918918918918919,15,15,0,1.0,0.9577464788732396,gemini,coral,breastca,PROMPT1_entailment
132,22,19,9,10,0.4736842105263157,7,4,3,0.5714285714285714,0.5179856115107914,gemini,coral,breastca,PROMPT1_entailment
133,23,16,14,2,0.875,9,8,1,0.8888888888888888,0.8818897637795274,gemini,coral,breastca,PROMPT1_entailment
134,24,17,14,3,0.8235294117647058,10,8,2,0.8,0.8115942028985507,gemini,coral,breastca,PROMPT1_entailment
135,25,23,22,1,0.9565217391304348,8,8,0,1.0,0.9777777777777776,gemini,coral,breastca,PROMPT1_entailment
136,26,17,14,3,0.8235294117647058,11,10,1,0.9090909090909092,0.8641975308641976,gemini,coral,breastca,PROMPT1_entailment
137,27,15,12,3,0.8,12,10,2,0.8333333333333334,0.816326530612245,gemini,coral,breastca,PROMPT1_entailment
138,28,15,13,2,0.8666666666666667,18,15,3,0.8333333333333334,0.8496732026143791,gemini,coral,breastca,PROMPT1_entailment
139,29,18,14,4,0.7777777777777778,9,6,3,0.6666666666666666,0.717948717948718,gemini,coral,breastca,PROMPT1_entailment
140,3,15,10,5,0.6666666666666666,11,5,6,0.4545454545454545,0.5405405405405405,gemini,coral,breastca,PROMPT1_entailment
141,30,32,12,20,0.375,18,14,4,0.7777777777777778,0.5060240963855422,gemini,coral,breastca,PROMPT1_entailment
142,31,20,12,8,0.6,13,10,3,0.7692307692307693,0.6741573033707865,gemini,coral,breastca,PROMPT1_entailment
143,32,13,12,1,0.9230769230769232,9,8,1,0.8888888888888888,0.9056603773584906,gemini,coral,breastca,PROMPT1_entailment
144,33,11,9,2,0.8181818181818182,8,7,1,0.875,0.8456375838926175,gemini,coral,breastca,PROMPT1_entailment
145,34,14,8,6,0.5714285714285714,10,5,5,0.5,0.5333333333333333,gemini,coral,breastca,PROMPT1_entailment
146,35,17,12,5,0.7058823529411765,12,9,3,0.75,0.7272727272727272,gemini,coral,breastca,PROMPT1_entailment
147,36,11,11,0,1.0,11,9,2,0.8181818181818182,0.9,gemini,coral,breastca,PROMPT1_entailment
148,37,9,8,1,0.8888888888888888,11,7,4,0.6363636363636364,0.7417218543046358,gemini,coral,breastca,PROMPT1_entailment
149,38,17,14,3,0.8235294117647058,11,9,2,0.8181818181818182,0.8208469055374593,gemini,coral,breastca,PROMPT1_entailment
150,39,13,13,0,1.0,11,10,1,0.9090909090909092,0.9523809523809524,gemini,coral,breastca,PROMPT1_entailment
151,4,49,23,26,0.4693877551020408,59,31,28,0.5254237288135594,0.4958275382475661,gemini,coral,breastca,PROMPT1_entailment
152,40,15,12,3,0.8,9,7,2,0.7777777777777778,0.7887323943661971,gemini,coral,breastca,PROMPT1_entailment
153,41,19,17,2,0.8947368421052632,14,14,0,1.0,0.9444444444444444,gemini,coral,breastca,PROMPT1_entailment
154,42,13,12,1,0.9230769230769232,9,3,6,0.3333333333333333,0.489795918367347,gemini,coral,breastca,PROMPT1_entailment
155,43,21,15,6,0.7142857142857143,9,7,2,0.7777777777777778,0.7446808510638298,gemini,coral,breastca,PROMPT1_entailment
156,44,10,10,0,1.0,9,9,0,1.0,1.0,gemini,coral,breastca,PROMPT1_entailment
157,45,7,6,1,0.8571428571428571,2,2,0,1.0,0.923076923076923,gemini,coral,breastca,PROMPT1_entailment
158,46,13,13,0,1.0,5,5,0,1.0,1.0,gemini,coral,breastca,PROMPT1_entailment
159,47,13,12,1,0.9230769230769232,2,2,0,1.0,0.96,gemini,coral,breastca,PROMPT1_entailment
160,48,12,11,1,0.9166666666666666,5,5,0,1.0,0.9565217391304348,gemini,coral,breastca,PROMPT1_entailment
161,49,25,16,9,0.64,16,9,7,0.5625,0.5987525987525987,gemini,coral,breastca,PROMPT1_entailment
162,5,37,25,12,0.6756756756756757,12,11,1,0.9166666666666666,0.7779349363507779,gemini,coral,breastca,PROMPT1_entailment
163,50,1,0,1,0.0,16,1,15,0.0625,0.0,gemini,coral,breastca,PROMPT1_entailment
164,51,44,30,14,0.6818181818181818,11,10,1,0.9090909090909092,0.7792207792207791,gemini,coral,breastca,PROMPT1_entailment
165,52,15,12,3,0.8,10,9,1,0.9,0.8470588235294118,gemini,coral,breastca,PROMPT1_entailment
166,53,13,13,0,1.0,10,10,0,1.0,1.0,gemini,coral,breastca,PROMPT1_entailment
167,54,14,13,1,0.9285714285714286,9,9,0,1.0,0.962962962962963,gemini,coral,breastca,PROMPT1_entailment
168,55,5,5,0,1.0,1,1,0,1.0,1.0,gemini,coral,breastca,PROMPT1_entailment
169,56,8,6,2,0.75,18,5,13,0.2777777777777778,0.4054054054054055,gemini,coral,breastca,PROMPT1_entailment
170,57,12,9,3,0.75,10,9,1,0.9,0.8181818181818182,gemini,coral,breastca,PROMPT1_entailment
171,58,19,16,3,0.8421052631578947,10,8,2,0.8,0.8205128205128205,gemini,coral,breastca,PROMPT1_entailment
172,59,17,15,2,0.8823529411764706,9,7,2,0.7777777777777778,0.8267716535433072,gemini,coral,breastca,PROMPT1_entailment
173,6,13,10,3,0.7692307692307693,8,7,1,0.875,0.8187134502923977,gemini,coral,breastca,PROMPT1_entailment
174,60,18,15,3,0.8333333333333334,10,8,2,0.8,0.816326530612245,gemini,coral,breastca,PROMPT1_entailment
175,61,7,6,1,0.8571428571428571,11,7,4,0.6363636363636364,0.7304347826086957,gemini,coral,breastca,PROMPT1_entailment
176,62,9,9,0,1.0,10,10,0,1.0,1.0,gemini,coral,breastca,PROMPT1_entailment
177,63,16,16,0,1.0,11,9,2,0.8181818181818182,0.9,gemini,coral,breastca,PROMPT1_entailment
178,64,23,18,5,0.782608695652174,18,9,9,0.5,0.6101694915254238,gemini,coral,breastca,PROMPT1_entailment
179,65,14,14,0,1.0,6,6,0,1.0,1.0,gemini,coral,breastca,PROMPT1_entailment
180,66,19,14,5,0.7368421052631579,10,9,1,0.9,0.810289389067524,gemini,coral,breastca,PROMPT1_entailment
181,67,36,12,24,0.3333333333333333,49,26,23,0.5306122448979592,0.4094488188976378,gemini,coral,breastca,PROMPT1_entailment
182,68,10,9,1,0.9,8,8,0,1.0,0.9473684210526316,gemini,coral,breastca,PROMPT1_entailment
183,69,20,11,9,0.55,12,4,8,0.3333333333333333,0.4150943396226416,gemini,coral,breastca,PROMPT1_entailment
184,7,15,14,1,0.9333333333333332,11,10,1,0.9090909090909092,0.9210526315789476,gemini,coral,breastca,PROMPT1_entailment
185,70,40,21,19,0.525,51,38,13,0.7450980392156863,0.6159783867232729,gemini,coral,breastca,PROMPT1_entailment
186,71,12,8,4,0.6666666666666666,5,5,0,1.0,0.8,gemini,coral,breastca,PROMPT1_entailment
187,72,12,12,0,1.0,3,2,1,0.6666666666666666,0.8,gemini,coral,breastca,PROMPT1_entailment
188,73,12,11,1,0.9166666666666666,1,1,0,1.0,0.9565217391304348,gemini,coral,breastca,PROMPT1_entailment
189,74,11,10,1,0.9090909090909092,2,2,0,1.0,0.9523809523809524,gemini,coral,breastca,PROMPT1_entailment
190,75,11,9,2,0.8181818181818182,6,4,2,0.6666666666666666,0.7346938775510203,gemini,coral,breastca,PROMPT1_entailment
191,76,12,12,0,1.0,7,7,0,1.0,1.0,gemini,coral,breastca,PROMPT1_entailment
192,77,8,7,1,0.875,15,7,8,0.4666666666666667,0.608695652173913,gemini,coral,breastca,PROMPT1_entailment
193,78,13,13,0,1.0,8,6,2,0.75,0.8571428571428571,gemini,coral,breastca,PROMPT1_entailment
194,79,11,10,1,0.9090909090909092,8,8,0,1.0,0.9523809523809524,gemini,coral,breastca,PROMPT1_entailment
195,8,13,9,4,0.6923076923076923,9,9,0,1.0,0.8181818181818181,gemini,coral,breastca,PROMPT1_entailment
196,80,38,29,9,0.7631578947368421,24,12,12,0.5,0.6041666666666667,gemini,coral,breastca,PROMPT1_entailment
197,81,32,27,5,0.84375,11,11,0,1.0,0.9152542372881356,gemini,coral,breastca,PROMPT1_entailment
198,82,11,7,4,0.6363636363636364,6,6,0,1.0,0.7777777777777778,gemini,coral,breastca,PROMPT1_entailment
199,83,14,14,0,1.0,6,6,0,1.0,1.0,gemini,coral,breastca,PROMPT1_entailment
200,84,22,18,4,0.8181818181818182,11,9,2,0.8181818181818182,0.8181818181818182,gemini,coral,breastca,PROMPT1_entailment
201,85,21,19,2,0.9047619047619048,7,6,1,0.8571428571428571,0.8803088803088803,gemini,coral,breastca,PROMPT1_entailment
202,86,22,13,9,0.5909090909090909,16,15,1,0.9375,0.724907063197026,gemini,coral,breastca,PROMPT1_entailment
203,87,10,10,0,1.0,8,7,1,0.875,0.9333333333333332,gemini,coral,breastca,PROMPT1_entailment
204,88,8,7,1,0.875,8,8,0,1.0,0.9333333333333332,gemini,coral,breastca,PROMPT1_entailment
205,89,14,12,2,0.8571428571428571,11,10,1,0.9090909090909092,0.8823529411764706,gemini,coral,breastca,PROMPT1_entailment
206,9,5,4,1,0.8,6,5,1,0.8333333333333334,0.816326530612245,gemini,coral,breastca,PROMPT1_entailment
207,90,57,36,21,0.631578947368421,17,12,5,0.7058823529411765,0.6666666666666667,gemini,coral,breastca,PROMPT1_entailment
208,91,14,13,1,0.9285714285714286,7,7,0,1.0,0.962962962962963,gemini,coral,breastca,PROMPT1_entailment
209,92,6,6,0,1.0,2,2,0,1.0,1.0,gemini,coral,breastca,PROMPT1_entailment
210,93,35,33,2,0.9428571428571428,13,13,0,1.0,0.9705882352941176,gemini,coral,breastca,PROMPT1_entailment
211,94,27,14,13,0.5185185185185185,25,19,6,0.76,0.6164542294322133,gemini,coral,breastca,PROMPT1_entailment
212,95,22,18,4,0.8181818181818182,13,10,3,0.7692307692307693,0.7929515418502203,gemini,coral,breastca,PROMPT1_entailment
213,96,20,16,4,0.8,10,10,0,1.0,0.888888888888889,gemini,coral,breastca,PROMPT1_entailment
214,97,17,16,1,0.9411764705882352,11,9,2,0.8181818181818182,0.8753799392097266,gemini,coral,breastca,PROMPT1_entailment
215,98,8,7,1,0.875,2,2,0,1.0,0.9333333333333332,gemini,coral,breastca,PROMPT1_entailment
216,99,8,8,0,1.0,15,13,2,0.8666666666666667,0.9285714285714286,gemini,coral,breastca,PROMPT1_entailment
0,0,13,13,0,1.0,10,10,0,1.0,1.0,gemini,coral,breastca,PROMPT1_ICL_entailment
1,1,10,10,0,1.0,12,5,7,0.4166666666666667,0.5882352941176471,gemini,coral,breastca,PROMPT1_ICL_entailment
2,10,24,22,2,0.9166666666666666,10,10,0,1.0,0.9565217391304348,gemini,coral,breastca,PROMPT1_ICL_entailment
3,100,36,25,11,0.6944444444444444,26,10,16,0.3846153846153846,0.495049504950495,gemini,coral,breastca,PROMPT1_ICL_entailment
4,101,12,11,1,0.9166666666666666,18,9,9,0.5,0.6470588235294118,gemini,coral,breastca,PROMPT1_ICL_entailment
5,102,14,13,1,0.9285714285714286,7,6,1,0.8571428571428571,0.8914285714285715,gemini,coral,breastca,PROMPT1_ICL_entailment
6,103,53,51,2,0.9622641509433962,10,8,2,0.8,0.8736616702355461,gemini,coral,breastca,PROMPT1_ICL_entailment
7,104,22,19,3,0.8636363636363636,26,13,13,0.5,0.6333333333333333,gemini,coral,breastca,PROMPT1_ICL_entailment
8,105,24,24,0,1.0,15,15,0,1.0,1.0,gemini,coral,breastca,PROMPT1_ICL_entailment
9,106,19,15,4,0.7894736842105263,9,9,0,1.0,0.8823529411764706,gemini,coral,breastca,PROMPT1_ICL_entailment
10,107,17,12,5,0.7058823529411765,9,7,2,0.7777777777777778,0.7400881057268723,gemini,coral,breastca,PROMPT1_ICL_entailment
11,108,19,17,2,0.8947368421052632,11,10,1,0.9090909090909092,0.9018567639257294,gemini,coral,breastca,PROMPT1_ICL_entailment
12,109,18,15,3,0.8333333333333334,11,11,0,1.0,0.9090909090909092,gemini,coral,breastca,PROMPT1_ICL_entailment
13,11,11,10,1,0.9090909090909092,3,3,0,1.0,0.9523809523809524,gemini,coral,breastca,PROMPT1_ICL_entailment
14,110,14,13,1,0.9285714285714286,11,10,1,0.9090909090909092,0.9187279151943464,gemini,coral,breastca,PROMPT1_ICL_entailment
15,111,1,0,1,0.0,10,1,9,0.1,0.0,gemini,coral,breastca,PROMPT1_ICL_entailment
16,112,22,21,1,0.9545454545454546,10,7,3,0.7,0.8076923076923077,gemini,coral,breastca,PROMPT1_ICL_entailment
17,113,53,36,17,0.6792452830188679,49,28,21,0.5714285714285714,0.6206896551724137,gemini,coral,breastca,PROMPT1_ICL_entailment
18,114,21,16,5,0.7619047619047619,21,6,15,0.2857142857142857,0.4155844155844155,gemini,coral,breastca,PROMPT1_ICL_entailment
19,115,20,17,3,0.85,9,8,1,0.8888888888888888,0.8690095846645367,gemini,coral,breastca,PROMPT1_ICL_entailment
20,116,37,33,4,0.8918918918918919,14,11,3,0.7857142857142857,0.8354430379746834,gemini,coral,breastca,PROMPT1_ICL_entailment
21,117,11,10,1,0.9090909090909092,2,1,1,0.5,0.6451612903225806,gemini,coral,breastca,PROMPT1_ICL_entailment
22,118,22,18,4,0.8181818181818182,19,12,7,0.631578947368421,0.712871287128713,gemini,coral,breastca,PROMPT1_ICL_entailment
23,119,15,14,1,0.9333333333333332,10,9,1,0.9,0.9163636363636364,gemini,coral,breastca,PROMPT1_ICL_entailment
24,12,16,14,2,0.875,10,9,1,0.9,0.8873239436619719,gemini,coral,breastca,PROMPT1_ICL_entailment
25,120,24,24,0,1.0,9,9,0,1.0,1.0,gemini,coral,breastca,PROMPT1_ICL_entailment
26,121,23,16,7,0.6956521739130435,10,10,0,1.0,0.8205128205128205,gemini,coral,breastca,PROMPT1_ICL_entailment
27,122,22,21,1,0.9545454545454546,9,8,1,0.8888888888888888,0.9205479452054794,gemini,coral,breastca,PROMPT1_ICL_entailment
28,123,17,17,0,1.0,8,6,2,0.75,0.8571428571428571,gemini,coral,breastca,PROMPT1_ICL_entailment
29,124,21,21,0,1.0,10,10,0,1.0,1.0,gemini,coral,breastca,PROMPT1_ICL_entailment
30,125,26,23,3,0.8846153846153846,11,9,2,0.8181818181818182,0.8501026694045174,gemini,coral,breastca,PROMPT1_ICL_entailment
31,126,17,15,2,0.8823529411764706,10,9,1,0.9,0.8910891089108911,gemini,coral,breastca,PROMPT1_ICL_entailment
32,127,27,24,3,0.8888888888888888,10,9,1,0.9,0.8944099378881988,gemini,coral,breastca,PROMPT1_ICL_entailment
33,128,24,24,0,1.0,11,10,1,0.9090909090909092,0.9523809523809524,gemini,coral,breastca,PROMPT1_ICL_entailment
34,129,22,20,2,0.9090909090909092,11,8,3,0.7272727272727273,0.8080808080808082,gemini,coral,breastca,PROMPT1_ICL_entailment
35,13,21,19,2,0.9047619047619048,10,10,0,1.0,0.95,gemini,coral,breastca,PROMPT1_ICL_entailment
36,130,1,0,1,0.0,7,2,5,0.2857142857142857,0.0,gemini,coral,breastca,PROMPT1_ICL_entailment
37,131,35,32,3,0.9142857142857144,10,9,1,0.9,0.9070866141732284,gemini,coral,breastca,PROMPT1_ICL_entailment
38,132,17,16,1,0.9411764705882352,8,8,0,1.0,0.9696969696969696,gemini,coral,breastca,PROMPT1_ICL_entailment
39,133,48,41,7,0.8541666666666666,29,19,10,0.6551724137931034,0.7415516420752022,gemini,coral,breastca,PROMPT1_ICL_entailment
40,134,1,0,1,0.0,11,2,9,0.1818181818181818,0.0,gemini,coral,breastca,PROMPT1_ICL_entailment
41,135,1,0,1,0.0,16,1,15,0.0625,0.0,gemini,coral,breastca,PROMPT1_ICL_entailment
42,136,24,22,2,0.9166666666666666,10,9,1,0.9,0.908256880733945,gemini,coral,breastca,PROMPT1_ICL_entailment
43,137,15,14,1,0.9333333333333332,10,10,0,1.0,0.9655172413793104,gemini,coral,breastca,PROMPT1_ICL_entailment
44,138,12,12,0,1.0,10,10,0,1.0,1.0,gemini,coral,breastca,PROMPT1_ICL_entailment
45,139,21,17,4,0.8095238095238095,11,9,2,0.8181818181818182,0.8138297872340425,gemini,coral,breastca,PROMPT1_ICL_entailment
46,14,21,14,7,0.6666666666666666,59,15,44,0.2542372881355932,0.3680981595092024,gemini,coral,breastca,PROMPT1_ICL_entailment
47,140,21,19,2,0.9047619047619048,9,9,0,1.0,0.95,gemini,coral,breastca,PROMPT1_ICL_entailment
48,141,25,22,3,0.88,11,11,0,1.0,0.9361702127659576,gemini,coral,breastca,PROMPT1_ICL_entailment
49,142,16,16,0,1.0,10,10,0,1.0,1.0,gemini,coral,breastca,PROMPT1_ICL_entailment
50,143,1,0,1,0.0,10,1,9,0.1,0.0,gemini,coral,breastca,PROMPT1_ICL_entailment
51,144,15,13,2,0.8666666666666667,5,4,1,0.8,0.832,gemini,coral,breastca,PROMPT1_ICL_entailment
52,145,15,14,1,0.9333333333333332,5,4,1,0.8,0.8615384615384616,gemini,coral,breastca,PROMPT1_ICL_entailment
53,146,16,15,1,0.9375,9,8,1,0.8888888888888888,0.9125475285171102,gemini,coral,breastca,PROMPT1_ICL_entailment
54,147,31,30,1,0.967741935483871,5,5,0,1.0,0.9836065573770492,gemini,coral,breastca,PROMPT1_ICL_entailment
55,148,23,21,2,0.9130434782608696,4,1,3,0.25,0.3925233644859812,gemini,coral,breastca,PROMPT1_ICL_entailment
56,149,13,13,0,1.0,1,1,0,1.0,1.0,gemini,coral,breastca,PROMPT1_ICL_entailment
57,15,32,21,11,0.65625,16,6,10,0.375,0.4772727272727273,gemini,coral,breastca,PROMPT1_ICL_entailment
58,150,19,16,3,0.8421052631578947,2,2,0,1.0,0.9142857142857144,gemini,coral,breastca,PROMPT1_ICL_entailment
59,151,16,15,1,0.9375,9,9,0,1.0,0.967741935483871,gemini,coral,breastca,PROMPT1_ICL_entailment
60,152,23,20,3,0.8695652173913043,16,16,0,1.0,0.9302325581395348,gemini,coral,breastca,PROMPT1_ICL_entailment
61,153,12,10,2,0.8333333333333334,1,1,0,1.0,0.9090909090909092,gemini,coral,breastca,PROMPT1_ICL_entailment
62,154,16,15,1,0.9375,10,9,1,0.9,0.9183673469387756,gemini,coral,breastca,PROMPT1_ICL_entailment
63,155,29,26,3,0.896551724137931,9,9,0,1.0,0.9454545454545454,gemini,coral,breastca,PROMPT1_ICL_entailment
64,156,26,25,1,0.9615384615384616,8,8,0,1.0,0.9803921568627452,gemini,coral,breastca,PROMPT1_ICL_entailment
65,157,25,23,2,0.92,9,9,0,1.0,0.9583333333333334,gemini,coral,breastca,PROMPT1_ICL_entailment
66,158,38,31,7,0.8157894736842105,16,16,0,1.0,0.898550724637681,gemini,coral,breastca,PROMPT1_ICL_entailment
67,159,36,28,8,0.7777777777777778,29,18,11,0.6206896551724138,0.6904109589041096,gemini,coral,breastca,PROMPT1_ICL_entailment
68,16,22,22,0,1.0,10,9,1,0.9,0.9473684210526316,gemini,coral,breastca,PROMPT1_ICL_entailment
69,160,80,66,14,0.825,18,15,3,0.8333333333333334,0.8291457286432161,gemini,coral,breastca,PROMPT1_ICL_entailment
70,161,36,32,4,0.8888888888888888,11,10,1,0.9090909090909092,0.8988764044943819,gemini,coral,breastca,PROMPT1_ICL_entailment
71,162,29,27,2,0.9310344827586208,16,15,1,0.9375,0.9342560553633218,gemini,coral,breastca,PROMPT1_ICL_entailment
72,163,17,14,3,0.8235294117647058,11,10,1,0.9090909090909092,0.8641975308641976,gemini,coral,breastca,PROMPT1_ICL_entailment
73,164,14,13,1,0.9285714285714286,8,6,2,0.75,0.8297872340425532,gemini,coral,breastca,PROMPT1_ICL_entailment
74,165,18,16,2,0.8888888888888888,12,9,3,0.75,0.8135593220338982,gemini,coral,breastca,PROMPT1_ICL_entailment
75,166,25,22,3,0.88,10,9,1,0.9,0.8898876404494382,gemini,coral,breastca,PROMPT1_ICL_entailment
76,167,18,16,2,0.8888888888888888,7,5,2,0.7142857142857143,0.792079207920792,gemini,coral,breastca,PROMPT1_ICL_entailment
77,168,10,7,3,0.7,7,4,3,0.5714285714285714,0.6292134831460674,gemini,coral,breastca,PROMPT1_ICL_entailment
78,169,14,11,3,0.7857142857142857,11,7,4,0.6363636363636364,0.7031963470319634,gemini,coral,breastca,PROMPT1_ICL_entailment
79,17,10,8,2,0.8,3,3,0,1.0,0.888888888888889,gemini,coral,breastca,PROMPT1_ICL_entailment
80,170,20,19,1,0.95,10,10,0,1.0,0.9743589743589745,gemini,coral,breastca,PROMPT1_ICL_entailment
81,171,30,28,2,0.9333333333333332,9,9,0,1.0,0.9655172413793104,gemini,coral,breastca,PROMPT1_ICL_entailment
82,172,32,26,6,0.8125,32,17,15,0.53125,0.6424418604651163,gemini,coral,breastca,PROMPT1_ICL_entailment
83,173,1,0,1,0.0,11,0,11,0.0,,gemini,coral,breastca,PROMPT1_ICL_entailment
84,174,19,12,7,0.631578947368421,7,5,2,0.7142857142857143,0.670391061452514,gemini,coral,breastca,PROMPT1_ICL_entailment
85,175,13,9,4,0.6923076923076923,10,7,3,0.7,0.6961325966850829,gemini,coral,breastca,PROMPT1_ICL_entailment
86,176,16,15,1,0.9375,10,10,0,1.0,0.967741935483871,gemini,coral,breastca,PROMPT1_ICL_entailment
87,177,22,21,1,0.9545454545454546,9,9,0,1.0,0.9767441860465116,gemini,coral,breastca,PROMPT1_ICL_entailment
88,178,17,13,4,0.7647058823529411,10,9,1,0.9,0.8268551236749118,gemini,coral,breastca,PROMPT1_ICL_entailment
89,179,19,18,1,0.9473684210526316,9,9,0,1.0,0.972972972972973,gemini,coral,breastca,PROMPT1_ICL_entailment
90,18,21,20,1,0.9523809523809524,8,8,0,1.0,0.975609756097561,gemini,coral,breastca,PROMPT1_ICL_entailment
91,180,8,5,3,0.625,10,8,2,0.8,0.7017543859649122,gemini,coral,breastca,PROMPT1_ICL_entailment
92,181,10,8,2,0.8,9,9,0,1.0,0.888888888888889,gemini,coral,breastca,PROMPT1_ICL_entailment
93,182,11,9,2,0.8181818181818182,9,4,5,0.4444444444444444,0.5760000000000001,gemini,coral,breastca,PROMPT1_ICL_entailment
94,183,14,14,0,1.0,10,9,1,0.9,0.9473684210526316,gemini,coral,breastca,PROMPT1_ICL_entailment
95,184,25,21,4,0.84,9,7,2,0.7777777777777778,0.8076923076923077,gemini,coral,breastca,PROMPT1_ICL_entailment
96,185,26,26,0,1.0,10,9,1,0.9,0.9473684210526316,gemini,coral,breastca,PROMPT1_ICL_entailment
97,186,20,19,1,0.95,5,5,0,1.0,0.9743589743589745,gemini,coral,breastca,PROMPT1_ICL_entailment
98,187,37,34,3,0.918918918918919,26,14,12,0.5384615384615384,0.6790299572039943,gemini,coral,breastca,PROMPT1_ICL_entailment
99,188,17,17,0,1.0,9,9,0,1.0,1.0,gemini,coral,breastca,PROMPT1_ICL_entailment
100,189,17,16,1,0.9411764705882352,9,9,0,1.0,0.9696969696969696,gemini,coral,breastca,PROMPT1_ICL_entailment
101,19,19,17,2,0.8947368421052632,8,7,1,0.875,0.8847583643122676,gemini,coral,breastca,PROMPT1_ICL_entailment
102,190,21,8,13,0.3809523809523809,34,13,21,0.3823529411764705,0.3816513761467889,gemini,coral,breastca,PROMPT1_ICL_entailment
103,191,1,0,1,0.0,14,0,14,0.0,,gemini,coral,breastca,PROMPT1_ICL_entailment
104,192,21,19,2,0.9047619047619048,12,11,1,0.9166666666666666,0.9106753812636164,gemini,coral,breastca,PROMPT1_ICL_entailment
105,193,16,14,2,0.875,2,2,0,1.0,0.9333333333333332,gemini,coral,breastca,PROMPT1_ICL_entailment
106,194,35,33,2,0.9428571428571428,15,13,2,0.8666666666666667,0.9031578947368422,gemini,coral,breastca,PROMPT1_ICL_entailment
107,195,20,18,2,0.9,13,13,0,1.0,0.9473684210526316,gemini,coral,breastca,PROMPT1_ICL_entailment
108,196,54,46,8,0.8518518518518519,30,24,6,0.8,0.8251121076233184,gemini,coral,breastca,PROMPT1_ICL_entailment
109,197,20,16,4,0.8,14,7,7,0.5,0.6153846153846154,gemini,coral,breastca,PROMPT1_ICL_entailment
110,198,23,20,3,0.8695652173913043,11,11,0,1.0,0.9302325581395348,gemini,coral,breastca,PROMPT1_ICL_entailment
111,199,7,7,0,1.0,2,2,0,1.0,1.0,gemini,coral,breastca,PROMPT1_ICL_entailment
112,2,36,29,7,0.8055555555555556,10,8,2,0.8,0.8027681660899654,gemini,coral,breastca,PROMPT1_ICL_entailment
113,20,19,12,7,0.631578947368421,17,10,7,0.5882352941176471,0.6091370558375635,gemini,coral,breastca,PROMPT1_ICL_entailment
114,200,60,60,0,1.0,15,13,2,0.8666666666666667,0.9285714285714286,gemini,coral,breastca,PROMPT1_ICL_entailment
115,201,36,20,16,0.5555555555555556,26,20,6,0.7692307692307693,0.6451612903225806,gemini,coral,breastca,PROMPT1_ICL_entailment
116,202,24,21,3,0.875,17,14,3,0.8235294117647058,0.8484848484848485,gemini,coral,breastca,PROMPT1_ICL_entailment
117,203,1,0,1,0.0,27,16,11,0.5925925925925926,0.0,gemini,coral,breastca,PROMPT1_ICL_entailment
118,204,19,19,0,1.0,11,11,0,1.0,1.0,gemini,coral,breastca,PROMPT1_ICL_entailment
119,205,34,32,2,0.9411764705882352,11,11,0,1.0,0.9696969696969696,gemini,coral,breastca,PROMPT1_ICL_entailment
120,206,20,19,1,0.95,4,4,0,1.0,0.9743589743589745,gemini,coral,breastca,PROMPT1_ICL_entailment
121,207,17,14,3,0.8235294117647058,12,10,2,0.8333333333333334,0.8284023668639053,gemini,coral,breastca,PROMPT1_ICL_entailment
122,208,20,20,0,1.0,9,8,1,0.8888888888888888,0.9411764705882352,gemini,coral,breastca,PROMPT1_ICL_entailment
123,209,50,48,2,0.96,11,10,1,0.9090909090909092,0.9338521400778208,gemini,coral,breastca,PROMPT1_ICL_entailment
124,21,55,36,19,0.6545454545454545,27,17,10,0.6296296296296297,0.6418458311484007,gemini,coral,breastca,PROMPT1_ICL_entailment
125,210,40,34,6,0.85,13,5,8,0.3846153846153846,0.5295950155763239,gemini,coral,breastca,PROMPT1_ICL_entailment
126,211,35,33,2,0.9428571428571428,11,11,0,1.0,0.9705882352941176,gemini,coral,breastca,PROMPT1_ICL_entailment
127,212,20,18,2,0.9,9,7,2,0.7777777777777778,0.8344370860927153,gemini,coral,breastca,PROMPT1_ICL_entailment
128,213,36,26,10,0.7222222222222222,11,10,1,0.9090909090909092,0.8049535603715171,gemini,coral,breastca,PROMPT1_ICL_entailment
129,214,40,24,16,0.6,28,14,14,0.5,0.5454545454545454,gemini,coral,breastca,PROMPT1_ICL_entailment
130,215,34,22,12,0.6470588235294118,37,18,19,0.4864864864864865,0.5553997194950913,gemini,coral,breastca,PROMPT1_ICL_entailment
131,216,47,43,4,0.9148936170212766,15,14,1,0.9333333333333332,0.9240214888718342,gemini,coral,breastca,PROMPT1_ICL_entailment
132,22,29,17,12,0.5862068965517241,7,5,2,0.7142857142857143,0.6439393939393939,gemini,coral,breastca,PROMPT1_ICL_entailment
133,23,13,10,3,0.7692307692307693,9,7,2,0.7777777777777778,0.7734806629834255,gemini,coral,breastca,PROMPT1_ICL_entailment
134,24,19,17,2,0.8947368421052632,10,8,2,0.8,0.84472049689441,gemini,coral,breastca,PROMPT1_ICL_entailment
135,25,23,22,1,0.9565217391304348,8,8,0,1.0,0.9777777777777776,gemini,coral,breastca,PROMPT1_ICL_entailment
136,26,22,21,1,0.9545454545454546,11,11,0,1.0,0.9767441860465116,gemini,coral,breastca,PROMPT1_ICL_entailment
137,27,24,23,1,0.9583333333333334,12,9,3,0.75,0.8414634146341463,gemini,coral,breastca,PROMPT1_ICL_entailment
138,28,22,22,0,1.0,18,13,5,0.7222222222222222,0.8387096774193548,gemini,coral,breastca,PROMPT1_ICL_entailment
139,29,30,26,4,0.8666666666666667,9,6,3,0.6666666666666666,0.7536231884057971,gemini,coral,breastca,PROMPT1_ICL_entailment
140,3,1,0,1,0.0,11,3,8,0.2727272727272727,0.0,gemini,coral,breastca,PROMPT1_ICL_entailment
141,30,68,54,14,0.7941176470588235,18,8,10,0.4444444444444444,0.5699208443271767,gemini,coral,breastca,PROMPT1_ICL_entailment
142,31,21,12,9,0.5714285714285714,13,11,2,0.8461538461538461,0.6821705426356589,gemini,coral,breastca,PROMPT1_ICL_entailment
143,32,15,14,1,0.9333333333333332,9,8,1,0.8888888888888888,0.9105691056910568,gemini,coral,breastca,PROMPT1_ICL_entailment
144,33,17,15,2,0.8823529411764706,8,7,1,0.875,0.8786610878661087,gemini,coral,breastca,PROMPT1_ICL_entailment
145,34,11,11,0,1.0,10,6,4,0.6,0.7499999999999999,gemini,coral,breastca,PROMPT1_ICL_entailment
146,35,19,17,2,0.8947368421052632,12,12,0,1.0,0.9444444444444444,gemini,coral,breastca,PROMPT1_ICL_entailment
147,36,26,26,0,1.0,11,11,0,1.0,1.0,gemini,coral,breastca,PROMPT1_ICL_entailment
148,37,17,16,1,0.9411764705882352,11,7,4,0.6363636363636364,0.759322033898305,gemini,coral,breastca,PROMPT1_ICL_entailment
149,38,20,18,2,0.9,11,9,2,0.8181818181818182,0.8571428571428572,gemini,coral,breastca,PROMPT1_ICL_entailment
150,39,1,0,1,0.0,11,1,10,0.0909090909090909,0.0,gemini,coral,breastca,PROMPT1_ICL_entailment
151,4,76,46,30,0.6052631578947368,59,31,28,0.5254237288135594,0.5625246548323471,gemini,coral,breastca,PROMPT1_ICL_entailment
152,40,16,16,0,1.0,9,8,1,0.8888888888888888,0.9411764705882352,gemini,coral,breastca,PROMPT1_ICL_entailment
153,41,15,15,0,1.0,14,12,2,0.8571428571428571,0.923076923076923,gemini,coral,breastca,PROMPT1_ICL_entailment
154,42,25,20,5,0.8,9,2,7,0.2222222222222222,0.3478260869565218,gemini,coral,breastca,PROMPT1_ICL_entailment
155,43,19,18,1,0.9473684210526316,9,7,2,0.7777777777777778,0.8542372881355932,gemini,coral,breastca,PROMPT1_ICL_entailment
156,44,21,17,4,0.8095238095238095,9,9,0,1.0,0.8947368421052632,gemini,coral,breastca,PROMPT1_ICL_entailment
157,45,3,0,3,0.0,2,1,1,0.5,0.0,gemini,coral,breastca,PROMPT1_ICL_entailment
158,46,19,18,1,0.9473684210526316,5,5,0,1.0,0.972972972972973,gemini,coral,breastca,PROMPT1_ICL_entailment
159,47,13,11,2,0.8461538461538461,2,2,0,1.0,0.9166666666666666,gemini,coral,breastca,PROMPT1_ICL_entailment
160,48,14,14,0,1.0,5,5,0,1.0,1.0,gemini,coral,breastca,PROMPT1_ICL_entailment
161,49,37,25,12,0.6756756756756757,16,10,6,0.625,0.6493506493506493,gemini,coral,breastca,PROMPT1_ICL_entailment
162,5,40,36,4,0.9,12,8,4,0.6666666666666666,0.7659574468085106,gemini,coral,breastca,PROMPT1_ICL_entailment
163,50,19,9,10,0.4736842105263157,16,13,3,0.8125,0.5984654731457801,gemini,coral,breastca,PROMPT1_ICL_entailment
164,51,38,31,7,0.8157894736842105,11,9,2,0.8181818181818182,0.8169838945827232,gemini,coral,breastca,PROMPT1_ICL_entailment
165,52,23,21,2,0.9130434782608696,10,8,2,0.8,0.852791878172589,gemini,coral,breastca,PROMPT1_ICL_entailment
166,53,23,23,0,1.0,10,10,0,1.0,1.0,gemini,coral,breastca,PROMPT1_ICL_entailment
167,54,33,30,3,0.9090909090909092,9,8,1,0.8888888888888888,0.8988764044943819,gemini,coral,breastca,PROMPT1_ICL_entailment
168,55,1,0,1,0.0,1,0,1,0.0,,gemini,coral,breastca,PROMPT1_ICL_entailment
169,56,10,10,0,1.0,18,5,13,0.2777777777777778,0.4347826086956522,gemini,coral,breastca,PROMPT1_ICL_entailment
170,57,30,29,1,0.9666666666666668,10,8,2,0.8,0.8754716981132077,gemini,coral,breastca,PROMPT1_ICL_entailment
171,58,24,23,1,0.9583333333333334,10,8,2,0.8,0.8720379146919433,gemini,coral,breastca,PROMPT1_ICL_entailment
172,59,1,0,1,0.0,9,0,9,0.0,,gemini,coral,breastca,PROMPT1_ICL_entailment
173,6,11,11,0,1.0,8,5,3,0.625,0.7692307692307693,gemini,coral,breastca,PROMPT1_ICL_entailment
174,60,19,19,0,1.0,10,8,2,0.8,0.888888888888889,gemini,coral,breastca,PROMPT1_ICL_entailment
175,61,18,18,0,1.0,11,11,0,1.0,1.0,gemini,coral,breastca,PROMPT1_ICL_entailment
176,62,17,15,2,0.8823529411764706,10,9,1,0.9,0.8910891089108911,gemini,coral,breastca,PROMPT1_ICL_entailment
177,63,21,18,3,0.8571428571428571,11,10,1,0.9090909090909092,0.8823529411764706,gemini,coral,breastca,PROMPT1_ICL_entailment
178,64,7,2,5,0.2857142857142857,17,1,16,0.0588235294117647,0.0975609756097561,gemini,coral,breastca,PROMPT1_ICL_entailment
179,65,34,32,2,0.9411764705882352,6,6,0,1.0,0.9696969696969696,gemini,coral,breastca,PROMPT1_ICL_entailment
180,66,29,29,0,1.0,10,10,0,1.0,1.0,gemini,coral,breastca,PROMPT1_ICL_entailment
181,67,57,37,20,0.6491228070175439,49,30,19,0.6122448979591837,0.6301447629860915,gemini,coral,breastca,PROMPT1_ICL_entailment
182,68,12,10,2,0.8333333333333334,8,7,1,0.875,0.8536585365853658,gemini,coral,breastca,PROMPT1_ICL_entailment
183,69,33,19,14,0.5757575757575758,12,5,7,0.4166666666666667,0.4834605597964377,gemini,coral,breastca,PROMPT1_ICL_entailment
184,7,24,24,0,1.0,11,11,0,1.0,1.0,gemini,coral,breastca,PROMPT1_ICL_entailment
185,70,54,48,6,0.8888888888888888,51,24,27,0.4705882352941176,0.6153846153846153,gemini,coral,breastca,PROMPT1_ICL_entailment
186,71,18,17,1,0.9444444444444444,5,4,1,0.8,0.8662420382165604,gemini,coral,breastca,PROMPT1_ICL_entailment
187,72,14,13,1,0.9285714285714286,3,3,0,1.0,0.962962962962963,gemini,coral,breastca,PROMPT1_ICL_entailment
188,73,12,11,1,0.9166666666666666,1,1,0,1.0,0.9565217391304348,gemini,coral,breastca,PROMPT1_ICL_entailment
189,74,19,17,2,0.8947368421052632,2,2,0,1.0,0.9444444444444444,gemini,coral,breastca,PROMPT1_ICL_entailment
190,75,22,20,2,0.9090909090909092,6,5,1,0.8333333333333334,0.8695652173913043,gemini,coral,breastca,PROMPT1_ICL_entailment
191,76,16,16,0,1.0,7,7,0,1.0,1.0,gemini,coral,breastca,PROMPT1_ICL_entailment
192,77,19,19,0,1.0,15,12,3,0.8,0.888888888888889,gemini,coral,breastca,PROMPT1_ICL_entailment
193,78,21,19,2,0.9047619047619048,8,6,2,0.75,0.8201438848920864,gemini,coral,breastca,PROMPT1_ICL_entailment
194,79,14,10,4,0.7142857142857143,8,7,1,0.875,0.7865168539325842,gemini,coral,breastca,PROMPT1_ICL_entailment
195,8,15,10,5,0.6666666666666666,9,9,0,1.0,0.8,gemini,coral,breastca,PROMPT1_ICL_entailment
196,80,25,23,2,0.92,24,16,8,0.6666666666666666,0.7731092436974789,gemini,coral,breastca,PROMPT1_ICL_entailment
197,81,23,22,1,0.9565217391304348,11,8,3,0.7272727272727273,0.8262910798122066,gemini,coral,breastca,PROMPT1_ICL_entailment
198,82,1,0,1,0.0,6,0,6,0.0,,gemini,coral,breastca,PROMPT1_ICL_entailment
199,83,15,15,0,1.0,6,6,0,1.0,1.0,gemini,coral,breastca,PROMPT1_ICL_entailment
200,84,27,22,5,0.8148148148148148,11,9,2,0.8181818181818182,0.8164948453608247,gemini,coral,breastca,PROMPT1_ICL_entailment
201,85,19,17,2,0.8947368421052632,7,6,1,0.8571428571428571,0.8755364806866952,gemini,coral,breastca,PROMPT1_ICL_entailment
202,86,25,21,4,0.84,16,13,3,0.8125,0.8260211800302573,gemini,coral,breastca,PROMPT1_ICL_entailment
203,87,19,17,2,0.8947368421052632,8,6,2,0.75,0.816,gemini,coral,breastca,PROMPT1_ICL_entailment
204,88,11,10,1,0.9090909090909092,8,6,2,0.75,0.821917808219178,gemini,coral,breastca,PROMPT1_ICL_entailment
205,89,1,0,1,0.0,11,2,9,0.1818181818181818,0.0,gemini,coral,breastca,PROMPT1_ICL_entailment
206,9,21,19,2,0.9047619047619048,6,6,0,1.0,0.95,gemini,coral,breastca,PROMPT1_ICL_entailment
207,90,9,4,5,0.4444444444444444,17,4,13,0.2352941176470588,0.3076923076923076,gemini,coral,breastca,PROMPT1_ICL_entailment
208,91,22,18,4,0.8181818181818182,7,5,2,0.7142857142857143,0.7627118644067797,gemini,coral,breastca,PROMPT1_ICL_entailment
209,92,24,2,22,0.0833333333333333,2,0,2,0.0,0.0,gemini,coral,breastca,PROMPT1_ICL_entailment
210,93,29,25,4,0.8620689655172413,13,9,4,0.6923076923076923,0.7679180887372012,gemini,coral,breastca,PROMPT1_ICL_entailment
211,94,1,0,1,0.0,25,2,23,0.08,0.0,gemini,coral,breastca,PROMPT1_ICL_entailment
212,95,42,35,7,0.8333333333333334,13,6,7,0.4615384615384615,0.594059405940594,gemini,coral,breastca,PROMPT1_ICL_entailment
213,96,19,16,3,0.8421052631578947,10,9,1,0.9,0.8700906344410877,gemini,coral,breastca,PROMPT1_ICL_entailment
214,97,15,13,2,0.8666666666666667,11,9,2,0.8181818181818182,0.8417266187050358,gemini,coral,breastca,PROMPT1_ICL_entailment
215,98,12,11,1,0.9166666666666666,2,2,0,1.0,0.9565217391304348,gemini,coral,breastca,PROMPT1_ICL_entailment
216,99,36,33,3,0.9166666666666666,15,11,4,0.7333333333333333,0.8148148148148148,gemini,coral,breastca,PROMPT1_ICL_entailment
0,0,52,51,1,0.9807692307692308,10,9,1,0.9,0.9386503067484664,gemini,coral,breastca,PROMPT2_ICL_entailment
1,1,54,36,18,0.6666666666666666,12,11,1,0.9166666666666666,0.7719298245614035,gemini,coral,breastca,PROMPT2_ICL_entailment
2,10,31,24,7,0.7741935483870968,10,8,2,0.8,0.7868852459016393,gemini,coral,breastca,PROMPT2_ICL_entailment
3,100,32,22,10,0.6875,26,11,15,0.4230769230769231,0.5238095238095238,gemini,coral,breastca,PROMPT2_ICL_entailment
4,101,61,56,5,0.918032786885246,18,12,6,0.6666666666666666,0.7724137931034483,gemini,coral,breastca,PROMPT2_ICL_entailment
5,102,17,16,1,0.9411764705882352,7,4,3,0.5714285714285714,0.7111111111111111,gemini,coral,breastca,PROMPT2_ICL_entailment
6,103,62,58,4,0.935483870967742,10,10,0,1.0,0.9666666666666666,gemini,coral,breastca,PROMPT2_ICL_entailment
7,104,1,0,1,0.0,26,1,25,0.0384615384615384,0.0,gemini,coral,breastca,PROMPT2_ICL_entailment
8,105,35,33,2,0.9428571428571428,15,15,0,1.0,0.9705882352941176,gemini,coral,breastca,PROMPT2_ICL_entailment
9,106,26,25,1,0.9615384615384616,9,9,0,1.0,0.9803921568627452,gemini,coral,breastca,PROMPT2_ICL_entailment
10,107,26,16,10,0.6153846153846154,9,9,0,1.0,0.761904761904762,gemini,coral,breastca,PROMPT2_ICL_entailment
11,108,22,21,1,0.9545454545454546,11,10,1,0.9090909090909092,0.9312638580931264,gemini,coral,breastca,PROMPT2_ICL_entailment
12,109,21,19,2,0.9047619047619048,11,11,0,1.0,0.95,gemini,coral,breastca,PROMPT2_ICL_entailment
13,11,17,12,5,0.7058823529411765,3,3,0,1.0,0.8275862068965517,gemini,coral,breastca,PROMPT2_ICL_entailment
14,110,20,17,3,0.85,11,9,2,0.8181818181818182,0.8337874659400545,gemini,coral,breastca,PROMPT2_ICL_entailment
15,111,25,20,5,0.8,10,10,0,1.0,0.888888888888889,gemini,coral,breastca,PROMPT2_ICL_entailment
16,112,23,23,0,1.0,10,9,1,0.9,0.9473684210526316,gemini,coral,breastca,PROMPT2_ICL_entailment
17,113,50,35,15,0.7,49,29,20,0.5918367346938775,0.641390205371248,gemini,coral,breastca,PROMPT2_ICL_entailment
18,114,35,27,8,0.7714285714285715,21,9,12,0.4285714285714285,0.5510204081632654,gemini,coral,breastca,PROMPT2_ICL_entailment
19,115,14,11,3,0.7857142857142857,9,5,4,0.5555555555555556,0.650887573964497,gemini,coral,breastca,PROMPT2_ICL_entailment
20,116,37,31,6,0.8378378378378378,14,12,2,0.8571428571428571,0.847380410022779,gemini,coral,breastca,PROMPT2_ICL_entailment
21,117,8,7,1,0.875,2,2,0,1.0,0.9333333333333332,gemini,coral,breastca,PROMPT2_ICL_entailment
22,118,19,19,0,1.0,19,8,11,0.4210526315789473,0.5925925925925926,gemini,coral,breastca,PROMPT2_ICL_entailment
23,119,20,17,3,0.85,10,9,1,0.9,0.8742857142857143,gemini,coral,breastca,PROMPT2_ICL_entailment
24,12,60,57,3,0.95,10,10,0,1.0,0.9743589743589745,gemini,coral,breastca,PROMPT2_ICL_entailment
25,120,38,36,2,0.9473684210526316,9,9,0,1.0,0.972972972972973,gemini,coral,breastca,PROMPT2_ICL_entailment
26,121,40,32,8,0.8,10,9,1,0.9,0.8470588235294118,gemini,coral,breastca,PROMPT2_ICL_entailment
27,122,29,28,1,0.9655172413793104,9,9,0,1.0,0.9824561403508772,gemini,coral,breastca,PROMPT2_ICL_entailment
28,123,28,27,1,0.9642857142857144,8,8,0,1.0,0.9818181818181818,gemini,coral,breastca,PROMPT2_ICL_entailment
29,124,25,24,1,0.96,10,10,0,1.0,0.979591836734694,gemini,coral,breastca,PROMPT2_ICL_entailment
30,125,30,25,5,0.8333333333333334,11,10,1,0.9090909090909092,0.8695652173913043,gemini,coral,breastca,PROMPT2_ICL_entailment
31,126,23,20,3,0.8695652173913043,10,9,1,0.9,0.8845208845208845,gemini,coral,breastca,PROMPT2_ICL_entailment
32,127,35,29,6,0.8285714285714286,10,10,0,1.0,0.90625,gemini,coral,breastca,PROMPT2_ICL_entailment
33,128,41,38,3,0.926829268292683,11,9,2,0.8181818181818182,0.8691232528589581,gemini,coral,breastca,PROMPT2_ICL_entailment
34,129,24,21,3,0.875,11,8,3,0.7272727272727273,0.7943262411347517,gemini,coral,breastca,PROMPT2_ICL_entailment
35,13,33,23,10,0.696969696969697,10,9,1,0.9,0.7855787476280834,gemini,coral,breastca,PROMPT2_ICL_entailment
36,130,1,0,1,0.0,7,1,6,0.1428571428571428,0.0,gemini,coral,breastca,PROMPT2_ICL_entailment
37,131,51,46,5,0.9019607843137256,10,10,0,1.0,0.9484536082474228,gemini,coral,breastca,PROMPT2_ICL_entailment
38,132,23,23,0,1.0,8,7,1,0.875,0.9333333333333332,gemini,coral,breastca,PROMPT2_ICL_entailment
39,133,61,50,11,0.819672131147541,29,21,8,0.7241379310344828,0.7689491028927135,gemini,coral,breastca,PROMPT2_ICL_entailment
40,134,15,11,4,0.7333333333333333,11,4,7,0.3636363636363636,0.4861878453038674,gemini,coral,breastca,PROMPT2_ICL_entailment
41,135,1,0,1,0.0,16,1,15,0.0625,0.0,gemini,coral,breastca,PROMPT2_ICL_entailment
42,136,26,20,6,0.7692307692307693,10,8,2,0.8,0.7843137254901961,gemini,coral,breastca,PROMPT2_ICL_entailment
43,137,14,11,3,0.7857142857142857,10,10,0,1.0,0.88,gemini,coral,breastca,PROMPT2_ICL_entailment
44,138,13,13,0,1.0,10,10,0,1.0,1.0,gemini,coral,breastca,PROMPT2_ICL_entailment
45,139,23,23,0,1.0,11,10,1,0.9090909090909092,0.9523809523809524,gemini,coral,breastca,PROMPT2_ICL_entailment
46,14,74,45,29,0.6081081081081081,59,23,36,0.3898305084745763,0.4750975441817764,gemini,coral,breastca,PROMPT2_ICL_entailment
47,140,48,44,4,0.9166666666666666,9,7,2,0.7777777777777778,0.8415300546448087,gemini,coral,breastca,PROMPT2_ICL_entailment
48,141,49,42,7,0.8571428571428571,11,11,0,1.0,0.923076923076923,gemini,coral,breastca,PROMPT2_ICL_entailment
49,142,17,15,2,0.8823529411764706,10,9,1,0.9,0.8910891089108911,gemini,coral,breastca,PROMPT2_ICL_entailment
50,143,13,12,1,0.9230769230769232,10,7,3,0.7,0.7962085308056872,gemini,coral,breastca,PROMPT2_ICL_entailment
51,144,25,24,1,0.96,5,5,0,1.0,0.979591836734694,gemini,coral,breastca,PROMPT2_ICL_entailment
52,145,17,16,1,0.9411764705882352,5,5,0,1.0,0.9696969696969696,gemini,coral,breastca,PROMPT2_ICL_entailment
53,146,21,21,0,1.0,9,9,0,1.0,1.0,gemini,coral,breastca,PROMPT2_ICL_entailment
54,147,28,25,3,0.8928571428571429,5,4,1,0.8,0.8438818565400844,gemini,coral,breastca,PROMPT2_ICL_entailment
55,148,17,14,3,0.8235294117647058,4,2,2,0.5,0.6222222222222222,gemini,coral,breastca,PROMPT2_ICL_entailment
56,149,17,16,1,0.9411764705882352,1,1,0,1.0,0.9696969696969696,gemini,coral,breastca,PROMPT2_ICL_entailment
57,15,95,71,24,0.7473684210526316,16,6,10,0.375,0.4994138335287221,gemini,coral,breastca,PROMPT2_ICL_entailment
58,150,20,20,0,1.0,2,2,0,1.0,1.0,gemini,coral,breastca,PROMPT2_ICL_entailment
59,151,25,23,2,0.92,9,8,1,0.8888888888888888,0.9041769041769042,gemini,coral,breastca,PROMPT2_ICL_entailment
60,152,28,24,4,0.8571428571428571,16,9,7,0.5625,0.6792452830188678,gemini,coral,breastca,PROMPT2_ICL_entailment
61,153,18,18,0,1.0,1,1,0,1.0,1.0,gemini,coral,breastca,PROMPT2_ICL_entailment
62,154,16,16,0,1.0,10,10,0,1.0,1.0,gemini,coral,breastca,PROMPT2_ICL_entailment
63,155,35,30,5,0.8571428571428571,9,9,0,1.0,0.923076923076923,gemini,coral,breastca,PROMPT2_ICL_entailment
64,156,31,27,4,0.8709677419354839,8,8,0,1.0,0.9310344827586208,gemini,coral,breastca,PROMPT2_ICL_entailment
65,157,34,33,1,0.9705882352941176,9,9,0,1.0,0.9850746268656716,gemini,coral,breastca,PROMPT2_ICL_entailment
66,158,78,64,14,0.8205128205128205,16,13,3,0.8125,0.81648675171737,gemini,coral,breastca,PROMPT2_ICL_entailment
67,159,39,29,10,0.7435897435897436,29,15,14,0.5172413793103449,0.6100981767180926,gemini,coral,breastca,PROMPT2_ICL_entailment
68,16,21,16,5,0.7619047619047619,10,7,3,0.7,0.7296416938110748,gemini,coral,breastca,PROMPT2_ICL_entailment
69,160,137,106,31,0.7737226277372263,18,13,5,0.7222222222222222,0.7470859311466522,gemini,coral,breastca,PROMPT2_ICL_entailment
70,161,35,35,0,1.0,11,9,2,0.8181818181818182,0.9,gemini,coral,breastca,PROMPT2_ICL_entailment
71,162,25,24,1,0.96,16,11,5,0.6875,0.8012139605462821,gemini,coral,breastca,PROMPT2_ICL_entailment
72,163,17,15,2,0.8823529411764706,11,11,0,1.0,0.9375,gemini,coral,breastca,PROMPT2_ICL_entailment
73,164,22,22,0,1.0,8,6,2,0.75,0.8571428571428571,gemini,coral,breastca,PROMPT2_ICL_entailment
74,165,25,24,1,0.96,12,10,2,0.8333333333333334,0.8921933085501859,gemini,coral,breastca,PROMPT2_ICL_entailment
75,166,16,14,2,0.875,10,5,5,0.5,0.6363636363636364,gemini,coral,breastca,PROMPT2_ICL_entailment
76,167,27,22,5,0.8148148148148148,7,6,1,0.8571428571428571,0.8354430379746836,gemini,coral,breastca,PROMPT2_ICL_entailment
77,168,22,18,4,0.8181818181818182,7,4,3,0.5714285714285714,0.6728971962616823,gemini,coral,breastca,PROMPT2_ICL_entailment
78,169,22,17,5,0.7727272727272727,11,9,2,0.8181818181818182,0.7948051948051948,gemini,coral,breastca,PROMPT2_ICL_entailment
79,17,1,1,0,1.0,3,2,1,0.6666666666666666,0.8,gemini,coral,breastca,PROMPT2_ICL_entailment
80,170,23,23,0,1.0,10,10,0,1.0,1.0,gemini,coral,breastca,PROMPT2_ICL_entailment
81,171,48,47,1,0.9791666666666666,9,8,1,0.8888888888888888,0.9318463444857495,gemini,coral,breastca,PROMPT2_ICL_entailment
82,172,112,97,15,0.8660714285714286,32,20,12,0.625,0.7260479041916168,gemini,coral,breastca,PROMPT2_ICL_entailment
83,173,16,14,2,0.875,11,7,4,0.6363636363636364,0.7368421052631579,gemini,coral,breastca,PROMPT2_ICL_entailment
84,174,18,17,1,0.9444444444444444,7,6,1,0.8571428571428571,0.8986784140969163,gemini,coral,breastca,PROMPT2_ICL_entailment
85,175,18,13,5,0.7222222222222222,10,10,0,1.0,0.8387096774193548,gemini,coral,breastca,PROMPT2_ICL_entailment
86,176,22,21,1,0.9545454545454546,10,10,0,1.0,0.9767441860465116,gemini,coral,breastca,PROMPT2_ICL_entailment
87,177,24,23,1,0.9583333333333334,9,9,0,1.0,0.9787234042553192,gemini,coral,breastca,PROMPT2_ICL_entailment
88,178,31,21,10,0.6774193548387096,10,8,2,0.8,0.7336244541484714,gemini,coral,breastca,PROMPT2_ICL_entailment
89,179,26,24,2,0.9230769230769232,9,9,0,1.0,0.96,gemini,coral,breastca,PROMPT2_ICL_entailment
90,18,40,37,3,0.925,8,8,0,1.0,0.961038961038961,gemini,coral,breastca,PROMPT2_ICL_entailment
91,180,21,19,2,0.9047619047619048,10,7,3,0.7,0.7893175074183976,gemini,coral,breastca,PROMPT2_ICL_entailment
92,181,15,14,1,0.9333333333333332,9,6,3,0.6666666666666666,0.7777777777777778,gemini,coral,breastca,PROMPT2_ICL_entailment
93,182,24,24,0,1.0,9,9,0,1.0,1.0,gemini,coral,breastca,PROMPT2_ICL_entailment
94,183,22,21,1,0.9545454545454546,10,9,1,0.9,0.9264705882352942,gemini,coral,breastca,PROMPT2_ICL_entailment
95,184,35,32,3,0.9142857142857144,9,9,0,1.0,0.955223880597015,gemini,coral,breastca,PROMPT2_ICL_entailment
96,185,31,29,2,0.935483870967742,10,9,1,0.9,0.9173989455184536,gemini,coral,breastca,PROMPT2_ICL_entailment
97,186,14,13,1,0.9285714285714286,5,4,1,0.8,0.859504132231405,gemini,coral,breastca,PROMPT2_ICL_entailment
98,187,89,72,17,0.8089887640449438,26,18,8,0.6923076923076923,0.7461139896373058,gemini,coral,breastca,PROMPT2_ICL_entailment
99,188,23,23,0,1.0,9,9,0,1.0,1.0,gemini,coral,breastca,PROMPT2_ICL_entailment
100,189,19,17,2,0.8947368421052632,9,9,0,1.0,0.9444444444444444,gemini,coral,breastca,PROMPT2_ICL_entailment
101,19,23,23,0,1.0,8,8,0,1.0,1.0,gemini,coral,breastca,PROMPT2_ICL_entailment
102,190,32,15,17,0.46875,34,18,16,0.5294117647058824,0.4972375690607735,gemini,coral,breastca,PROMPT2_ICL_entailment
103,191,74,50,24,0.6756756756756757,14,9,5,0.6428571428571429,0.6588579795021962,gemini,coral,breastca,PROMPT2_ICL_entailment
104,192,28,22,6,0.7857142857142857,12,11,1,0.9166666666666666,0.8461538461538461,gemini,coral,breastca,PROMPT2_ICL_entailment
105,193,18,15,3,0.8333333333333334,2,2,0,1.0,0.9090909090909092,gemini,coral,breastca,PROMPT2_ICL_entailment
106,194,53,48,5,0.9056603773584906,15,13,2,0.8666666666666667,0.8857345635202272,gemini,coral,breastca,PROMPT2_ICL_entailment
107,195,30,26,4,0.8666666666666667,13,13,0,1.0,0.9285714285714286,gemini,coral,breastca,PROMPT2_ICL_entailment
108,196,45,37,8,0.8222222222222222,30,22,8,0.7333333333333333,0.7752380952380953,gemini,coral,breastca,PROMPT2_ICL_entailment
109,197,75,62,13,0.8266666666666667,14,13,1,0.9285714285714286,0.8746608790016278,gemini,coral,breastca,PROMPT2_ICL_entailment
110,198,23,21,2,0.9130434782608696,11,10,1,0.9090909090909092,0.9110629067245118,gemini,coral,breastca,PROMPT2_ICL_entailment
111,199,7,6,1,0.8571428571428571,2,2,0,1.0,0.923076923076923,gemini,coral,breastca,PROMPT2_ICL_entailment
112,2,41,29,12,0.7073170731707317,10,9,1,0.9,0.7921092564491654,gemini,coral,breastca,PROMPT2_ICL_entailment
113,20,47,31,16,0.6595744680851063,17,7,10,0.4117647058823529,0.5070093457943926,gemini,coral,breastca,PROMPT2_ICL_entailment
114,200,96,89,7,0.9270833333333334,15,11,4,0.7333333333333333,0.8189042241739858,gemini,coral,breastca,PROMPT2_ICL_entailment
115,201,41,30,11,0.7317073170731707,26,20,6,0.7692307692307693,0.7499999999999999,gemini,coral,breastca,PROMPT2_ICL_entailment
116,202,25,19,6,0.76,17,15,2,0.8823529411764706,0.816618911174785,gemini,coral,breastca,PROMPT2_ICL_entailment
117,203,82,65,17,0.7926829268292683,27,23,4,0.8518518518518519,0.821202966218072,gemini,coral,breastca,PROMPT2_ICL_entailment
118,204,27,26,1,0.9629629629629628,11,9,2,0.8181818181818182,0.8846880907372401,gemini,coral,breastca,PROMPT2_ICL_entailment
119,205,36,34,2,0.9444444444444444,11,11,0,1.0,0.9714285714285714,gemini,coral,breastca,PROMPT2_ICL_entailment
120,206,25,24,1,0.96,4,4,0,1.0,0.979591836734694,gemini,coral,breastca,PROMPT2_ICL_entailment
121,207,20,18,2,0.9,12,5,7,0.4166666666666667,0.569620253164557,gemini,coral,breastca,PROMPT2_ICL_entailment
122,208,21,21,0,1.0,9,9,0,1.0,1.0,gemini,coral,breastca,PROMPT2_ICL_entailment
123,209,52,49,3,0.9423076923076924,11,8,3,0.7272727272727273,0.8209424083769633,gemini,coral,breastca,PROMPT2_ICL_entailment
124,21,122,74,48,0.6065573770491803,27,19,8,0.7037037037037037,0.6515291936978684,gemini,coral,breastca,PROMPT2_ICL_entailment
125,210,59,39,20,0.6610169491525424,13,9,4,0.6923076923076923,0.6763005780346821,gemini,coral,breastca,PROMPT2_ICL_entailment
126,211,48,44,4,0.9166666666666666,11,11,0,1.0,0.9565217391304348,gemini,coral,breastca,PROMPT2_ICL_entailment
127,212,28,22,6,0.7857142857142857,9,5,4,0.5555555555555556,0.650887573964497,gemini,coral,breastca,PROMPT2_ICL_entailment
128,213,58,47,11,0.8103448275862069,11,9,2,0.8181818181818182,0.8142444658325312,gemini,coral,breastca,PROMPT2_ICL_entailment
129,214,30,12,18,0.4,28,19,9,0.6785714285714286,0.5033112582781457,gemini,coral,breastca,PROMPT2_ICL_entailment
130,215,83,49,34,0.5903614457831325,37,21,16,0.5675675675675675,0.578740157480315,gemini,coral,breastca,PROMPT2_ICL_entailment
131,216,56,48,8,0.8571428571428571,15,12,3,0.8,0.8275862068965518,gemini,coral,breastca,PROMPT2_ICL_entailment
132,22,26,19,7,0.7307692307692307,7,5,2,0.7142857142857143,0.7224334600760457,gemini,coral,breastca,PROMPT2_ICL_entailment
133,23,16,14,2,0.875,9,8,1,0.8888888888888888,0.8818897637795274,gemini,coral,breastca,PROMPT2_ICL_entailment
134,24,27,23,4,0.8518518518518519,10,9,1,0.9,0.8752642706131079,gemini,coral,breastca,PROMPT2_ICL_entailment
135,25,37,35,2,0.945945945945946,8,8,0,1.0,0.9722222222222222,gemini,coral,breastca,PROMPT2_ICL_entailment
136,26,28,25,3,0.8928571428571429,11,11,0,1.0,0.9433962264150944,gemini,coral,breastca,PROMPT2_ICL_entailment
137,27,35,32,3,0.9142857142857144,12,10,2,0.8333333333333334,0.8719346049046321,gemini,coral,breastca,PROMPT2_ICL_entailment
138,28,37,36,1,0.972972972972973,18,15,3,0.8333333333333334,0.8977556109725686,gemini,coral,breastca,PROMPT2_ICL_entailment
139,29,44,36,8,0.8181818181818182,9,5,4,0.5555555555555556,0.661764705882353,gemini,coral,breastca,PROMPT2_ICL_entailment
140,3,43,21,22,0.4883720930232558,11,9,2,0.8181818181818182,0.6116504854368932,gemini,coral,breastca,PROMPT2_ICL_entailment
141,30,71,54,17,0.7605633802816901,18,9,9,0.5,0.6033519553072626,gemini,coral,breastca,PROMPT2_ICL_entailment
142,31,23,19,4,0.8260869565217391,13,9,4,0.6923076923076923,0.7533039647577092,gemini,coral,breastca,PROMPT2_ICL_entailment
143,32,18,16,2,0.8888888888888888,9,8,1,0.8888888888888888,0.8888888888888888,gemini,coral,breastca,PROMPT2_ICL_entailment
144,33,26,24,2,0.9230769230769232,8,7,1,0.875,0.8983957219251337,gemini,coral,breastca,PROMPT2_ICL_entailment
145,34,15,13,2,0.8666666666666667,10,3,7,0.3,0.4457142857142857,gemini,coral,breastca,PROMPT2_ICL_entailment
146,35,25,22,3,0.88,12,10,2,0.8333333333333334,0.8560311284046693,gemini,coral,breastca,PROMPT2_ICL_entailment
147,36,33,29,4,0.8787878787878788,11,10,1,0.9090909090909092,0.8936825885978428,gemini,coral,breastca,PROMPT2_ICL_entailment
148,37,21,19,2,0.9047619047619048,11,9,2,0.8181818181818182,0.8592964824120602,gemini,coral,breastca,PROMPT2_ICL_entailment
149,38,22,20,2,0.9090909090909092,11,6,5,0.5454545454545454,0.6818181818181818,gemini,coral,breastca,PROMPT2_ICL_entailment
150,39,25,25,0,1.0,11,9,2,0.8181818181818182,0.9,gemini,coral,breastca,PROMPT2_ICL_entailment
151,4,64,43,21,0.671875,59,28,31,0.4745762711864407,0.5562485562485562,gemini,coral,breastca,PROMPT2_ICL_entailment
152,40,17,17,0,1.0,9,8,1,0.8888888888888888,0.9411764705882352,gemini,coral,breastca,PROMPT2_ICL_entailment
153,41,19,19,0,1.0,14,12,2,0.8571428571428571,0.923076923076923,gemini,coral,breastca,PROMPT2_ICL_entailment
154,42,22,17,5,0.7727272727272727,9,5,4,0.5555555555555556,0.6463878326996197,gemini,coral,breastca,PROMPT2_ICL_entailment
155,43,20,19,1,0.95,9,8,1,0.8888888888888888,0.918429003021148,gemini,coral,breastca,PROMPT2_ICL_entailment
156,44,21,17,4,0.8095238095238095,9,9,0,1.0,0.8947368421052632,gemini,coral,breastca,PROMPT2_ICL_entailment
157,45,1,1,0,1.0,2,1,1,0.5,0.6666666666666666,gemini,coral,breastca,PROMPT2_ICL_entailment
158,46,27,27,0,1.0,5,5,0,1.0,1.0,gemini,coral,breastca,PROMPT2_ICL_entailment
159,47,19,17,2,0.8947368421052632,2,2,0,1.0,0.9444444444444444,gemini,coral,breastca,PROMPT2_ICL_entailment
160,48,28,28,0,1.0,5,5,0,1.0,1.0,gemini,coral,breastca,PROMPT2_ICL_entailment
161,49,50,30,20,0.6,16,9,7,0.5625,0.5806451612903225,gemini,coral,breastca,PROMPT2_ICL_entailment
162,5,61,49,12,0.8032786885245902,12,11,1,0.9166666666666666,0.8562351072279586,gemini,coral,breastca,PROMPT2_ICL_entailment
163,50,51,31,20,0.6078431372549019,16,12,4,0.75,0.671480144404332,gemini,coral,breastca,PROMPT2_ICL_entailment
164,51,39,26,13,0.6666666666666666,11,10,1,0.9090909090909092,0.7692307692307692,gemini,coral,breastca,PROMPT2_ICL_entailment
165,52,23,19,4,0.8260869565217391,10,10,0,1.0,0.9047619047619048,gemini,coral,breastca,PROMPT2_ICL_entailment
166,53,23,22,1,0.9565217391304348,10,10,0,1.0,0.9777777777777776,gemini,coral,breastca,PROMPT2_ICL_entailment
167,54,38,32,6,0.8421052631578947,9,9,0,1.0,0.9142857142857144,gemini,coral,breastca,PROMPT2_ICL_entailment
168,55,2,2,0,1.0,1,1,0,1.0,1.0,gemini,coral,breastca,PROMPT2_ICL_entailment
169,56,20,17,3,0.85,18,5,13,0.2777777777777778,0.4187192118226601,gemini,coral,breastca,PROMPT2_ICL_entailment
170,57,41,39,2,0.951219512195122,10,10,0,1.0,0.975,gemini,coral,breastca,PROMPT2_ICL_entailment
171,58,30,30,0,1.0,10,9,1,0.9,0.9473684210526316,gemini,coral,breastca,PROMPT2_ICL_entailment
172,59,22,21,1,0.9545454545454546,9,9,0,1.0,0.9767441860465116,gemini,coral,breastca,PROMPT2_ICL_entailment
173,6,26,24,2,0.9230769230769232,8,8,0,1.0,0.96,gemini,coral,breastca,PROMPT2_ICL_entailment
174,60,19,17,2,0.8947368421052632,10,10,0,1.0,0.9444444444444444,gemini,coral,breastca,PROMPT2_ICL_entailment
175,61,24,24,0,1.0,11,10,1,0.9090909090909092,0.9523809523809524,gemini,coral,breastca,PROMPT2_ICL_entailment
176,62,31,26,5,0.8387096774193549,10,10,0,1.0,0.912280701754386,gemini,coral,breastca,PROMPT2_ICL_entailment
177,63,23,23,0,1.0,11,11,0,1.0,1.0,gemini,coral,breastca,PROMPT2_ICL_entailment
178,64,1,0,1,0.0,17,1,16,0.0588235294117647,0.0,gemini,coral,breastca,PROMPT2_ICL_entailment
179,65,46,43,3,0.9347826086956522,6,5,1,0.8333333333333334,0.8811475409836066,gemini,coral,breastca,PROMPT2_ICL_entailment
180,66,34,31,3,0.9117647058823528,10,10,0,1.0,0.953846153846154,gemini,coral,breastca,PROMPT2_ICL_entailment
181,67,62,42,20,0.6774193548387096,49,28,21,0.5714285714285714,0.6199261992619925,gemini,coral,breastca,PROMPT2_ICL_entailment
182,68,18,15,3,0.8333333333333334,8,7,1,0.875,0.8536585365853658,gemini,coral,breastca,PROMPT2_ICL_entailment
183,69,46,26,20,0.5652173913043478,12,7,5,0.5833333333333334,0.5741324921135648,gemini,coral,breastca,PROMPT2_ICL_entailment
184,7,39,37,2,0.9487179487179488,11,9,2,0.8181818181818182,0.8786279683377309,gemini,coral,breastca,PROMPT2_ICL_entailment
185,70,150,108,42,0.72,51,31,20,0.6078431372549019,0.6591848789131719,gemini,coral,breastca,PROMPT2_ICL_entailment
186,71,16,16,0,1.0,5,5,0,1.0,1.0,gemini,coral,breastca,PROMPT2_ICL_entailment
187,72,15,15,0,1.0,3,3,0,1.0,1.0,gemini,coral,breastca,PROMPT2_ICL_entailment
188,73,19,18,1,0.9473684210526316,1,1,0,1.0,0.972972972972973,gemini,coral,breastca,PROMPT2_ICL_entailment
189,74,19,14,5,0.7368421052631579,2,2,0,1.0,0.8484848484848484,gemini,coral,breastca,PROMPT2_ICL_entailment
190,75,28,24,4,0.8571428571428571,6,6,0,1.0,0.923076923076923,gemini,coral,breastca,PROMPT2_ICL_entailment
191,76,17,17,0,1.0,7,7,0,1.0,1.0,gemini,coral,breastca,PROMPT2_ICL_entailment
192,77,24,23,1,0.9583333333333334,15,9,6,0.6,0.7379679144385026,gemini,coral,breastca,PROMPT2_ICL_entailment
193,78,27,24,3,0.8888888888888888,8,6,2,0.75,0.8135593220338982,gemini,coral,breastca,PROMPT2_ICL_entailment
194,79,15,10,5,0.6666666666666666,8,7,1,0.875,0.7567567567567567,gemini,coral,breastca,PROMPT2_ICL_entailment
195,8,22,17,5,0.7727272727272727,9,8,1,0.8888888888888888,0.8267477203647416,gemini,coral,breastca,PROMPT2_ICL_entailment
196,80,41,39,2,0.951219512195122,24,19,5,0.7916666666666666,0.8641399416909621,gemini,coral,breastca,PROMPT2_ICL_entailment
197,81,37,34,3,0.918918918918919,11,7,4,0.6363636363636364,0.7519747235387046,gemini,coral,breastca,PROMPT2_ICL_entailment
198,82,20,17,3,0.85,6,6,0,1.0,0.9189189189189187,gemini,coral,breastca,PROMPT2_ICL_entailment
199,83,23,23,0,1.0,6,6,0,1.0,1.0,gemini,coral,breastca,PROMPT2_ICL_entailment
200,84,39,32,7,0.8205128205128205,11,9,2,0.8181818181818182,0.8193456614509247,gemini,coral,breastca,PROMPT2_ICL_entailment
201,85,27,26,1,0.9629629629629628,7,7,0,1.0,0.981132075471698,gemini,coral,breastca,PROMPT2_ICL_entailment
202,86,42,27,15,0.6428571428571429,16,10,6,0.625,0.6338028169014085,gemini,coral,breastca,PROMPT2_ICL_entailment
203,87,22,22,0,1.0,8,8,0,1.0,1.0,gemini,coral,breastca,PROMPT2_ICL_entailment
204,88,12,11,1,0.9166666666666666,8,8,0,1.0,0.9565217391304348,gemini,coral,breastca,PROMPT2_ICL_entailment
205,89,19,14,5,0.7368421052631579,11,10,1,0.9090909090909092,0.813953488372093,gemini,coral,breastca,PROMPT2_ICL_entailment
206,9,27,21,6,0.7777777777777778,6,6,0,1.0,0.8750000000000001,gemini,coral,breastca,PROMPT2_ICL_entailment
207,90,69,51,18,0.7391304347826086,17,8,9,0.4705882352941176,0.5750528541226216,gemini,coral,breastca,PROMPT2_ICL_entailment
208,91,1,0,1,0.0,7,1,6,0.1428571428571428,0.0,gemini,coral,breastca,PROMPT2_ICL_entailment
209,92,1,0,1,0.0,2,0,2,0.0,,gemini,coral,breastca,PROMPT2_ICL_entailment
210,93,117,99,18,0.8461538461538461,13,11,2,0.8461538461538461,0.8461538461538461,gemini,coral,breastca,PROMPT2_ICL_entailment
211,94,39,24,15,0.6153846153846154,25,19,6,0.76,0.680089485458613,gemini,coral,breastca,PROMPT2_ICL_entailment
212,95,61,44,17,0.7213114754098361,13,7,6,0.5384615384615384,0.6166166166166166,gemini,coral,breastca,PROMPT2_ICL_entailment
213,96,38,28,10,0.7368421052631579,10,10,0,1.0,0.8484848484848484,gemini,coral,breastca,PROMPT2_ICL_entailment
214,97,38,26,12,0.6842105263157895,11,10,1,0.9090909090909092,0.7807807807807808,gemini,coral,breastca,PROMPT2_ICL_entailment
215,98,9,7,2,0.7777777777777778,2,2,0,1.0,0.8750000000000001,gemini,coral,breastca,PROMPT2_ICL_entailment
216,99,54,51,3,0.9444444444444444,15,12,3,0.8,0.8662420382165604,gemini,coral,breastca,PROMPT2_ICL_entailment
0,0,25,23,2,0.92,10,9,1,0.9,0.90989010989011,gemini,coral,breastca,PROMPT2_entailment
1,1,14,13,1,0.9285714285714286,12,3,9,0.25,0.3939393939393939,gemini,coral,breastca,PROMPT2_entailment
2,10,15,12,3,0.8,10,6,4,0.6,0.6857142857142857,gemini,coral,breastca,PROMPT2_entailment
3,100,29,20,9,0.6896551724137931,26,13,13,0.5,0.5797101449275363,gemini,coral,breastca,PROMPT2_entailment
4,101,50,42,8,0.84,18,14,4,0.7777777777777778,0.8076923076923077,gemini,coral,breastca,PROMPT2_entailment
5,102,14,13,1,0.9285714285714286,7,6,1,0.8571428571428571,0.8914285714285715,gemini,coral,breastca,PROMPT2_entailment
6,103,34,32,2,0.9411764705882352,10,7,3,0.7,0.8028673835125448,gemini,coral,breastca,PROMPT2_entailment
7,104,86,70,16,0.813953488372093,26,15,11,0.5769230769230769,0.6752411575562701,gemini,coral,breastca,PROMPT2_entailment
8,105,21,20,1,0.9523809523809524,15,15,0,1.0,0.975609756097561,gemini,coral,breastca,PROMPT2_entailment
9,106,26,24,2,0.9230769230769232,9,9,0,1.0,0.96,gemini,coral,breastca,PROMPT2_entailment
10,107,19,15,4,0.7894736842105263,9,9,0,1.0,0.8823529411764706,gemini,coral,breastca,PROMPT2_entailment
11,108,22,20,2,0.9090909090909092,11,11,0,1.0,0.9523809523809524,gemini,coral,breastca,PROMPT2_entailment
12,109,19,17,2,0.8947368421052632,11,11,0,1.0,0.9444444444444444,gemini,coral,breastca,PROMPT2_entailment
13,11,17,11,6,0.6470588235294118,3,3,0,1.0,0.7857142857142858,gemini,coral,breastca,PROMPT2_entailment
14,110,13,12,1,0.9230769230769232,11,5,6,0.4545454545454545,0.6091370558375634,gemini,coral,breastca,PROMPT2_entailment
15,111,19,16,3,0.8421052631578947,10,9,1,0.9,0.8700906344410877,gemini,coral,breastca,PROMPT2_entailment
16,112,20,20,0,1.0,10,9,1,0.9,0.9473684210526316,gemini,coral,breastca,PROMPT2_entailment
17,113,54,34,20,0.6296296296296297,49,26,23,0.5306122448979592,0.5758957654723127,gemini,coral,breastca,PROMPT2_entailment
18,114,50,38,12,0.76,21,16,5,0.7619047619047619,0.7609511889862328,gemini,coral,breastca,PROMPT2_entailment
19,115,18,15,3,0.8333333333333334,9,8,1,0.8888888888888888,0.8602150537634408,gemini,coral,breastca,PROMPT2_entailment
20,116,42,32,10,0.7619047619047619,14,10,4,0.7142857142857143,0.7373271889400921,gemini,coral,breastca,PROMPT2_entailment
21,117,6,6,0,1.0,2,1,1,0.5,0.6666666666666666,gemini,coral,breastca,PROMPT2_entailment
22,118,15,15,0,1.0,19,5,14,0.2631578947368421,0.4166666666666667,gemini,coral,breastca,PROMPT2_entailment
23,119,19,17,2,0.8947368421052632,10,9,1,0.9,0.8973607038123168,gemini,coral,breastca,PROMPT2_entailment
24,12,23,22,1,0.9565217391304348,10,9,1,0.9,0.9274004683840747,gemini,coral,breastca,PROMPT2_entailment
25,120,39,35,4,0.8974358974358975,9,9,0,1.0,0.945945945945946,gemini,coral,breastca,PROMPT2_entailment
26,121,30,27,3,0.9,10,10,0,1.0,0.9473684210526316,gemini,coral,breastca,PROMPT2_entailment
27,122,28,27,1,0.9642857142857144,9,9,0,1.0,0.9818181818181818,gemini,coral,breastca,PROMPT2_entailment
28,123,26,26,0,1.0,8,8,0,1.0,1.0,gemini,coral,breastca,PROMPT2_entailment
29,124,23,19,4,0.8260869565217391,10,10,0,1.0,0.9047619047619048,gemini,coral,breastca,PROMPT2_entailment
30,125,29,28,1,0.9655172413793104,11,7,4,0.6363636363636364,0.7671232876712328,gemini,coral,breastca,PROMPT2_entailment
31,126,23,21,2,0.9130434782608696,10,10,0,1.0,0.9545454545454544,gemini,coral,breastca,PROMPT2_entailment
32,127,28,21,7,0.75,10,9,1,0.9,0.8181818181818182,gemini,coral,breastca,PROMPT2_entailment
33,128,29,27,2,0.9310344827586208,11,9,2,0.8181818181818182,0.8709677419354839,gemini,coral,breastca,PROMPT2_entailment
34,129,19,17,2,0.8947368421052632,11,8,3,0.7272727272727273,0.8023598820058998,gemini,coral,breastca,PROMPT2_entailment
35,13,25,19,6,0.76,10,8,2,0.8,0.7794871794871796,gemini,coral,breastca,PROMPT2_entailment
36,130,4,1,3,0.25,7,0,7,0.0,0.0,gemini,coral,breastca,PROMPT2_entailment
37,131,43,40,3,0.9302325581395348,10,10,0,1.0,0.963855421686747,gemini,coral,breastca,PROMPT2_entailment
38,132,17,17,0,1.0,8,8,0,1.0,1.0,gemini,coral,breastca,PROMPT2_entailment
39,133,39,31,8,0.7948717948717948,29,19,10,0.6551724137931034,0.7182926829268292,gemini,coral,breastca,PROMPT2_entailment
40,134,16,7,9,0.4375,11,8,3,0.7272727272727273,0.5463414634146341,gemini,coral,breastca,PROMPT2_entailment
41,135,29,17,12,0.5862068965517241,16,11,5,0.6875,0.6328257191201353,gemini,coral,breastca,PROMPT2_entailment
42,136,20,14,6,0.7,10,9,1,0.9,0.7875,gemini,coral,breastca,PROMPT2_entailment
43,137,16,15,1,0.9375,10,10,0,1.0,0.967741935483871,gemini,coral,breastca,PROMPT2_entailment
44,138,12,12,0,1.0,10,10,0,1.0,1.0,gemini,coral,breastca,PROMPT2_entailment
45,139,19,17,2,0.8947368421052632,11,9,2,0.8181818181818182,0.8547486033519553,gemini,coral,breastca,PROMPT2_entailment
46,14,66,41,25,0.6212121212121212,59,26,33,0.4406779661016949,0.5155985489721886,gemini,coral,breastca,PROMPT2_entailment
47,140,22,21,1,0.9545454545454546,9,9,0,1.0,0.9767441860465116,gemini,coral,breastca,PROMPT2_entailment
48,141,27,20,7,0.7407407407407407,11,10,1,0.9090909090909092,0.8163265306122449,gemini,coral,breastca,PROMPT2_entailment
49,142,9,9,0,1.0,10,9,1,0.9,0.9473684210526316,gemini,coral,breastca,PROMPT2_entailment
50,143,9,7,2,0.7777777777777778,10,8,2,0.8,0.7887323943661971,gemini,coral,breastca,PROMPT2_entailment
51,144,22,17,5,0.7727272727272727,5,5,0,1.0,0.8717948717948718,gemini,coral,breastca,PROMPT2_entailment
52,145,14,12,2,0.8571428571428571,5,4,1,0.8,0.8275862068965518,gemini,coral,breastca,PROMPT2_entailment
53,146,20,17,3,0.85,9,8,1,0.8888888888888888,0.8690095846645367,gemini,coral,breastca,PROMPT2_entailment
54,147,20,18,2,0.9,5,3,2,0.6,0.7200000000000001,gemini,coral,breastca,PROMPT2_entailment
55,148,19,17,2,0.8947368421052632,4,1,3,0.25,0.3908045977011494,gemini,coral,breastca,PROMPT2_entailment
56,149,17,12,5,0.7058823529411765,1,1,0,1.0,0.8275862068965517,gemini,coral,breastca,PROMPT2_entailment
57,15,63,49,14,0.7777777777777778,16,11,5,0.6875,0.7298578199052133,gemini,coral,breastca,PROMPT2_entailment
58,150,18,14,4,0.7777777777777778,2,2,0,1.0,0.8750000000000001,gemini,coral,breastca,PROMPT2_entailment
59,151,16,16,0,1.0,9,9,0,1.0,1.0,gemini,coral,breastca,PROMPT2_entailment
60,152,16,13,3,0.8125,16,11,5,0.6875,0.7447916666666666,gemini,coral,breastca,PROMPT2_entailment
61,153,12,11,1,0.9166666666666666,1,1,0,1.0,0.9565217391304348,gemini,coral,breastca,PROMPT2_entailment
62,154,15,13,2,0.8666666666666667,10,10,0,1.0,0.9285714285714286,gemini,coral,breastca,PROMPT2_entailment
63,155,24,22,2,0.9166666666666666,9,9,0,1.0,0.9565217391304348,gemini,coral,breastca,PROMPT2_entailment
64,156,15,14,1,0.9333333333333332,8,8,0,1.0,0.9655172413793104,gemini,coral,breastca,PROMPT2_entailment
65,157,16,16,0,1.0,9,9,0,1.0,1.0,gemini,coral,breastca,PROMPT2_entailment
66,158,39,25,14,0.6410256410256411,16,11,5,0.6875,0.6634499396863692,gemini,coral,breastca,PROMPT2_entailment
67,159,25,19,6,0.76,29,14,15,0.4827586206896552,0.590455049944506,gemini,coral,breastca,PROMPT2_entailment
68,16,12,9,3,0.75,10,2,8,0.2,0.3157894736842105,gemini,coral,breastca,PROMPT2_entailment
69,160,101,75,26,0.7425742574257426,18,11,7,0.6111111111111112,0.6704591629418936,gemini,coral,breastca,PROMPT2_entailment
70,161,33,33,0,1.0,11,9,2,0.8181818181818182,0.9,gemini,coral,breastca,PROMPT2_entailment
71,162,15,15,0,1.0,16,11,5,0.6875,0.8148148148148148,gemini,coral,breastca,PROMPT2_entailment
72,163,21,19,2,0.9047619047619048,11,11,0,1.0,0.95,gemini,coral,breastca,PROMPT2_entailment
73,164,19,15,4,0.7894736842105263,8,6,2,0.75,0.7692307692307692,gemini,coral,breastca,PROMPT2_entailment
74,165,22,22,0,1.0,12,10,2,0.8333333333333334,0.9090909090909092,gemini,coral,breastca,PROMPT2_entailment
75,166,12,11,1,0.9166666666666666,10,3,7,0.3,0.4520547945205479,gemini,coral,breastca,PROMPT2_entailment
76,167,18,12,6,0.6666666666666666,7,6,1,0.8571428571428571,0.75,gemini,coral,breastca,PROMPT2_entailment
77,168,13,12,1,0.9230769230769232,7,4,3,0.5714285714285714,0.7058823529411765,gemini,coral,breastca,PROMPT2_entailment
78,169,12,11,1,0.9166666666666666,11,7,4,0.6363636363636364,0.7512195121951218,gemini,coral,breastca,PROMPT2_entailment
79,17,3,2,1,0.6666666666666666,3,0,3,0.0,0.0,gemini,coral,breastca,PROMPT2_entailment
80,170,19,19,0,1.0,10,9,1,0.9,0.9473684210526316,gemini,coral,breastca,PROMPT2_entailment
81,171,39,39,0,1.0,9,9,0,1.0,1.0,gemini,coral,breastca,PROMPT2_entailment
82,172,36,35,1,0.9722222222222222,32,20,12,0.625,0.7608695652173912,gemini,coral,breastca,PROMPT2_entailment
83,173,20,18,2,0.9,11,10,1,0.9090909090909092,0.9045226130653266,gemini,coral,breastca,PROMPT2_entailment
84,174,19,15,4,0.7894736842105263,7,5,2,0.7142857142857143,0.7500000000000001,gemini,coral,breastca,PROMPT2_entailment
85,175,11,10,1,0.9090909090909092,10,7,3,0.7,0.7909604519774012,gemini,coral,breastca,PROMPT2_entailment
86,176,14,14,0,1.0,10,6,4,0.6,0.7499999999999999,gemini,coral,breastca,PROMPT2_entailment
87,177,18,17,1,0.9444444444444444,9,8,1,0.8888888888888888,0.9158249158249158,gemini,coral,breastca,PROMPT2_entailment
88,178,25,18,7,0.72,10,7,3,0.7,0.7098591549295775,gemini,coral,breastca,PROMPT2_entailment
89,179,21,21,0,1.0,9,7,2,0.7777777777777778,0.8750000000000001,gemini,coral,breastca,PROMPT2_entailment
90,18,24,24,0,1.0,8,8,0,1.0,1.0,gemini,coral,breastca,PROMPT2_entailment
91,180,19,16,3,0.8421052631578947,10,9,1,0.9,0.8700906344410877,gemini,coral,breastca,PROMPT2_entailment
92,181,9,8,1,0.8888888888888888,9,7,2,0.7777777777777778,0.8296296296296296,gemini,coral,breastca,PROMPT2_entailment
93,182,16,16,0,1.0,9,5,4,0.5555555555555556,0.7142857142857143,gemini,coral,breastca,PROMPT2_entailment
94,183,20,20,0,1.0,10,9,1,0.9,0.9473684210526316,gemini,coral,breastca,PROMPT2_entailment
95,184,20,18,2,0.9,9,7,2,0.7777777777777778,0.8344370860927153,gemini,coral,breastca,PROMPT2_entailment
96,185,29,26,3,0.896551724137931,10,6,4,0.6,0.7188940092165897,gemini,coral,breastca,PROMPT2_entailment
97,186,15,14,1,0.9333333333333332,5,4,1,0.8,0.8615384615384616,gemini,coral,breastca,PROMPT2_entailment
98,187,51,43,8,0.8431372549019608,26,17,9,0.6538461538461539,0.7365239294710328,gemini,coral,breastca,PROMPT2_entailment
99,188,19,19,0,1.0,9,9,0,1.0,1.0,gemini,coral,breastca,PROMPT2_entailment
100,189,21,17,4,0.8095238095238095,9,9,0,1.0,0.8947368421052632,gemini,coral,breastca,PROMPT2_entailment
101,19,19,15,4,0.7894736842105263,8,8,0,1.0,0.8823529411764706,gemini,coral,breastca,PROMPT2_entailment
102,190,27,16,11,0.5925925925925926,34,17,17,0.5,0.5423728813559322,gemini,coral,breastca,PROMPT2_entailment
103,191,67,49,18,0.7313432835820896,14,10,4,0.7142857142857143,0.7227138643067847,gemini,coral,breastca,PROMPT2_entailment
104,192,16,13,3,0.8125,12,9,3,0.75,0.78,gemini,coral,breastca,PROMPT2_entailment
105,193,11,11,0,1.0,2,1,1,0.5,0.6666666666666666,gemini,coral,breastca,PROMPT2_entailment
106,194,25,24,1,0.96,15,13,2,0.8666666666666667,0.910948905109489,gemini,coral,breastca,PROMPT2_entailment
107,195,21,19,2,0.9047619047619048,13,12,1,0.9230769230769232,0.9138276553106212,gemini,coral,breastca,PROMPT2_entailment
108,196,48,40,8,0.8333333333333334,30,23,7,0.7666666666666667,0.7986111111111112,gemini,coral,breastca,PROMPT2_entailment
109,197,56,52,4,0.9285714285714286,14,8,6,0.5714285714285714,0.7074829931972789,gemini,coral,breastca,PROMPT2_entailment
110,198,19,16,3,0.8421052631578947,11,8,3,0.7272727272727273,0.7804878048780488,gemini,coral,breastca,PROMPT2_entailment
111,199,6,6,0,1.0,2,2,0,1.0,1.0,gemini,coral,breastca,PROMPT2_entailment
112,2,27,18,9,0.6666666666666666,10,8,2,0.8,0.7272727272727272,gemini,coral,breastca,PROMPT2_entailment
113,20,22,10,12,0.4545454545454545,17,4,13,0.2352941176470588,0.3100775193798449,gemini,coral,breastca,PROMPT2_entailment
114,200,63,48,15,0.7619047619047619,15,8,7,0.5333333333333333,0.6274509803921569,gemini,coral,breastca,PROMPT2_entailment
115,201,30,21,9,0.7,26,22,4,0.8461538461538461,0.7661691542288558,gemini,coral,breastca,PROMPT2_entailment
116,202,23,17,6,0.7391304347826086,17,14,3,0.8235294117647058,0.779050736497545,gemini,coral,breastca,PROMPT2_entailment
117,203,67,56,11,0.835820895522388,27,19,8,0.7037037037037037,0.7640933572710952,gemini,coral,breastca,PROMPT2_entailment
118,204,22,22,0,1.0,11,6,5,0.5454545454545454,0.7058823529411764,gemini,coral,breastca,PROMPT2_entailment
119,205,29,27,2,0.9310344827586208,11,9,2,0.8181818181818182,0.8709677419354839,gemini,coral,breastca,PROMPT2_entailment
120,206,19,18,1,0.9473684210526316,4,4,0,1.0,0.972972972972973,gemini,coral,breastca,PROMPT2_entailment
121,207,20,18,2,0.9,12,7,5,0.5833333333333334,0.7078651685393258,gemini,coral,breastca,PROMPT2_entailment
122,208,19,18,1,0.9473684210526316,9,7,2,0.7777777777777778,0.8542372881355932,gemini,coral,breastca,PROMPT2_entailment
123,209,50,49,1,0.98,11,10,1,0.9090909090909092,0.9432146294513954,gemini,coral,breastca,PROMPT2_entailment
124,21,77,48,29,0.6233766233766234,27,18,9,0.6666666666666666,0.6442953020134228,gemini,coral,breastca,PROMPT2_entailment
125,210,42,29,13,0.6904761904761905,13,8,5,0.6153846153846154,0.6507713884992988,gemini,coral,breastca,PROMPT2_entailment
126,211,44,41,3,0.9318181818181818,11,9,2,0.8181818181818182,0.871310507674144,gemini,coral,breastca,PROMPT2_entailment
127,212,18,17,1,0.9444444444444444,9,7,2,0.7777777777777778,0.8530465949820788,gemini,coral,breastca,PROMPT2_entailment
128,213,23,20,3,0.8695652173913043,11,9,2,0.8181818181818182,0.8430913348946135,gemini,coral,breastca,PROMPT2_entailment
129,214,23,7,16,0.3043478260869565,28,17,11,0.6071428571428571,0.4054514480408858,gemini,coral,breastca,PROMPT2_entailment
130,215,70,46,24,0.6571428571428571,37,25,12,0.6756756756756757,0.6662804171494785,gemini,coral,breastca,PROMPT2_entailment
131,216,24,21,3,0.875,15,10,5,0.6666666666666666,0.7567567567567567,gemini,coral,breastca,PROMPT2_entailment
132,22,25,18,7,0.72,7,5,2,0.7142857142857143,0.7171314741035857,gemini,coral,breastca,PROMPT2_entailment
133,23,19,18,1,0.9473684210526316,9,9,0,1.0,0.972972972972973,gemini,coral,breastca,PROMPT2_entailment
134,24,20,17,3,0.85,10,10,0,1.0,0.9189189189189187,gemini,coral,breastca,PROMPT2_entailment
135,25,28,28,0,1.0,8,8,0,1.0,1.0,gemini,coral,breastca,PROMPT2_entailment
136,26,25,21,4,0.84,11,10,1,0.9090909090909092,0.8731808731808731,gemini,coral,breastca,PROMPT2_entailment
137,27,36,29,7,0.8055555555555556,12,9,3,0.75,0.7767857142857144,gemini,coral,breastca,PROMPT2_entailment
138,28,30,28,2,0.9333333333333332,18,15,3,0.8333333333333334,0.8805031446540881,gemini,coral,breastca,PROMPT2_entailment
139,29,29,24,5,0.8275862068965517,9,6,3,0.6666666666666666,0.7384615384615385,gemini,coral,breastca,PROMPT2_entailment
140,3,37,24,13,0.6486486486486487,11,9,2,0.8181818181818182,0.7236180904522613,gemini,coral,breastca,PROMPT2_entailment
141,30,66,45,21,0.6818181818181818,18,12,6,0.6666666666666666,0.6741573033707865,gemini,coral,breastca,PROMPT2_entailment
142,31,21,14,7,0.6666666666666666,13,11,2,0.8461538461538461,0.7457627118644068,gemini,coral,breastca,PROMPT2_entailment
143,32,16,13,3,0.8125,9,6,3,0.6666666666666666,0.7323943661971831,gemini,coral,breastca,PROMPT2_entailment
144,33,32,27,5,0.84375,8,7,1,0.875,0.8590909090909091,gemini,coral,breastca,PROMPT2_entailment
145,34,10,10,0,1.0,10,5,5,0.5,0.6666666666666666,gemini,coral,breastca,PROMPT2_entailment
146,35,15,13,2,0.8666666666666667,12,8,4,0.6666666666666666,0.7536231884057971,gemini,coral,breastca,PROMPT2_entailment
147,36,22,20,2,0.9090909090909092,11,9,2,0.8181818181818182,0.861244019138756,gemini,coral,breastca,PROMPT2_entailment
148,37,11,11,0,1.0,11,9,2,0.8181818181818182,0.9,gemini,coral,breastca,PROMPT2_entailment
149,38,19,18,1,0.9473684210526316,11,6,5,0.5454545454545454,0.6923076923076923,gemini,coral,breastca,PROMPT2_entailment
150,39,19,19,0,1.0,11,10,1,0.9090909090909092,0.9523809523809524,gemini,coral,breastca,PROMPT2_entailment
151,4,58,43,15,0.7413793103448276,59,26,33,0.4406779661016949,0.5527812113720644,gemini,coral,breastca,PROMPT2_entailment
152,40,14,14,0,1.0,9,8,1,0.8888888888888888,0.9411764705882352,gemini,coral,breastca,PROMPT2_entailment
153,41,13,13,0,1.0,14,11,3,0.7857142857142857,0.88,gemini,coral,breastca,PROMPT2_entailment
154,42,24,18,6,0.75,9,3,6,0.3333333333333333,0.4615384615384615,gemini,coral,breastca,PROMPT2_entailment
155,43,20,17,3,0.85,9,8,1,0.8888888888888888,0.8690095846645367,gemini,coral,breastca,PROMPT2_entailment
156,44,22,17,5,0.7727272727272727,9,8,1,0.8888888888888888,0.8267477203647416,gemini,coral,breastca,PROMPT2_entailment
157,45,1,0,1,0.0,2,0,2,0.0,,gemini,coral,breastca,PROMPT2_entailment
158,46,17,16,1,0.9411764705882352,5,5,0,1.0,0.9696969696969696,gemini,coral,breastca,PROMPT2_entailment
159,47,12,11,1,0.9166666666666666,2,2,0,1.0,0.9565217391304348,gemini,coral,breastca,PROMPT2_entailment
160,48,18,18,0,1.0,5,4,1,0.8,0.888888888888889,gemini,coral,breastca,PROMPT2_entailment
161,49,24,16,8,0.6666666666666666,16,8,8,0.5,0.5714285714285715,gemini,coral,breastca,PROMPT2_entailment
162,5,48,41,7,0.8541666666666666,12,9,3,0.75,0.7987012987012988,gemini,coral,breastca,PROMPT2_entailment
163,50,34,23,11,0.6764705882352942,16,12,4,0.75,0.7113402061855669,gemini,coral,breastca,PROMPT2_entailment
164,51,38,28,10,0.7368421052631579,11,10,1,0.9090909090909092,0.813953488372093,gemini,coral,breastca,PROMPT2_entailment
165,52,22,19,3,0.8636363636363636,10,9,1,0.9,0.8814432989690723,gemini,coral,breastca,PROMPT2_entailment
166,53,21,20,1,0.9523809523809524,10,10,0,1.0,0.975609756097561,gemini,coral,breastca,PROMPT2_entailment
167,54,24,21,3,0.875,9,6,3,0.6666666666666666,0.7567567567567567,gemini,coral,breastca,PROMPT2_entailment
168,55,5,5,0,1.0,1,1,0,1.0,1.0,gemini,coral,breastca,PROMPT2_entailment
169,56,14,13,1,0.9285714285714286,18,8,10,0.4444444444444444,0.6011560693641618,gemini,coral,breastca,PROMPT2_entailment
170,57,32,31,1,0.96875,10,9,1,0.9,0.9331103678929769,gemini,coral,breastca,PROMPT2_entailment
171,58,27,26,1,0.9629629629629628,10,9,1,0.9,0.930417495029821,gemini,coral,breastca,PROMPT2_entailment
172,59,17,13,4,0.7647058823529411,9,7,2,0.7777777777777778,0.7711864406779662,gemini,coral,breastca,PROMPT2_entailment
173,6,21,18,3,0.8571428571428571,8,8,0,1.0,0.923076923076923,gemini,coral,breastca,PROMPT2_entailment
174,60,20,19,1,0.95,10,9,1,0.9,0.9243243243243242,gemini,coral,breastca,PROMPT2_entailment
175,61,24,24,0,1.0,11,10,1,0.9090909090909092,0.9523809523809524,gemini,coral,breastca,PROMPT2_entailment
176,62,28,23,5,0.8214285714285714,10,10,0,1.0,0.9019607843137256,gemini,coral,breastca,PROMPT2_entailment
177,63,18,17,1,0.9444444444444444,11,10,1,0.9090909090909092,0.9264305177111716,gemini,coral,breastca,PROMPT2_entailment
178,64,6,2,4,0.3333333333333333,17,0,17,0.0,0.0,gemini,coral,breastca,PROMPT2_entailment
179,65,34,33,1,0.9705882352941176,6,6,0,1.0,0.9850746268656716,gemini,coral,breastca,PROMPT2_entailment
180,66,26,25,1,0.9615384615384616,10,8,2,0.8,0.8733624454148472,gemini,coral,breastca,PROMPT2_entailment
181,67,48,22,26,0.4583333333333333,49,24,25,0.4897959183673469,0.4735426008968609,gemini,coral,breastca,PROMPT2_entailment
182,68,21,19,2,0.9047619047619048,8,8,0,1.0,0.95,gemini,coral,breastca,PROMPT2_entailment
183,69,19,15,4,0.7894736842105263,12,4,8,0.3333333333333333,0.46875,gemini,coral,breastca,PROMPT2_entailment
184,7,33,32,1,0.9696969696969696,11,9,2,0.8181818181818182,0.8875192604006162,gemini,coral,breastca,PROMPT2_entailment
185,70,190,160,30,0.8421052631578947,51,35,16,0.6862745098039216,0.7562457798784605,gemini,coral,breastca,PROMPT2_entailment
186,71,13,11,2,0.8461538461538461,5,5,0,1.0,0.9166666666666666,gemini,coral,breastca,PROMPT2_entailment
187,72,12,12,0,1.0,3,3,0,1.0,1.0,gemini,coral,breastca,PROMPT2_entailment
188,73,14,13,1,0.9285714285714286,1,1,0,1.0,0.962962962962963,gemini,coral,breastca,PROMPT2_entailment
189,74,20,17,3,0.85,2,1,1,0.5,0.6296296296296295,gemini,coral,breastca,PROMPT2_entailment
190,75,22,19,3,0.8636363636363636,6,6,0,1.0,0.9268292682926828,gemini,coral,breastca,PROMPT2_entailment
191,76,16,14,2,0.875,7,7,0,1.0,0.9333333333333332,gemini,coral,breastca,PROMPT2_entailment
192,77,15,13,2,0.8666666666666667,15,8,7,0.5333333333333333,0.6603174603174604,gemini,coral,breastca,PROMPT2_entailment
193,78,22,19,3,0.8636363636363636,8,6,2,0.75,0.8028169014084506,gemini,coral,breastca,PROMPT2_entailment
194,79,14,12,2,0.8571428571428571,8,8,0,1.0,0.923076923076923,gemini,coral,breastca,PROMPT2_entailment
195,8,18,14,4,0.7777777777777778,9,6,3,0.6666666666666666,0.717948717948718,gemini,coral,breastca,PROMPT2_entailment
196,80,34,33,1,0.9705882352941176,24,19,5,0.7916666666666666,0.8720445062586926,gemini,coral,breastca,PROMPT2_entailment
197,81,31,27,4,0.8709677419354839,11,9,2,0.8181818181818182,0.84375,gemini,coral,breastca,PROMPT2_entailment
198,82,16,10,6,0.625,6,5,1,0.8333333333333334,0.7142857142857143,gemini,coral,breastca,PROMPT2_entailment
199,83,18,17,1,0.9444444444444444,6,6,0,1.0,0.9714285714285714,gemini,coral,breastca,PROMPT2_entailment
200,84,38,31,7,0.8157894736842105,11,9,2,0.8181818181818182,0.8169838945827232,gemini,coral,breastca,PROMPT2_entailment
201,85,31,23,8,0.7419354838709677,7,5,2,0.7142857142857143,0.7278481012658229,gemini,coral,breastca,PROMPT2_entailment
202,86,29,22,7,0.7586206896551724,16,13,3,0.8125,0.784636488340192,gemini,coral,breastca,PROMPT2_entailment
203,87,19,19,0,1.0,8,8,0,1.0,1.0,gemini,coral,breastca,PROMPT2_entailment
204,88,10,10,0,1.0,8,7,1,0.875,0.9333333333333332,gemini,coral,breastca,PROMPT2_entailment
205,89,13,13,0,1.0,11,8,3,0.7272727272727273,0.8421052631578948,gemini,coral,breastca,PROMPT2_entailment
206,9,21,18,3,0.8571428571428571,6,6,0,1.0,0.923076923076923,gemini,coral,breastca,PROMPT2_entailment
207,90,89,61,28,0.6853932584269663,17,14,3,0.8235294117647058,0.748138414367061,gemini,coral,breastca,PROMPT2_entailment
208,91,23,20,3,0.8695652173913043,7,6,1,0.8571428571428571,0.8633093525179856,gemini,coral,breastca,PROMPT2_entailment
209,92,4,4,0,1.0,2,1,1,0.5,0.6666666666666666,gemini,coral,breastca,PROMPT2_entailment
210,93,42,40,2,0.9523809523809524,13,10,3,0.7692307692307693,0.8510638297872339,gemini,coral,breastca,PROMPT2_entailment
211,94,28,16,12,0.5714285714285714,25,17,8,0.68,0.6210045662100457,gemini,coral,breastca,PROMPT2_entailment
212,95,57,42,15,0.7368421052631579,13,8,5,0.6153846153846154,0.6706586826347305,gemini,coral,breastca,PROMPT2_entailment
213,96,23,15,8,0.6521739130434783,10,9,1,0.9,0.7563025210084033,gemini,coral,breastca,PROMPT2_entailment
214,97,38,33,5,0.868421052631579,11,9,2,0.8181818181818182,0.8425531914893618,gemini,coral,breastca,PROMPT2_entailment
215,98,14,12,2,0.8571428571428571,2,2,0,1.0,0.923076923076923,gemini,coral,breastca,PROMPT2_entailment
216,99,45,43,2,0.9555555555555556,15,13,2,0.8666666666666667,0.9089430894308944,gemini,coral,breastca,PROMPT2_entailment
0,0,23,7,16,0.3043478260869565,11,11,0,1.0,0.4666666666666667,gemini,mimiciii,nursing_note,PROMPT1_entailment
1,1,50,17,33,0.34,31,24,7,0.7741935483870968,0.472495657209033,gemini,mimiciii,nursing_note,PROMPT1_entailment
2,10,23,15,8,0.6521739130434783,18,14,4,0.7777777777777778,0.7094594594594594,gemini,mimiciii,nursing_note,PROMPT1_entailment
3,100,11,11,0,1.0,6,6,0,1.0,1.0,gemini,mimiciii,nursing_note,PROMPT1_entailment
4,101,12,11,1,0.9166666666666666,27,26,1,0.9629629629629628,0.9392446633825944,gemini,mimiciii,nursing_note,PROMPT1_entailment
5,102,36,27,9,0.75,26,22,4,0.8461538461538461,0.7951807228915662,gemini,mimiciii,nursing_note,PROMPT1_entailment
6,103,7,7,0,1.0,22,21,1,0.9545454545454546,0.9767441860465116,gemini,mimiciii,nursing_note,PROMPT1_entailment
7,104,35,29,6,0.8285714285714286,20,20,0,1.0,0.90625,gemini,mimiciii,nursing_note,PROMPT1_entailment
8,105,12,7,5,0.5833333333333334,20,20,0,1.0,0.7368421052631579,gemini,mimiciii,nursing_note,PROMPT1_entailment
9,106,8,8,0,1.0,4,4,0,1.0,1.0,gemini,mimiciii,nursing_note,PROMPT1_entailment
10,107,63,42,21,0.6666666666666666,63,58,5,0.9206349206349206,0.7733333333333333,gemini,mimiciii,nursing_note,PROMPT1_entailment
11,108,48,37,11,0.7708333333333334,28,24,4,0.8571428571428571,0.8117001828153565,gemini,mimiciii,nursing_note,PROMPT1_entailment
12,109,6,6,0,1.0,4,4,0,1.0,1.0,gemini,mimiciii,nursing_note,PROMPT1_entailment
13,11,9,4,5,0.4444444444444444,2,2,0,1.0,0.6153846153846153,gemini,mimiciii,nursing_note,PROMPT1_entailment
14,110,19,18,1,0.9473684210526316,13,10,3,0.7692307692307693,0.8490566037735849,gemini,mimiciii,nursing_note,PROMPT1_entailment
15,111,38,25,13,0.6578947368421053,34,28,6,0.8235294117647058,0.7314524555903866,gemini,mimiciii,nursing_note,PROMPT1_entailment
16,112,56,37,19,0.6607142857142857,37,34,3,0.918918918918919,0.7687137183012528,gemini,mimiciii,nursing_note,PROMPT1_entailment
17,113,8,7,1,0.875,5,4,1,0.8,0.8358208955223881,gemini,mimiciii,nursing_note,PROMPT1_entailment
18,114,9,8,1,0.8888888888888888,19,18,1,0.9473684210526316,0.9171974522292994,gemini,mimiciii,nursing_note,PROMPT1_entailment
19,115,8,6,2,0.75,7,6,1,0.8571428571428571,0.7999999999999999,gemini,mimiciii,nursing_note,PROMPT1_entailment
20,116,35,32,3,0.9142857142857144,31,28,3,0.9032258064516128,0.9087221095334684,gemini,mimiciii,nursing_note,PROMPT1_entailment
21,117,10,7,3,0.7,18,16,2,0.8888888888888888,0.7832167832167831,gemini,mimiciii,nursing_note,PROMPT1_entailment
22,118,10,10,0,1.0,25,21,4,0.84,0.9130434782608696,gemini,mimiciii,nursing_note,PROMPT1_entailment
23,119,28,25,3,0.8928571428571429,26,21,5,0.8076923076923077,0.8481421647819063,gemini,mimiciii,nursing_note,PROMPT1_entailment
24,12,29,21,8,0.7241379310344828,18,15,3,0.8333333333333334,0.7749077490774907,gemini,mimiciii,nursing_note,PROMPT1_entailment
25,120,27,17,10,0.6296296296296297,18,18,0,1.0,0.7727272727272727,gemini,mimiciii,nursing_note,PROMPT1_entailment
26,121,23,15,8,0.6521739130434783,37,29,8,0.7837837837837838,0.7119476268412438,gemini,mimiciii,nursing_note,PROMPT1_entailment
27,122,10,9,1,0.9,11,10,1,0.9090909090909092,0.9045226130653266,gemini,mimiciii,nursing_note,PROMPT1_entailment
28,123,6,6,0,1.0,6,5,1,0.8333333333333334,0.9090909090909092,gemini,mimiciii,nursing_note,PROMPT1_entailment
29,124,8,7,1,0.875,5,5,0,1.0,0.9333333333333332,gemini,mimiciii,nursing_note,PROMPT1_entailment
30,125,16,16,0,1.0,43,35,8,0.813953488372093,0.8974358974358974,gemini,mimiciii,nursing_note,PROMPT1_entailment
31,126,5,3,2,0.6,28,26,2,0.9285714285714286,0.7289719626168225,gemini,mimiciii,nursing_note,PROMPT1_entailment
32,127,9,7,2,0.7777777777777778,10,9,1,0.9,0.8344370860927153,gemini,mimiciii,nursing_note,PROMPT1_entailment
33,128,23,18,5,0.782608695652174,17,17,0,1.0,0.878048780487805,gemini,mimiciii,nursing_note,PROMPT1_entailment
34,129,40,32,8,0.8,29,25,4,0.8620689655172413,0.8298755186721992,gemini,mimiciii,nursing_note,PROMPT1_entailment
35,13,58,45,13,0.7758620689655172,34,29,5,0.8529411764705882,0.8125778331257784,gemini,mimiciii,nursing_note,PROMPT1_entailment
36,130,7,6,1,0.8571428571428571,33,18,15,0.5454545454545454,0.6666666666666665,gemini,mimiciii,nursing_note,PROMPT1_entailment
37,131,8,7,1,0.875,31,29,2,0.935483870967742,0.9042316258351892,gemini,mimiciii,nursing_note,PROMPT1_entailment
38,132,44,23,21,0.5227272727272727,17,16,1,0.9411764705882352,0.6721461187214611,gemini,mimiciii,nursing_note,PROMPT1_entailment
39,133,6,3,3,0.5,10,10,0,1.0,0.6666666666666666,gemini,mimiciii,nursing_note,PROMPT1_entailment
40,134,53,24,29,0.4528301886792453,30,23,7,0.7666666666666667,0.5693656523981434,gemini,mimiciii,nursing_note,PROMPT1_entailment
41,135,11,8,3,0.7272727272727273,47,31,16,0.6595744680851063,0.691771269177127,gemini,mimiciii,nursing_note,PROMPT1_entailment
42,136,54,46,8,0.8518518518518519,41,38,3,0.926829268292683,0.887760284408329,gemini,mimiciii,nursing_note,PROMPT1_entailment
43,137,5,5,0,1.0,2,1,1,0.5,0.6666666666666666,gemini,mimiciii,nursing_note,PROMPT1_entailment
44,138,5,5,0,1.0,5,4,1,0.8,0.888888888888889,gemini,mimiciii,nursing_note,PROMPT1_entailment
45,139,9,7,2,0.7777777777777778,4,3,1,0.75,0.7636363636363638,gemini,mimiciii,nursing_note,PROMPT1_entailment
46,14,13,11,2,0.8461538461538461,26,22,4,0.8461538461538461,0.8461538461538461,gemini,mimiciii,nursing_note,PROMPT1_entailment
47,140,9,4,5,0.4444444444444444,24,21,3,0.875,0.5894736842105263,gemini,mimiciii,nursing_note,PROMPT1_entailment
48,141,12,11,1,0.9166666666666666,11,9,2,0.8181818181818182,0.8646288209606987,gemini,mimiciii,nursing_note,PROMPT1_entailment
49,142,53,40,13,0.7547169811320755,8,7,1,0.875,0.8104196816208394,gemini,mimiciii,nursing_note,PROMPT1_entailment
50,143,11,8,3,0.7272727272727273,2,2,0,1.0,0.8421052631578948,gemini,mimiciii,nursing_note,PROMPT1_entailment
51,144,9,8,1,0.8888888888888888,5,4,1,0.8,0.8421052631578948,gemini,mimiciii,nursing_note,PROMPT1_entailment
52,145,38,24,14,0.631578947368421,19,17,2,0.8947368421052632,0.7404718693284936,gemini,mimiciii,nursing_note,PROMPT1_entailment
53,146,9,8,1,0.8888888888888888,6,6,0,1.0,0.9411764705882352,gemini,mimiciii,nursing_note,PROMPT1_entailment
54,147,32,22,10,0.6875,26,21,5,0.8076923076923077,0.7427652733118971,gemini,mimiciii,nursing_note,PROMPT1_entailment
55,148,10,9,1,0.9,7,7,0,1.0,0.9473684210526316,gemini,mimiciii,nursing_note,PROMPT1_entailment
56,149,49,33,16,0.673469387755102,36,34,2,0.9444444444444444,0.7862648913805186,gemini,mimiciii,nursing_note,PROMPT1_entailment
57,15,8,6,2,0.75,33,25,8,0.7575757575757576,0.7537688442211055,gemini,mimiciii,nursing_note,PROMPT1_entailment
58,150,15,14,1,0.9333333333333332,8,8,0,1.0,0.9655172413793104,gemini,mimiciii,nursing_note,PROMPT1_entailment
59,151,36,29,7,0.8055555555555556,26,21,5,0.8076923076923077,0.8066225165562914,gemini,mimiciii,nursing_note,PROMPT1_entailment
60,152,18,16,2,0.8888888888888888,44,37,7,0.8409090909090909,0.8642335766423359,gemini,mimiciii,nursing_note,PROMPT1_entailment
61,153,5,5,0,1.0,4,4,0,1.0,1.0,gemini,mimiciii,nursing_note,PROMPT1_entailment
62,154,46,32,14,0.6956521739130435,34,29,5,0.8529411764705882,0.7663088356729975,gemini,mimiciii,nursing_note,PROMPT1_entailment
63,155,44,33,11,0.75,51,48,3,0.9411764705882352,0.8347826086956521,gemini,mimiciii,nursing_note,PROMPT1_entailment
64,156,11,9,2,0.8181818181818182,26,22,4,0.8461538461538461,0.8319327731092436,gemini,mimiciii,nursing_note,PROMPT1_entailment
65,157,9,9,0,1.0,5,4,1,0.8,0.888888888888889,gemini,mimiciii,nursing_note,PROMPT1_entailment
66,158,37,29,8,0.7837837837837838,22,19,3,0.8636363636363636,0.8217747949291573,gemini,mimiciii,nursing_note,PROMPT1_entailment
67,159,8,7,1,0.875,8,8,0,1.0,0.9333333333333332,gemini,mimiciii,nursing_note,PROMPT1_entailment
68,16,16,16,0,1.0,30,26,4,0.8666666666666667,0.9285714285714286,gemini,mimiciii,nursing_note,PROMPT1_entailment
69,160,8,8,0,1.0,21,21,0,1.0,1.0,gemini,mimiciii,nursing_note,PROMPT1_entailment
70,161,7,7,0,1.0,6,5,1,0.8333333333333334,0.9090909090909092,gemini,mimiciii,nursing_note,PROMPT1_entailment
71,162,41,22,19,0.5365853658536586,31,27,4,0.8709677419354839,0.6640581330352152,gemini,mimiciii,nursing_note,PROMPT1_entailment
72,163,8,8,0,1.0,4,4,0,1.0,1.0,gemini,mimiciii,nursing_note,PROMPT1_entailment
73,164,20,18,2,0.9,13,12,1,0.9230769230769232,0.9113924050632912,gemini,mimiciii,nursing_note,PROMPT1_entailment
74,165,45,34,11,0.7555555555555555,24,20,4,0.8333333333333334,0.7925407925407925,gemini,mimiciii,nursing_note,PROMPT1_entailment
75,166,14,14,0,1.0,3,3,0,1.0,1.0,gemini,mimiciii,nursing_note,PROMPT1_entailment
76,167,24,21,3,0.875,16,16,0,1.0,0.9333333333333332,gemini,mimiciii,nursing_note,PROMPT1_entailment
77,168,41,19,22,0.4634146341463415,25,22,3,0.88,0.6071169208424111,gemini,mimiciii,nursing_note,PROMPT1_entailment
78,169,26,22,4,0.8461538461538461,12,10,2,0.8333333333333334,0.8396946564885497,gemini,mimiciii,nursing_note,PROMPT1_entailment
79,17,18,13,5,0.7222222222222222,39,32,7,0.8205128205128205,0.7682363804247461,gemini,mimiciii,nursing_note,PROMPT1_entailment
80,170,44,30,14,0.6818181818181818,21,18,3,0.8571428571428571,0.759493670886076,gemini,mimiciii,nursing_note,PROMPT1_entailment
81,171,9,7,2,0.7777777777777778,8,7,1,0.875,0.823529411764706,gemini,mimiciii,nursing_note,PROMPT1_entailment
82,172,11,9,2,0.8181818181818182,38,34,4,0.8947368421052632,0.8547486033519553,gemini,mimiciii,nursing_note,PROMPT1_entailment
83,173,9,8,1,0.8888888888888888,20,16,4,0.8,0.8421052631578948,gemini,mimiciii,nursing_note,PROMPT1_entailment
84,174,7,6,1,0.8571428571428571,8,8,0,1.0,0.923076923076923,gemini,mimiciii,nursing_note,PROMPT1_entailment
85,175,4,3,1,0.75,4,3,1,0.75,0.75,gemini,mimiciii,nursing_note,PROMPT1_entailment
86,176,17,13,4,0.7647058823529411,13,12,1,0.9230769230769232,0.8364611260053619,gemini,mimiciii,nursing_note,PROMPT1_entailment
87,177,49,32,17,0.6530612244897959,38,34,4,0.8947368421052632,0.755031228313671,gemini,mimiciii,nursing_note,PROMPT1_entailment
88,178,51,48,3,0.9411764705882352,25,23,2,0.92,0.9304677623261696,gemini,mimiciii,nursing_note,PROMPT1_entailment
89,179,25,22,3,0.88,22,16,6,0.7272727272727273,0.7963800904977375,gemini,mimiciii,nursing_note,PROMPT1_entailment
90,18,9,7,2,0.7777777777777778,25,18,7,0.72,0.747774480712166,gemini,mimiciii,nursing_note,PROMPT1_entailment
91,180,17,14,3,0.8235294117647058,27,26,1,0.9629629629629628,0.8878048780487804,gemini,mimiciii,nursing_note,PROMPT1_entailment
92,181,35,21,14,0.6,25,23,2,0.92,0.7263157894736842,gemini,mimiciii,nursing_note,PROMPT1_entailment
93,182,23,18,5,0.782608695652174,10,10,0,1.0,0.878048780487805,gemini,mimiciii,nursing_note,PROMPT1_entailment
94,183,7,6,1,0.8571428571428571,5,4,1,0.8,0.8275862068965518,gemini,mimiciii,nursing_note,PROMPT1_entailment
95,184,15,13,2,0.8666666666666667,1,0,1,0.0,0.0,gemini,mimiciii,nursing_note,PROMPT1_entailment
96,185,6,4,2,0.6666666666666666,30,26,4,0.8666666666666667,0.7536231884057971,gemini,mimiciii,nursing_note,PROMPT1_entailment
97,186,6,5,1,0.8333333333333334,4,3,1,0.75,0.7894736842105262,gemini,mimiciii,nursing_note,PROMPT1_entailment
98,187,39,36,3,0.9230769230769232,37,32,5,0.8648648648648649,0.8930232558139535,gemini,mimiciii,nursing_note,PROMPT1_entailment
99,188,7,7,0,1.0,2,1,1,0.5,0.6666666666666666,gemini,mimiciii,nursing_note,PROMPT1_entailment
100,189,12,8,4,0.6666666666666666,21,14,7,0.6666666666666666,0.6666666666666666,gemini,mimiciii,nursing_note,PROMPT1_entailment
101,19,59,34,25,0.576271186440678,45,38,7,0.8444444444444444,0.6850477200424179,gemini,mimiciii,nursing_note,PROMPT1_entailment
102,190,10,9,1,0.9,24,21,3,0.875,0.8873239436619719,gemini,mimiciii,nursing_note,PROMPT1_entailment
103,191,6,6,0,1.0,29,25,4,0.8620689655172413,0.925925925925926,gemini,mimiciii,nursing_note,PROMPT1_entailment
104,192,8,7,1,0.875,15,13,2,0.8666666666666667,0.8708133971291866,gemini,mimiciii,nursing_note,PROMPT1_entailment
105,193,14,11,3,0.7857142857142857,40,31,9,0.775,0.7803203661327232,gemini,mimiciii,nursing_note,PROMPT1_entailment
106,194,10,9,1,0.9,13,11,2,0.8461538461538461,0.8722466960352422,gemini,mimiciii,nursing_note,PROMPT1_entailment
107,195,10,10,0,1.0,7,6,1,0.8571428571428571,0.923076923076923,gemini,mimiciii,nursing_note,PROMPT1_entailment
108,196,12,8,4,0.6666666666666666,34,32,2,0.9411764705882352,0.7804878048780487,gemini,mimiciii,nursing_note,PROMPT1_entailment
109,197,39,29,10,0.7435897435897436,27,25,2,0.925925925925926,0.8248009101251421,gemini,mimiciii,nursing_note,PROMPT1_entailment
110,198,54,44,10,0.8148148148148148,38,34,4,0.8947368421052632,0.8529076396807297,gemini,mimiciii,nursing_note,PROMPT1_entailment
111,199,17,17,0,1.0,14,13,1,0.9285714285714286,0.962962962962963,gemini,mimiciii,nursing_note,PROMPT1_entailment
112,2,58,29,29,0.5,43,34,9,0.7906976744186046,0.6126126126126126,gemini,mimiciii,nursing_note,PROMPT1_entailment
113,20,13,10,3,0.7692307692307693,46,41,5,0.8913043478260869,0.8257804632426989,gemini,mimiciii,nursing_note,PROMPT1_entailment
114,200,16,7,9,0.4375,44,36,8,0.8181818181818182,0.5701357466063348,gemini,mimiciii,nursing_note,PROMPT1_entailment
115,201,24,22,2,0.9166666666666666,29,23,6,0.7931034482758621,0.850420168067227,gemini,mimiciii,nursing_note,PROMPT1_entailment
116,202,9,7,2,0.7777777777777778,9,8,1,0.8888888888888888,0.8296296296296296,gemini,mimiciii,nursing_note,PROMPT1_entailment
117,203,9,8,1,0.8888888888888888,7,6,1,0.8571428571428571,0.8727272727272727,gemini,mimiciii,nursing_note,PROMPT1_entailment
118,204,9,7,2,0.7777777777777778,24,20,4,0.8333333333333334,0.8045977011494253,gemini,mimiciii,nursing_note,PROMPT1_entailment
119,205,51,48,3,0.9411764705882352,69,62,7,0.8985507246376812,0.9193697868396664,gemini,mimiciii,nursing_note,PROMPT1_entailment
120,206,5,5,0,1.0,6,5,1,0.8333333333333334,0.9090909090909092,gemini,mimiciii,nursing_note,PROMPT1_entailment
121,207,52,44,8,0.8461538461538461,29,23,6,0.7931034482758621,0.8187702265372168,gemini,mimiciii,nursing_note,PROMPT1_entailment
122,208,11,11,0,1.0,7,7,0,1.0,1.0,gemini,mimiciii,nursing_note,PROMPT1_entailment
123,209,7,7,0,1.0,2,2,0,1.0,1.0,gemini,mimiciii,nursing_note,PROMPT1_entailment
124,21,9,8,1,0.8888888888888888,6,5,1,0.8333333333333334,0.8602150537634408,gemini,mimiciii,nursing_note,PROMPT1_entailment
125,210,24,14,10,0.5833333333333334,22,19,3,0.8636363636363636,0.6963350785340314,gemini,mimiciii,nursing_note,PROMPT1_entailment
126,211,9,8,1,0.8888888888888888,4,4,0,1.0,0.9411764705882352,gemini,mimiciii,nursing_note,PROMPT1_entailment
127,212,49,38,11,0.7755102040816326,37,30,7,0.8108108108108109,0.7927677329624478,gemini,mimiciii,nursing_note,PROMPT1_entailment
128,213,8,8,0,1.0,18,17,1,0.9444444444444444,0.9714285714285714,gemini,mimiciii,nursing_note,PROMPT1_entailment
129,214,12,9,3,0.75,3,2,1,0.6666666666666666,0.7058823529411765,gemini,mimiciii,nursing_note,PROMPT1_entailment
130,215,10,10,0,1.0,7,7,0,1.0,1.0,gemini,mimiciii,nursing_note,PROMPT1_entailment
131,216,30,19,11,0.6333333333333333,13,11,2,0.8461538461538461,0.7244367417677643,gemini,mimiciii,nursing_note,PROMPT1_entailment
132,217,43,30,13,0.6976744186046512,25,20,5,0.8,0.7453416149068322,gemini,mimiciii,nursing_note,PROMPT1_entailment
133,218,14,12,2,0.8571428571428571,18,15,3,0.8333333333333334,0.8450704225352113,gemini,mimiciii,nursing_note,PROMPT1_entailment
134,219,35,30,5,0.8571428571428571,14,10,4,0.7142857142857143,0.7792207792207793,gemini,mimiciii,nursing_note,PROMPT1_entailment
135,22,10,6,4,0.6,26,24,2,0.9230769230769232,0.7272727272727274,gemini,mimiciii,nursing_note,PROMPT1_entailment
136,220,13,12,1,0.9230769230769232,5,3,2,0.6,0.7272727272727274,gemini,mimiciii,nursing_note,PROMPT1_entailment
137,221,11,8,3,0.7272727272727273,45,32,13,0.7111111111111111,0.7191011235955056,gemini,mimiciii,nursing_note,PROMPT1_entailment
138,222,6,6,0,1.0,3,3,0,1.0,1.0,gemini,mimiciii,nursing_note,PROMPT1_entailment
139,223,10,5,5,0.5,30,27,3,0.9,0.6428571428571429,gemini,mimiciii,nursing_note,PROMPT1_entailment
140,224,11,11,0,1.0,6,6,0,1.0,1.0,gemini,mimiciii,nursing_note,PROMPT1_entailment
141,225,40,19,21,0.475,45,38,7,0.8444444444444444,0.608,gemini,mimiciii,nursing_note,PROMPT1_entailment
142,226,9,8,1,0.8888888888888888,20,16,4,0.8,0.8421052631578948,gemini,mimiciii,nursing_note,PROMPT1_entailment
143,227,21,17,4,0.8095238095238095,15,12,3,0.8,0.8047337278106509,gemini,mimiciii,nursing_note,PROMPT1_entailment
144,228,8,5,3,0.625,38,32,6,0.8421052631578947,0.7174887892376681,gemini,mimiciii,nursing_note,PROMPT1_entailment
145,229,18,18,0,1.0,22,19,3,0.8636363636363636,0.9268292682926828,gemini,mimiciii,nursing_note,PROMPT1_entailment
146,23,46,29,17,0.6304347826086957,44,32,12,0.7272727272727273,0.6754002911208152,gemini,mimiciii,nursing_note,PROMPT1_entailment
147,230,14,12,2,0.8571428571428571,7,6,1,0.8571428571428571,0.8571428571428571,gemini,mimiciii,nursing_note,PROMPT1_entailment
148,231,54,47,7,0.8703703703703703,15,8,7,0.5333333333333333,0.6613896218117854,gemini,mimiciii,nursing_note,PROMPT1_entailment
149,232,10,9,1,0.9,2,1,1,0.5,0.6428571428571429,gemini,mimiciii,nursing_note,PROMPT1_entailment
150,233,12,8,4,0.6666666666666666,44,28,16,0.6363636363636364,0.6511627906976744,gemini,mimiciii,nursing_note,PROMPT1_entailment
151,234,17,16,1,0.9411764705882352,32,22,10,0.6875,0.7945823927765238,gemini,mimiciii,nursing_note,PROMPT1_entailment
152,235,13,13,0,1.0,10,10,0,1.0,1.0,gemini,mimiciii,nursing_note,PROMPT1_entailment
153,236,19,17,2,0.8947368421052632,7,5,2,0.7142857142857143,0.794392523364486,gemini,mimiciii,nursing_note,PROMPT1_entailment
154,237,21,13,8,0.6190476190476191,35,32,3,0.9142857142857144,0.7382431233362912,gemini,mimiciii,nursing_note,PROMPT1_entailment
155,238,52,33,19,0.6346153846153846,42,33,9,0.7857142857142857,0.7021276595744681,gemini,mimiciii,nursing_note,PROMPT1_entailment
156,239,35,22,13,0.6285714285714286,21,16,5,0.7619047619047619,0.6888454011741683,gemini,mimiciii,nursing_note,PROMPT1_entailment
157,24,9,8,1,0.8888888888888888,5,5,0,1.0,0.9411764705882352,gemini,mimiciii,nursing_note,PROMPT1_entailment
158,240,11,9,2,0.8181818181818182,42,32,10,0.7619047619047619,0.7890410958904108,gemini,mimiciii,nursing_note,PROMPT1_entailment
159,241,19,16,3,0.8421052631578947,21,20,1,0.9523809523809524,0.8938547486033519,gemini,mimiciii,nursing_note,PROMPT1_entailment
160,242,6,5,1,0.8333333333333334,16,12,4,0.75,0.7894736842105262,gemini,mimiciii,nursing_note,PROMPT1_entailment
161,243,8,8,0,1.0,5,3,2,0.6,0.7499999999999999,gemini,mimiciii,nursing_note,PROMPT1_entailment
162,244,9,9,0,1.0,16,14,2,0.875,0.9333333333333332,gemini,mimiciii,nursing_note,PROMPT1_entailment
163,245,8,7,1,0.875,37,30,7,0.8108108108108109,0.841683366733467,gemini,mimiciii,nursing_note,PROMPT1_entailment
164,246,23,22,1,0.9565217391304348,10,9,1,0.9,0.9274004683840747,gemini,mimiciii,nursing_note,PROMPT1_entailment
165,247,8,8,0,1.0,6,4,2,0.6666666666666666,0.8,gemini,mimiciii,nursing_note,PROMPT1_entailment
166,248,46,36,10,0.782608695652174,42,32,10,0.7619047619047619,0.772117962466488,gemini,mimiciii,nursing_note,PROMPT1_entailment
167,249,10,9,1,0.9,39,31,8,0.7948717948717948,0.8441754916792739,gemini,mimiciii,nursing_note,PROMPT1_entailment
168,25,43,23,20,0.5348837209302325,23,20,3,0.8695652173913043,0.6623470122390208,gemini,mimiciii,nursing_note,PROMPT1_entailment
169,26,46,41,5,0.8913043478260869,35,32,3,0.9142857142857144,0.9026487788097696,gemini,mimiciii,nursing_note,PROMPT1_entailment
170,27,7,7,0,1.0,3,2,1,0.6666666666666666,0.8,gemini,mimiciii,nursing_note,PROMPT1_entailment
171,28,48,32,16,0.6666666666666666,16,14,2,0.875,0.7567567567567567,gemini,mimiciii,nursing_note,PROMPT1_entailment
172,29,29,23,6,0.7931034482758621,33,22,11,0.6666666666666666,0.7244094488188977,gemini,mimiciii,nursing_note,PROMPT1_entailment
173,3,11,9,2,0.8181818181818182,6,5,1,0.8333333333333334,0.8256880733944955,gemini,mimiciii,nursing_note,PROMPT1_entailment
174,30,12,11,1,0.9166666666666666,17,9,8,0.5294117647058824,0.6711864406779661,gemini,mimiciii,nursing_note,PROMPT1_entailment
175,31,20,15,5,0.75,19,18,1,0.9473684210526316,0.8372093023255814,gemini,mimiciii,nursing_note,PROMPT1_entailment
176,32,19,15,4,0.7894736842105263,44,41,3,0.9318181818181818,0.8547602501737316,gemini,mimiciii,nursing_note,PROMPT1_entailment
177,33,10,10,0,1.0,5,5,0,1.0,1.0,gemini,mimiciii,nursing_note,PROMPT1_entailment
178,34,7,7,0,1.0,3,3,0,1.0,1.0,gemini,mimiciii,nursing_note,PROMPT1_entailment
179,35,12,11,1,0.9166666666666666,7,7,0,1.0,0.9565217391304348,gemini,mimiciii,nursing_note,PROMPT1_entailment
180,36,93,62,31,0.6666666666666666,62,57,5,0.9193548387096774,0.7728813559322033,gemini,mimiciii,nursing_note,PROMPT1_entailment
181,37,10,7,3,0.7,38,29,9,0.7631578947368421,0.7302158273381294,gemini,mimiciii,nursing_note,PROMPT1_entailment
182,38,12,9,3,0.75,26,21,5,0.8076923076923077,0.7777777777777779,gemini,mimiciii,nursing_note,PROMPT1_entailment
183,39,23,20,3,0.8695652173913043,3,2,1,0.6666666666666666,0.7547169811320754,gemini,mimiciii,nursing_note,PROMPT1_entailment
184,4,32,21,11,0.65625,26,20,6,0.7692307692307693,0.7082630691399663,gemini,mimiciii,nursing_note,PROMPT1_entailment
185,40,10,9,1,0.9,3,3,0,1.0,0.9473684210526316,gemini,mimiciii,nursing_note,PROMPT1_entailment
186,41,54,47,7,0.8703703703703703,50,44,6,0.88,0.8751586965721541,gemini,mimiciii,nursing_note,PROMPT1_entailment
187,42,39,19,20,0.4871794871794871,7,7,0,1.0,0.6551724137931034,gemini,mimiciii,nursing_note,PROMPT1_entailment
188,43,38,26,12,0.6842105263157895,14,10,4,0.7142857142857143,0.6989247311827957,gemini,mimiciii,nursing_note,PROMPT1_entailment
189,44,6,6,0,1.0,3,3,0,1.0,1.0,gemini,mimiciii,nursing_note,PROMPT1_entailment
190,45,41,32,9,0.7804878048780488,34,18,16,0.5294117647058824,0.6308871851040525,gemini,mimiciii,nursing_note,PROMPT1_entailment
191,46,54,42,12,0.7777777777777778,33,29,4,0.8787878787878788,0.8252032520325203,gemini,mimiciii,nursing_note,PROMPT1_entailment
192,47,6,5,1,0.8333333333333334,14,13,1,0.9285714285714286,0.8783783783783784,gemini,mimiciii,nursing_note,PROMPT1_entailment
193,48,14,12,2,0.8571428571428571,9,9,0,1.0,0.923076923076923,gemini,mimiciii,nursing_note,PROMPT1_entailment
194,49,5,4,1,0.8,3,2,1,0.6666666666666666,0.7272727272727272,gemini,mimiciii,nursing_note,PROMPT1_entailment
195,5,37,30,7,0.8108108108108109,15,12,3,0.8,0.8053691275167786,gemini,mimiciii,nursing_note,PROMPT1_entailment
196,50,16,14,2,0.875,16,11,5,0.6875,0.77,gemini,mimiciii,nursing_note,PROMPT1_entailment
197,51,8,8,0,1.0,6,6,0,1.0,1.0,gemini,mimiciii,nursing_note,PROMPT1_entailment
198,52,17,16,1,0.9411764705882352,38,30,8,0.7894736842105263,0.8586762075134169,gemini,mimiciii,nursing_note,PROMPT1_entailment
199,53,7,6,1,0.8571428571428571,6,5,1,0.8333333333333334,0.8450704225352113,gemini,mimiciii,nursing_note,PROMPT1_entailment
200,54,43,25,18,0.5813953488372093,37,27,10,0.7297297297297297,0.6471716203259827,gemini,mimiciii,nursing_note,PROMPT1_entailment
201,55,48,38,10,0.7916666666666666,35,26,9,0.7428571428571429,0.7664856477889838,gemini,mimiciii,nursing_note,PROMPT1_entailment
202,56,12,12,0,1.0,2,2,0,1.0,1.0,gemini,mimiciii,nursing_note,PROMPT1_entailment
203,57,54,47,7,0.8703703703703703,18,14,4,0.7777777777777778,0.8214731585518102,gemini,mimiciii,nursing_note,PROMPT1_entailment
204,58,19,16,3,0.8421052631578947,28,21,7,0.75,0.7933884297520661,gemini,mimiciii,nursing_note,PROMPT1_entailment
205,59,10,10,0,1.0,9,8,1,0.8888888888888888,0.9411764705882352,gemini,mimiciii,nursing_note,PROMPT1_entailment
206,6,10,10,0,1.0,8,7,1,0.875,0.9333333333333332,gemini,mimiciii,nursing_note,PROMPT1_entailment
207,60,7,6,1,0.8571428571428571,27,21,6,0.7777777777777778,0.8155339805825242,gemini,mimiciii,nursing_note,PROMPT1_entailment
208,61,7,5,2,0.7142857142857143,20,19,1,0.95,0.8154506437768242,gemini,mimiciii,nursing_note,PROMPT1_entailment
209,62,40,29,11,0.725,37,32,5,0.8648648648648649,0.7887802804929877,gemini,mimiciii,nursing_note,PROMPT1_entailment
210,63,9,9,0,1.0,5,4,1,0.8,0.888888888888889,gemini,mimiciii,nursing_note,PROMPT1_entailment
211,64,51,44,7,0.8627450980392157,27,20,7,0.7407407407407407,0.7971014492753624,gemini,mimiciii,nursing_note,PROMPT1_entailment
212,65,16,13,3,0.8125,19,15,4,0.7894736842105263,0.8008213552361396,gemini,mimiciii,nursing_note,PROMPT1_entailment
213,66,11,10,1,0.9090909090909092,1,0,1,0.0,0.0,gemini,mimiciii,nursing_note,PROMPT1_entailment
214,67,12,10,2,0.8333333333333334,7,7,0,1.0,0.9090909090909092,gemini,mimiciii,nursing_note,PROMPT1_entailment
215,68,8,4,4,0.5,18,15,3,0.8333333333333334,0.625,gemini,mimiciii,nursing_note,PROMPT1_entailment
216,69,33,19,14,0.5757575757575758,25,18,7,0.72,0.6398503274087932,gemini,mimiciii,nursing_note,PROMPT1_entailment
217,7,6,6,0,1.0,2,2,0,1.0,1.0,gemini,mimiciii,nursing_note,PROMPT1_entailment
218,70,12,11,1,0.9166666666666666,45,24,21,0.5333333333333333,0.6743295019157088,gemini,mimiciii,nursing_note,PROMPT1_entailment
219,71,51,27,24,0.5294117647058824,52,38,14,0.7307692307692307,0.6140035906642728,gemini,mimiciii,nursing_note,PROMPT1_entailment
220,72,13,11,2,0.8461538461538461,12,9,3,0.75,0.7951807228915662,gemini,mimiciii,nursing_note,PROMPT1_entailment
221,73,44,26,18,0.5909090909090909,38,31,7,0.8157894736842105,0.6853741496598639,gemini,mimiciii,nursing_note,PROMPT1_entailment
222,74,8,8,0,1.0,8,7,1,0.875,0.9333333333333332,gemini,mimiciii,nursing_note,PROMPT1_entailment
223,75,52,34,18,0.6538461538461539,27,24,3,0.8888888888888888,0.7534626038781164,gemini,mimiciii,nursing_note,PROMPT1_entailment
224,76,4,4,0,1.0,1,1,0,1.0,1.0,gemini,mimiciii,nursing_note,PROMPT1_entailment
225,77,14,9,5,0.6428571428571429,59,49,10,0.8305084745762712,0.7247329498767462,gemini,mimiciii,nursing_note,PROMPT1_entailment
226,78,43,26,17,0.6046511627906976,20,18,2,0.9,0.723338485316847,gemini,mimiciii,nursing_note,PROMPT1_entailment
227,79,42,33,9,0.7857142857142857,30,26,4,0.8666666666666667,0.8242074927953891,gemini,mimiciii,nursing_note,PROMPT1_entailment
228,8,11,11,0,1.0,14,10,4,0.7142857142857143,0.8333333333333333,gemini,mimiciii,nursing_note,PROMPT1_entailment
229,80,8,7,1,0.875,22,22,0,1.0,0.9333333333333332,gemini,mimiciii,nursing_note,PROMPT1_entailment
230,81,25,14,11,0.56,22,19,3,0.8636363636363636,0.6794380587484036,gemini,mimiciii,nursing_note,PROMPT1_entailment
231,82,27,21,6,0.7777777777777778,17,12,5,0.7058823529411765,0.7400881057268723,gemini,mimiciii,nursing_note,PROMPT1_entailment
232,83,13,8,5,0.6153846153846154,34,22,12,0.6470588235294118,0.6308243727598567,gemini,mimiciii,nursing_note,PROMPT1_entailment
233,84,13,12,1,0.9230769230769232,6,6,0,1.0,0.96,gemini,mimiciii,nursing_note,PROMPT1_entailment
234,85,35,27,8,0.7714285714285715,27,20,7,0.7407407407407407,0.755773268019594,gemini,mimiciii,nursing_note,PROMPT1_entailment
235,86,54,39,15,0.7222222222222222,40,27,13,0.675,0.6978131212723659,gemini,mimiciii,nursing_note,PROMPT1_entailment
236,87,15,12,3,0.8,15,13,2,0.8666666666666667,0.832,gemini,mimiciii,nursing_note,PROMPT1_entailment
237,88,13,11,2,0.8461538461538461,15,12,3,0.8,0.8224299065420562,gemini,mimiciii,nursing_note,PROMPT1_entailment
238,89,11,9,2,0.8181818181818182,29,23,6,0.7931034482758621,0.8054474708171206,gemini,mimiciii,nursing_note,PROMPT1_entailment
239,9,12,11,1,0.9166666666666666,17,13,4,0.7647058823529411,0.8338192419825073,gemini,mimiciii,nursing_note,PROMPT1_entailment
240,90,40,24,16,0.6,14,13,1,0.9285714285714286,0.7289719626168225,gemini,mimiciii,nursing_note,PROMPT1_entailment
241,91,9,8,1,0.8888888888888888,25,23,2,0.92,0.9041769041769042,gemini,mimiciii,nursing_note,PROMPT1_entailment
242,92,55,46,9,0.8363636363636363,28,27,1,0.9642857142857144,0.8957807428777498,gemini,mimiciii,nursing_note,PROMPT1_entailment
243,93,11,9,2,0.8181818181818182,23,22,1,0.9565217391304348,0.8819599109131404,gemini,mimiciii,nursing_note,PROMPT1_entailment
244,94,7,6,1,0.8571428571428571,5,5,0,1.0,0.923076923076923,gemini,mimiciii,nursing_note,PROMPT1_entailment
245,95,17,14,3,0.8235294117647058,14,12,2,0.8571428571428571,0.84,gemini,mimiciii,nursing_note,PROMPT1_entailment
246,96,10,10,0,1.0,6,6,0,1.0,1.0,gemini,mimiciii,nursing_note,PROMPT1_entailment
247,97,9,7,2,0.7777777777777778,10,10,0,1.0,0.8750000000000001,gemini,mimiciii,nursing_note,PROMPT1_entailment
248,98,65,49,16,0.7538461538461538,13,11,2,0.8461538461538461,0.7973372781065088,gemini,mimiciii,nursing_note,PROMPT1_entailment
249,99,56,43,13,0.7678571428571429,44,40,4,0.9090909090909092,0.8325266214908035,gemini,mimiciii,nursing_note,PROMPT1_entailment
0,0,17,7,10,0.4117647058823529,11,10,1,0.9090909090909092,0.5668016194331984,gemini,mimiciii,nursing_note,PROMPT1_ICL_entailment
1,1,48,21,27,0.4375,31,24,7,0.7741935483870968,0.5590682196339434,gemini,mimiciii,nursing_note,PROMPT1_ICL_entailment
2,10,29,16,13,0.5517241379310345,18,13,5,0.7222222222222222,0.6255639097744361,gemini,mimiciii,nursing_note,PROMPT1_ICL_entailment
3,100,13,12,1,0.9230769230769232,6,6,0,1.0,0.96,gemini,mimiciii,nursing_note,PROMPT1_ICL_entailment
4,101,35,26,9,0.7428571428571429,27,25,2,0.925925925925926,0.8243500317057705,gemini,mimiciii,nursing_note,PROMPT1_ICL_entailment
5,102,45,36,9,0.8,26,19,7,0.7307692307692307,0.763819095477387,gemini,mimiciii,nursing_note,PROMPT1_ICL_entailment
6,103,1,0,1,0.0,22,3,19,0.1363636363636363,0.0,gemini,mimiciii,nursing_note,PROMPT1_ICL_entailment
7,104,28,23,5,0.8214285714285714,20,20,0,1.0,0.9019607843137256,gemini,mimiciii,nursing_note,PROMPT1_ICL_entailment
8,105,50,36,14,0.72,20,18,2,0.9,0.7999999999999999,gemini,mimiciii,nursing_note,PROMPT1_ICL_entailment
9,106,9,9,0,1.0,4,3,1,0.75,0.8571428571428571,gemini,mimiciii,nursing_note,PROMPT1_ICL_entailment
10,107,63,50,13,0.7936507936507936,63,40,23,0.6349206349206349,0.7054673721340389,gemini,mimiciii,nursing_note,PROMPT1_ICL_entailment
11,108,59,49,10,0.8305084745762712,28,27,1,0.9642857142857144,0.8924114671163574,gemini,mimiciii,nursing_note,PROMPT1_ICL_entailment
12,109,5,5,0,1.0,4,4,0,1.0,1.0,gemini,mimiciii,nursing_note,PROMPT1_ICL_entailment
13,11,4,4,0,1.0,2,2,0,1.0,1.0,gemini,mimiciii,nursing_note,PROMPT1_ICL_entailment
14,110,22,21,1,0.9545454545454546,13,12,1,0.9230769230769232,0.9385474860335196,gemini,mimiciii,nursing_note,PROMPT1_ICL_entailment
15,111,45,34,11,0.7555555555555555,34,30,4,0.8823529411764706,0.8140462889066241,gemini,mimiciii,nursing_note,PROMPT1_ICL_entailment
16,112,1,0,1,0.0,37,7,30,0.1891891891891892,0.0,gemini,mimiciii,nursing_note,PROMPT1_ICL_entailment
17,113,7,7,0,1.0,5,5,0,1.0,1.0,gemini,mimiciii,nursing_note,PROMPT1_ICL_entailment
18,114,24,13,11,0.5416666666666666,19,13,6,0.6842105263157895,0.6046511627906976,gemini,mimiciii,nursing_note,PROMPT1_ICL_entailment
19,115,13,13,0,1.0,7,6,1,0.8571428571428571,0.923076923076923,gemini,mimiciii,nursing_note,PROMPT1_ICL_entailment
20,116,33,33,0,1.0,31,24,7,0.7741935483870968,0.8727272727272727,gemini,mimiciii,nursing_note,PROMPT1_ICL_entailment
21,117,56,42,14,0.75,18,17,1,0.9444444444444444,0.8360655737704917,gemini,mimiciii,nursing_note,PROMPT1_ICL_entailment
22,118,50,29,21,0.58,25,20,5,0.8,0.672463768115942,gemini,mimiciii,nursing_note,PROMPT1_ICL_entailment
23,119,46,37,9,0.8043478260869565,26,21,5,0.8076923076923077,0.8060165975103735,gemini,mimiciii,nursing_note,PROMPT1_ICL_entailment
24,12,34,31,3,0.9117647058823528,18,14,4,0.7777777777777778,0.8394584139264991,gemini,mimiciii,nursing_note,PROMPT1_ICL_entailment
25,120,22,15,7,0.6818181818181818,18,18,0,1.0,0.8108108108108109,gemini,mimiciii,nursing_note,PROMPT1_ICL_entailment
26,121,49,38,11,0.7755102040816326,37,33,4,0.8918918918918919,0.8296394310287794,gemini,mimiciii,nursing_note,PROMPT1_ICL_entailment
27,122,36,28,8,0.7777777777777778,11,8,3,0.7272727272727273,0.7516778523489932,gemini,mimiciii,nursing_note,PROMPT1_ICL_entailment
28,123,8,8,0,1.0,6,6,0,1.0,1.0,gemini,mimiciii,nursing_note,PROMPT1_ICL_entailment
29,124,10,10,0,1.0,5,5,0,1.0,1.0,gemini,mimiciii,nursing_note,PROMPT1_ICL_entailment
30,125,52,49,3,0.9423076923076924,43,36,7,0.8372093023255814,0.8866549384267405,gemini,mimiciii,nursing_note,PROMPT1_ICL_entailment
31,126,34,27,7,0.7941176470588235,28,24,4,0.8571428571428571,0.8244274809160305,gemini,mimiciii,nursing_note,PROMPT1_ICL_entailment
32,127,33,22,11,0.6666666666666666,10,10,0,1.0,0.8,gemini,mimiciii,nursing_note,PROMPT1_ICL_entailment
33,128,41,27,14,0.6585365853658537,17,16,1,0.9411764705882352,0.7748878923766818,gemini,mimiciii,nursing_note,PROMPT1_ICL_entailment
34,129,39,29,10,0.7435897435897436,29,26,3,0.896551724137931,0.8129380053908356,gemini,mimiciii,nursing_note,PROMPT1_ICL_entailment
35,13,66,59,7,0.8939393939393939,34,29,5,0.8529411764705882,0.8729591836734694,gemini,mimiciii,nursing_note,PROMPT1_ICL_entailment
36,130,41,28,13,0.6829268292682927,33,29,4,0.8787878787878788,0.7685754850922859,gemini,mimiciii,nursing_note,PROMPT1_ICL_entailment
37,131,35,33,2,0.9428571428571428,31,27,4,0.8709677419354839,0.9054878048780488,gemini,mimiciii,nursing_note,PROMPT1_ICL_entailment
38,132,47,32,15,0.6808510638297872,17,16,1,0.9411764705882352,0.7901234567901235,gemini,mimiciii,nursing_note,PROMPT1_ICL_entailment
39,133,1,1,0,1.0,10,1,9,0.1,0.1818181818181818,gemini,mimiciii,nursing_note,PROMPT1_ICL_entailment
40,134,55,26,29,0.4727272727272727,30,25,5,0.8333333333333334,0.6032482598607888,gemini,mimiciii,nursing_note,PROMPT1_ICL_entailment
41,135,80,53,27,0.6625,47,34,13,0.723404255319149,0.6916138936864326,gemini,mimiciii,nursing_note,PROMPT1_ICL_entailment
42,136,88,75,13,0.8522727272727273,41,38,3,0.926829268292683,0.8879887832995793,gemini,mimiciii,nursing_note,PROMPT1_ICL_entailment
43,137,5,5,0,1.0,2,1,1,0.5,0.6666666666666666,gemini,mimiciii,nursing_note,PROMPT1_ICL_entailment
44,138,8,8,0,1.0,5,4,1,0.8,0.888888888888889,gemini,mimiciii,nursing_note,PROMPT1_ICL_entailment
45,139,10,10,0,1.0,4,3,1,0.75,0.8571428571428571,gemini,mimiciii,nursing_note,PROMPT1_ICL_entailment
46,14,37,33,4,0.8918918918918919,26,25,1,0.9615384615384616,0.9254066180594503,gemini,mimiciii,nursing_note,PROMPT1_ICL_entailment
47,140,35,18,17,0.5142857142857142,24,21,3,0.875,0.6478149100257069,gemini,mimiciii,nursing_note,PROMPT1_ICL_entailment
48,141,17,16,1,0.9411764705882352,11,11,0,1.0,0.9696969696969696,gemini,mimiciii,nursing_note,PROMPT1_ICL_entailment
49,142,68,49,19,0.7205882352941176,8,7,1,0.875,0.7903225806451613,gemini,mimiciii,nursing_note,PROMPT1_ICL_entailment
50,143,18,12,6,0.6666666666666666,2,2,0,1.0,0.8,gemini,mimiciii,nursing_note,PROMPT1_ICL_entailment
51,144,12,11,1,0.9166666666666666,5,5,0,1.0,0.9565217391304348,gemini,mimiciii,nursing_note,PROMPT1_ICL_entailment
52,145,52,33,19,0.6346153846153846,19,16,3,0.8421052631578947,0.7237834132967785,gemini,mimiciii,nursing_note,PROMPT1_ICL_entailment
53,146,12,7,5,0.5833333333333334,6,6,0,1.0,0.7368421052631579,gemini,mimiciii,nursing_note,PROMPT1_ICL_entailment
54,147,45,30,15,0.6666666666666666,26,24,2,0.9230769230769232,0.7741935483870968,gemini,mimiciii,nursing_note,PROMPT1_ICL_entailment
55,148,19,17,2,0.8947368421052632,7,7,0,1.0,0.9444444444444444,gemini,mimiciii,nursing_note,PROMPT1_ICL_entailment
56,149,57,40,17,0.7017543859649122,36,30,6,0.8333333333333334,0.7619047619047619,gemini,mimiciii,nursing_note,PROMPT1_ICL_entailment
57,15,44,33,11,0.75,33,28,5,0.8484848484848485,0.7962085308056871,gemini,mimiciii,nursing_note,PROMPT1_ICL_entailment
58,150,16,16,0,1.0,8,8,0,1.0,1.0,gemini,mimiciii,nursing_note,PROMPT1_ICL_entailment
59,151,46,34,12,0.7391304347826086,26,20,6,0.7692307692307693,0.7538802660753879,gemini,mimiciii,nursing_note,PROMPT1_ICL_entailment
60,152,73,59,14,0.8082191780821918,44,41,3,0.9318181818181818,0.8656289139380927,gemini,mimiciii,nursing_note,PROMPT1_ICL_entailment
61,153,8,8,0,1.0,4,3,1,0.75,0.8571428571428571,gemini,mimiciii,nursing_note,PROMPT1_ICL_entailment
62,154,46,33,13,0.717391304347826,34,29,5,0.8529411764705882,0.7793159609120521,gemini,mimiciii,nursing_note,PROMPT1_ICL_entailment
63,155,60,46,14,0.7666666666666667,51,45,6,0.8823529411764706,0.8204518430439953,gemini,mimiciii,nursing_note,PROMPT1_ICL_entailment
64,156,30,25,5,0.8333333333333334,26,21,5,0.8076923076923077,0.8203125000000001,gemini,mimiciii,nursing_note,PROMPT1_ICL_entailment
65,157,8,8,0,1.0,5,5,0,1.0,1.0,gemini,mimiciii,nursing_note,PROMPT1_ICL_entailment
66,158,51,45,6,0.8823529411764706,22,18,4,0.8181818181818182,0.8490566037735848,gemini,mimiciii,nursing_note,PROMPT1_ICL_entailment
67,159,15,12,3,0.8,8,7,1,0.875,0.8358208955223881,gemini,mimiciii,nursing_note,PROMPT1_ICL_entailment
68,16,53,44,9,0.8301886792452831,30,25,5,0.8333333333333334,0.8317580340264651,gemini,mimiciii,nursing_note,PROMPT1_ICL_entailment
69,160,50,41,9,0.82,21,20,1,0.9523809523809524,0.8812466415905426,gemini,mimiciii,nursing_note,PROMPT1_ICL_entailment
70,161,6,6,0,1.0,6,5,1,0.8333333333333334,0.9090909090909092,gemini,mimiciii,nursing_note,PROMPT1_ICL_entailment
71,162,40,37,3,0.925,31,26,5,0.8387096774193549,0.8797439414723366,gemini,mimiciii,nursing_note,PROMPT1_ICL_entailment
72,163,11,10,1,0.9090909090909092,4,4,0,1.0,0.9523809523809524,gemini,mimiciii,nursing_note,PROMPT1_ICL_entailment
73,164,25,21,4,0.84,13,12,1,0.9230769230769232,0.8795811518324608,gemini,mimiciii,nursing_note,PROMPT1_ICL_entailment
74,165,59,46,13,0.7796610169491526,24,21,3,0.875,0.8245838668373879,gemini,mimiciii,nursing_note,PROMPT1_ICL_entailment
75,166,1,1,0,1.0,3,0,3,0.0,0.0,gemini,mimiciii,nursing_note,PROMPT1_ICL_entailment
76,167,44,39,5,0.8863636363636364,16,15,1,0.9375,0.911214953271028,gemini,mimiciii,nursing_note,PROMPT1_ICL_entailment
77,168,46,26,20,0.5652173913043478,25,18,7,0.72,0.6332882273342354,gemini,mimiciii,nursing_note,PROMPT1_ICL_entailment
78,169,27,24,3,0.8888888888888888,12,12,0,1.0,0.9411764705882352,gemini,mimiciii,nursing_note,PROMPT1_ICL_entailment
79,17,35,29,6,0.8285714285714286,39,32,7,0.8205128205128205,0.8245224344735674,gemini,mimiciii,nursing_note,PROMPT1_ICL_entailment
80,170,52,41,11,0.7884615384615384,21,19,2,0.9047619047619048,0.8426176311519741,gemini,mimiciii,nursing_note,PROMPT1_ICL_entailment
81,171,12,10,2,0.8333333333333334,8,7,1,0.875,0.8536585365853658,gemini,mimiciii,nursing_note,PROMPT1_ICL_entailment
82,172,44,40,4,0.9090909090909092,38,30,8,0.7894736842105263,0.8450704225352113,gemini,mimiciii,nursing_note,PROMPT1_ICL_entailment
83,173,27,25,2,0.925925925925926,20,15,5,0.75,0.8287292817679557,gemini,mimiciii,nursing_note,PROMPT1_ICL_entailment
84,174,10,10,0,1.0,8,8,0,1.0,1.0,gemini,mimiciii,nursing_note,PROMPT1_ICL_entailment
85,175,5,3,2,0.6,4,4,0,1.0,0.7499999999999999,gemini,mimiciii,nursing_note,PROMPT1_ICL_entailment
86,176,23,19,4,0.8260869565217391,13,10,3,0.7692307692307693,0.7966457023060797,gemini,mimiciii,nursing_note,PROMPT1_ICL_entailment
87,177,62,49,13,0.7903225806451613,38,32,6,0.8421052631578947,0.8153926157046282,gemini,mimiciii,nursing_note,PROMPT1_ICL_entailment
88,178,48,46,2,0.9583333333333334,25,20,5,0.8,0.8720379146919433,gemini,mimiciii,nursing_note,PROMPT1_ICL_entailment
89,179,37,31,6,0.8378378378378378,22,17,5,0.7727272727272727,0.8039664378337147,gemini,mimiciii,nursing_note,PROMPT1_ICL_entailment
90,18,49,34,15,0.6938775510204082,25,21,4,0.84,0.7599787120808941,gemini,mimiciii,nursing_note,PROMPT1_ICL_entailment
91,180,66,47,19,0.7121212121212122,27,25,2,0.925925925925926,0.8050702295306613,gemini,mimiciii,nursing_note,PROMPT1_ICL_entailment
92,181,39,27,12,0.6923076923076923,25,24,1,0.96,0.8044692737430168,gemini,mimiciii,nursing_note,PROMPT1_ICL_entailment
93,182,33,26,7,0.7878787878787878,10,6,4,0.6,0.6812227074235808,gemini,mimiciii,nursing_note,PROMPT1_ICL_entailment
94,183,7,6,1,0.8571428571428571,5,5,0,1.0,0.923076923076923,gemini,mimiciii,nursing_note,PROMPT1_ICL_entailment
95,184,20,19,1,0.95,1,1,0,1.0,0.9743589743589745,gemini,mimiciii,nursing_note,PROMPT1_ICL_entailment
96,185,33,28,5,0.8484848484848485,30,29,1,0.9666666666666668,0.9037284362826934,gemini,mimiciii,nursing_note,PROMPT1_ICL_entailment
97,186,5,5,0,1.0,4,3,1,0.75,0.8571428571428571,gemini,mimiciii,nursing_note,PROMPT1_ICL_entailment
98,187,54,53,1,0.9814814814814816,37,33,4,0.8918918918918919,0.9345444830349986,gemini,mimiciii,nursing_note,PROMPT1_ICL_entailment
99,188,6,6,0,1.0,2,2,0,1.0,1.0,gemini,mimiciii,nursing_note,PROMPT1_ICL_entailment
100,189,60,47,13,0.7833333333333333,21,21,0,1.0,0.8785046728971964,gemini,mimiciii,nursing_note,PROMPT1_ICL_entailment
101,19,69,58,11,0.8405797101449275,45,38,7,0.8444444444444444,0.8425076452599389,gemini,mimiciii,nursing_note,PROMPT1_ICL_entailment
102,190,38,35,3,0.9210526315789472,24,23,1,0.9583333333333334,0.939323220536756,gemini,mimiciii,nursing_note,PROMPT1_ICL_entailment
103,191,46,35,11,0.7608695652173914,29,24,5,0.8275862068965517,0.7928268050967437,gemini,mimiciii,nursing_note,PROMPT1_ICL_entailment
104,192,22,21,1,0.9545454545454546,15,14,1,0.9333333333333332,0.9438202247191012,gemini,mimiciii,nursing_note,PROMPT1_ICL_entailment
105,193,57,40,17,0.7017543859649122,40,35,5,0.875,0.7788595271210013,gemini,mimiciii,nursing_note,PROMPT1_ICL_entailment
106,194,20,19,1,0.95,13,13,0,1.0,0.9743589743589745,gemini,mimiciii,nursing_note,PROMPT1_ICL_entailment
107,195,10,10,0,1.0,7,7,0,1.0,1.0,gemini,mimiciii,nursing_note,PROMPT1_ICL_entailment
108,196,41,36,5,0.8780487804878049,34,33,1,0.9705882352941176,0.9220023282887078,gemini,mimiciii,nursing_note,PROMPT1_ICL_entailment
109,197,68,48,20,0.7058823529411765,27,26,1,0.9629629629629628,0.8146214099216711,gemini,mimiciii,nursing_note,PROMPT1_ICL_entailment
110,198,69,56,13,0.8115942028985508,38,30,8,0.7894736842105263,0.800381133873273,gemini,mimiciii,nursing_note,PROMPT1_ICL_entailment
111,199,24,20,4,0.8333333333333334,14,12,2,0.8571428571428571,0.8450704225352113,gemini,mimiciii,nursing_note,PROMPT1_ICL_entailment
112,2,70,36,34,0.5142857142857142,43,36,7,0.8372093023255814,0.6371681415929202,gemini,mimiciii,nursing_note,PROMPT1_ICL_entailment
113,20,75,41,34,0.5466666666666666,46,37,9,0.8043478260869565,0.650933276121004,gemini,mimiciii,nursing_note,PROMPT1_ICL_entailment
114,200,50,34,16,0.68,44,33,11,0.75,0.7132867132867132,gemini,mimiciii,nursing_note,PROMPT1_ICL_entailment
115,201,39,39,0,1.0,29,22,7,0.7586206896551724,0.8627450980392156,gemini,mimiciii,nursing_note,PROMPT1_ICL_entailment
116,202,11,11,0,1.0,9,7,2,0.7777777777777778,0.8750000000000001,gemini,mimiciii,nursing_note,PROMPT1_ICL_entailment
117,203,15,15,0,1.0,7,7,0,1.0,1.0,gemini,mimiciii,nursing_note,PROMPT1_ICL_entailment
118,204,46,32,14,0.6956521739130435,24,21,3,0.875,0.7750865051903115,gemini,mimiciii,nursing_note,PROMPT1_ICL_entailment
119,205,51,48,3,0.9411764705882352,69,65,4,0.9420289855072465,0.9416025350837482,gemini,mimiciii,nursing_note,PROMPT1_ICL_entailment
120,206,12,12,0,1.0,6,6,0,1.0,1.0,gemini,mimiciii,nursing_note,PROMPT1_ICL_entailment
121,207,61,54,7,0.8852459016393442,29,26,3,0.896551724137931,0.8908629441624365,gemini,mimiciii,nursing_note,PROMPT1_ICL_entailment
122,208,17,17,0,1.0,7,6,1,0.8571428571428571,0.923076923076923,gemini,mimiciii,nursing_note,PROMPT1_ICL_entailment
123,209,4,3,1,0.75,2,2,0,1.0,0.8571428571428571,gemini,mimiciii,nursing_note,PROMPT1_ICL_entailment
124,21,7,7,0,1.0,6,5,1,0.8333333333333334,0.9090909090909092,gemini,mimiciii,nursing_note,PROMPT1_ICL_entailment
125,210,28,20,8,0.7142857142857143,22,20,2,0.9090909090909092,0.8,gemini,mimiciii,nursing_note,PROMPT1_ICL_entailment
126,211,5,5,0,1.0,4,4,0,1.0,1.0,gemini,mimiciii,nursing_note,PROMPT1_ICL_entailment
127,212,53,44,9,0.8301886792452831,37,33,4,0.8918918918918919,0.8599348534201955,gemini,mimiciii,nursing_note,PROMPT1_ICL_entailment
128,213,23,20,3,0.8695652173913043,18,17,1,0.9444444444444444,0.9054593874833556,gemini,mimiciii,nursing_note,PROMPT1_ICL_entailment
129,214,12,12,0,1.0,3,3,0,1.0,1.0,gemini,mimiciii,nursing_note,PROMPT1_ICL_entailment
130,215,11,11,0,1.0,7,6,1,0.8571428571428571,0.923076923076923,gemini,mimiciii,nursing_note,PROMPT1_ICL_entailment
131,216,28,20,8,0.7142857142857143,13,10,3,0.7692307692307693,0.7407407407407408,gemini,mimiciii,nursing_note,PROMPT1_ICL_entailment
132,217,58,49,9,0.8448275862068966,25,24,1,0.96,0.8987390141383264,gemini,mimiciii,nursing_note,PROMPT1_ICL_entailment
133,218,26,23,3,0.8846153846153846,18,15,3,0.8333333333333334,0.8582089552238806,gemini,mimiciii,nursing_note,PROMPT1_ICL_entailment
134,219,32,19,13,0.59375,14,12,2,0.8571428571428571,0.7015384615384614,gemini,mimiciii,nursing_note,PROMPT1_ICL_entailment
135,22,44,37,7,0.8409090909090909,26,21,5,0.8076923076923077,0.823966065747614,gemini,mimiciii,nursing_note,PROMPT1_ICL_entailment
136,220,14,13,1,0.9285714285714286,5,3,2,0.6,0.7289719626168225,gemini,mimiciii,nursing_note,PROMPT1_ICL_entailment
137,221,31,18,13,0.5806451612903226,45,31,14,0.6888888888888889,0.6301524562394127,gemini,mimiciii,nursing_note,PROMPT1_ICL_entailment
138,222,7,7,0,1.0,3,3,0,1.0,1.0,gemini,mimiciii,nursing_note,PROMPT1_ICL_entailment
139,223,38,19,19,0.5,30,30,0,1.0,0.6666666666666666,gemini,mimiciii,nursing_note,PROMPT1_ICL_entailment
140,224,8,8,0,1.0,6,4,2,0.6666666666666666,0.8,gemini,mimiciii,nursing_note,PROMPT1_ICL_entailment
141,225,82,47,35,0.573170731707317,45,39,6,0.8666666666666667,0.6900056465273856,gemini,mimiciii,nursing_note,PROMPT1_ICL_entailment
142,226,53,50,3,0.9433962264150944,20,19,1,0.95,0.9466865969108124,gemini,mimiciii,nursing_note,PROMPT1_ICL_entailment
143,227,25,22,3,0.88,15,14,1,0.9333333333333332,0.9058823529411764,gemini,mimiciii,nursing_note,PROMPT1_ICL_entailment
144,228,65,39,26,0.6,38,30,8,0.7894736842105263,0.6818181818181819,gemini,mimiciii,nursing_note,PROMPT1_ICL_entailment
145,229,42,38,4,0.9047619047619048,22,21,1,0.9545454545454546,0.9289871944121072,gemini,mimiciii,nursing_note,PROMPT1_ICL_entailment
146,23,68,56,12,0.8235294117647058,44,29,15,0.6590909090909091,0.7321911632100992,gemini,mimiciii,nursing_note,PROMPT1_ICL_entailment
147,230,19,17,2,0.8947368421052632,7,6,1,0.8571428571428571,0.8755364806866952,gemini,mimiciii,nursing_note,PROMPT1_ICL_entailment
148,231,55,45,10,0.8181818181818182,15,11,4,0.7333333333333333,0.7734375,gemini,mimiciii,nursing_note,PROMPT1_ICL_entailment
149,232,9,7,2,0.7777777777777778,2,2,0,1.0,0.8750000000000001,gemini,mimiciii,nursing_note,PROMPT1_ICL_entailment
150,233,51,23,28,0.4509803921568627,44,36,8,0.8181818181818182,0.5814606741573034,gemini,mimiciii,nursing_note,PROMPT1_ICL_entailment
151,234,51,50,1,0.9803921568627452,32,27,5,0.84375,0.9069533087000335,gemini,mimiciii,nursing_note,PROMPT1_ICL_entailment
152,235,25,25,0,1.0,10,9,1,0.9,0.9473684210526316,gemini,mimiciii,nursing_note,PROMPT1_ICL_entailment
153,236,12,11,1,0.9166666666666666,7,6,1,0.8571428571428571,0.8859060402684563,gemini,mimiciii,nursing_note,PROMPT1_ICL_entailment
154,237,44,40,4,0.9090909090909092,35,28,7,0.8,0.8510638297872342,gemini,mimiciii,nursing_note,PROMPT1_ICL_entailment
155,238,72,47,25,0.6527777777777778,42,38,4,0.9047619047619048,0.7583864118895965,gemini,mimiciii,nursing_note,PROMPT1_ICL_entailment
156,239,50,35,15,0.7,21,15,6,0.7142857142857143,0.7070707070707072,gemini,mimiciii,nursing_note,PROMPT1_ICL_entailment
157,24,12,12,0,1.0,5,5,0,1.0,1.0,gemini,mimiciii,nursing_note,PROMPT1_ICL_entailment
158,240,52,42,10,0.8076923076923077,42,33,9,0.7857142857142857,0.796551724137931,gemini,mimiciii,nursing_note,PROMPT1_ICL_entailment
159,241,32,26,6,0.8125,21,21,0,1.0,0.896551724137931,gemini,mimiciii,nursing_note,PROMPT1_ICL_entailment
160,242,48,29,19,0.6041666666666666,16,11,5,0.6875,0.6431451612903226,gemini,mimiciii,nursing_note,PROMPT1_ICL_entailment
161,243,11,11,0,1.0,5,5,0,1.0,1.0,gemini,mimiciii,nursing_note,PROMPT1_ICL_entailment
162,244,52,33,19,0.6346153846153846,16,11,5,0.6875,0.6599999999999999,gemini,mimiciii,nursing_note,PROMPT1_ICL_entailment
163,245,53,36,17,0.6792452830188679,37,30,7,0.8108108108108109,0.7392197125256673,gemini,mimiciii,nursing_note,PROMPT1_ICL_entailment
164,246,34,31,3,0.9117647058823528,10,9,1,0.9,0.9058441558441558,gemini,mimiciii,nursing_note,PROMPT1_ICL_entailment
165,247,7,7,0,1.0,6,4,2,0.6666666666666666,0.8,gemini,mimiciii,nursing_note,PROMPT1_ICL_entailment
166,248,61,50,11,0.819672131147541,42,36,6,0.8571428571428571,0.8379888268156425,gemini,mimiciii,nursing_note,PROMPT1_ICL_entailment
167,249,58,35,23,0.603448275862069,39,35,4,0.8974358974358975,0.7216494845360825,gemini,mimiciii,nursing_note,PROMPT1_ICL_entailment
168,25,53,34,19,0.6415094339622641,23,17,6,0.7391304347826086,0.6868686868686867,gemini,mimiciii,nursing_note,PROMPT1_ICL_entailment
169,26,50,42,8,0.84,35,32,3,0.9142857142857144,0.8755700325732898,gemini,mimiciii,nursing_note,PROMPT1_ICL_entailment
170,27,6,6,0,1.0,3,2,1,0.6666666666666666,0.8,gemini,mimiciii,nursing_note,PROMPT1_ICL_entailment
171,28,48,42,6,0.875,16,7,9,0.4375,0.5833333333333334,gemini,mimiciii,nursing_note,PROMPT1_ICL_entailment
172,29,45,36,9,0.8,33,26,7,0.7878787878787878,0.7938931297709925,gemini,mimiciii,nursing_note,PROMPT1_ICL_entailment
173,3,13,10,3,0.7692307692307693,6,5,1,0.8333333333333334,0.8,gemini,mimiciii,nursing_note,PROMPT1_ICL_entailment
174,30,22,20,2,0.9090909090909092,17,9,8,0.5294117647058824,0.6691449814126393,gemini,mimiciii,nursing_note,PROMPT1_ICL_entailment
175,31,29,24,5,0.8275862068965517,19,16,3,0.8421052631578947,0.8347826086956522,gemini,mimiciii,nursing_note,PROMPT1_ICL_entailment
176,32,70,64,6,0.9142857142857144,44,42,2,0.9545454545454546,0.9339819318971508,gemini,mimiciii,nursing_note,PROMPT1_ICL_entailment
177,33,12,11,1,0.9166666666666666,5,5,0,1.0,0.9565217391304348,gemini,mimiciii,nursing_note,PROMPT1_ICL_entailment
178,34,6,6,0,1.0,3,3,0,1.0,1.0,gemini,mimiciii,nursing_note,PROMPT1_ICL_entailment
179,35,16,15,1,0.9375,7,7,0,1.0,0.967741935483871,gemini,mimiciii,nursing_note,PROMPT1_ICL_entailment
180,36,55,44,11,0.8,62,46,16,0.7419354838709677,0.7698744769874478,gemini,mimiciii,nursing_note,PROMPT1_ICL_entailment
181,37,41,21,20,0.5121951219512195,38,27,11,0.7105263157894737,0.5952755905511811,gemini,mimiciii,nursing_note,PROMPT1_ICL_entailment
182,38,48,30,18,0.625,26,23,3,0.8846153846153846,0.7324840764331211,gemini,mimiciii,nursing_note,PROMPT1_ICL_entailment
183,39,24,19,5,0.7916666666666666,3,1,2,0.3333333333333333,0.4691358024691357,gemini,mimiciii,nursing_note,PROMPT1_ICL_entailment
184,4,1,0,1,0.0,26,5,21,0.1923076923076923,0.0,gemini,mimiciii,nursing_note,PROMPT1_ICL_entailment
185,40,12,12,0,1.0,3,3,0,1.0,1.0,gemini,mimiciii,nursing_note,PROMPT1_ICL_entailment
186,41,88,80,8,0.9090909090909092,50,42,8,0.84,0.8731808731808731,gemini,mimiciii,nursing_note,PROMPT1_ICL_entailment
187,42,48,36,12,0.75,7,7,0,1.0,0.8571428571428571,gemini,mimiciii,nursing_note,PROMPT1_ICL_entailment
188,43,37,32,5,0.8648648648648649,14,12,2,0.8571428571428571,0.8609865470852017,gemini,mimiciii,nursing_note,PROMPT1_ICL_entailment
189,44,9,9,0,1.0,3,3,0,1.0,1.0,gemini,mimiciii,nursing_note,PROMPT1_ICL_entailment
190,45,71,63,8,0.8873239436619719,34,32,2,0.9411764705882352,0.9134571816946082,gemini,mimiciii,nursing_note,PROMPT1_ICL_entailment
191,46,68,57,11,0.8382352941176471,33,26,7,0.7878787878787878,0.8122773362565087,gemini,mimiciii,nursing_note,PROMPT1_ICL_entailment
192,47,43,34,9,0.7906976744186046,14,12,2,0.8571428571428571,0.8225806451612903,gemini,mimiciii,nursing_note,PROMPT1_ICL_entailment
193,48,1,0,1,0.0,9,2,7,0.2222222222222222,0.0,gemini,mimiciii,nursing_note,PROMPT1_ICL_entailment
194,49,7,7,0,1.0,3,2,1,0.6666666666666666,0.8,gemini,mimiciii,nursing_note,PROMPT1_ICL_entailment
195,5,34,27,7,0.7941176470588235,15,13,2,0.8666666666666667,0.8288075560802834,gemini,mimiciii,nursing_note,PROMPT1_ICL_entailment
196,50,20,16,4,0.8,16,13,3,0.8125,0.8062015503875969,gemini,mimiciii,nursing_note,PROMPT1_ICL_entailment
197,51,14,13,1,0.9285714285714286,6,6,0,1.0,0.962962962962963,gemini,mimiciii,nursing_note,PROMPT1_ICL_entailment
198,52,42,29,13,0.6904761904761905,38,29,9,0.7631578947368421,0.725,gemini,mimiciii,nursing_note,PROMPT1_ICL_entailment
199,53,9,8,1,0.8888888888888888,6,6,0,1.0,0.9411764705882352,gemini,mimiciii,nursing_note,PROMPT1_ICL_entailment
200,54,54,28,26,0.5185185185185185,37,27,10,0.7297297297297297,0.6062550120288692,gemini,mimiciii,nursing_note,PROMPT1_ICL_entailment
201,55,58,46,12,0.7931034482758621,35,29,6,0.8285714285714286,0.81044957472661,gemini,mimiciii,nursing_note,PROMPT1_ICL_entailment
202,56,17,16,1,0.9411764705882352,2,2,0,1.0,0.9696969696969696,gemini,mimiciii,nursing_note,PROMPT1_ICL_entailment
203,57,67,60,7,0.8955223880597015,18,13,5,0.7222222222222222,0.7995899538698105,gemini,mimiciii,nursing_note,PROMPT1_ICL_entailment
204,58,47,37,10,0.7872340425531915,28,23,5,0.8214285714285714,0.8039678790741616,gemini,mimiciii,nursing_note,PROMPT1_ICL_entailment
205,59,15,14,1,0.9333333333333332,9,8,1,0.8888888888888888,0.9105691056910568,gemini,mimiciii,nursing_note,PROMPT1_ICL_entailment
206,6,17,16,1,0.9411764705882352,8,8,0,1.0,0.9696969696969696,gemini,mimiciii,nursing_note,PROMPT1_ICL_entailment
207,60,57,34,23,0.5964912280701754,27,24,3,0.8888888888888888,0.7139107611548556,gemini,mimiciii,nursing_note,PROMPT1_ICL_entailment
208,61,30,20,10,0.6666666666666666,20,19,1,0.95,0.7835051546391752,gemini,mimiciii,nursing_note,PROMPT1_ICL_entailment
209,62,50,38,12,0.76,37,31,6,0.8378378378378378,0.79702300405954,gemini,mimiciii,nursing_note,PROMPT1_ICL_entailment
210,63,8,8,0,1.0,5,5,0,1.0,1.0,gemini,mimiciii,nursing_note,PROMPT1_ICL_entailment
211,64,68,59,9,0.8676470588235294,27,25,2,0.925925925925926,0.8958396598846037,gemini,mimiciii,nursing_note,PROMPT1_ICL_entailment
212,65,26,23,3,0.8846153846153846,19,16,3,0.8421052631578947,0.8628370457209847,gemini,mimiciii,nursing_note,PROMPT1_ICL_entailment
213,66,13,12,1,0.9230769230769232,1,1,0,1.0,0.96,gemini,mimiciii,nursing_note,PROMPT1_ICL_entailment
214,67,11,10,1,0.9090909090909092,7,7,0,1.0,0.9523809523809524,gemini,mimiciii,nursing_note,PROMPT1_ICL_entailment
215,68,1,0,1,0.0,18,3,15,0.1666666666666666,0.0,gemini,mimiciii,nursing_note,PROMPT1_ICL_entailment
216,69,48,29,19,0.6041666666666666,25,19,6,0.76,0.6731826511912034,gemini,mimiciii,nursing_note,PROMPT1_ICL_entailment
217,7,5,5,0,1.0,2,2,0,1.0,1.0,gemini,mimiciii,nursing_note,PROMPT1_ICL_entailment
218,70,57,49,8,0.8596491228070176,45,33,12,0.7333333333333333,0.7914831130690161,gemini,mimiciii,nursing_note,PROMPT1_ICL_entailment
219,71,100,55,45,0.55,52,39,13,0.75,0.6346153846153847,gemini,mimiciii,nursing_note,PROMPT1_ICL_entailment
220,72,26,22,4,0.8461538461538461,12,9,3,0.75,0.7951807228915662,gemini,mimiciii,nursing_note,PROMPT1_ICL_entailment
221,73,47,32,15,0.6808510638297872,38,28,10,0.7368421052631579,0.7077409162717219,gemini,mimiciii,nursing_note,PROMPT1_ICL_entailment
222,74,16,15,1,0.9375,8,6,2,0.75,0.8333333333333334,gemini,mimiciii,nursing_note,PROMPT1_ICL_entailment
223,75,52,38,14,0.7307692307692307,27,21,6,0.7777777777777778,0.7535410764872521,gemini,mimiciii,nursing_note,PROMPT1_ICL_entailment
224,76,5,5,0,1.0,1,1,0,1.0,1.0,gemini,mimiciii,nursing_note,PROMPT1_ICL_entailment
225,77,77,37,40,0.4805194805194805,59,48,11,0.8135593220338984,0.6041843850995067,gemini,mimiciii,nursing_note,PROMPT1_ICL_entailment
226,78,59,30,29,0.5084745762711864,20,17,3,0.85,0.6363069245165314,gemini,mimiciii,nursing_note,PROMPT1_ICL_entailment
227,79,65,58,7,0.8923076923076924,30,27,3,0.9,0.8961373390557941,gemini,mimiciii,nursing_note,PROMPT1_ICL_entailment
228,8,15,15,0,1.0,14,10,4,0.7142857142857143,0.8333333333333333,gemini,mimiciii,nursing_note,PROMPT1_ICL_entailment
229,80,49,36,13,0.7346938775510204,22,22,0,1.0,0.8470588235294119,gemini,mimiciii,nursing_note,PROMPT1_ICL_entailment
230,81,33,28,5,0.8484848484848485,22,19,3,0.8636363636363636,0.8559935639581658,gemini,mimiciii,nursing_note,PROMPT1_ICL_entailment
231,82,43,38,5,0.8837209302325582,17,12,5,0.7058823529411765,0.7848537005163513,gemini,mimiciii,nursing_note,PROMPT1_ICL_entailment
232,83,24,21,3,0.875,34,17,17,0.5,0.6363636363636364,gemini,mimiciii,nursing_note,PROMPT1_ICL_entailment
233,84,14,14,0,1.0,6,6,0,1.0,1.0,gemini,mimiciii,nursing_note,PROMPT1_ICL_entailment
234,85,48,38,10,0.7916666666666666,27,19,8,0.7037037037037037,0.7450980392156864,gemini,mimiciii,nursing_note,PROMPT1_ICL_entailment
235,86,45,33,12,0.7333333333333333,40,29,11,0.725,0.7291428571428571,gemini,mimiciii,nursing_note,PROMPT1_ICL_entailment
236,87,19,14,5,0.7368421052631579,15,11,4,0.7333333333333333,0.7350835322195703,gemini,mimiciii,nursing_note,PROMPT1_ICL_entailment
237,88,42,31,11,0.7380952380952381,15,10,5,0.6666666666666666,0.7005649717514125,gemini,mimiciii,nursing_note,PROMPT1_ICL_entailment
238,89,46,30,16,0.6521739130434783,29,27,2,0.9310344827586208,0.7670454545454545,gemini,mimiciii,nursing_note,PROMPT1_ICL_entailment
239,9,56,47,9,0.8392857142857143,17,14,3,0.8235294117647058,0.8313329121920405,gemini,mimiciii,nursing_note,PROMPT1_ICL_entailment
240,90,33,26,7,0.7878787878787878,14,12,2,0.8571428571428571,0.8210526315789474,gemini,mimiciii,nursing_note,PROMPT1_ICL_entailment
241,91,32,22,10,0.6875,25,21,4,0.84,0.7561374795417349,gemini,mimiciii,nursing_note,PROMPT1_ICL_entailment
242,92,62,50,12,0.8064516129032258,28,22,6,0.7857142857142857,0.7959479015918958,gemini,mimiciii,nursing_note,PROMPT1_ICL_entailment
243,93,38,35,3,0.9210526315789472,23,22,1,0.9565217391304348,0.938452163315052,gemini,mimiciii,nursing_note,PROMPT1_ICL_entailment
244,94,8,8,0,1.0,5,5,0,1.0,1.0,gemini,mimiciii,nursing_note,PROMPT1_ICL_entailment
245,95,35,32,3,0.9142857142857144,14,13,1,0.9285714285714286,0.9213732004429678,gemini,mimiciii,nursing_note,PROMPT1_ICL_entailment
246,96,13,13,0,1.0,6,5,1,0.8333333333333334,0.9090909090909092,gemini,mimiciii,nursing_note,PROMPT1_ICL_entailment
247,97,16,16,0,1.0,10,10,0,1.0,1.0,gemini,mimiciii,nursing_note,PROMPT1_ICL_entailment
248,98,68,51,17,0.75,13,12,1,0.9230769230769232,0.8275862068965517,gemini,mimiciii,nursing_note,PROMPT1_ICL_entailment
249,99,62,50,12,0.8064516129032258,44,40,4,0.9090909090909092,0.8547008547008547,gemini,mimiciii,nursing_note,PROMPT1_ICL_entailment
0,0,24,15,9,0.625,11,11,0,1.0,0.7692307692307693,gemini,mimiciii,nursing_note,PROMPT2_ICL_entailment
1,1,57,20,37,0.3508771929824561,31,24,7,0.7741935483870968,0.4828973843058349,gemini,mimiciii,nursing_note,PROMPT2_ICL_entailment
2,10,29,21,8,0.7241379310344828,18,13,5,0.7222222222222222,0.7231788079470198,gemini,mimiciii,nursing_note,PROMPT2_ICL_entailment
3,100,16,15,1,0.9375,6,6,0,1.0,0.967741935483871,gemini,mimiciii,nursing_note,PROMPT2_ICL_entailment
4,101,53,43,10,0.8113207547169812,27,27,0,1.0,0.8958333333333334,gemini,mimiciii,nursing_note,PROMPT2_ICL_entailment
5,102,57,48,9,0.8421052631578947,26,23,3,0.8846153846153846,0.8628370457209847,gemini,mimiciii,nursing_note,PROMPT2_ICL_entailment
6,103,1,0,1,0.0,22,3,19,0.1363636363636363,0.0,gemini,mimiciii,nursing_note,PROMPT2_ICL_entailment
7,104,37,32,5,0.8648648648648649,20,20,0,1.0,0.927536231884058,gemini,mimiciii,nursing_note,PROMPT2_ICL_entailment
8,105,59,36,23,0.6101694915254238,20,18,2,0.9,0.7272727272727273,gemini,mimiciii,nursing_note,PROMPT2_ICL_entailment
9,106,9,9,0,1.0,4,3,1,0.75,0.8571428571428571,gemini,mimiciii,nursing_note,PROMPT2_ICL_entailment
10,107,76,64,12,0.8421052631578947,63,39,24,0.6190476190476191,0.7135506003430532,gemini,mimiciii,nursing_note,PROMPT2_ICL_entailment
11,108,72,57,15,0.7916666666666666,28,27,1,0.9642857142857144,0.8694915254237288,gemini,mimiciii,nursing_note,PROMPT2_ICL_entailment
12,109,7,7,0,1.0,4,4,0,1.0,1.0,gemini,mimiciii,nursing_note,PROMPT2_ICL_entailment
13,11,2,2,0,1.0,2,2,0,1.0,1.0,gemini,mimiciii,nursing_note,PROMPT2_ICL_entailment
14,110,23,22,1,0.9565217391304348,13,12,1,0.9230769230769232,0.9395017793594308,gemini,mimiciii,nursing_note,PROMPT2_ICL_entailment
15,111,55,42,13,0.7636363636363637,34,32,2,0.9411764705882352,0.8431618569636136,gemini,mimiciii,nursing_note,PROMPT2_ICL_entailment
16,112,1,0,1,0.0,37,6,31,0.1621621621621621,0.0,gemini,mimiciii,nursing_note,PROMPT2_ICL_entailment
17,113,8,7,1,0.875,5,4,1,0.8,0.8358208955223881,gemini,mimiciii,nursing_note,PROMPT2_ICL_entailment
18,114,24,15,9,0.625,19,15,4,0.7894736842105263,0.6976744186046512,gemini,mimiciii,nursing_note,PROMPT2_ICL_entailment
19,115,18,15,3,0.8333333333333334,7,5,2,0.7142857142857143,0.7692307692307692,gemini,mimiciii,nursing_note,PROMPT2_ICL_entailment
20,116,36,33,3,0.9166666666666666,31,30,1,0.967741935483871,0.94151212553495,gemini,mimiciii,nursing_note,PROMPT2_ICL_entailment
21,117,56,42,14,0.75,18,13,5,0.7222222222222222,0.7358490566037735,gemini,mimiciii,nursing_note,PROMPT2_ICL_entailment
22,118,50,25,25,0.5,25,17,8,0.68,0.576271186440678,gemini,mimiciii,nursing_note,PROMPT2_ICL_entailment
23,119,56,45,11,0.8035714285714286,26,23,3,0.8846153846153846,0.8421480878763222,gemini,mimiciii,nursing_note,PROMPT2_ICL_entailment
24,12,46,42,4,0.9130434782608696,18,16,2,0.8888888888888888,0.900804289544236,gemini,mimiciii,nursing_note,PROMPT2_ICL_entailment
25,120,28,19,9,0.6785714285714286,18,17,1,0.9444444444444444,0.7897310513447433,gemini,mimiciii,nursing_note,PROMPT2_ICL_entailment
26,121,65,56,9,0.8615384615384616,37,27,10,0.7297297297297297,0.7901750718578521,gemini,mimiciii,nursing_note,PROMPT2_ICL_entailment
27,122,39,31,8,0.7948717948717948,11,9,2,0.8181818181818182,0.8063583815028901,gemini,mimiciii,nursing_note,PROMPT2_ICL_entailment
28,123,10,10,0,1.0,6,6,0,1.0,1.0,gemini,mimiciii,nursing_note,PROMPT2_ICL_entailment
29,124,10,10,0,1.0,5,4,1,0.8,0.888888888888889,gemini,mimiciii,nursing_note,PROMPT2_ICL_entailment
30,125,50,45,5,0.9,43,35,8,0.813953488372093,0.8548168249660787,gemini,mimiciii,nursing_note,PROMPT2_ICL_entailment
31,126,47,28,19,0.5957446808510638,28,16,12,0.5714285714285714,0.5833333333333334,gemini,mimiciii,nursing_note,PROMPT2_ICL_entailment
32,127,29,23,6,0.7931034482758621,10,9,1,0.9,0.8431771894093688,gemini,mimiciii,nursing_note,PROMPT2_ICL_entailment
33,128,44,33,11,0.75,17,17,0,1.0,0.8571428571428571,gemini,mimiciii,nursing_note,PROMPT2_ICL_entailment
34,129,47,32,15,0.6808510638297872,29,24,5,0.8275862068965517,0.7470817120622568,gemini,mimiciii,nursing_note,PROMPT2_ICL_entailment
35,13,71,64,7,0.9014084507042254,34,31,3,0.9117647058823528,0.9065570025131368,gemini,mimiciii,nursing_note,PROMPT2_ICL_entailment
36,130,72,49,23,0.6805555555555556,33,29,4,0.8787878787878788,0.7670715249662619,gemini,mimiciii,nursing_note,PROMPT2_ICL_entailment
37,131,58,48,10,0.8275862068965517,31,25,6,0.8064516129032258,0.8168822328114362,gemini,mimiciii,nursing_note,PROMPT2_ICL_entailment
38,132,49,33,16,0.673469387755102,17,14,3,0.8235294117647058,0.7409783480352846,gemini,mimiciii,nursing_note,PROMPT2_ICL_entailment
39,133,1,0,1,0.0,10,1,9,0.1,0.0,gemini,mimiciii,nursing_note,PROMPT2_ICL_entailment
40,134,60,24,36,0.4,30,24,6,0.8,0.5333333333333333,gemini,mimiciii,nursing_note,PROMPT2_ICL_entailment
41,135,107,76,31,0.7102803738317757,47,40,7,0.851063829787234,0.7743250127356087,gemini,mimiciii,nursing_note,PROMPT2_ICL_entailment
42,136,1,0,1,0.0,41,3,38,0.073170731707317,0.0,gemini,mimiciii,nursing_note,PROMPT2_ICL_entailment
43,137,5,5,0,1.0,2,1,1,0.5,0.6666666666666666,gemini,mimiciii,nursing_note,PROMPT2_ICL_entailment
44,138,8,8,0,1.0,5,4,1,0.8,0.888888888888889,gemini,mimiciii,nursing_note,PROMPT2_ICL_entailment
45,139,12,11,1,0.9166666666666666,4,3,1,0.75,0.8250000000000001,gemini,mimiciii,nursing_note,PROMPT2_ICL_entailment
46,14,49,45,4,0.9183673469387756,26,22,4,0.8461538461538461,0.8807829181494662,gemini,mimiciii,nursing_note,PROMPT2_ICL_entailment
47,140,57,31,26,0.543859649122807,24,22,2,0.9166666666666666,0.6826826826826827,gemini,mimiciii,nursing_note,PROMPT2_ICL_entailment
48,141,25,21,4,0.84,11,10,1,0.9090909090909092,0.8731808731808731,gemini,mimiciii,nursing_note,PROMPT2_ICL_entailment
49,142,69,51,18,0.7391304347826086,8,7,1,0.875,0.8013468013468014,gemini,mimiciii,nursing_note,PROMPT2_ICL_entailment
50,143,22,21,1,0.9545454545454546,2,1,1,0.5,0.65625,gemini,mimiciii,nursing_note,PROMPT2_ICL_entailment
51,144,13,12,1,0.9230769230769232,5,4,1,0.8,0.8571428571428571,gemini,mimiciii,nursing_note,PROMPT2_ICL_entailment
52,145,65,43,22,0.6615384615384615,19,16,3,0.8421052631578947,0.7409800753904147,gemini,mimiciii,nursing_note,PROMPT2_ICL_entailment
53,146,11,10,1,0.9090909090909092,6,5,1,0.8333333333333334,0.8695652173913043,gemini,mimiciii,nursing_note,PROMPT2_ICL_entailment
54,147,46,28,18,0.6086956521739131,26,21,5,0.8076923076923077,0.6942148760330579,gemini,mimiciii,nursing_note,PROMPT2_ICL_entailment
55,148,23,20,3,0.8695652173913043,7,7,0,1.0,0.9302325581395348,gemini,mimiciii,nursing_note,PROMPT2_ICL_entailment
56,149,59,47,12,0.7966101694915254,36,28,8,0.7777777777777778,0.7870813397129187,gemini,mimiciii,nursing_note,PROMPT2_ICL_entailment
57,15,35,26,9,0.7428571428571429,33,28,5,0.8484848484848485,0.7921653971708379,gemini,mimiciii,nursing_note,PROMPT2_ICL_entailment
58,150,18,17,1,0.9444444444444444,8,6,2,0.75,0.8360655737704917,gemini,mimiciii,nursing_note,PROMPT2_ICL_entailment
59,151,51,40,11,0.7843137254901961,26,24,2,0.9230769230769232,0.8480565371024734,gemini,mimiciii,nursing_note,PROMPT2_ICL_entailment
60,152,69,56,13,0.8115942028985508,44,34,10,0.7727272727272727,0.7916839916839916,gemini,mimiciii,nursing_note,PROMPT2_ICL_entailment
61,153,9,9,0,1.0,4,4,0,1.0,1.0,gemini,mimiciii,nursing_note,PROMPT2_ICL_entailment
62,154,51,38,13,0.7450980392156863,34,26,8,0.7647058823529411,0.7547746371275782,gemini,mimiciii,nursing_note,PROMPT2_ICL_entailment
63,155,83,61,22,0.7349397590361446,51,43,8,0.8431372549019608,0.7853293413173654,gemini,mimiciii,nursing_note,PROMPT2_ICL_entailment
64,156,27,22,5,0.8148148148148148,26,20,6,0.7692307692307693,0.7913669064748201,gemini,mimiciii,nursing_note,PROMPT2_ICL_entailment
65,157,9,9,0,1.0,5,5,0,1.0,1.0,gemini,mimiciii,nursing_note,PROMPT2_ICL_entailment
66,158,49,44,5,0.8979591836734694,22,20,2,0.9090909090909092,0.9034907597535936,gemini,mimiciii,nursing_note,PROMPT2_ICL_entailment
67,159,19,14,5,0.7368421052631579,8,8,0,1.0,0.8484848484848484,gemini,mimiciii,nursing_note,PROMPT2_ICL_entailment
68,16,56,44,12,0.7857142857142857,30,24,6,0.8,0.7927927927927927,gemini,mimiciii,nursing_note,PROMPT2_ICL_entailment
69,160,55,49,6,0.8909090909090909,21,19,2,0.9047619047619048,0.8977820636451301,gemini,mimiciii,nursing_note,PROMPT2_ICL_entailment
70,161,8,6,2,0.75,6,5,1,0.8333333333333334,0.7894736842105262,gemini,mimiciii,nursing_note,PROMPT2_ICL_entailment
71,162,49,39,10,0.7959183673469388,31,24,7,0.7741935483870968,0.7849056603773585,gemini,mimiciii,nursing_note,PROMPT2_ICL_entailment
72,163,15,14,1,0.9333333333333332,4,4,0,1.0,0.9655172413793104,gemini,mimiciii,nursing_note,PROMPT2_ICL_entailment
73,164,28,25,3,0.8928571428571429,13,11,2,0.8461538461538461,0.8688783570300157,gemini,mimiciii,nursing_note,PROMPT2_ICL_entailment
74,165,78,52,26,0.6666666666666666,24,18,6,0.75,0.7058823529411765,gemini,mimiciii,nursing_note,PROMPT2_ICL_entailment
75,166,16,16,0,1.0,3,3,0,1.0,1.0,gemini,mimiciii,nursing_note,PROMPT2_ICL_entailment
76,167,53,44,9,0.8301886792452831,16,15,1,0.9375,0.8805870580386924,gemini,mimiciii,nursing_note,PROMPT2_ICL_entailment
77,168,43,20,23,0.4651162790697674,25,21,4,0.84,0.5987170349251604,gemini,mimiciii,nursing_note,PROMPT2_ICL_entailment
78,169,30,25,5,0.8333333333333334,12,12,0,1.0,0.9090909090909092,gemini,mimiciii,nursing_note,PROMPT2_ICL_entailment
79,17,48,40,8,0.8333333333333334,39,29,10,0.7435897435897436,0.7859078590785907,gemini,mimiciii,nursing_note,PROMPT2_ICL_entailment
80,170,69,45,24,0.6521739130434783,21,18,3,0.8571428571428571,0.7407407407407407,gemini,mimiciii,nursing_note,PROMPT2_ICL_entailment
81,171,12,12,0,1.0,8,7,1,0.875,0.9333333333333332,gemini,mimiciii,nursing_note,PROMPT2_ICL_entailment
82,172,64,58,6,0.90625,38,33,5,0.868421052631579,0.8869323447636701,gemini,mimiciii,nursing_note,PROMPT2_ICL_entailment
83,173,45,40,5,0.8888888888888888,20,13,7,0.65,0.7509025270758123,gemini,mimiciii,nursing_note,PROMPT2_ICL_entailment
84,174,13,12,1,0.9230769230769232,8,7,1,0.875,0.8983957219251337,gemini,mimiciii,nursing_note,PROMPT2_ICL_entailment
85,175,6,3,3,0.5,4,4,0,1.0,0.6666666666666666,gemini,mimiciii,nursing_note,PROMPT2_ICL_entailment
86,176,32,25,7,0.78125,13,12,1,0.9230769230769232,0.846262341325811,gemini,mimiciii,nursing_note,PROMPT2_ICL_entailment
87,177,79,60,19,0.759493670886076,38,33,5,0.868421052631579,0.8103130755064457,gemini,mimiciii,nursing_note,PROMPT2_ICL_entailment
88,178,54,52,2,0.9629629629629628,25,21,4,0.84,0.8972884141331141,gemini,mimiciii,nursing_note,PROMPT2_ICL_entailment
89,179,45,36,9,0.8,22,16,6,0.7272727272727273,0.761904761904762,gemini,mimiciii,nursing_note,PROMPT2_ICL_entailment
90,18,54,42,12,0.7777777777777778,25,21,4,0.84,0.8076923076923077,gemini,mimiciii,nursing_note,PROMPT2_ICL_entailment
91,180,53,43,10,0.8113207547169812,27,25,2,0.925925925925926,0.8648431214802896,gemini,mimiciii,nursing_note,PROMPT2_ICL_entailment
92,181,40,27,13,0.675,25,24,1,0.96,0.7926605504587156,gemini,mimiciii,nursing_note,PROMPT2_ICL_entailment
93,182,39,31,8,0.7948717948717948,10,8,2,0.8,0.7974276527331189,gemini,mimiciii,nursing_note,PROMPT2_ICL_entailment
94,183,9,9,0,1.0,5,4,1,0.8,0.888888888888889,gemini,mimiciii,nursing_note,PROMPT2_ICL_entailment
95,184,19,19,0,1.0,1,1,0,1.0,1.0,gemini,mimiciii,nursing_note,PROMPT2_ICL_entailment
96,185,40,34,6,0.85,30,27,3,0.9,0.8742857142857143,gemini,mimiciii,nursing_note,PROMPT2_ICL_entailment
97,186,5,5,0,1.0,4,3,1,0.75,0.8571428571428571,gemini,mimiciii,nursing_note,PROMPT2_ICL_entailment
98,187,57,50,7,0.8771929824561403,37,31,6,0.8378378378378378,0.8570638650815592,gemini,mimiciii,nursing_note,PROMPT2_ICL_entailment
99,188,5,5,0,1.0,2,1,1,0.5,0.6666666666666666,gemini,mimiciii,nursing_note,PROMPT2_ICL_entailment
100,189,52,46,6,0.8846153846153846,21,19,2,0.9047619047619048,0.8945752302968271,gemini,mimiciii,nursing_note,PROMPT2_ICL_entailment
101,19,78,59,19,0.7564102564102564,45,38,7,0.8444444444444444,0.798006762769176,gemini,mimiciii,nursing_note,PROMPT2_ICL_entailment
102,190,55,51,4,0.9272727272727272,24,19,5,0.7916666666666666,0.8541207580431909,gemini,mimiciii,nursing_note,PROMPT2_ICL_entailment
103,191,49,41,8,0.8367346938775511,29,21,8,0.7241379310344828,0.7763751127141568,gemini,mimiciii,nursing_note,PROMPT2_ICL_entailment
104,192,23,20,3,0.8695652173913043,15,13,2,0.8666666666666667,0.8681135225375627,gemini,mimiciii,nursing_note,PROMPT2_ICL_entailment
105,193,73,54,19,0.7397260273972602,40,32,8,0.8,0.7686832740213523,gemini,mimiciii,nursing_note,PROMPT2_ICL_entailment
106,194,22,22,0,1.0,13,11,2,0.8461538461538461,0.9166666666666666,gemini,mimiciii,nursing_note,PROMPT2_ICL_entailment
107,195,12,12,0,1.0,7,7,0,1.0,1.0,gemini,mimiciii,nursing_note,PROMPT2_ICL_entailment
108,196,60,48,12,0.8,34,28,6,0.8235294117647058,0.8115942028985507,gemini,mimiciii,nursing_note,PROMPT2_ICL_entailment
109,197,71,53,18,0.7464788732394366,27,25,2,0.925925925925926,0.8265751715533376,gemini,mimiciii,nursing_note,PROMPT2_ICL_entailment
110,198,77,64,13,0.8311688311688312,38,33,5,0.868421052631579,0.8493866881158255,gemini,mimiciii,nursing_note,PROMPT2_ICL_entailment
111,199,23,19,4,0.8260869565217391,14,12,2,0.8571428571428571,0.8413284132841329,gemini,mimiciii,nursing_note,PROMPT2_ICL_entailment
112,2,85,48,37,0.5647058823529412,43,40,3,0.9302325581395348,0.7027818448023425,gemini,mimiciii,nursing_note,PROMPT2_ICL_entailment
113,20,1,0,1,0.0,46,8,38,0.1739130434782608,0.0,gemini,mimiciii,nursing_note,PROMPT2_ICL_entailment
114,200,57,42,15,0.7368421052631579,44,36,8,0.8181818181818182,0.7753846153846154,gemini,mimiciii,nursing_note,PROMPT2_ICL_entailment
115,201,46,44,2,0.9565217391304348,29,21,8,0.7241379310344828,0.8242640499553969,gemini,mimiciii,nursing_note,PROMPT2_ICL_entailment
116,202,14,11,3,0.7857142857142857,9,7,2,0.7777777777777778,0.7817258883248731,gemini,mimiciii,nursing_note,PROMPT2_ICL_entailment
117,203,15,15,0,1.0,7,6,1,0.8571428571428571,0.923076923076923,gemini,mimiciii,nursing_note,PROMPT2_ICL_entailment
118,204,59,42,17,0.711864406779661,24,15,9,0.625,0.6656101426307449,gemini,mimiciii,nursing_note,PROMPT2_ICL_entailment
119,205,66,62,4,0.9393939393939394,69,61,8,0.8840579710144928,0.9108863198458576,gemini,mimiciii,nursing_note,PROMPT2_ICL_entailment
120,206,11,11,0,1.0,6,5,1,0.8333333333333334,0.9090909090909092,gemini,mimiciii,nursing_note,PROMPT2_ICL_entailment
121,207,80,67,13,0.8375,29,26,3,0.896551724137931,0.8660203827989065,gemini,mimiciii,nursing_note,PROMPT2_ICL_entailment
122,208,19,19,0,1.0,7,7,0,1.0,1.0,gemini,mimiciii,nursing_note,PROMPT2_ICL_entailment
123,209,5,5,0,1.0,2,2,0,1.0,1.0,gemini,mimiciii,nursing_note,PROMPT2_ICL_entailment
124,21,12,11,1,0.9166666666666666,6,5,1,0.8333333333333334,0.8730158730158729,gemini,mimiciii,nursing_note,PROMPT2_ICL_entailment
125,210,31,23,8,0.7419354838709677,22,19,3,0.8636363636363636,0.7981735159817351,gemini,mimiciii,nursing_note,PROMPT2_ICL_entailment
126,211,11,11,0,1.0,4,4,0,1.0,1.0,gemini,mimiciii,nursing_note,PROMPT2_ICL_entailment
127,212,63,49,14,0.7777777777777778,37,34,3,0.918918918918919,0.8424778761061947,gemini,mimiciii,nursing_note,PROMPT2_ICL_entailment
128,213,37,29,8,0.7837837837837838,18,17,1,0.9444444444444444,0.8566463944396177,gemini,mimiciii,nursing_note,PROMPT2_ICL_entailment
129,214,18,16,2,0.8888888888888888,3,3,0,1.0,0.9411764705882352,gemini,mimiciii,nursing_note,PROMPT2_ICL_entailment
130,215,13,12,1,0.9230769230769232,7,6,1,0.8571428571428571,0.888888888888889,gemini,mimiciii,nursing_note,PROMPT2_ICL_entailment
131,216,29,20,9,0.6896551724137931,13,9,4,0.6923076923076923,0.6909788867562381,gemini,mimiciii,nursing_note,PROMPT2_ICL_entailment
132,217,70,50,20,0.7142857142857143,25,23,2,0.92,0.8041958041958042,gemini,mimiciii,nursing_note,PROMPT2_ICL_entailment
133,218,29,28,1,0.9655172413793104,18,15,3,0.8333333333333334,0.8945686900958466,gemini,mimiciii,nursing_note,PROMPT2_ICL_entailment
134,219,39,27,12,0.6923076923076923,14,12,2,0.8571428571428571,0.7659574468085107,gemini,mimiciii,nursing_note,PROMPT2_ICL_entailment
135,22,60,48,12,0.8,26,25,1,0.9615384615384616,0.8733624454148472,gemini,mimiciii,nursing_note,PROMPT2_ICL_entailment
136,220,19,17,2,0.8947368421052632,5,4,1,0.8,0.84472049689441,gemini,mimiciii,nursing_note,PROMPT2_ICL_entailment
137,221,49,28,21,0.5714285714285714,45,32,13,0.7111111111111111,0.6336633663366337,gemini,mimiciii,nursing_note,PROMPT2_ICL_entailment
138,222,7,6,1,0.8571428571428571,3,3,0,1.0,0.923076923076923,gemini,mimiciii,nursing_note,PROMPT2_ICL_entailment
139,223,53,23,30,0.4339622641509434,30,27,3,0.9,0.5855728429985856,gemini,mimiciii,nursing_note,PROMPT2_ICL_entailment
140,224,9,8,1,0.8888888888888888,6,6,0,1.0,0.9411764705882352,gemini,mimiciii,nursing_note,PROMPT2_ICL_entailment
141,225,91,50,41,0.5494505494505495,45,41,4,0.9111111111111112,0.6855040963049657,gemini,mimiciii,nursing_note,PROMPT2_ICL_entailment
142,226,57,56,1,0.9824561403508772,20,18,2,0.9,0.9394221808014912,gemini,mimiciii,nursing_note,PROMPT2_ICL_entailment
143,227,25,21,4,0.84,15,15,0,1.0,0.9130434782608696,gemini,mimiciii,nursing_note,PROMPT2_ICL_entailment
144,228,65,42,23,0.6461538461538462,38,33,5,0.868421052631579,0.7409783480352846,gemini,mimiciii,nursing_note,PROMPT2_ICL_entailment
145,229,49,41,8,0.8367346938775511,22,18,4,0.8181818181818182,0.8273542600896862,gemini,mimiciii,nursing_note,PROMPT2_ICL_entailment
146,23,72,61,11,0.8472222222222222,44,41,3,0.9318181818181818,0.8875088715400993,gemini,mimiciii,nursing_note,PROMPT2_ICL_entailment
147,230,22,21,1,0.9545454545454546,7,6,1,0.8571428571428571,0.9032258064516128,gemini,mimiciii,nursing_note,PROMPT2_ICL_entailment
148,231,69,62,7,0.8985507246376812,15,12,3,0.8,0.8464163822525597,gemini,mimiciii,nursing_note,PROMPT2_ICL_entailment
149,232,11,9,2,0.8181818181818182,2,2,0,1.0,0.9,gemini,mimiciii,nursing_note,PROMPT2_ICL_entailment
150,233,54,29,25,0.5370370370370371,44,27,17,0.6136363636363636,0.5727871250914411,gemini,mimiciii,nursing_note,PROMPT2_ICL_entailment
151,234,53,50,3,0.9433962264150944,32,25,7,0.78125,0.8547008547008547,gemini,mimiciii,nursing_note,PROMPT2_ICL_entailment
152,235,30,29,1,0.9666666666666668,10,10,0,1.0,0.983050847457627,gemini,mimiciii,nursing_note,PROMPT2_ICL_entailment
153,236,22,17,5,0.7727272727272727,7,6,1,0.8571428571428571,0.8127490039840638,gemini,mimiciii,nursing_note,PROMPT2_ICL_entailment
154,237,53,49,4,0.9245283018867924,35,21,14,0.6,0.7277227722772277,gemini,mimiciii,nursing_note,PROMPT2_ICL_entailment
155,238,94,66,28,0.7021276595744681,42,37,5,0.8809523809523809,0.78144,gemini,mimiciii,nursing_note,PROMPT2_ICL_entailment
156,239,58,43,15,0.7413793103448276,21,18,3,0.8571428571428571,0.7950693374422189,gemini,mimiciii,nursing_note,PROMPT2_ICL_entailment
157,24,13,13,0,1.0,5,5,0,1.0,1.0,gemini,mimiciii,nursing_note,PROMPT2_ICL_entailment
158,240,52,43,9,0.8269230769230769,42,27,15,0.6428571428571429,0.7233644859813083,gemini,mimiciii,nursing_note,PROMPT2_ICL_entailment
159,241,40,29,11,0.725,21,21,0,1.0,0.8405797101449275,gemini,mimiciii,nursing_note,PROMPT2_ICL_entailment
160,242,54,28,26,0.5185185185185185,16,12,4,0.75,0.6131386861313868,gemini,mimiciii,nursing_note,PROMPT2_ICL_entailment
161,243,12,12,0,1.0,5,4,1,0.8,0.888888888888889,gemini,mimiciii,nursing_note,PROMPT2_ICL_entailment
162,244,66,45,21,0.6818181818181818,16,14,2,0.875,0.7664233576642336,gemini,mimiciii,nursing_note,PROMPT2_ICL_entailment
163,245,59,40,19,0.6779661016949152,37,28,9,0.7567567567567568,0.7151979565772668,gemini,mimiciii,nursing_note,PROMPT2_ICL_entailment
164,246,44,38,6,0.8636363636363636,10,8,2,0.8,0.8306010928961749,gemini,mimiciii,nursing_note,PROMPT2_ICL_entailment
165,247,9,9,0,1.0,6,4,2,0.6666666666666666,0.8,gemini,mimiciii,nursing_note,PROMPT2_ICL_entailment
166,248,49,43,6,0.8775510204081632,42,37,5,0.8809523809523809,0.8792484111633049,gemini,mimiciii,nursing_note,PROMPT2_ICL_entailment
167,249,61,36,25,0.5901639344262295,39,33,6,0.8461538461538461,0.6953467954345918,gemini,mimiciii,nursing_note,PROMPT2_ICL_entailment
168,25,65,35,30,0.5384615384615384,23,19,4,0.8260869565217391,0.6519607843137255,gemini,mimiciii,nursing_note,PROMPT2_ICL_entailment
169,26,68,54,14,0.7941176470588235,35,29,6,0.8285714285714286,0.8109787674779907,gemini,mimiciii,nursing_note,PROMPT2_ICL_entailment
170,27,9,8,1,0.8888888888888888,3,2,1,0.6666666666666666,0.761904761904762,gemini,mimiciii,nursing_note,PROMPT2_ICL_entailment
171,28,64,50,14,0.78125,16,14,2,0.875,0.8254716981132075,gemini,mimiciii,nursing_note,PROMPT2_ICL_entailment
172,29,47,38,9,0.8085106382978723,33,24,9,0.7272727272727273,0.765743073047859,gemini,mimiciii,nursing_note,PROMPT2_ICL_entailment
173,3,12,8,4,0.6666666666666666,6,5,1,0.8333333333333334,0.7407407407407408,gemini,mimiciii,nursing_note,PROMPT2_ICL_entailment
174,30,18,17,1,0.9444444444444444,17,14,3,0.8235294117647058,0.8798521256931607,gemini,mimiciii,nursing_note,PROMPT2_ICL_entailment
175,31,36,27,9,0.75,19,16,3,0.8421052631578947,0.7933884297520661,gemini,mimiciii,nursing_note,PROMPT2_ICL_entailment
176,32,83,76,7,0.9156626506024096,44,43,1,0.9772727272727272,0.945465065818024,gemini,mimiciii,nursing_note,PROMPT2_ICL_entailment
177,33,11,11,0,1.0,5,5,0,1.0,1.0,gemini,mimiciii,nursing_note,PROMPT2_ICL_entailment
178,34,7,6,1,0.8571428571428571,3,3,0,1.0,0.923076923076923,gemini,mimiciii,nursing_note,PROMPT2_ICL_entailment
179,35,18,18,0,1.0,7,7,0,1.0,1.0,gemini,mimiciii,nursing_note,PROMPT2_ICL_entailment
180,36,111,88,23,0.7927927927927928,62,58,4,0.935483870967742,0.8582478560618799,gemini,mimiciii,nursing_note,PROMPT2_ICL_entailment
181,37,56,22,34,0.3928571428571428,38,25,13,0.6578947368421053,0.4919499105545618,gemini,mimiciii,nursing_note,PROMPT2_ICL_entailment
182,38,53,33,20,0.6226415094339622,26,18,8,0.6923076923076923,0.6556291390728477,gemini,mimiciii,nursing_note,PROMPT2_ICL_entailment
183,39,28,21,7,0.75,3,3,0,1.0,0.8571428571428571,gemini,mimiciii,nursing_note,PROMPT2_ICL_entailment
184,4,54,35,19,0.6481481481481481,26,22,4,0.8461538461538461,0.7340324118207817,gemini,mimiciii,nursing_note,PROMPT2_ICL_entailment
185,40,12,10,2,0.8333333333333334,3,3,0,1.0,0.9090909090909092,gemini,mimiciii,nursing_note,PROMPT2_ICL_entailment
186,41,100,89,11,0.89,50,39,11,0.78,0.8313772455089821,gemini,mimiciii,nursing_note,PROMPT2_ICL_entailment
187,42,57,36,21,0.631578947368421,7,6,1,0.8571428571428571,0.7272727272727273,gemini,mimiciii,nursing_note,PROMPT2_ICL_entailment
188,43,42,31,11,0.7380952380952381,14,12,2,0.8571428571428571,0.7931769722814499,gemini,mimiciii,nursing_note,PROMPT2_ICL_entailment
189,44,12,11,1,0.9166666666666666,3,3,0,1.0,0.9565217391304348,gemini,mimiciii,nursing_note,PROMPT2_ICL_entailment
190,45,67,59,8,0.8805970149253731,34,31,3,0.9117647058823528,0.8959098701934852,gemini,mimiciii,nursing_note,PROMPT2_ICL_entailment
191,46,70,61,9,0.8714285714285714,33,24,9,0.7272727272727273,0.7928513403736799,gemini,mimiciii,nursing_note,PROMPT2_ICL_entailment
192,47,52,33,19,0.6346153846153846,14,8,6,0.5714285714285714,0.6013667425968109,gemini,mimiciii,nursing_note,PROMPT2_ICL_entailment
193,48,29,18,11,0.6206896551724138,9,9,0,1.0,0.7659574468085107,gemini,mimiciii,nursing_note,PROMPT2_ICL_entailment
194,49,8,7,1,0.875,3,2,1,0.6666666666666666,0.7567567567567567,gemini,mimiciii,nursing_note,PROMPT2_ICL_entailment
195,5,39,36,3,0.9230769230769232,15,8,7,0.5333333333333333,0.676056338028169,gemini,mimiciii,nursing_note,PROMPT2_ICL_entailment
196,50,31,25,6,0.8064516129032258,16,12,4,0.75,0.77720207253886,gemini,mimiciii,nursing_note,PROMPT2_ICL_entailment
197,51,12,12,0,1.0,6,6,0,1.0,1.0,gemini,mimiciii,nursing_note,PROMPT2_ICL_entailment
198,52,43,25,18,0.5813953488372093,38,32,6,0.8421052631578947,0.6878761822871883,gemini,mimiciii,nursing_note,PROMPT2_ICL_entailment
199,53,11,11,0,1.0,6,5,1,0.8333333333333334,0.9090909090909092,gemini,mimiciii,nursing_note,PROMPT2_ICL_entailment
200,54,73,43,30,0.589041095890411,37,25,12,0.6756756756756757,0.6293911007025762,gemini,mimiciii,nursing_note,PROMPT2_ICL_entailment
201,55,64,53,11,0.828125,35,26,9,0.7428571428571429,0.7831770389315147,gemini,mimiciii,nursing_note,PROMPT2_ICL_entailment
202,56,17,15,2,0.8823529411764706,2,2,0,1.0,0.9375,gemini,mimiciii,nursing_note,PROMPT2_ICL_entailment
203,57,1,0,1,0.0,18,2,16,0.1111111111111111,0.0,gemini,mimiciii,nursing_note,PROMPT2_ICL_entailment
204,58,78,56,22,0.717948717948718,28,22,6,0.7857142857142857,0.7503045066991474,gemini,mimiciii,nursing_note,PROMPT2_ICL_entailment
205,59,15,14,1,0.9333333333333332,9,6,3,0.6666666666666666,0.7777777777777778,gemini,mimiciii,nursing_note,PROMPT2_ICL_entailment
206,6,17,17,0,1.0,8,7,1,0.875,0.9333333333333332,gemini,mimiciii,nursing_note,PROMPT2_ICL_entailment
207,60,56,38,18,0.6785714285714286,27,21,6,0.7777777777777778,0.7247956403269754,gemini,mimiciii,nursing_note,PROMPT2_ICL_entailment
208,61,47,27,20,0.574468085106383,20,17,3,0.85,0.6855862584017924,gemini,mimiciii,nursing_note,PROMPT2_ICL_entailment
209,62,1,1,0,1.0,37,7,30,0.1891891891891892,0.3181818181818182,gemini,mimiciii,nursing_note,PROMPT2_ICL_entailment
210,63,10,10,0,1.0,5,5,0,1.0,1.0,gemini,mimiciii,nursing_note,PROMPT2_ICL_entailment
211,64,76,69,7,0.9078947368421052,27,26,1,0.9629629629629628,0.9346183902057827,gemini,mimiciii,nursing_note,PROMPT2_ICL_entailment
212,65,1,0,1,0.0,19,3,16,0.1578947368421052,0.0,gemini,mimiciii,nursing_note,PROMPT2_ICL_entailment
213,66,16,15,1,0.9375,1,1,0,1.0,0.967741935483871,gemini,mimiciii,nursing_note,PROMPT2_ICL_entailment
214,67,18,17,1,0.9444444444444444,7,7,0,1.0,0.9714285714285714,gemini,mimiciii,nursing_note,PROMPT2_ICL_entailment
215,68,52,36,16,0.6923076923076923,18,14,4,0.7777777777777778,0.7325581395348836,gemini,mimiciii,nursing_note,PROMPT2_ICL_entailment
216,69,48,26,22,0.5416666666666666,25,23,2,0.92,0.6818700114025085,gemini,mimiciii,nursing_note,PROMPT2_ICL_entailment
217,7,6,6,0,1.0,2,2,0,1.0,1.0,gemini,mimiciii,nursing_note,PROMPT2_ICL_entailment
218,70,56,42,14,0.75,45,34,11,0.7555555555555555,0.7527675276752768,gemini,mimiciii,nursing_note,PROMPT2_ICL_entailment
219,71,82,44,38,0.5365853658536586,52,40,12,0.7692307692307693,0.6321839080459771,gemini,mimiciii,nursing_note,PROMPT2_ICL_entailment
220,72,30,27,3,0.9,12,10,2,0.8333333333333334,0.8653846153846153,gemini,mimiciii,nursing_note,PROMPT2_ICL_entailment
221,73,46,31,15,0.6739130434782609,38,32,6,0.8421052631578947,0.7486792452830189,gemini,mimiciii,nursing_note,PROMPT2_ICL_entailment
222,74,14,11,3,0.7857142857142857,8,6,2,0.75,0.7674418604651163,gemini,mimiciii,nursing_note,PROMPT2_ICL_entailment
223,75,85,59,26,0.6941176470588235,27,25,2,0.925925925925926,0.7934373318988704,gemini,mimiciii,nursing_note,PROMPT2_ICL_entailment
224,76,4,4,0,1.0,1,1,0,1.0,1.0,gemini,mimiciii,nursing_note,PROMPT2_ICL_entailment
225,77,105,50,55,0.4761904761904761,59,50,9,0.847457627118644,0.6097560975609755,gemini,mimiciii,nursing_note,PROMPT2_ICL_entailment
226,78,71,42,29,0.5915492957746479,20,17,3,0.85,0.6976062530532486,gemini,mimiciii,nursing_note,PROMPT2_ICL_entailment
227,79,66,56,10,0.8484848484848485,30,25,5,0.8333333333333334,0.8408408408408408,gemini,mimiciii,nursing_note,PROMPT2_ICL_entailment
228,8,12,11,1,0.9166666666666666,14,9,5,0.6428571428571429,0.7557251908396947,gemini,mimiciii,nursing_note,PROMPT2_ICL_entailment
229,80,55,39,16,0.7090909090909091,22,22,0,1.0,0.8297872340425533,gemini,mimiciii,nursing_note,PROMPT2_ICL_entailment
230,81,40,26,14,0.65,22,18,4,0.8181818181818182,0.7244582043343654,gemini,mimiciii,nursing_note,PROMPT2_ICL_entailment
231,82,51,41,10,0.803921568627451,17,13,4,0.7647058823529411,0.7838235294117647,gemini,mimiciii,nursing_note,PROMPT2_ICL_entailment
232,83,27,22,5,0.8148148148148148,34,22,12,0.6470588235294118,0.7213114754098361,gemini,mimiciii,nursing_note,PROMPT2_ICL_entailment
233,84,18,17,1,0.9444444444444444,6,5,1,0.8333333333333334,0.8854166666666667,gemini,mimiciii,nursing_note,PROMPT2_ICL_entailment
234,85,57,43,14,0.7543859649122807,27,18,9,0.6666666666666666,0.7078189300411523,gemini,mimiciii,nursing_note,PROMPT2_ICL_entailment
235,86,66,52,14,0.7878787878787878,40,33,7,0.825,0.806012212306247,gemini,mimiciii,nursing_note,PROMPT2_ICL_entailment
236,87,1,1,0,1.0,15,0,15,0.0,0.0,gemini,mimiciii,nursing_note,PROMPT2_ICL_entailment
237,88,52,42,10,0.8076923076923077,15,14,1,0.9333333333333332,0.8659793814432989,gemini,mimiciii,nursing_note,PROMPT2_ICL_entailment
238,89,52,32,20,0.6153846153846154,29,24,5,0.8275862068965517,0.7058823529411765,gemini,mimiciii,nursing_note,PROMPT2_ICL_entailment
239,9,68,55,13,0.8088235294117647,17,15,2,0.8823529411764706,0.8439897698209718,gemini,mimiciii,nursing_note,PROMPT2_ICL_entailment
240,90,39,23,16,0.5897435897435898,14,12,2,0.8571428571428571,0.6987341772151898,gemini,mimiciii,nursing_note,PROMPT2_ICL_entailment
241,91,40,20,20,0.5,25,20,5,0.8,0.6153846153846154,gemini,mimiciii,nursing_note,PROMPT2_ICL_entailment
242,92,55,44,11,0.8,28,27,1,0.9642857142857144,0.8744939271255061,gemini,mimiciii,nursing_note,PROMPT2_ICL_entailment
243,93,53,42,11,0.7924528301886793,23,20,3,0.8695652173913043,0.8292201382033563,gemini,mimiciii,nursing_note,PROMPT2_ICL_entailment
244,94,8,7,1,0.875,5,5,0,1.0,0.9333333333333332,gemini,mimiciii,nursing_note,PROMPT2_ICL_entailment
245,95,48,36,12,0.75,14,11,3,0.7857142857142857,0.7674418604651163,gemini,mimiciii,nursing_note,PROMPT2_ICL_entailment
246,96,16,16,0,1.0,6,6,0,1.0,1.0,gemini,mimiciii,nursing_note,PROMPT2_ICL_entailment
247,97,25,25,0,1.0,10,9,1,0.9,0.9473684210526316,gemini,mimiciii,nursing_note,PROMPT2_ICL_entailment
248,98,78,66,12,0.8461538461538461,13,11,2,0.8461538461538461,0.8461538461538461,gemini,mimiciii,nursing_note,PROMPT2_ICL_entailment
249,99,81,59,22,0.7283950617283951,44,37,7,0.8409090909090909,0.7806186304308957,gemini,mimiciii,nursing_note,PROMPT2_ICL_entailment
0,0,20,11,9,0.55,11,11,0,1.0,0.7096774193548387,gemini,mimiciii,nursing_note,PROMPT2_entailment
1,1,44,16,28,0.3636363636363636,31,22,9,0.7096774193548387,0.4808743169398907,gemini,mimiciii,nursing_note,PROMPT2_entailment
2,10,24,17,7,0.7083333333333334,18,14,4,0.7777777777777778,0.7414330218068536,gemini,mimiciii,nursing_note,PROMPT2_entailment
3,100,13,11,2,0.8461538461538461,6,6,0,1.0,0.9166666666666666,gemini,mimiciii,nursing_note,PROMPT2_entailment
4,101,34,28,6,0.8235294117647058,27,25,2,0.925925925925926,0.87173100871731,gemini,mimiciii,nursing_note,PROMPT2_entailment
5,102,32,23,9,0.71875,26,22,4,0.8461538461538461,0.7772657450076804,gemini,mimiciii,nursing_note,PROMPT2_entailment
6,103,1,0,1,0.0,22,3,19,0.1363636363636363,0.0,gemini,mimiciii,nursing_note,PROMPT2_entailment
7,104,31,27,4,0.8709677419354839,20,17,3,0.85,0.8603561387066542,gemini,mimiciii,nursing_note,PROMPT2_entailment
8,105,44,28,16,0.6363636363636364,20,16,4,0.8,0.7088607594936709,gemini,mimiciii,nursing_note,PROMPT2_entailment
9,106,9,9,0,1.0,4,2,2,0.5,0.6666666666666666,gemini,mimiciii,nursing_note,PROMPT2_entailment
10,107,56,43,13,0.7678571428571429,63,36,27,0.5714285714285714,0.6552380952380952,gemini,mimiciii,nursing_note,PROMPT2_entailment
11,108,61,51,10,0.8360655737704918,28,22,6,0.7857142857142857,0.8101083032490974,gemini,mimiciii,nursing_note,PROMPT2_entailment
12,109,5,4,1,0.8,4,4,0,1.0,0.888888888888889,gemini,mimiciii,nursing_note,PROMPT2_entailment
13,11,2,2,0,1.0,2,2,0,1.0,1.0,gemini,mimiciii,nursing_note,PROMPT2_entailment
14,110,19,19,0,1.0,13,11,2,0.8461538461538461,0.9166666666666666,gemini,mimiciii,nursing_note,PROMPT2_entailment
15,111,44,37,7,0.8409090909090909,34,29,5,0.8529411764705882,0.8468823993685872,gemini,mimiciii,nursing_note,PROMPT2_entailment
16,112,1,0,1,0.0,37,7,30,0.1891891891891892,0.0,gemini,mimiciii,nursing_note,PROMPT2_entailment
17,113,6,6,0,1.0,5,4,1,0.8,0.888888888888889,gemini,mimiciii,nursing_note,PROMPT2_entailment
18,114,30,24,6,0.8,19,15,4,0.7894736842105263,0.794701986754967,gemini,mimiciii,nursing_note,PROMPT2_entailment
19,115,15,14,1,0.9333333333333332,7,6,1,0.8571428571428571,0.8936170212765957,gemini,mimiciii,nursing_note,PROMPT2_entailment
20,116,36,33,3,0.9166666666666666,31,28,3,0.9032258064516128,0.9098966026587888,gemini,mimiciii,nursing_note,PROMPT2_entailment
21,117,56,42,14,0.75,18,15,3,0.8333333333333334,0.7894736842105262,gemini,mimiciii,nursing_note,PROMPT2_entailment
22,118,43,26,17,0.6046511627906976,25,15,10,0.6,0.6023166023166023,gemini,mimiciii,nursing_note,PROMPT2_entailment
23,119,39,31,8,0.7948717948717948,26,21,5,0.8076923076923077,0.8012307692307691,gemini,mimiciii,nursing_note,PROMPT2_entailment
24,12,38,33,5,0.868421052631579,18,13,5,0.7222222222222222,0.7886029411764707,gemini,mimiciii,nursing_note,PROMPT2_entailment
25,120,32,21,11,0.65625,18,17,1,0.9444444444444444,0.7744034707158352,gemini,mimiciii,nursing_note,PROMPT2_entailment
26,121,78,53,25,0.6794871794871795,37,26,11,0.7027027027027027,0.6908999749310604,gemini,mimiciii,nursing_note,PROMPT2_entailment
27,122,45,33,12,0.7333333333333333,11,8,3,0.7272727272727273,0.7302904564315353,gemini,mimiciii,nursing_note,PROMPT2_entailment
28,123,7,7,0,1.0,6,6,0,1.0,1.0,gemini,mimiciii,nursing_note,PROMPT2_entailment
29,124,6,5,1,0.8333333333333334,5,4,1,0.8,0.816326530612245,gemini,mimiciii,nursing_note,PROMPT2_entailment
30,125,35,33,2,0.9428571428571428,43,34,9,0.7906976744186046,0.8600996550402453,gemini,mimiciii,nursing_note,PROMPT2_entailment
31,126,41,29,12,0.7073170731707317,28,26,2,0.9285714285714286,0.8029818956336527,gemini,mimiciii,nursing_note,PROMPT2_entailment
32,127,27,21,6,0.7777777777777778,10,10,0,1.0,0.8750000000000001,gemini,mimiciii,nursing_note,PROMPT2_entailment
33,128,29,20,9,0.6896551724137931,17,15,2,0.8823529411764706,0.7741935483870969,gemini,mimiciii,nursing_note,PROMPT2_entailment
34,129,39,30,9,0.7692307692307693,29,21,8,0.7241379310344828,0.7460035523978686,gemini,mimiciii,nursing_note,PROMPT2_entailment
35,13,47,42,5,0.8936170212765957,34,29,5,0.8529411764705882,0.8728054460766751,gemini,mimiciii,nursing_note,PROMPT2_entailment
36,130,60,42,18,0.7,33,28,5,0.8484848484848485,0.7671232876712328,gemini,mimiciii,nursing_note,PROMPT2_entailment
37,131,37,29,8,0.7837837837837838,31,28,3,0.9032258064516128,0.8392764857881136,gemini,mimiciii,nursing_note,PROMPT2_entailment
38,132,42,23,19,0.5476190476190477,17,13,4,0.7647058823529411,0.6382070437566703,gemini,mimiciii,nursing_note,PROMPT2_entailment
39,133,21,16,5,0.7619047619047619,10,9,1,0.9,0.8252148997134672,gemini,mimiciii,nursing_note,PROMPT2_entailment
40,134,45,22,23,0.4888888888888889,30,21,9,0.7,0.5757009345794393,gemini,mimiciii,nursing_note,PROMPT2_entailment
41,135,87,63,24,0.7241379310344828,47,45,2,0.9574468085106383,0.824607329842932,gemini,mimiciii,nursing_note,PROMPT2_entailment
42,136,1,0,1,0.0,41,3,38,0.073170731707317,0.0,gemini,mimiciii,nursing_note,PROMPT2_entailment
43,137,5,4,1,0.8,2,1,1,0.5,0.6153846153846154,gemini,mimiciii,nursing_note,PROMPT2_entailment
44,138,4,4,0,1.0,5,4,1,0.8,0.888888888888889,gemini,mimiciii,nursing_note,PROMPT2_entailment
45,139,11,11,0,1.0,4,3,1,0.75,0.8571428571428571,gemini,mimiciii,nursing_note,PROMPT2_entailment
46,14,30,27,3,0.9,26,24,2,0.9230769230769232,0.9113924050632912,gemini,mimiciii,nursing_note,PROMPT2_entailment
47,140,40,26,14,0.65,24,21,3,0.875,0.7459016393442623,gemini,mimiciii,nursing_note,PROMPT2_entailment
48,141,19,17,2,0.8947368421052632,11,9,2,0.8181818181818182,0.8547486033519553,gemini,mimiciii,nursing_note,PROMPT2_entailment
49,142,57,44,13,0.7719298245614035,8,7,1,0.875,0.8202396804260985,gemini,mimiciii,nursing_note,PROMPT2_entailment
50,143,17,14,3,0.8235294117647058,2,1,1,0.5,0.6222222222222222,gemini,mimiciii,nursing_note,PROMPT2_entailment
51,144,8,8,0,1.0,5,4,1,0.8,0.888888888888889,gemini,mimiciii,nursing_note,PROMPT2_entailment
52,145,43,28,15,0.6511627906976745,19,15,4,0.7894736842105263,0.713678844519966,gemini,mimiciii,nursing_note,PROMPT2_entailment
53,146,10,9,1,0.9,6,4,2,0.6666666666666666,0.7659574468085106,gemini,mimiciii,nursing_note,PROMPT2_entailment
54,147,45,29,16,0.6444444444444445,26,21,5,0.8076923076923077,0.716892289582107,gemini,mimiciii,nursing_note,PROMPT2_entailment
55,148,14,13,1,0.9285714285714286,7,6,1,0.8571428571428571,0.8914285714285715,gemini,mimiciii,nursing_note,PROMPT2_entailment
56,149,53,34,19,0.6415094339622641,36,25,11,0.6944444444444444,0.6669282071400549,gemini,mimiciii,nursing_note,PROMPT2_entailment
57,15,32,23,9,0.71875,33,27,6,0.8181818181818182,0.7652495378927912,gemini,mimiciii,nursing_note,PROMPT2_entailment
58,150,14,13,1,0.9285714285714286,8,6,2,0.75,0.8297872340425532,gemini,mimiciii,nursing_note,PROMPT2_entailment
59,151,37,32,5,0.8648648648648649,26,21,5,0.8076923076923077,0.8353014294592915,gemini,mimiciii,nursing_note,PROMPT2_entailment
60,152,46,34,12,0.7391304347826086,44,32,12,0.7272727272727273,0.7331536388140162,gemini,mimiciii,nursing_note,PROMPT2_entailment
61,153,4,3,1,0.75,4,4,0,1.0,0.8571428571428571,gemini,mimiciii,nursing_note,PROMPT2_entailment
62,154,42,35,7,0.8333333333333334,34,28,6,0.8235294117647058,0.8284023668639053,gemini,mimiciii,nursing_note,PROMPT2_entailment
63,155,68,54,14,0.7941176470588235,51,45,6,0.8823529411764706,0.8359133126934986,gemini,mimiciii,nursing_note,PROMPT2_entailment
64,156,29,21,8,0.7241379310344828,26,18,8,0.6923076923076923,0.7078651685393258,gemini,mimiciii,nursing_note,PROMPT2_entailment
65,157,5,5,0,1.0,5,3,2,0.6,0.7499999999999999,gemini,mimiciii,nursing_note,PROMPT2_entailment
66,158,43,39,4,0.9069767441860463,22,17,5,0.7727272727272727,0.8344870988042793,gemini,mimiciii,nursing_note,PROMPT2_entailment
67,159,15,9,6,0.6,8,5,3,0.625,0.6122448979591836,gemini,mimiciii,nursing_note,PROMPT2_entailment
68,16,55,45,10,0.8181818181818182,30,24,6,0.8,0.8089887640449439,gemini,mimiciii,nursing_note,PROMPT2_entailment
69,160,46,40,6,0.8695652173913043,21,18,3,0.8571428571428571,0.8633093525179856,gemini,mimiciii,nursing_note,PROMPT2_entailment
70,161,6,6,0,1.0,6,6,0,1.0,1.0,gemini,mimiciii,nursing_note,PROMPT2_entailment
71,162,1,0,1,0.0,31,4,27,0.1290322580645161,0.0,gemini,mimiciii,nursing_note,PROMPT2_entailment
72,163,9,8,1,0.8888888888888888,4,4,0,1.0,0.9411764705882352,gemini,mimiciii,nursing_note,PROMPT2_entailment
73,164,18,16,2,0.8888888888888888,13,12,1,0.9230769230769232,0.9056603773584906,gemini,mimiciii,nursing_note,PROMPT2_entailment
74,165,59,49,10,0.8305084745762712,24,19,5,0.7916666666666666,0.8106225511536788,gemini,mimiciii,nursing_note,PROMPT2_entailment
75,166,14,13,1,0.9285714285714286,3,3,0,1.0,0.962962962962963,gemini,mimiciii,nursing_note,PROMPT2_entailment
76,167,45,38,7,0.8444444444444444,16,15,1,0.9375,0.8885424785658612,gemini,mimiciii,nursing_note,PROMPT2_entailment
77,168,41,26,15,0.6341463414634146,25,18,7,0.72,0.6743515850144093,gemini,mimiciii,nursing_note,PROMPT2_entailment
78,169,29,25,4,0.8620689655172413,12,12,0,1.0,0.925925925925926,gemini,mimiciii,nursing_note,PROMPT2_entailment
79,17,28,25,3,0.8928571428571429,39,30,9,0.7692307692307693,0.8264462809917357,gemini,mimiciii,nursing_note,PROMPT2_entailment
80,170,38,31,7,0.8157894736842105,21,15,6,0.7142857142857143,0.7616707616707618,gemini,mimiciii,nursing_note,PROMPT2_entailment
81,171,10,9,1,0.9,8,6,2,0.75,0.8181818181818182,gemini,mimiciii,nursing_note,PROMPT2_entailment
82,172,45,39,6,0.8666666666666667,38,28,10,0.7368421052631579,0.7964989059080962,gemini,mimiciii,nursing_note,PROMPT2_entailment
83,173,30,23,7,0.7666666666666667,20,15,5,0.75,0.7582417582417583,gemini,mimiciii,nursing_note,PROMPT2_entailment
84,174,12,12,0,1.0,8,6,2,0.75,0.8571428571428571,gemini,mimiciii,nursing_note,PROMPT2_entailment
85,175,3,2,1,0.6666666666666666,4,3,1,0.75,0.7058823529411765,gemini,mimiciii,nursing_note,PROMPT2_entailment
86,176,22,16,6,0.7272727272727273,13,11,2,0.8461538461538461,0.7822222222222223,gemini,mimiciii,nursing_note,PROMPT2_entailment
87,177,47,31,16,0.6595744680851063,38,36,2,0.9473684210526316,0.7777003484320557,gemini,mimiciii,nursing_note,PROMPT2_entailment
88,178,46,43,3,0.9347826086956522,25,22,3,0.88,0.9065644465740298,gemini,mimiciii,nursing_note,PROMPT2_entailment
89,179,37,30,7,0.8108108108108109,22,16,6,0.7272727272727273,0.7667731629392973,gemini,mimiciii,nursing_note,PROMPT2_entailment
90,18,1,0,1,0.0,25,5,20,0.2,0.0,gemini,mimiciii,nursing_note,PROMPT2_entailment
91,180,47,36,11,0.7659574468085106,27,19,8,0.7037037037037037,0.7335120643431635,gemini,mimiciii,nursing_note,PROMPT2_entailment
92,181,30,19,11,0.6333333333333333,25,22,3,0.88,0.7365638766519824,gemini,mimiciii,nursing_note,PROMPT2_entailment
93,182,35,26,9,0.7428571428571429,10,8,2,0.8,0.7703703703703704,gemini,mimiciii,nursing_note,PROMPT2_entailment
94,183,7,7,0,1.0,5,4,1,0.8,0.888888888888889,gemini,mimiciii,nursing_note,PROMPT2_entailment
95,184,14,12,2,0.8571428571428571,1,1,0,1.0,0.923076923076923,gemini,mimiciii,nursing_note,PROMPT2_entailment
96,185,32,24,8,0.75,30,25,5,0.8333333333333334,0.7894736842105262,gemini,mimiciii,nursing_note,PROMPT2_entailment
97,186,5,5,0,1.0,4,3,1,0.75,0.8571428571428571,gemini,mimiciii,nursing_note,PROMPT2_entailment
98,187,43,41,2,0.9534883720930232,37,31,6,0.8378378378378378,0.8919298245614036,gemini,mimiciii,nursing_note,PROMPT2_entailment
99,188,8,8,0,1.0,2,2,0,1.0,1.0,gemini,mimiciii,nursing_note,PROMPT2_entailment
100,189,49,39,10,0.7959183673469388,21,16,5,0.7619047619047619,0.7785402370555208,gemini,mimiciii,nursing_note,PROMPT2_entailment
101,19,58,39,19,0.6724137931034483,45,33,12,0.7333333333333333,0.7015535568274734,gemini,mimiciii,nursing_note,PROMPT2_entailment
102,190,36,32,4,0.8888888888888888,24,18,6,0.75,0.8135593220338982,gemini,mimiciii,nursing_note,PROMPT2_entailment
103,191,48,39,9,0.8125,29,23,6,0.7931034482758621,0.8026845637583893,gemini,mimiciii,nursing_note,PROMPT2_entailment
104,192,14,14,0,1.0,15,13,2,0.8666666666666667,0.9285714285714286,gemini,mimiciii,nursing_note,PROMPT2_entailment
105,193,55,46,9,0.8363636363636363,40,33,7,0.825,0.8306429548563612,gemini,mimiciii,nursing_note,PROMPT2_entailment
106,194,18,18,0,1.0,13,11,2,0.8461538461538461,0.9166666666666666,gemini,mimiciii,nursing_note,PROMPT2_entailment
107,195,10,9,1,0.9,7,7,0,1.0,0.9473684210526316,gemini,mimiciii,nursing_note,PROMPT2_entailment
108,196,45,38,7,0.8444444444444444,34,31,3,0.9117647058823528,0.8768142910308894,gemini,mimiciii,nursing_note,PROMPT2_entailment
109,197,53,40,13,0.7547169811320755,27,25,2,0.925925925925926,0.8316008316008316,gemini,mimiciii,nursing_note,PROMPT2_entailment
110,198,55,40,15,0.7272727272727273,38,31,7,0.8157894736842105,0.7689922480620155,gemini,mimiciii,nursing_note,PROMPT2_entailment
111,199,23,20,3,0.8695652173913043,14,12,2,0.8571428571428571,0.8633093525179856,gemini,mimiciii,nursing_note,PROMPT2_entailment
112,2,1,0,1,0.0,43,3,40,0.0697674418604651,0.0,gemini,mimiciii,nursing_note,PROMPT2_entailment
113,20,91,57,34,0.6263736263736264,46,39,7,0.8478260869565217,0.7204666990763247,gemini,mimiciii,nursing_note,PROMPT2_entailment
114,200,55,36,19,0.6545454545454545,44,29,15,0.6590909090909091,0.6568103177099717,gemini,mimiciii,nursing_note,PROMPT2_entailment
115,201,38,35,3,0.9210526315789472,29,22,7,0.7586206896551724,0.8319827120475419,gemini,mimiciii,nursing_note,PROMPT2_entailment
116,202,11,10,1,0.9090909090909092,9,7,2,0.7777777777777778,0.8383233532934132,gemini,mimiciii,nursing_note,PROMPT2_entailment
117,203,14,14,0,1.0,7,7,0,1.0,1.0,gemini,mimiciii,nursing_note,PROMPT2_entailment
118,204,39,28,11,0.717948717948718,24,19,5,0.7916666666666666,0.7530077848549186,gemini,mimiciii,nursing_note,PROMPT2_entailment
119,205,55,52,3,0.9454545454545454,69,38,31,0.5507246376811594,0.6960197252553715,gemini,mimiciii,nursing_note,PROMPT2_entailment
120,206,10,10,0,1.0,6,5,1,0.8333333333333334,0.9090909090909092,gemini,mimiciii,nursing_note,PROMPT2_entailment
121,207,44,39,5,0.8863636363636364,29,27,2,0.9310344827586208,0.908150064683053,gemini,mimiciii,nursing_note,PROMPT2_entailment
122,208,15,15,0,1.0,7,7,0,1.0,1.0,gemini,mimiciii,nursing_note,PROMPT2_entailment
123,209,3,3,0,1.0,2,2,0,1.0,1.0,gemini,mimiciii,nursing_note,PROMPT2_entailment
124,21,9,8,1,0.8888888888888888,6,5,1,0.8333333333333334,0.8602150537634408,gemini,mimiciii,nursing_note,PROMPT2_entailment
125,210,31,21,10,0.6774193548387096,22,20,2,0.9090909090909092,0.7763401109057301,gemini,mimiciii,nursing_note,PROMPT2_entailment
126,211,9,9,0,1.0,4,4,0,1.0,1.0,gemini,mimiciii,nursing_note,PROMPT2_entailment
127,212,44,38,6,0.8636363636363636,37,30,7,0.8108108108108109,0.8363903154805576,gemini,mimiciii,nursing_note,PROMPT2_entailment
128,213,26,19,7,0.7307692307692307,18,15,3,0.8333333333333334,0.7786885245901639,gemini,mimiciii,nursing_note,PROMPT2_entailment
129,214,14,11,3,0.7857142857142857,3,3,0,1.0,0.88,gemini,mimiciii,nursing_note,PROMPT2_entailment
130,215,10,10,0,1.0,7,6,1,0.8571428571428571,0.923076923076923,gemini,mimiciii,nursing_note,PROMPT2_entailment
131,216,28,22,6,0.7857142857142857,13,8,5,0.6153846153846154,0.6901960784313727,gemini,mimiciii,nursing_note,PROMPT2_entailment
132,217,47,35,12,0.7446808510638298,25,21,4,0.84,0.7894736842105262,gemini,mimiciii,nursing_note,PROMPT2_entailment
133,218,29,28,1,0.9655172413793104,18,15,3,0.8333333333333334,0.8945686900958466,gemini,mimiciii,nursing_note,PROMPT2_entailment
134,219,34,24,10,0.7058823529411765,14,12,2,0.8571428571428571,0.7741935483870968,gemini,mimiciii,nursing_note,PROMPT2_entailment
135,22,43,38,5,0.8837209302325582,26,24,2,0.9230769230769232,0.902970297029703,gemini,mimiciii,nursing_note,PROMPT2_entailment
136,220,13,11,2,0.8461538461538461,5,4,1,0.8,0.8224299065420562,gemini,mimiciii,nursing_note,PROMPT2_entailment
137,221,35,22,13,0.6285714285714286,45,27,18,0.6,0.613953488372093,gemini,mimiciii,nursing_note,PROMPT2_entailment
138,222,7,7,0,1.0,3,3,0,1.0,1.0,gemini,mimiciii,nursing_note,PROMPT2_entailment
139,223,37,22,15,0.5945945945945946,30,30,0,1.0,0.7457627118644068,gemini,mimiciii,nursing_note,PROMPT2_entailment
140,224,9,9,0,1.0,6,6,0,1.0,1.0,gemini,mimiciii,nursing_note,PROMPT2_entailment
141,225,80,42,38,0.525,45,39,6,0.8666666666666667,0.6538922155688623,gemini,mimiciii,nursing_note,PROMPT2_entailment
142,226,39,36,3,0.9230769230769232,20,16,4,0.8,0.8571428571428571,gemini,mimiciii,nursing_note,PROMPT2_entailment
143,227,22,19,3,0.8636363636363636,15,15,0,1.0,0.9268292682926828,gemini,mimiciii,nursing_note,PROMPT2_entailment
144,228,55,34,21,0.6181818181818182,38,33,5,0.868421052631579,0.722240102993241,gemini,mimiciii,nursing_note,PROMPT2_entailment
145,229,37,26,11,0.7027027027027027,22,18,4,0.8181818181818182,0.7560581583198709,gemini,mimiciii,nursing_note,PROMPT2_entailment
146,23,56,43,13,0.7678571428571429,44,39,5,0.8863636363636364,0.8228655544651619,gemini,mimiciii,nursing_note,PROMPT2_entailment
147,230,16,13,3,0.8125,7,5,2,0.7142857142857143,0.7602339181286549,gemini,mimiciii,nursing_note,PROMPT2_entailment
148,231,58,48,10,0.8275862068965517,15,12,3,0.8,0.8135593220338982,gemini,mimiciii,nursing_note,PROMPT2_entailment
149,232,10,9,1,0.9,2,2,0,1.0,0.9473684210526316,gemini,mimiciii,nursing_note,PROMPT2_entailment
150,233,42,22,20,0.5238095238095238,44,26,18,0.5909090909090909,0.5553398058252427,gemini,mimiciii,nursing_note,PROMPT2_entailment
151,234,56,51,5,0.9107142857142856,32,27,5,0.84375,0.8759541984732826,gemini,mimiciii,nursing_note,PROMPT2_entailment
152,235,31,29,2,0.935483870967742,10,9,1,0.9,0.9173989455184536,gemini,mimiciii,nursing_note,PROMPT2_entailment
153,236,21,20,1,0.9523809523809524,7,4,3,0.5714285714285714,0.7142857142857142,gemini,mimiciii,nursing_note,PROMPT2_entailment
154,237,41,34,7,0.8292682926829268,35,23,12,0.6571428571428571,0.7332395686826066,gemini,mimiciii,nursing_note,PROMPT2_entailment
155,238,53,25,28,0.4716981132075472,42,34,8,0.8095238095238095,0.5960729312762973,gemini,mimiciii,nursing_note,PROMPT2_entailment
156,239,50,37,13,0.74,21,15,6,0.7142857142857143,0.7269155206286838,gemini,mimiciii,nursing_note,PROMPT2_entailment
157,24,15,15,0,1.0,5,5,0,1.0,1.0,gemini,mimiciii,nursing_note,PROMPT2_entailment
158,240,35,32,3,0.9142857142857144,42,32,10,0.7619047619047619,0.8311688311688312,gemini,mimiciii,nursing_note,PROMPT2_entailment
159,241,30,18,12,0.6,21,19,2,0.9047619047619048,0.7215189873417721,gemini,mimiciii,nursing_note,PROMPT2_entailment
160,242,48,32,16,0.6666666666666666,16,12,4,0.75,0.7058823529411765,gemini,mimiciii,nursing_note,PROMPT2_entailment
161,243,12,11,1,0.9166666666666666,5,3,2,0.6,0.7252747252747253,gemini,mimiciii,nursing_note,PROMPT2_entailment
162,244,44,29,15,0.6590909090909091,16,14,2,0.875,0.7518518518518518,gemini,mimiciii,nursing_note,PROMPT2_entailment
163,245,38,29,9,0.7631578947368421,37,29,8,0.7837837837837838,0.7733333333333334,gemini,mimiciii,nursing_note,PROMPT2_entailment
164,246,33,27,6,0.8181818181818182,10,6,4,0.6,0.6923076923076923,gemini,mimiciii,nursing_note,PROMPT2_entailment
165,247,8,8,0,1.0,6,4,2,0.6666666666666666,0.8,gemini,mimiciii,nursing_note,PROMPT2_entailment
166,248,47,36,11,0.7659574468085106,42,31,11,0.7380952380952381,0.7517682721455036,gemini,mimiciii,nursing_note,PROMPT2_entailment
167,249,43,30,13,0.6976744186046512,39,28,11,0.717948717948718,0.7076663858466724,gemini,mimiciii,nursing_note,PROMPT2_entailment
168,25,42,30,12,0.7142857142857143,23,12,11,0.5217391304347826,0.6030150753768844,gemini,mimiciii,nursing_note,PROMPT2_entailment
169,26,60,49,11,0.8166666666666667,35,31,4,0.8857142857142857,0.8497902097902097,gemini,mimiciii,nursing_note,PROMPT2_entailment
170,27,8,8,0,1.0,3,2,1,0.6666666666666666,0.8,gemini,mimiciii,nursing_note,PROMPT2_entailment
171,28,35,26,9,0.7428571428571429,16,12,4,0.75,0.7464114832535885,gemini,mimiciii,nursing_note,PROMPT2_entailment
172,29,36,25,11,0.6944444444444444,33,22,11,0.6666666666666666,0.6802721088435373,gemini,mimiciii,nursing_note,PROMPT2_entailment
173,3,13,11,2,0.8461538461538461,6,6,0,1.0,0.9166666666666666,gemini,mimiciii,nursing_note,PROMPT2_entailment
174,30,14,11,3,0.7857142857142857,17,13,4,0.7647058823529411,0.7750677506775069,gemini,mimiciii,nursing_note,PROMPT2_entailment
175,31,31,22,9,0.7096774193548387,19,17,2,0.8947368421052632,0.7915343915343915,gemini,mimiciii,nursing_note,PROMPT2_entailment
176,32,64,62,2,0.96875,44,37,7,0.8409090909090909,0.9003139717425432,gemini,mimiciii,nursing_note,PROMPT2_entailment
177,33,9,9,0,1.0,5,5,0,1.0,1.0,gemini,mimiciii,nursing_note,PROMPT2_entailment
178,34,7,7,0,1.0,3,3,0,1.0,1.0,gemini,mimiciii,nursing_note,PROMPT2_entailment
179,35,19,19,0,1.0,7,7,0,1.0,1.0,gemini,mimiciii,nursing_note,PROMPT2_entailment
180,36,92,66,26,0.717391304347826,62,53,9,0.8548387096774194,0.780107047279215,gemini,mimiciii,nursing_note,PROMPT2_entailment
181,37,43,23,20,0.5348837209302325,38,24,14,0.631578947368421,0.5792235047219307,gemini,mimiciii,nursing_note,PROMPT2_entailment
182,38,37,24,13,0.6486486486486487,26,23,3,0.8846153846153846,0.7484745762711865,gemini,mimiciii,nursing_note,PROMPT2_entailment
183,39,22,16,6,0.7272727272727273,3,2,1,0.6666666666666666,0.6956521739130435,gemini,mimiciii,nursing_note,PROMPT2_entailment
184,4,1,0,1,0.0,26,5,21,0.1923076923076923,0.0,gemini,mimiciii,nursing_note,PROMPT2_entailment
185,40,11,9,2,0.8181818181818182,3,3,0,1.0,0.9,gemini,mimiciii,nursing_note,PROMPT2_entailment
186,41,53,44,9,0.8301886792452831,50,43,7,0.86,0.844831435588301,gemini,mimiciii,nursing_note,PROMPT2_entailment
187,42,46,30,16,0.6521739130434783,7,6,1,0.8571428571428571,0.7407407407407407,gemini,mimiciii,nursing_note,PROMPT2_entailment
188,43,37,30,7,0.8108108108108109,14,10,4,0.7142857142857143,0.759493670886076,gemini,mimiciii,nursing_note,PROMPT2_entailment
189,44,8,8,0,1.0,3,3,0,1.0,1.0,gemini,mimiciii,nursing_note,PROMPT2_entailment
190,45,45,38,7,0.8444444444444444,34,23,11,0.6764705882352942,0.7511817791147402,gemini,mimiciii,nursing_note,PROMPT2_entailment
191,46,45,43,2,0.9555555555555556,33,26,7,0.7878787878787878,0.8636539204325996,gemini,mimiciii,nursing_note,PROMPT2_entailment
192,47,37,23,14,0.6216216216216216,14,10,4,0.7142857142857143,0.6647398843930636,gemini,mimiciii,nursing_note,PROMPT2_entailment
193,48,24,20,4,0.8333333333333334,9,9,0,1.0,0.9090909090909092,gemini,mimiciii,nursing_note,PROMPT2_entailment
194,49,7,5,2,0.7142857142857143,3,2,1,0.6666666666666666,0.689655172413793,gemini,mimiciii,nursing_note,PROMPT2_entailment
195,5,36,26,10,0.7222222222222222,15,13,2,0.8666666666666667,0.7878787878787877,gemini,mimiciii,nursing_note,PROMPT2_entailment
196,50,27,17,10,0.6296296296296297,16,12,4,0.75,0.6845637583892616,gemini,mimiciii,nursing_note,PROMPT2_entailment
197,51,11,11,0,1.0,6,6,0,1.0,1.0,gemini,mimiciii,nursing_note,PROMPT2_entailment
198,52,39,23,16,0.5897435897435898,38,33,5,0.868421052631579,0.7024525682554373,gemini,mimiciii,nursing_note,PROMPT2_entailment
199,53,8,7,1,0.875,6,6,0,1.0,0.9333333333333332,gemini,mimiciii,nursing_note,PROMPT2_entailment
200,54,35,19,16,0.5428571428571428,37,30,7,0.8108108108108109,0.6503137478608101,gemini,mimiciii,nursing_note,PROMPT2_entailment
201,55,64,51,13,0.796875,35,26,9,0.7428571428571429,0.7689185271093071,gemini,mimiciii,nursing_note,PROMPT2_entailment
202,56,17,16,1,0.9411764705882352,2,2,0,1.0,0.9696969696969696,gemini,mimiciii,nursing_note,PROMPT2_entailment
203,57,44,39,5,0.8863636363636364,18,10,8,0.5555555555555556,0.6830122591943958,gemini,mimiciii,nursing_note,PROMPT2_entailment
204,58,63,50,13,0.7936507936507936,28,26,2,0.9285714285714286,0.8558262014483212,gemini,mimiciii,nursing_note,PROMPT2_entailment
205,59,14,13,1,0.9285714285714286,9,8,1,0.8888888888888888,0.9082969432314412,gemini,mimiciii,nursing_note,PROMPT2_entailment
206,6,14,13,1,0.9285714285714286,8,8,0,1.0,0.962962962962963,gemini,mimiciii,nursing_note,PROMPT2_entailment
207,60,45,35,10,0.7777777777777778,27,22,5,0.8148148148148148,0.7958656330749354,gemini,mimiciii,nursing_note,PROMPT2_entailment
208,61,38,24,14,0.631578947368421,20,18,2,0.9,0.7422680412371133,gemini,mimiciii,nursing_note,PROMPT2_entailment
209,62,1,1,0,1.0,37,7,30,0.1891891891891892,0.3181818181818182,gemini,mimiciii,nursing_note,PROMPT2_entailment
210,63,8,8,0,1.0,5,5,0,1.0,1.0,gemini,mimiciii,nursing_note,PROMPT2_entailment
211,64,62,56,6,0.9032258064516128,27,25,2,0.925925925925926,0.914435009797518,gemini,mimiciii,nursing_note,PROMPT2_entailment
212,65,26,22,4,0.8461538461538461,19,16,3,0.8421052631578947,0.8441247002398081,gemini,mimiciii,nursing_note,PROMPT2_entailment
213,66,13,11,2,0.8461538461538461,1,1,0,1.0,0.9166666666666666,gemini,mimiciii,nursing_note,PROMPT2_entailment
214,67,10,8,2,0.8,7,3,4,0.4285714285714285,0.5581395348837209,gemini,mimiciii,nursing_note,PROMPT2_entailment
215,68,1,0,1,0.0,18,3,15,0.1666666666666666,0.0,gemini,mimiciii,nursing_note,PROMPT2_entailment
216,69,35,22,13,0.6285714285714286,25,22,3,0.88,0.7333333333333334,gemini,mimiciii,nursing_note,PROMPT2_entailment
217,7,4,4,0,1.0,2,2,0,1.0,1.0,gemini,mimiciii,nursing_note,PROMPT2_entailment
218,70,52,46,6,0.8846153846153846,45,36,9,0.8,0.8401826484018265,gemini,mimiciii,nursing_note,PROMPT2_entailment
219,71,80,40,40,0.5,52,33,19,0.6346153846153846,0.559322033898305,gemini,mimiciii,nursing_note,PROMPT2_entailment
220,72,23,21,2,0.9130434782608696,12,9,3,0.75,0.8235294117647057,gemini,mimiciii,nursing_note,PROMPT2_entailment
221,73,46,30,16,0.6521739130434783,38,31,7,0.8157894736842105,0.724863600935308,gemini,mimiciii,nursing_note,PROMPT2_entailment
222,74,9,9,0,1.0,8,6,2,0.75,0.8571428571428571,gemini,mimiciii,nursing_note,PROMPT2_entailment
223,75,55,36,19,0.6545454545454545,27,21,6,0.7777777777777778,0.7108603667136812,gemini,mimiciii,nursing_note,PROMPT2_entailment
224,76,1,0,1,0.0,1,0,1,0.0,,gemini,mimiciii,nursing_note,PROMPT2_entailment
225,77,77,44,33,0.5714285714285714,59,48,11,0.8135593220338984,0.6713286713286714,gemini,mimiciii,nursing_note,PROMPT2_entailment
226,78,54,31,23,0.5740740740740741,20,10,10,0.5,0.5344827586206897,gemini,mimiciii,nursing_note,PROMPT2_entailment
227,79,49,41,8,0.8367346938775511,30,21,9,0.7,0.7622841965471447,gemini,mimiciii,nursing_note,PROMPT2_entailment
228,8,15,15,0,1.0,14,11,3,0.7857142857142857,0.88,gemini,mimiciii,nursing_note,PROMPT2_entailment
229,80,43,29,14,0.6744186046511628,22,19,3,0.8636363636363636,0.7573883161512027,gemini,mimiciii,nursing_note,PROMPT2_entailment
230,81,32,22,10,0.6875,22,21,1,0.9545454545454546,0.7993079584775087,gemini,mimiciii,nursing_note,PROMPT2_entailment
231,82,41,32,9,0.7804878048780488,17,13,4,0.7647058823529411,0.7725162488393685,gemini,mimiciii,nursing_note,PROMPT2_entailment
232,83,23,18,5,0.782608695652174,34,21,13,0.6176470588235294,0.6904109589041096,gemini,mimiciii,nursing_note,PROMPT2_entailment
233,84,13,11,2,0.8461538461538461,6,6,0,1.0,0.9166666666666666,gemini,mimiciii,nursing_note,PROMPT2_entailment
234,85,40,38,2,0.95,27,18,9,0.6666666666666666,0.7835051546391752,gemini,mimiciii,nursing_note,PROMPT2_entailment
235,86,59,42,17,0.711864406779661,40,24,16,0.6,0.6511627906976744,gemini,mimiciii,nursing_note,PROMPT2_entailment
236,87,23,20,3,0.8695652173913043,15,13,2,0.8666666666666667,0.8681135225375627,gemini,mimiciii,nursing_note,PROMPT2_entailment
237,88,41,26,15,0.6341463414634146,15,13,2,0.8666666666666667,0.7323943661971831,gemini,mimiciii,nursing_note,PROMPT2_entailment
238,89,38,30,8,0.7894736842105263,29,20,9,0.6896551724137931,0.736196319018405,gemini,mimiciii,nursing_note,PROMPT2_entailment
239,9,45,34,11,0.7555555555555555,17,15,2,0.8823529411764706,0.8140462889066241,gemini,mimiciii,nursing_note,PROMPT2_entailment
240,90,32,21,11,0.65625,14,12,2,0.8571428571428571,0.743362831858407,gemini,mimiciii,nursing_note,PROMPT2_entailment
241,91,34,19,15,0.5588235294117647,25,23,2,0.92,0.6953062848050915,gemini,mimiciii,nursing_note,PROMPT2_entailment
242,92,51,46,5,0.9019607843137256,28,28,0,1.0,0.9484536082474228,gemini,mimiciii,nursing_note,PROMPT2_entailment
243,93,35,30,5,0.8571428571428571,23,18,5,0.782608695652174,0.8181818181818182,gemini,mimiciii,nursing_note,PROMPT2_entailment
244,94,8,8,0,1.0,5,4,1,0.8,0.888888888888889,gemini,mimiciii,nursing_note,PROMPT2_entailment
245,95,37,27,10,0.7297297297297297,14,13,1,0.9285714285714286,0.8172293364377183,gemini,mimiciii,nursing_note,PROMPT2_entailment
246,96,11,10,1,0.9090909090909092,6,6,0,1.0,0.9523809523809524,gemini,mimiciii,nursing_note,PROMPT2_entailment
247,97,16,16,0,1.0,10,8,2,0.8,0.888888888888889,gemini,mimiciii,nursing_note,PROMPT2_entailment
248,98,72,60,12,0.8333333333333334,13,12,1,0.9230769230769232,0.8759124087591241,gemini,mimiciii,nursing_note,PROMPT2_entailment
249,99,56,48,8,0.8571428571428571,44,38,6,0.8636363636363636,0.860377358490566,gemini,mimiciii,nursing_note,PROMPT2_entailment
0,0,14,13,1,0.9285714285714286,21,17,4,0.8095238095238095,0.8649706457925637,gemini,mimiciii,radiology_report,PROMPT1_entailment
1,1,20,14,6,0.7,15,9,6,0.6,0.6461538461538462,gemini,mimiciii,radiology_report,PROMPT1_entailment
2,10,14,12,2,0.8571428571428571,18,15,3,0.8333333333333334,0.8450704225352113,gemini,mimiciii,radiology_report,PROMPT1_entailment
3,100,9,9,0,1.0,9,8,1,0.8888888888888888,0.9411764705882352,gemini,mimiciii,radiology_report,PROMPT1_entailment
4,101,11,9,2,0.8181818181818182,15,13,2,0.8666666666666667,0.8417266187050358,gemini,mimiciii,radiology_report,PROMPT1_entailment
5,102,13,11,2,0.8461538461538461,16,12,4,0.75,0.7951807228915662,gemini,mimiciii,radiology_report,PROMPT1_entailment
6,103,11,9,2,0.8181818181818182,19,14,5,0.7368421052631579,0.7753846153846154,gemini,mimiciii,radiology_report,PROMPT1_entailment
7,104,13,9,4,0.6923076923076923,17,13,4,0.7647058823529411,0.7267080745341614,gemini,mimiciii,radiology_report,PROMPT1_entailment
8,105,8,8,0,1.0,8,5,3,0.625,0.7692307692307693,gemini,mimiciii,radiology_report,PROMPT1_entailment
9,106,7,6,1,0.8571428571428571,12,10,2,0.8333333333333334,0.8450704225352113,gemini,mimiciii,radiology_report,PROMPT1_entailment
10,107,16,14,2,0.875,19,13,6,0.6842105263157895,0.7679324894514769,gemini,mimiciii,radiology_report,PROMPT1_entailment
11,108,12,11,1,0.9166666666666666,13,11,2,0.8461538461538461,0.8799999999999999,gemini,mimiciii,radiology_report,PROMPT1_entailment
12,109,11,6,5,0.5454545454545454,20,16,4,0.8,0.6486486486486486,gemini,mimiciii,radiology_report,PROMPT1_entailment
13,11,22,15,7,0.6818181818181818,24,23,1,0.9583333333333334,0.7967667436489608,gemini,mimiciii,radiology_report,PROMPT1_entailment
14,110,9,4,5,0.4444444444444444,17,14,3,0.8235294117647058,0.5773195876288659,gemini,mimiciii,radiology_report,PROMPT1_entailment
15,111,12,11,1,0.9166666666666666,20,12,8,0.6,0.7252747252747253,gemini,mimiciii,radiology_report,PROMPT1_entailment
16,112,9,7,2,0.7777777777777778,14,11,3,0.7857142857142857,0.7817258883248731,gemini,mimiciii,radiology_report,PROMPT1_entailment
17,113,16,10,6,0.625,20,17,3,0.85,0.7203389830508474,gemini,mimiciii,radiology_report,PROMPT1_entailment
18,114,16,8,8,0.5,23,21,2,0.9130434782608696,0.6461538461538461,gemini,mimiciii,radiology_report,PROMPT1_entailment
19,115,13,7,6,0.5384615384615384,20,17,3,0.85,0.6592797783933518,gemini,mimiciii,radiology_report,PROMPT1_entailment
20,116,6,5,1,0.8333333333333334,13,8,5,0.6153846153846154,0.7079646017699115,gemini,mimiciii,radiology_report,PROMPT1_entailment
21,117,11,10,1,0.9090909090909092,16,12,4,0.75,0.821917808219178,gemini,mimiciii,radiology_report,PROMPT1_entailment
22,118,23,15,8,0.6521739130434783,24,19,5,0.7916666666666666,0.7151819322459221,gemini,mimiciii,radiology_report,PROMPT1_entailment
23,119,11,9,2,0.8181818181818182,17,13,4,0.7647058823529411,0.7905405405405405,gemini,mimiciii,radiology_report,PROMPT1_entailment
24,12,10,10,0,1.0,17,14,3,0.8235294117647058,0.9032258064516128,gemini,mimiciii,radiology_report,PROMPT1_entailment
25,120,12,7,5,0.5833333333333334,16,11,5,0.6875,0.6311475409836065,gemini,mimiciii,radiology_report,PROMPT1_entailment
26,121,20,17,3,0.85,26,20,6,0.7692307692307693,0.8076009501187649,gemini,mimiciii,radiology_report,PROMPT1_entailment
27,122,12,6,6,0.5,20,14,6,0.7,0.5833333333333334,gemini,mimiciii,radiology_report,PROMPT1_entailment
28,123,9,7,2,0.7777777777777778,13,9,4,0.6923076923076923,0.7325581395348836,gemini,mimiciii,radiology_report,PROMPT1_entailment
29,124,8,8,0,1.0,12,12,0,1.0,1.0,gemini,mimiciii,radiology_report,PROMPT1_entailment
30,125,16,12,4,0.75,23,19,4,0.8260869565217391,0.786206896551724,gemini,mimiciii,radiology_report,PROMPT1_entailment
31,126,7,5,2,0.7142857142857143,9,7,2,0.7777777777777778,0.7446808510638298,gemini,mimiciii,radiology_report,PROMPT1_entailment
32,127,24,24,0,1.0,50,41,9,0.82,0.9010989010989012,gemini,mimiciii,radiology_report,PROMPT1_entailment
33,128,7,2,5,0.2857142857142857,14,8,6,0.5714285714285714,0.3809523809523809,gemini,mimiciii,radiology_report,PROMPT1_entailment
34,129,12,8,4,0.6666666666666666,16,12,4,0.75,0.7058823529411765,gemini,mimiciii,radiology_report,PROMPT1_entailment
35,13,10,7,3,0.7,17,12,5,0.7058823529411765,0.7029288702928871,gemini,mimiciii,radiology_report,PROMPT1_entailment
36,130,12,12,0,1.0,29,20,9,0.6896551724137931,0.8163265306122449,gemini,mimiciii,radiology_report,PROMPT1_entailment
37,131,12,12,0,1.0,45,23,22,0.5111111111111111,0.676470588235294,gemini,mimiciii,radiology_report,PROMPT1_entailment
38,132,13,8,5,0.6153846153846154,23,13,10,0.5652173913043478,0.5892351274787536,gemini,mimiciii,radiology_report,PROMPT1_entailment
39,133,21,18,3,0.8571428571428571,21,16,5,0.7619047619047619,0.8067226890756302,gemini,mimiciii,radiology_report,PROMPT1_entailment
40,134,23,18,5,0.782608695652174,23,19,4,0.8260869565217391,0.8037602820211517,gemini,mimiciii,radiology_report,PROMPT1_entailment
41,135,13,11,2,0.8461538461538461,20,16,4,0.8,0.8224299065420562,gemini,mimiciii,radiology_report,PROMPT1_entailment
42,136,8,7,1,0.875,14,10,4,0.7142857142857143,0.7865168539325842,gemini,mimiciii,radiology_report,PROMPT1_entailment
43,137,6,5,1,0.8333333333333334,10,8,2,0.8,0.816326530612245,gemini,mimiciii,radiology_report,PROMPT1_entailment
44,138,12,8,4,0.6666666666666666,14,12,2,0.8571428571428571,0.75,gemini,mimiciii,radiology_report,PROMPT1_entailment
45,139,9,6,3,0.6666666666666666,13,12,1,0.9230769230769232,0.7741935483870968,gemini,mimiciii,radiology_report,PROMPT1_entailment
46,14,8,7,1,0.875,12,10,2,0.8333333333333334,0.8536585365853658,gemini,mimiciii,radiology_report,PROMPT1_entailment
47,140,6,2,4,0.3333333333333333,18,17,1,0.9444444444444444,0.4927536231884057,gemini,mimiciii,radiology_report,PROMPT1_entailment
48,141,13,10,3,0.7692307692307693,16,10,6,0.625,0.6896551724137931,gemini,mimiciii,radiology_report,PROMPT1_entailment
49,142,6,3,3,0.5,14,12,2,0.8571428571428571,0.631578947368421,gemini,mimiciii,radiology_report,PROMPT1_entailment
50,143,14,12,2,0.8571428571428571,32,25,7,0.78125,0.8174386920980925,gemini,mimiciii,radiology_report,PROMPT1_entailment
51,144,12,12,0,1.0,26,16,10,0.6153846153846154,0.761904761904762,gemini,mimiciii,radiology_report,PROMPT1_entailment
52,145,14,9,5,0.6428571428571429,10,9,1,0.9,0.75,gemini,mimiciii,radiology_report,PROMPT1_entailment
53,146,8,8,0,1.0,11,8,3,0.7272727272727273,0.8421052631578948,gemini,mimiciii,radiology_report,PROMPT1_entailment
54,147,9,7,2,0.7777777777777778,10,7,3,0.7,0.7368421052631577,gemini,mimiciii,radiology_report,PROMPT1_entailment
55,148,21,17,4,0.8095238095238095,26,22,4,0.8461538461538461,0.8274336283185841,gemini,mimiciii,radiology_report,PROMPT1_entailment
56,149,18,15,3,0.8333333333333334,20,15,5,0.75,0.7894736842105262,gemini,mimiciii,radiology_report,PROMPT1_entailment
57,15,20,15,5,0.75,29,23,6,0.7931034482758621,0.770949720670391,gemini,mimiciii,radiology_report,PROMPT1_entailment
58,150,16,11,5,0.6875,14,13,1,0.9285714285714286,0.7900552486187846,gemini,mimiciii,radiology_report,PROMPT1_entailment
59,151,11,9,2,0.8181818181818182,15,9,6,0.6,0.6923076923076923,gemini,mimiciii,radiology_report,PROMPT1_entailment
60,152,18,12,6,0.6666666666666666,18,11,7,0.6111111111111112,0.6376811594202899,gemini,mimiciii,radiology_report,PROMPT1_entailment
61,153,11,10,1,0.9090909090909092,16,14,2,0.875,0.8917197452229298,gemini,mimiciii,radiology_report,PROMPT1_entailment
62,154,12,8,4,0.6666666666666666,23,21,2,0.9130434782608696,0.7706422018348623,gemini,mimiciii,radiology_report,PROMPT1_entailment
63,155,20,18,2,0.9,47,37,10,0.7872340425531915,0.8398486759142497,gemini,mimiciii,radiology_report,PROMPT1_entailment
64,156,14,5,9,0.3571428571428571,20,13,7,0.65,0.4609929078014185,gemini,mimiciii,radiology_report,PROMPT1_entailment
65,157,10,9,1,0.9,12,9,3,0.75,0.8181818181818182,gemini,mimiciii,radiology_report,PROMPT1_entailment
66,158,5,5,0,1.0,6,3,3,0.5,0.6666666666666666,gemini,mimiciii,radiology_report,PROMPT1_entailment
67,159,10,10,0,1.0,13,11,2,0.8461538461538461,0.9166666666666666,gemini,mimiciii,radiology_report,PROMPT1_entailment
68,16,16,11,5,0.6875,17,11,6,0.6470588235294118,0.6666666666666667,gemini,mimiciii,radiology_report,PROMPT1_entailment
69,160,10,9,1,0.9,12,7,5,0.5833333333333334,0.7078651685393258,gemini,mimiciii,radiology_report,PROMPT1_entailment
70,161,9,6,3,0.6666666666666666,13,9,4,0.6923076923076923,0.6792452830188679,gemini,mimiciii,radiology_report,PROMPT1_entailment
71,162,11,9,2,0.8181818181818182,11,9,2,0.8181818181818182,0.8181818181818182,gemini,mimiciii,radiology_report,PROMPT1_entailment
72,163,7,7,0,1.0,8,5,3,0.625,0.7692307692307693,gemini,mimiciii,radiology_report,PROMPT1_entailment
73,164,7,7,0,1.0,10,8,2,0.8,0.888888888888889,gemini,mimiciii,radiology_report,PROMPT1_entailment
74,165,14,13,1,0.9285714285714286,28,24,4,0.8571428571428571,0.8914285714285715,gemini,mimiciii,radiology_report,PROMPT1_entailment
75,166,28,14,14,0.5,26,18,8,0.6923076923076923,0.5806451612903226,gemini,mimiciii,radiology_report,PROMPT1_entailment
76,167,5,4,1,0.8,10,5,5,0.5,0.6153846153846154,gemini,mimiciii,radiology_report,PROMPT1_entailment
77,168,10,9,1,0.9,13,9,4,0.6923076923076923,0.7826086956521738,gemini,mimiciii,radiology_report,PROMPT1_entailment
78,169,15,11,4,0.7333333333333333,22,20,2,0.9090909090909092,0.8118081180811808,gemini,mimiciii,radiology_report,PROMPT1_entailment
79,17,6,6,0,1.0,12,9,3,0.75,0.8571428571428571,gemini,mimiciii,radiology_report,PROMPT1_entailment
80,170,17,13,4,0.7647058823529411,24,17,7,0.7083333333333334,0.735440931780366,gemini,mimiciii,radiology_report,PROMPT1_entailment
81,171,5,5,0,1.0,7,6,1,0.8571428571428571,0.923076923076923,gemini,mimiciii,radiology_report,PROMPT1_entailment
82,172,8,6,2,0.75,14,8,6,0.5714285714285714,0.6486486486486486,gemini,mimiciii,radiology_report,PROMPT1_entailment
83,173,8,7,1,0.875,12,10,2,0.8333333333333334,0.8536585365853658,gemini,mimiciii,radiology_report,PROMPT1_entailment
84,174,10,10,0,1.0,20,13,7,0.65,0.787878787878788,gemini,mimiciii,radiology_report,PROMPT1_entailment
85,175,6,6,0,1.0,8,7,1,0.875,0.9333333333333332,gemini,mimiciii,radiology_report,PROMPT1_entailment
86,176,12,7,5,0.5833333333333334,19,17,2,0.8947368421052632,0.7062314540059348,gemini,mimiciii,radiology_report,PROMPT1_entailment
87,177,10,8,2,0.8,16,14,2,0.875,0.8358208955223881,gemini,mimiciii,radiology_report,PROMPT1_entailment
88,178,13,8,5,0.6153846153846154,25,19,6,0.76,0.680089485458613,gemini,mimiciii,radiology_report,PROMPT1_entailment
89,179,8,7,1,0.875,17,10,7,0.5882352941176471,0.7035175879396985,gemini,mimiciii,radiology_report,PROMPT1_entailment
90,18,13,11,2,0.8461538461538461,17,10,7,0.5882352941176471,0.694006309148265,gemini,mimiciii,radiology_report,PROMPT1_entailment
91,180,12,10,2,0.8333333333333334,11,8,3,0.7272727272727273,0.7766990291262137,gemini,mimiciii,radiology_report,PROMPT1_entailment
92,181,23,21,2,0.9130434782608696,26,19,7,0.7307692307692307,0.8118006103763987,gemini,mimiciii,radiology_report,PROMPT1_entailment
93,182,13,9,4,0.6923076923076923,23,18,5,0.782608695652174,0.7346938775510203,gemini,mimiciii,radiology_report,PROMPT1_entailment
94,183,7,6,1,0.8571428571428571,17,7,10,0.4117647058823529,0.5562913907284768,gemini,mimiciii,radiology_report,PROMPT1_entailment
95,184,10,7,3,0.7,15,11,4,0.7333333333333333,0.7162790697674419,gemini,mimiciii,radiology_report,PROMPT1_entailment
96,185,7,6,1,0.8571428571428571,6,3,3,0.5,0.631578947368421,gemini,mimiciii,radiology_report,PROMPT1_entailment
97,186,7,6,1,0.8571428571428571,26,20,6,0.7692307692307693,0.8108108108108107,gemini,mimiciii,radiology_report,PROMPT1_entailment
98,187,9,7,2,0.7777777777777778,14,11,3,0.7857142857142857,0.7817258883248731,gemini,mimiciii,radiology_report,PROMPT1_entailment
99,188,10,9,1,0.9,22,16,6,0.7272727272727273,0.8044692737430167,gemini,mimiciii,radiology_report,PROMPT1_entailment
100,189,9,9,0,1.0,15,13,2,0.8666666666666667,0.9285714285714286,gemini,mimiciii,radiology_report,PROMPT1_entailment
101,19,8,7,1,0.875,14,10,4,0.7142857142857143,0.7865168539325842,gemini,mimiciii,radiology_report,PROMPT1_entailment
102,190,13,11,2,0.8461538461538461,17,15,2,0.8823529411764706,0.8638743455497382,gemini,mimiciii,radiology_report,PROMPT1_entailment
103,191,10,6,4,0.6,15,10,5,0.6666666666666666,0.631578947368421,gemini,mimiciii,radiology_report,PROMPT1_entailment
104,192,9,7,2,0.7777777777777778,28,21,7,0.75,0.7636363636363638,gemini,mimiciii,radiology_report,PROMPT1_entailment
105,193,12,7,5,0.5833333333333334,14,13,1,0.9285714285714286,0.7165354330708663,gemini,mimiciii,radiology_report,PROMPT1_entailment
106,194,18,15,3,0.8333333333333334,38,34,4,0.8947368421052632,0.8629441624365481,gemini,mimiciii,radiology_report,PROMPT1_entailment
107,195,16,11,5,0.6875,21,14,7,0.6666666666666666,0.676923076923077,gemini,mimiciii,radiology_report,PROMPT1_entailment
108,196,14,10,4,0.7142857142857143,18,15,3,0.8333333333333334,0.7692307692307692,gemini,mimiciii,radiology_report,PROMPT1_entailment
109,197,8,5,3,0.625,15,9,6,0.6,0.6122448979591836,gemini,mimiciii,radiology_report,PROMPT1_entailment
110,198,10,9,1,0.9,9,7,2,0.7777777777777778,0.8344370860927153,gemini,mimiciii,radiology_report,PROMPT1_entailment
111,199,14,11,3,0.7857142857142857,23,19,4,0.8260869565217391,0.8053949903660885,gemini,mimiciii,radiology_report,PROMPT1_entailment
112,2,8,6,2,0.75,15,8,7,0.5333333333333333,0.6233766233766235,gemini,mimiciii,radiology_report,PROMPT1_entailment
113,20,6,6,0,1.0,42,32,10,0.7619047619047619,0.8648648648648648,gemini,mimiciii,radiology_report,PROMPT1_entailment
114,200,16,14,2,0.875,14,12,2,0.8571428571428571,0.8659793814432989,gemini,mimiciii,radiology_report,PROMPT1_entailment
115,201,12,8,4,0.6666666666666666,18,14,4,0.7777777777777778,0.717948717948718,gemini,mimiciii,radiology_report,PROMPT1_entailment
116,202,14,11,3,0.7857142857142857,24,15,9,0.625,0.6962025316455697,gemini,mimiciii,radiology_report,PROMPT1_entailment
117,203,13,11,2,0.8461538461538461,19,16,3,0.8421052631578947,0.8441247002398081,gemini,mimiciii,radiology_report,PROMPT1_entailment
118,204,13,10,3,0.7692307692307693,23,18,5,0.782608695652174,0.7758620689655172,gemini,mimiciii,radiology_report,PROMPT1_entailment
119,205,9,6,3,0.6666666666666666,14,13,1,0.9285714285714286,0.7761194029850746,gemini,mimiciii,radiology_report,PROMPT1_entailment
120,206,6,4,2,0.6666666666666666,13,10,3,0.7692307692307693,0.7142857142857142,gemini,mimiciii,radiology_report,PROMPT1_entailment
121,207,7,6,1,0.8571428571428571,9,6,3,0.6666666666666666,0.75,gemini,mimiciii,radiology_report,PROMPT1_entailment
122,208,11,9,2,0.8181818181818182,18,13,5,0.7222222222222222,0.7672131147540984,gemini,mimiciii,radiology_report,PROMPT1_entailment
123,209,11,9,2,0.8181818181818182,16,12,4,0.75,0.7826086956521738,gemini,mimiciii,radiology_report,PROMPT1_entailment
124,21,16,14,2,0.875,27,18,9,0.6666666666666666,0.7567567567567567,gemini,mimiciii,radiology_report,PROMPT1_entailment
125,210,6,5,1,0.8333333333333334,14,10,4,0.7142857142857143,0.7692307692307692,gemini,mimiciii,radiology_report,PROMPT1_entailment
126,211,7,6,1,0.8571428571428571,13,11,2,0.8461538461538461,0.8516129032258064,gemini,mimiciii,radiology_report,PROMPT1_entailment
127,212,8,6,2,0.75,19,17,2,0.8947368421052632,0.816,gemini,mimiciii,radiology_report,PROMPT1_entailment
128,213,13,9,4,0.6923076923076923,22,14,8,0.6363636363636364,0.663157894736842,gemini,mimiciii,radiology_report,PROMPT1_entailment
129,214,22,14,8,0.6363636363636364,23,19,4,0.8260869565217391,0.7189189189189189,gemini,mimiciii,radiology_report,PROMPT1_entailment
130,215,3,2,1,0.6666666666666666,10,8,2,0.8,0.7272727272727272,gemini,mimiciii,radiology_report,PROMPT1_entailment
131,216,9,8,1,0.8888888888888888,19,15,4,0.7894736842105263,0.8362369337979094,gemini,mimiciii,radiology_report,PROMPT1_entailment
132,217,10,6,4,0.6,20,13,7,0.65,0.624,gemini,mimiciii,radiology_report,PROMPT1_entailment
133,218,19,10,9,0.5263157894736842,15,10,5,0.6666666666666666,0.5882352941176471,gemini,mimiciii,radiology_report,PROMPT1_entailment
134,219,12,10,2,0.8333333333333334,13,9,4,0.6923076923076923,0.7563025210084034,gemini,mimiciii,radiology_report,PROMPT1_entailment
135,22,9,7,2,0.7777777777777778,19,17,2,0.8947368421052632,0.8321678321678322,gemini,mimiciii,radiology_report,PROMPT1_entailment
136,220,11,9,2,0.8181818181818182,19,18,1,0.9473684210526316,0.8780487804878049,gemini,mimiciii,radiology_report,PROMPT1_entailment
137,221,12,7,5,0.5833333333333334,27,19,8,0.7037037037037037,0.6378896882494005,gemini,mimiciii,radiology_report,PROMPT1_entailment
138,222,10,8,2,0.8,16,14,2,0.875,0.8358208955223881,gemini,mimiciii,radiology_report,PROMPT1_entailment
139,223,13,10,3,0.7692307692307693,21,15,6,0.7142857142857143,0.7407407407407408,gemini,mimiciii,radiology_report,PROMPT1_entailment
140,224,12,8,4,0.6666666666666666,17,10,7,0.5882352941176471,0.625,gemini,mimiciii,radiology_report,PROMPT1_entailment
141,225,7,7,0,1.0,11,9,2,0.8181818181818182,0.9,gemini,mimiciii,radiology_report,PROMPT1_entailment
142,226,10,8,2,0.8,18,15,3,0.8333333333333334,0.816326530612245,gemini,mimiciii,radiology_report,PROMPT1_entailment
143,227,13,13,0,1.0,18,16,2,0.8888888888888888,0.9411764705882352,gemini,mimiciii,radiology_report,PROMPT1_entailment
144,228,15,11,4,0.7333333333333333,17,14,3,0.8235294117647058,0.7758186397984888,gemini,mimiciii,radiology_report,PROMPT1_entailment
145,229,18,17,1,0.9444444444444444,44,31,13,0.7045454545454546,0.8070444104134763,gemini,mimiciii,radiology_report,PROMPT1_entailment
146,23,11,9,2,0.8181818181818182,15,13,2,0.8666666666666667,0.8417266187050358,gemini,mimiciii,radiology_report,PROMPT1_entailment
147,230,12,11,1,0.9166666666666666,17,14,3,0.8235294117647058,0.8676056338028169,gemini,mimiciii,radiology_report,PROMPT1_entailment
148,231,11,11,0,1.0,13,10,3,0.7692307692307693,0.8695652173913044,gemini,mimiciii,radiology_report,PROMPT1_entailment
149,232,5,2,3,0.4,18,14,4,0.7777777777777778,0.5283018867924528,gemini,mimiciii,radiology_report,PROMPT1_entailment
150,233,7,5,2,0.7142857142857143,17,11,6,0.6470588235294118,0.6790123456790124,gemini,mimiciii,radiology_report,PROMPT1_entailment
151,234,8,6,2,0.75,11,8,3,0.7272727272727273,0.7384615384615384,gemini,mimiciii,radiology_report,PROMPT1_entailment
152,235,7,5,2,0.7142857142857143,14,10,4,0.7142857142857143,0.7142857142857143,gemini,mimiciii,radiology_report,PROMPT1_entailment
153,236,12,11,1,0.9166666666666666,11,9,2,0.8181818181818182,0.8646288209606987,gemini,mimiciii,radiology_report,PROMPT1_entailment
154,237,7,2,5,0.2857142857142857,17,12,5,0.7058823529411765,0.4067796610169491,gemini,mimiciii,radiology_report,PROMPT1_entailment
155,238,12,9,3,0.75,20,14,6,0.7,0.7241379310344827,gemini,mimiciii,radiology_report,PROMPT1_entailment
156,239,12,6,6,0.5,17,12,5,0.7058823529411765,0.5853658536585366,gemini,mimiciii,radiology_report,PROMPT1_entailment
157,24,16,13,3,0.8125,18,12,6,0.6666666666666666,0.7323943661971831,gemini,mimiciii,radiology_report,PROMPT1_entailment
158,240,7,7,0,1.0,13,11,2,0.8461538461538461,0.9166666666666666,gemini,mimiciii,radiology_report,PROMPT1_entailment
159,241,10,9,1,0.9,16,13,3,0.8125,0.854014598540146,gemini,mimiciii,radiology_report,PROMPT1_entailment
160,242,9,6,3,0.6666666666666666,18,16,2,0.8888888888888888,0.761904761904762,gemini,mimiciii,radiology_report,PROMPT1_entailment
161,243,4,4,0,1.0,13,8,5,0.6153846153846154,0.761904761904762,gemini,mimiciii,radiology_report,PROMPT1_entailment
162,244,15,10,5,0.6666666666666666,17,16,1,0.9411764705882352,0.7804878048780487,gemini,mimiciii,radiology_report,PROMPT1_entailment
163,245,14,10,4,0.7142857142857143,28,26,2,0.9285714285714286,0.8074534161490684,gemini,mimiciii,radiology_report,PROMPT1_entailment
164,246,7,5,2,0.7142857142857143,12,8,4,0.6666666666666666,0.689655172413793,gemini,mimiciii,radiology_report,PROMPT1_entailment
165,247,11,8,3,0.7272727272727273,12,10,2,0.8333333333333334,0.7766990291262137,gemini,mimiciii,radiology_report,PROMPT1_entailment
166,248,10,7,3,0.7,17,13,4,0.7647058823529411,0.7309236947791163,gemini,mimiciii,radiology_report,PROMPT1_entailment
167,249,12,9,3,0.75,23,17,6,0.7391304347826086,0.7445255474452556,gemini,mimiciii,radiology_report,PROMPT1_entailment
168,25,23,17,6,0.7391304347826086,27,20,7,0.7407407407407407,0.7399347116430903,gemini,mimiciii,radiology_report,PROMPT1_entailment
169,250,7,6,1,0.8571428571428571,8,7,1,0.875,0.8659793814432989,gemini,mimiciii,radiology_report,PROMPT1_entailment
170,251,15,13,2,0.8666666666666667,22,18,4,0.8181818181818182,0.8417266187050358,gemini,mimiciii,radiology_report,PROMPT1_entailment
171,252,8,8,0,1.0,10,8,2,0.8,0.888888888888889,gemini,mimiciii,radiology_report,PROMPT1_entailment
172,253,11,8,3,0.7272727272727273,24,19,5,0.7916666666666666,0.7581047381546134,gemini,mimiciii,radiology_report,PROMPT1_entailment
173,254,11,8,3,0.7272727272727273,13,10,3,0.7692307692307693,0.7476635514018691,gemini,mimiciii,radiology_report,PROMPT1_entailment
174,255,9,7,2,0.7777777777777778,16,12,4,0.75,0.7636363636363638,gemini,mimiciii,radiology_report,PROMPT1_entailment
175,256,6,2,4,0.3333333333333333,19,17,2,0.8947368421052632,0.4857142857142856,gemini,mimiciii,radiology_report,PROMPT1_entailment
176,257,7,6,1,0.8571428571428571,15,14,1,0.9333333333333332,0.8936170212765957,gemini,mimiciii,radiology_report,PROMPT1_entailment
177,258,12,11,1,0.9166666666666666,20,14,6,0.7,0.7938144329896907,gemini,mimiciii,radiology_report,PROMPT1_entailment
178,259,11,4,7,0.3636363636363636,17,12,5,0.7058823529411765,0.48,gemini,mimiciii,radiology_report,PROMPT1_entailment
179,26,14,13,1,0.9285714285714286,18,14,4,0.7777777777777778,0.8465116279069766,gemini,mimiciii,radiology_report,PROMPT1_entailment
180,260,16,9,7,0.5625,20,13,7,0.65,0.6030927835051547,gemini,mimiciii,radiology_report,PROMPT1_entailment
181,261,20,17,3,0.85,30,24,6,0.8,0.8242424242424243,gemini,mimiciii,radiology_report,PROMPT1_entailment
182,262,15,9,6,0.6,23,17,6,0.7391304347826086,0.6623376623376623,gemini,mimiciii,radiology_report,PROMPT1_entailment
183,263,9,5,4,0.5555555555555556,27,22,5,0.8148148148148148,0.6606606606606608,gemini,mimiciii,radiology_report,PROMPT1_entailment
184,264,21,16,5,0.7619047619047619,20,17,3,0.85,0.8035450516986705,gemini,mimiciii,radiology_report,PROMPT1_entailment
185,265,11,9,2,0.8181818181818182,9,7,2,0.7777777777777778,0.7974683544303799,gemini,mimiciii,radiology_report,PROMPT1_entailment
186,266,9,7,2,0.7777777777777778,18,17,1,0.9444444444444444,0.8530465949820788,gemini,mimiciii,radiology_report,PROMPT1_entailment
187,267,11,8,3,0.7272727272727273,16,12,4,0.75,0.7384615384615384,gemini,mimiciii,radiology_report,PROMPT1_entailment
188,268,8,6,2,0.75,20,18,2,0.9,0.8181818181818182,gemini,mimiciii,radiology_report,PROMPT1_entailment
189,269,23,22,1,0.9565217391304348,25,21,4,0.84,0.8944820909970957,gemini,mimiciii,radiology_report,PROMPT1_entailment
190,27,17,15,2,0.8823529411764706,14,10,4,0.7142857142857143,0.7894736842105262,gemini,mimiciii,radiology_report,PROMPT1_entailment
191,270,14,12,2,0.8571428571428571,17,14,3,0.8235294117647058,0.84,gemini,mimiciii,radiology_report,PROMPT1_entailment
192,271,9,8,1,0.8888888888888888,17,11,6,0.6470588235294118,0.7489361702127659,gemini,mimiciii,radiology_report,PROMPT1_entailment
193,272,13,9,4,0.6923076923076923,17,10,7,0.5882352941176471,0.6360424028268552,gemini,mimiciii,radiology_report,PROMPT1_entailment
194,273,7,7,0,1.0,12,8,4,0.6666666666666666,0.8,gemini,mimiciii,radiology_report,PROMPT1_entailment
195,274,10,4,6,0.4,20,13,7,0.65,0.4952380952380952,gemini,mimiciii,radiology_report,PROMPT1_entailment
196,275,14,14,0,1.0,12,12,0,1.0,1.0,gemini,mimiciii,radiology_report,PROMPT1_entailment
197,276,9,9,0,1.0,24,18,6,0.75,0.8571428571428571,gemini,mimiciii,radiology_report,PROMPT1_entailment
198,277,18,15,3,0.8333333333333334,25,14,11,0.56,0.6698564593301435,gemini,mimiciii,radiology_report,PROMPT1_entailment
199,278,12,11,1,0.9166666666666666,16,11,5,0.6875,0.7857142857142857,gemini,mimiciii,radiology_report,PROMPT1_entailment
200,279,10,9,1,0.9,10,7,3,0.7,0.7875,gemini,mimiciii,radiology_report,PROMPT1_entailment
201,28,12,12,0,1.0,30,22,8,0.7333333333333333,0.846153846153846,gemini,mimiciii,radiology_report,PROMPT1_entailment
202,280,6,3,3,0.5,12,8,4,0.6666666666666666,0.5714285714285715,gemini,mimiciii,radiology_report,PROMPT1_entailment
203,281,16,13,3,0.8125,24,20,4,0.8333333333333334,0.8227848101265822,gemini,mimiciii,radiology_report,PROMPT1_entailment
204,282,12,10,2,0.8333333333333334,12,10,2,0.8333333333333334,0.8333333333333334,gemini,mimiciii,radiology_report,PROMPT1_entailment
205,283,16,14,2,0.875,25,21,4,0.84,0.8571428571428572,gemini,mimiciii,radiology_report,PROMPT1_entailment
206,284,12,7,5,0.5833333333333334,14,9,5,0.6428571428571429,0.6116504854368933,gemini,mimiciii,radiology_report,PROMPT1_entailment
207,285,10,9,1,0.9,18,15,3,0.8333333333333334,0.8653846153846153,gemini,mimiciii,radiology_report,PROMPT1_entailment
208,286,7,7,0,1.0,6,6,0,1.0,1.0,gemini,mimiciii,radiology_report,PROMPT1_entailment
209,287,11,11,0,1.0,18,14,4,0.7777777777777778,0.8750000000000001,gemini,mimiciii,radiology_report,PROMPT1_entailment
210,288,12,10,2,0.8333333333333334,32,28,4,0.875,0.8536585365853658,gemini,mimiciii,radiology_report,PROMPT1_entailment
211,289,21,13,8,0.6190476190476191,20,15,5,0.75,0.6782608695652174,gemini,mimiciii,radiology_report,PROMPT1_entailment
212,29,8,8,0,1.0,8,6,2,0.75,0.8571428571428571,gemini,mimiciii,radiology_report,PROMPT1_entailment
213,290,11,10,1,0.9090909090909092,11,8,3,0.7272727272727273,0.8080808080808082,gemini,mimiciii,radiology_report,PROMPT1_entailment
214,291,11,8,3,0.7272727272727273,23,13,10,0.5652173913043478,0.6360856269113149,gemini,mimiciii,radiology_report,PROMPT1_entailment
215,292,7,5,2,0.7142857142857143,21,16,5,0.7619047619047619,0.7373271889400921,gemini,mimiciii,radiology_report,PROMPT1_entailment
216,293,8,5,3,0.625,18,14,4,0.7777777777777778,0.6930693069306931,gemini,mimiciii,radiology_report,PROMPT1_entailment
217,294,7,4,3,0.5714285714285714,22,11,11,0.5,0.5333333333333333,gemini,mimiciii,radiology_report,PROMPT1_entailment
218,295,5,5,0,1.0,32,25,7,0.78125,0.8771929824561403,gemini,mimiciii,radiology_report,PROMPT1_entailment
219,296,17,15,2,0.8823529411764706,17,13,4,0.7647058823529411,0.8193277310924368,gemini,mimiciii,radiology_report,PROMPT1_entailment
220,297,12,11,1,0.9166666666666666,24,17,7,0.7083333333333334,0.7991452991452992,gemini,mimiciii,radiology_report,PROMPT1_entailment
221,298,16,11,5,0.6875,20,15,5,0.75,0.717391304347826,gemini,mimiciii,radiology_report,PROMPT1_entailment
222,299,23,21,2,0.9130434782608696,28,25,3,0.8928571428571429,0.9028374892519346,gemini,mimiciii,radiology_report,PROMPT1_entailment
223,3,11,11,0,1.0,20,16,4,0.8,0.888888888888889,gemini,mimiciii,radiology_report,PROMPT1_entailment
224,30,17,12,5,0.7058823529411765,25,22,3,0.88,0.7833827893175075,gemini,mimiciii,radiology_report,PROMPT1_entailment
225,300,11,9,2,0.8181818181818182,13,9,4,0.6923076923076923,0.7500000000000001,gemini,mimiciii,radiology_report,PROMPT1_entailment
226,301,8,8,0,1.0,16,11,5,0.6875,0.8148148148148148,gemini,mimiciii,radiology_report,PROMPT1_entailment
227,302,15,11,4,0.7333333333333333,15,10,5,0.6666666666666666,0.6984126984126984,gemini,mimiciii,radiology_report,PROMPT1_entailment
228,303,6,4,2,0.6666666666666666,24,18,6,0.75,0.7058823529411765,gemini,mimiciii,radiology_report,PROMPT1_entailment
229,304,7,6,1,0.8571428571428571,19,17,2,0.8947368421052632,0.8755364806866952,gemini,mimiciii,radiology_report,PROMPT1_entailment
230,305,13,9,4,0.6923076923076923,24,21,3,0.875,0.7730061349693251,gemini,mimiciii,radiology_report,PROMPT1_entailment
231,306,12,7,5,0.5833333333333334,14,10,4,0.7142857142857143,0.6422018348623854,gemini,mimiciii,radiology_report,PROMPT1_entailment
232,307,12,12,0,1.0,17,10,7,0.5882352941176471,0.7407407407407407,gemini,mimiciii,radiology_report,PROMPT1_entailment
233,308,11,9,2,0.8181818181818182,15,12,3,0.8,0.8089887640449439,gemini,mimiciii,radiology_report,PROMPT1_entailment
234,309,11,9,2,0.8181818181818182,26,20,6,0.7692307692307693,0.7929515418502203,gemini,mimiciii,radiology_report,PROMPT1_entailment
235,31,9,4,5,0.4444444444444444,19,13,6,0.6842105263157895,0.5388601036269429,gemini,mimiciii,radiology_report,PROMPT1_entailment
236,310,16,12,4,0.75,24,18,6,0.75,0.75,gemini,mimiciii,radiology_report,PROMPT1_entailment
237,311,9,8,1,0.8888888888888888,15,9,6,0.6,0.7164179104477612,gemini,mimiciii,radiology_report,PROMPT1_entailment
238,312,13,11,2,0.8461538461538461,18,12,6,0.6666666666666666,0.7457627118644068,gemini,mimiciii,radiology_report,PROMPT1_entailment
239,313,10,8,2,0.8,17,12,5,0.7058823529411765,0.7500000000000001,gemini,mimiciii,radiology_report,PROMPT1_entailment
240,314,11,6,5,0.5454545454545454,15,14,1,0.9333333333333332,0.6885245901639344,gemini,mimiciii,radiology_report,PROMPT1_entailment
241,315,29,18,11,0.6206896551724138,25,17,8,0.68,0.6489925768822906,gemini,mimiciii,radiology_report,PROMPT1_entailment
242,316,8,6,2,0.75,10,9,1,0.9,0.8181818181818182,gemini,mimiciii,radiology_report,PROMPT1_entailment
243,317,11,9,2,0.8181818181818182,26,23,3,0.8846153846153846,0.8501026694045174,gemini,mimiciii,radiology_report,PROMPT1_entailment
244,318,12,8,4,0.6666666666666666,21,14,7,0.6666666666666666,0.6666666666666666,gemini,mimiciii,radiology_report,PROMPT1_entailment
245,319,12,12,0,1.0,12,11,1,0.9166666666666666,0.9565217391304348,gemini,mimiciii,radiology_report,PROMPT1_entailment
246,32,12,11,1,0.9166666666666666,15,12,3,0.8,0.854368932038835,gemini,mimiciii,radiology_report,PROMPT1_entailment
247,320,5,5,0,1.0,11,9,2,0.8181818181818182,0.9,gemini,mimiciii,radiology_report,PROMPT1_entailment
248,321,13,8,5,0.6153846153846154,21,17,4,0.8095238095238095,0.699228791773779,gemini,mimiciii,radiology_report,PROMPT1_entailment
249,322,8,8,0,1.0,8,7,1,0.875,0.9333333333333332,gemini,mimiciii,radiology_report,PROMPT1_entailment
250,323,12,9,3,0.75,25,16,9,0.64,0.6906474820143884,gemini,mimiciii,radiology_report,PROMPT1_entailment
251,324,16,10,6,0.625,18,16,2,0.8888888888888888,0.7339449541284404,gemini,mimiciii,radiology_report,PROMPT1_entailment
252,325,12,11,1,0.9166666666666666,22,17,5,0.7727272727272727,0.8385650224215245,gemini,mimiciii,radiology_report,PROMPT1_entailment
253,326,11,7,4,0.6363636363636364,23,21,2,0.9130434782608696,0.75,gemini,mimiciii,radiology_report,PROMPT1_entailment
254,327,10,8,2,0.8,9,9,0,1.0,0.888888888888889,gemini,mimiciii,radiology_report,PROMPT1_entailment
255,328,13,12,1,0.9230769230769232,17,12,5,0.7058823529411765,0.8000000000000002,gemini,mimiciii,radiology_report,PROMPT1_entailment
256,329,14,12,2,0.8571428571428571,24,18,6,0.75,0.7999999999999999,gemini,mimiciii,radiology_report,PROMPT1_entailment
257,33,7,5,2,0.7142857142857143,9,8,1,0.8888888888888888,0.792079207920792,gemini,mimiciii,radiology_report,PROMPT1_entailment
258,330,11,8,3,0.7272727272727273,11,11,0,1.0,0.8421052631578948,gemini,mimiciii,radiology_report,PROMPT1_entailment
259,331,12,9,3,0.75,15,14,1,0.9333333333333332,0.8316831683168316,gemini,mimiciii,radiology_report,PROMPT1_entailment
260,332,15,12,3,0.8,19,13,6,0.6842105263157895,0.7375886524822695,gemini,mimiciii,radiology_report,PROMPT1_entailment
261,333,10,10,0,1.0,13,11,2,0.8461538461538461,0.9166666666666666,gemini,mimiciii,radiology_report,PROMPT1_entailment
262,334,16,11,5,0.6875,20,18,2,0.9,0.7795275590551182,gemini,mimiciii,radiology_report,PROMPT1_entailment
263,335,16,13,3,0.8125,17,14,3,0.8235294117647058,0.8179775280898876,gemini,mimiciii,radiology_report,PROMPT1_entailment
264,336,14,10,4,0.7142857142857143,16,11,5,0.6875,0.7006369426751592,gemini,mimiciii,radiology_report,PROMPT1_entailment
265,337,16,14,2,0.875,16,14,2,0.875,0.875,gemini,mimiciii,radiology_report,PROMPT1_entailment
266,338,9,9,0,1.0,13,12,1,0.9230769230769232,0.96,gemini,mimiciii,radiology_report,PROMPT1_entailment
267,339,17,14,3,0.8235294117647058,28,23,5,0.8214285714285714,0.8224776500638569,gemini,mimiciii,radiology_report,PROMPT1_entailment
268,34,8,8,0,1.0,14,13,1,0.9285714285714286,0.962962962962963,gemini,mimiciii,radiology_report,PROMPT1_entailment
269,340,20,11,9,0.55,15,13,2,0.8666666666666667,0.6729411764705883,gemini,mimiciii,radiology_report,PROMPT1_entailment
270,341,6,6,0,1.0,6,6,0,1.0,1.0,gemini,mimiciii,radiology_report,PROMPT1_entailment
271,342,8,6,2,0.75,15,13,2,0.8666666666666667,0.8041237113402062,gemini,mimiciii,radiology_report,PROMPT1_entailment
272,343,11,10,1,0.9090909090909092,22,17,5,0.7727272727272727,0.8353808353808354,gemini,mimiciii,radiology_report,PROMPT1_entailment
273,344,11,8,3,0.7272727272727273,19,15,4,0.7894736842105263,0.7570977917981072,gemini,mimiciii,radiology_report,PROMPT1_entailment
274,345,27,18,9,0.6666666666666666,22,15,7,0.6818181818181818,0.6741573033707865,gemini,mimiciii,radiology_report,PROMPT1_entailment
275,346,10,8,2,0.8,15,13,2,0.8666666666666667,0.832,gemini,mimiciii,radiology_report,PROMPT1_entailment
276,347,8,7,1,0.875,15,13,2,0.8666666666666667,0.8708133971291866,gemini,mimiciii,radiology_report,PROMPT1_entailment
277,348,10,5,5,0.5,12,6,6,0.5,0.5,gemini,mimiciii,radiology_report,PROMPT1_entailment
278,349,4,3,1,0.75,16,11,5,0.6875,0.717391304347826,gemini,mimiciii,radiology_report,PROMPT1_entailment
279,35,8,3,5,0.375,21,17,4,0.8095238095238095,0.5125628140703518,gemini,mimiciii,radiology_report,PROMPT1_entailment
280,350,9,5,4,0.5555555555555556,21,15,6,0.7142857142857143,0.6250000000000001,gemini,mimiciii,radiology_report,PROMPT1_entailment
281,351,10,9,1,0.9,21,20,1,0.9523809523809524,0.9254498714652956,gemini,mimiciii,radiology_report,PROMPT1_entailment
282,352,15,9,6,0.6,22,15,7,0.6818181818181818,0.6382978723404256,gemini,mimiciii,radiology_report,PROMPT1_entailment
283,353,15,8,7,0.5333333333333333,23,14,9,0.6086956521739131,0.568527918781726,gemini,mimiciii,radiology_report,PROMPT1_entailment
284,354,12,5,7,0.4166666666666667,26,19,7,0.7307692307692307,0.5307262569832402,gemini,mimiciii,radiology_report,PROMPT1_entailment
285,355,11,10,1,0.9090909090909092,18,16,2,0.8888888888888888,0.8988764044943819,gemini,mimiciii,radiology_report,PROMPT1_entailment
286,356,14,10,4,0.7142857142857143,22,16,6,0.7272727272727273,0.7207207207207208,gemini,mimiciii,radiology_report,PROMPT1_entailment
287,357,8,6,2,0.75,15,7,8,0.4666666666666667,0.5753424657534245,gemini,mimiciii,radiology_report,PROMPT1_entailment
288,358,8,6,2,0.75,12,10,2,0.8333333333333334,0.7894736842105262,gemini,mimiciii,radiology_report,PROMPT1_entailment
289,359,9,6,3,0.6666666666666666,18,16,2,0.8888888888888888,0.761904761904762,gemini,mimiciii,radiology_report,PROMPT1_entailment
290,36,21,12,9,0.5714285714285714,22,16,6,0.7272727272727273,0.64,gemini,mimiciii,radiology_report,PROMPT1_entailment
291,360,14,13,1,0.9285714285714286,15,10,5,0.6666666666666666,0.7761194029850746,gemini,mimiciii,radiology_report,PROMPT1_entailment
292,361,23,11,12,0.4782608695652174,23,21,2,0.9130434782608696,0.6277173913043479,gemini,mimiciii,radiology_report,PROMPT1_entailment
293,362,13,7,6,0.5384615384615384,24,17,7,0.7083333333333334,0.6118251928020565,gemini,mimiciii,radiology_report,PROMPT1_entailment
294,363,15,9,6,0.6,22,15,7,0.6818181818181818,0.6382978723404256,gemini,mimiciii,radiology_report,PROMPT1_entailment
295,364,6,6,0,1.0,11,8,3,0.7272727272727273,0.8421052631578948,gemini,mimiciii,radiology_report,PROMPT1_entailment
296,365,25,18,7,0.72,29,22,7,0.7586206896551724,0.7388059701492536,gemini,mimiciii,radiology_report,PROMPT1_entailment
297,366,10,8,2,0.8,13,7,6,0.5384615384615384,0.6436781609195402,gemini,mimiciii,radiology_report,PROMPT1_entailment
298,367,28,20,8,0.7142857142857143,16,11,5,0.6875,0.7006369426751592,gemini,mimiciii,radiology_report,PROMPT1_entailment
299,368,12,8,4,0.6666666666666666,20,15,5,0.75,0.7058823529411765,gemini,mimiciii,radiology_report,PROMPT1_entailment
300,369,24,17,7,0.7083333333333334,20,14,6,0.7,0.7041420118343196,gemini,mimiciii,radiology_report,PROMPT1_entailment
301,37,11,9,2,0.8181818181818182,21,13,8,0.6190476190476191,0.7048192771084337,gemini,mimiciii,radiology_report,PROMPT1_entailment
302,370,12,7,5,0.5833333333333334,19,12,7,0.631578947368421,0.6064981949458484,gemini,mimiciii,radiology_report,PROMPT1_entailment
303,371,12,9,3,0.75,17,13,4,0.7647058823529411,0.7572815533980582,gemini,mimiciii,radiology_report,PROMPT1_entailment
304,372,14,13,1,0.9285714285714286,27,23,4,0.8518518518518519,0.8885586924219911,gemini,mimiciii,radiology_report,PROMPT1_entailment
305,373,12,8,4,0.6666666666666666,23,17,6,0.7391304347826086,0.7010309278350515,gemini,mimiciii,radiology_report,PROMPT1_entailment
306,374,11,9,2,0.8181818181818182,11,7,4,0.6363636363636364,0.7159090909090909,gemini,mimiciii,radiology_report,PROMPT1_entailment
307,375,11,11,0,1.0,16,12,4,0.75,0.8571428571428571,gemini,mimiciii,radiology_report,PROMPT1_entailment
308,376,13,8,5,0.6153846153846154,18,16,2,0.8888888888888888,0.7272727272727274,gemini,mimiciii,radiology_report,PROMPT1_entailment
309,377,11,10,1,0.9090909090909092,10,8,2,0.8,0.8510638297872342,gemini,mimiciii,radiology_report,PROMPT1_entailment
310,378,14,12,2,0.8571428571428571,24,17,7,0.7083333333333334,0.7756653992395437,gemini,mimiciii,radiology_report,PROMPT1_entailment
311,379,11,8,3,0.7272727272727273,18,18,0,1.0,0.8421052631578948,gemini,mimiciii,radiology_report,PROMPT1_entailment
312,38,10,7,3,0.7,19,17,2,0.8947368421052632,0.7854785478547854,gemini,mimiciii,radiology_report,PROMPT1_entailment
313,380,5,5,0,1.0,8,6,2,0.75,0.8571428571428571,gemini,mimiciii,radiology_report,PROMPT1_entailment
314,381,9,7,2,0.7777777777777778,14,11,3,0.7857142857142857,0.7817258883248731,gemini,mimiciii,radiology_report,PROMPT1_entailment
315,382,5,5,0,1.0,13,11,2,0.8461538461538461,0.9166666666666666,gemini,mimiciii,radiology_report,PROMPT1_entailment
316,383,15,9,6,0.6,17,14,3,0.8235294117647058,0.6942148760330579,gemini,mimiciii,radiology_report,PROMPT1_entailment
317,384,9,8,1,0.8888888888888888,13,12,1,0.9230769230769232,0.9056603773584906,gemini,mimiciii,radiology_report,PROMPT1_entailment
318,385,14,7,7,0.5,27,23,4,0.8518518518518519,0.6301369863013698,gemini,mimiciii,radiology_report,PROMPT1_entailment
319,386,11,8,3,0.7272727272727273,18,15,3,0.8333333333333334,0.7766990291262137,gemini,mimiciii,radiology_report,PROMPT1_entailment
320,387,11,10,1,0.9090909090909092,19,13,6,0.6842105263157895,0.7807807807807808,gemini,mimiciii,radiology_report,PROMPT1_entailment
321,388,14,10,4,0.7142857142857143,33,28,5,0.8484848484848485,0.775623268698061,gemini,mimiciii,radiology_report,PROMPT1_entailment
322,389,10,7,3,0.7,12,10,2,0.8333333333333334,0.7608695652173915,gemini,mimiciii,radiology_report,PROMPT1_entailment
323,39,11,11,0,1.0,10,8,2,0.8,0.888888888888889,gemini,mimiciii,radiology_report,PROMPT1_entailment
324,390,11,9,2,0.8181818181818182,14,12,2,0.8571428571428571,0.8372093023255814,gemini,mimiciii,radiology_report,PROMPT1_entailment
325,391,10,8,2,0.8,13,10,3,0.7692307692307693,0.7843137254901961,gemini,mimiciii,radiology_report,PROMPT1_entailment
326,392,11,8,3,0.7272727272727273,15,7,8,0.4666666666666667,0.5685279187817259,gemini,mimiciii,radiology_report,PROMPT1_entailment
327,393,15,9,6,0.6,19,15,4,0.7894736842105263,0.6818181818181819,gemini,mimiciii,radiology_report,PROMPT1_entailment
328,394,14,13,1,0.9285714285714286,18,15,3,0.8333333333333334,0.8783783783783784,gemini,mimiciii,radiology_report,PROMPT1_entailment
329,395,12,10,2,0.8333333333333334,16,14,2,0.875,0.8536585365853658,gemini,mimiciii,radiology_report,PROMPT1_entailment
330,396,12,8,4,0.6666666666666666,19,16,3,0.8421052631578947,0.744186046511628,gemini,mimiciii,radiology_report,PROMPT1_entailment
331,397,13,8,5,0.6153846153846154,18,12,6,0.6666666666666666,0.64,gemini,mimiciii,radiology_report,PROMPT1_entailment
332,398,7,3,4,0.4285714285714285,21,16,5,0.7619047619047619,0.5485714285714285,gemini,mimiciii,radiology_report,PROMPT1_entailment
333,399,7,7,0,1.0,19,16,3,0.8421052631578947,0.9142857142857144,gemini,mimiciii,radiology_report,PROMPT1_entailment
334,4,14,12,2,0.8571428571428571,16,10,6,0.625,0.7228915662650602,gemini,mimiciii,radiology_report,PROMPT1_entailment
335,40,9,7,2,0.7777777777777778,17,14,3,0.8235294117647058,0.7999999999999999,gemini,mimiciii,radiology_report,PROMPT1_entailment
336,400,10,8,2,0.8,13,11,2,0.8461538461538461,0.8224299065420562,gemini,mimiciii,radiology_report,PROMPT1_entailment
337,401,7,7,0,1.0,9,8,1,0.8888888888888888,0.9411764705882352,gemini,mimiciii,radiology_report,PROMPT1_entailment
338,402,10,9,1,0.9,20,14,6,0.7,0.7875,gemini,mimiciii,radiology_report,PROMPT1_entailment
339,403,9,6,3,0.6666666666666666,18,12,6,0.6666666666666666,0.6666666666666666,gemini,mimiciii,radiology_report,PROMPT1_entailment
340,404,17,15,2,0.8823529411764706,19,15,4,0.7894736842105263,0.8333333333333333,gemini,mimiciii,radiology_report,PROMPT1_entailment
341,405,9,7,2,0.7777777777777778,14,12,2,0.8571428571428571,0.8155339805825242,gemini,mimiciii,radiology_report,PROMPT1_entailment
342,406,13,11,2,0.8461538461538461,25,21,4,0.84,0.8430656934306568,gemini,mimiciii,radiology_report,PROMPT1_entailment
343,407,13,8,5,0.6153846153846154,20,16,4,0.8,0.6956521739130435,gemini,mimiciii,radiology_report,PROMPT1_entailment
344,408,13,10,3,0.7692307692307693,20,15,5,0.75,0.7594936708860761,gemini,mimiciii,radiology_report,PROMPT1_entailment
345,409,13,13,0,1.0,18,14,4,0.7777777777777778,0.8750000000000001,gemini,mimiciii,radiology_report,PROMPT1_entailment
346,41,23,17,6,0.7391304347826086,26,17,9,0.6538461538461539,0.693877551020408,gemini,mimiciii,radiology_report,PROMPT1_entailment
347,410,11,9,2,0.8181818181818182,20,11,9,0.55,0.6578073089700998,gemini,mimiciii,radiology_report,PROMPT1_entailment
348,411,6,5,1,0.8333333333333334,6,5,1,0.8333333333333334,0.8333333333333334,gemini,mimiciii,radiology_report,PROMPT1_entailment
349,412,16,9,7,0.5625,26,17,9,0.6538461538461539,0.6047430830039526,gemini,mimiciii,radiology_report,PROMPT1_entailment
350,413,9,8,1,0.8888888888888888,14,13,1,0.9285714285714286,0.9082969432314412,gemini,mimiciii,radiology_report,PROMPT1_entailment
351,414,16,13,3,0.8125,28,21,7,0.75,0.78,gemini,mimiciii,radiology_report,PROMPT1_entailment
352,415,11,10,1,0.9090909090909092,20,18,2,0.9,0.9045226130653266,gemini,mimiciii,radiology_report,PROMPT1_entailment
353,416,8,7,1,0.875,17,12,5,0.7058823529411765,0.7813953488372093,gemini,mimiciii,radiology_report,PROMPT1_entailment
354,417,11,7,4,0.6363636363636364,20,17,3,0.85,0.72782874617737,gemini,mimiciii,radiology_report,PROMPT1_entailment
355,418,10,8,2,0.8,14,10,4,0.7142857142857143,0.7547169811320756,gemini,mimiciii,radiology_report,PROMPT1_entailment
356,419,11,8,3,0.7272727272727273,16,14,2,0.875,0.7943262411347517,gemini,mimiciii,radiology_report,PROMPT1_entailment
357,42,10,9,1,0.9,14,8,6,0.5714285714285714,0.6990291262135921,gemini,mimiciii,radiology_report,PROMPT1_entailment
358,420,12,10,2,0.8333333333333334,15,12,3,0.8,0.816326530612245,gemini,mimiciii,radiology_report,PROMPT1_entailment
359,421,12,9,3,0.75,23,17,6,0.7391304347826086,0.7445255474452556,gemini,mimiciii,radiology_report,PROMPT1_entailment
360,422,12,11,1,0.9166666666666666,20,12,8,0.6,0.7252747252747253,gemini,mimiciii,radiology_report,PROMPT1_entailment
361,423,10,9,1,0.9,12,10,2,0.8333333333333334,0.8653846153846153,gemini,mimiciii,radiology_report,PROMPT1_entailment
362,424,6,6,0,1.0,9,7,2,0.7777777777777778,0.8750000000000001,gemini,mimiciii,radiology_report,PROMPT1_entailment
363,425,18,14,4,0.7777777777777778,19,14,5,0.7368421052631579,0.7567567567567567,gemini,mimiciii,radiology_report,PROMPT1_entailment
364,426,9,5,4,0.5555555555555556,16,12,4,0.75,0.6382978723404256,gemini,mimiciii,radiology_report,PROMPT1_entailment
365,427,8,6,2,0.75,15,11,4,0.7333333333333333,0.7415730337078651,gemini,mimiciii,radiology_report,PROMPT1_entailment
366,428,4,3,1,0.75,15,10,5,0.6666666666666666,0.7058823529411765,gemini,mimiciii,radiology_report,PROMPT1_entailment
367,429,13,12,1,0.9230769230769232,13,10,3,0.7692307692307693,0.8391608391608392,gemini,mimiciii,radiology_report,PROMPT1_entailment
368,43,7,7,0,1.0,7,7,0,1.0,1.0,gemini,mimiciii,radiology_report,PROMPT1_entailment
369,430,5,5,0,1.0,7,5,2,0.7142857142857143,0.8333333333333333,gemini,mimiciii,radiology_report,PROMPT1_entailment
370,431,11,8,3,0.7272727272727273,18,14,4,0.7777777777777778,0.7516778523489932,gemini,mimiciii,radiology_report,PROMPT1_entailment
371,432,16,6,10,0.375,13,8,5,0.6153846153846154,0.4660194174757281,gemini,mimiciii,radiology_report,PROMPT1_entailment
372,433,12,9,3,0.75,18,16,2,0.8888888888888888,0.8135593220338982,gemini,mimiciii,radiology_report,PROMPT1_entailment
373,434,8,7,1,0.875,27,21,6,0.7777777777777778,0.823529411764706,gemini,mimiciii,radiology_report,PROMPT1_entailment
374,435,9,7,2,0.7777777777777778,13,9,4,0.6923076923076923,0.7325581395348836,gemini,mimiciii,radiology_report,PROMPT1_entailment
375,436,15,10,5,0.6666666666666666,25,22,3,0.88,0.7586206896551725,gemini,mimiciii,radiology_report,PROMPT1_entailment
376,437,4,4,0,1.0,7,5,2,0.7142857142857143,0.8333333333333333,gemini,mimiciii,radiology_report,PROMPT1_entailment
377,438,11,10,1,0.9090909090909092,19,14,5,0.7368421052631579,0.813953488372093,gemini,mimiciii,radiology_report,PROMPT1_entailment
378,439,19,11,8,0.5789473684210527,22,13,9,0.5909090909090909,0.5848670756646217,gemini,mimiciii,radiology_report,PROMPT1_entailment
379,44,8,7,1,0.875,16,12,4,0.75,0.8076923076923077,gemini,mimiciii,radiology_report,PROMPT1_entailment
380,440,13,6,7,0.4615384615384615,19,13,6,0.6842105263157895,0.5512367491166078,gemini,mimiciii,radiology_report,PROMPT1_entailment
381,441,13,7,6,0.5384615384615384,17,16,1,0.9411764705882352,0.6850152905198776,gemini,mimiciii,radiology_report,PROMPT1_entailment
382,442,6,6,0,1.0,12,6,6,0.5,0.6666666666666666,gemini,mimiciii,radiology_report,PROMPT1_entailment
383,443,10,6,4,0.6,21,15,6,0.7142857142857143,0.6521739130434783,gemini,mimiciii,radiology_report,PROMPT1_entailment
384,444,9,9,0,1.0,8,5,3,0.625,0.7692307692307693,gemini,mimiciii,radiology_report,PROMPT1_entailment
385,445,12,10,2,0.8333333333333334,22,18,4,0.8181818181818182,0.8256880733944955,gemini,mimiciii,radiology_report,PROMPT1_entailment
386,446,20,14,6,0.7,22,18,4,0.8181818181818182,0.7544910179640719,gemini,mimiciii,radiology_report,PROMPT1_entailment
387,447,9,7,2,0.7777777777777778,14,13,1,0.9285714285714286,0.8465116279069766,gemini,mimiciii,radiology_report,PROMPT1_entailment
388,448,10,9,1,0.9,36,25,11,0.6944444444444444,0.7839721254355401,gemini,mimiciii,radiology_report,PROMPT1_entailment
389,449,7,6,1,0.8571428571428571,9,7,2,0.7777777777777778,0.8155339805825242,gemini,mimiciii,radiology_report,PROMPT1_entailment
390,45,12,9,3,0.75,20,18,2,0.9,0.8181818181818182,gemini,mimiciii,radiology_report,PROMPT1_entailment
391,450,11,11,0,1.0,21,14,7,0.6666666666666666,0.8,gemini,mimiciii,radiology_report,PROMPT1_entailment
392,451,7,6,1,0.8571428571428571,10,7,3,0.7,0.7706422018348624,gemini,mimiciii,radiology_report,PROMPT1_entailment
393,452,13,10,3,0.7692307692307693,16,12,4,0.75,0.7594936708860761,gemini,mimiciii,radiology_report,PROMPT1_entailment
394,453,10,9,1,0.9,14,12,2,0.8571428571428571,0.8780487804878048,gemini,mimiciii,radiology_report,PROMPT1_entailment
395,454,7,5,2,0.7142857142857143,10,7,3,0.7,0.7070707070707072,gemini,mimiciii,radiology_report,PROMPT1_entailment
396,455,11,10,1,0.9090909090909092,16,13,3,0.8125,0.858085808580858,gemini,mimiciii,radiology_report,PROMPT1_entailment
397,456,10,8,2,0.8,21,19,2,0.9047619047619048,0.8491620111731844,gemini,mimiciii,radiology_report,PROMPT1_entailment
398,457,9,9,0,1.0,12,9,3,0.75,0.8571428571428571,gemini,mimiciii,radiology_report,PROMPT1_entailment
399,458,12,11,1,0.9166666666666666,16,10,6,0.625,0.7432432432432433,gemini,mimiciii,radiology_report,PROMPT1_entailment
400,459,14,10,4,0.7142857142857143,13,9,4,0.6923076923076923,0.7031250000000001,gemini,mimiciii,radiology_report,PROMPT1_entailment
401,46,16,14,2,0.875,26,21,5,0.8076923076923077,0.8400000000000001,gemini,mimiciii,radiology_report,PROMPT1_entailment
402,460,20,17,3,0.85,20,19,1,0.95,0.8972222222222223,gemini,mimiciii,radiology_report,PROMPT1_entailment
403,461,18,12,6,0.6666666666666666,22,12,10,0.5454545454545454,0.6,gemini,mimiciii,radiology_report,PROMPT1_entailment
404,462,18,11,7,0.6111111111111112,20,16,4,0.8,0.6929133858267716,gemini,mimiciii,radiology_report,PROMPT1_entailment
405,463,8,8,0,1.0,12,10,2,0.8333333333333334,0.9090909090909092,gemini,mimiciii,radiology_report,PROMPT1_entailment
406,464,13,9,4,0.6923076923076923,25,17,8,0.68,0.6860986547085203,gemini,mimiciii,radiology_report,PROMPT1_entailment
407,465,13,7,6,0.5384615384615384,33,20,13,0.6060606060606061,0.570264765784114,gemini,mimiciii,radiology_report,PROMPT1_entailment
408,466,10,7,3,0.7,22,16,6,0.7272727272727273,0.7133757961783439,gemini,mimiciii,radiology_report,PROMPT1_entailment
409,467,10,10,0,1.0,14,13,1,0.9285714285714286,0.962962962962963,gemini,mimiciii,radiology_report,PROMPT1_entailment
410,468,14,11,3,0.7857142857142857,18,13,5,0.7222222222222222,0.7526315789473684,gemini,mimiciii,radiology_report,PROMPT1_entailment
411,469,13,8,5,0.6153846153846154,25,20,5,0.8,0.6956521739130435,gemini,mimiciii,radiology_report,PROMPT1_entailment
412,47,8,7,1,0.875,15,10,5,0.6666666666666666,0.7567567567567567,gemini,mimiciii,radiology_report,PROMPT1_entailment
413,470,9,5,4,0.5555555555555556,15,12,3,0.8,0.6557377049180328,gemini,mimiciii,radiology_report,PROMPT1_entailment
414,471,5,5,0,1.0,18,11,7,0.6111111111111112,0.7586206896551725,gemini,mimiciii,radiology_report,PROMPT1_entailment
415,472,11,10,1,0.9090909090909092,16,13,3,0.8125,0.858085808580858,gemini,mimiciii,radiology_report,PROMPT1_entailment
416,473,8,7,1,0.875,11,8,3,0.7272727272727273,0.7943262411347517,gemini,mimiciii,radiology_report,PROMPT1_entailment
417,474,20,14,6,0.7,25,19,6,0.76,0.7287671232876711,gemini,mimiciii,radiology_report,PROMPT1_entailment
418,475,7,6,1,0.8571428571428571,7,5,2,0.7142857142857143,0.7792207792207793,gemini,mimiciii,radiology_report,PROMPT1_entailment
419,476,7,5,2,0.7142857142857143,12,10,2,0.8333333333333334,0.7692307692307692,gemini,mimiciii,radiology_report,PROMPT1_entailment
420,477,12,10,2,0.8333333333333334,16,13,3,0.8125,0.8227848101265822,gemini,mimiciii,radiology_report,PROMPT1_entailment
421,478,12,11,1,0.9166666666666666,21,14,7,0.6666666666666666,0.7719298245614035,gemini,mimiciii,radiology_report,PROMPT1_entailment
422,479,13,11,2,0.8461538461538461,22,16,6,0.7272727272727273,0.7822222222222223,gemini,mimiciii,radiology_report,PROMPT1_entailment
423,48,13,8,5,0.6153846153846154,21,17,4,0.8095238095238095,0.699228791773779,gemini,mimiciii,radiology_report,PROMPT1_entailment
424,480,7,5,2,0.7142857142857143,10,7,3,0.7,0.7070707070707072,gemini,mimiciii,radiology_report,PROMPT1_entailment
425,481,21,13,8,0.6190476190476191,17,14,3,0.8235294117647058,0.7067961165048543,gemini,mimiciii,radiology_report,PROMPT1_entailment
426,482,14,9,5,0.6428571428571429,19,15,4,0.7894736842105263,0.7086614173228346,gemini,mimiciii,radiology_report,PROMPT1_entailment
427,483,15,12,3,0.8,23,15,8,0.6521739130434783,0.718562874251497,gemini,mimiciii,radiology_report,PROMPT1_entailment
428,484,8,6,2,0.75,13,6,7,0.4615384615384615,0.5714285714285714,gemini,mimiciii,radiology_report,PROMPT1_entailment
429,485,13,10,3,0.7692307692307693,24,17,7,0.7083333333333334,0.737527114967462,gemini,mimiciii,radiology_report,PROMPT1_entailment
430,486,5,4,1,0.8,11,9,2,0.8181818181818182,0.8089887640449439,gemini,mimiciii,radiology_report,PROMPT1_entailment
431,487,11,9,2,0.8181818181818182,20,16,4,0.8,0.8089887640449439,gemini,mimiciii,radiology_report,PROMPT1_entailment
432,488,15,6,9,0.4,15,9,6,0.6,0.48,gemini,mimiciii,radiology_report,PROMPT1_entailment
433,489,16,13,3,0.8125,18,12,6,0.6666666666666666,0.7323943661971831,gemini,mimiciii,radiology_report,PROMPT1_entailment
434,49,7,6,1,0.8571428571428571,24,20,4,0.8333333333333334,0.8450704225352113,gemini,mimiciii,radiology_report,PROMPT1_entailment
435,490,6,6,0,1.0,8,3,5,0.375,0.5454545454545454,gemini,mimiciii,radiology_report,PROMPT1_entailment
436,491,14,11,3,0.7857142857142857,17,13,4,0.7647058823529411,0.7750677506775069,gemini,mimiciii,radiology_report,PROMPT1_entailment
437,492,13,11,2,0.8461538461538461,13,9,4,0.6923076923076923,0.7615384615384616,gemini,mimiciii,radiology_report,PROMPT1_entailment
438,493,7,7,0,1.0,9,6,3,0.6666666666666666,0.8,gemini,mimiciii,radiology_report,PROMPT1_entailment
439,494,6,5,1,0.8333333333333334,8,5,3,0.625,0.7142857142857143,gemini,mimiciii,radiology_report,PROMPT1_entailment
440,495,8,8,0,1.0,12,11,1,0.9166666666666666,0.9565217391304348,gemini,mimiciii,radiology_report,PROMPT1_entailment
441,496,17,17,0,1.0,32,25,7,0.78125,0.8771929824561403,gemini,mimiciii,radiology_report,PROMPT1_entailment
442,497,16,14,2,0.875,22,15,7,0.6818181818181818,0.7664233576642336,gemini,mimiciii,radiology_report,PROMPT1_entailment
443,498,22,16,6,0.7272727272727273,22,17,5,0.7727272727272727,0.7493112947658402,gemini,mimiciii,radiology_report,PROMPT1_entailment
444,499,13,11,2,0.8461538461538461,17,15,2,0.8823529411764706,0.8638743455497382,gemini,mimiciii,radiology_report,PROMPT1_entailment
445,5,7,5,2,0.7142857142857143,22,20,2,0.9090909090909092,0.8,gemini,mimiciii,radiology_report,PROMPT1_entailment
446,50,8,6,2,0.75,15,11,4,0.7333333333333333,0.7415730337078651,gemini,mimiciii,radiology_report,PROMPT1_entailment
447,51,13,11,2,0.8461538461538461,13,10,3,0.7692307692307693,0.8058608058608059,gemini,mimiciii,radiology_report,PROMPT1_entailment
448,52,17,13,4,0.7647058823529411,21,15,6,0.7142857142857143,0.7386363636363635,gemini,mimiciii,radiology_report,PROMPT1_entailment
449,53,12,11,1,0.9166666666666666,12,8,4,0.6666666666666666,0.7719298245614035,gemini,mimiciii,radiology_report,PROMPT1_entailment
450,54,7,7,0,1.0,10,7,3,0.7,0.8235294117647058,gemini,mimiciii,radiology_report,PROMPT1_entailment
451,55,6,5,1,0.8333333333333334,18,11,7,0.6111111111111112,0.7051282051282051,gemini,mimiciii,radiology_report,PROMPT1_entailment
452,56,14,11,3,0.7857142857142857,21,14,7,0.6666666666666666,0.721311475409836,gemini,mimiciii,radiology_report,PROMPT1_entailment
453,57,9,7,2,0.7777777777777778,10,4,6,0.4,0.5283018867924528,gemini,mimiciii,radiology_report,PROMPT1_entailment
454,58,10,8,2,0.8,16,13,3,0.8125,0.8062015503875969,gemini,mimiciii,radiology_report,PROMPT1_entailment
455,59,12,9,3,0.75,16,12,4,0.75,0.75,gemini,mimiciii,radiology_report,PROMPT1_entailment
456,6,7,7,0,1.0,8,7,1,0.875,0.9333333333333332,gemini,mimiciii,radiology_report,PROMPT1_entailment
457,60,11,10,1,0.9090909090909092,19,14,5,0.7368421052631579,0.813953488372093,gemini,mimiciii,radiology_report,PROMPT1_entailment
458,61,13,11,2,0.8461538461538461,22,19,3,0.8636363636363636,0.8548057259713701,gemini,mimiciii,radiology_report,PROMPT1_entailment
459,62,13,8,5,0.6153846153846154,13,10,3,0.7692307692307693,0.6837606837606838,gemini,mimiciii,radiology_report,PROMPT1_entailment
460,63,11,9,2,0.8181818181818182,15,12,3,0.8,0.8089887640449439,gemini,mimiciii,radiology_report,PROMPT1_entailment
461,64,16,11,5,0.6875,20,18,2,0.9,0.7795275590551182,gemini,mimiciii,radiology_report,PROMPT1_entailment
462,65,14,10,4,0.7142857142857143,18,14,4,0.7777777777777778,0.7446808510638298,gemini,mimiciii,radiology_report,PROMPT1_entailment
463,66,13,11,2,0.8461538461538461,34,24,10,0.7058823529411765,0.7696793002915452,gemini,mimiciii,radiology_report,PROMPT1_entailment
464,67,14,10,4,0.7142857142857143,28,27,1,0.9642857142857144,0.8206686930091186,gemini,mimiciii,radiology_report,PROMPT1_entailment
465,68,14,13,1,0.9285714285714286,35,21,14,0.6,0.7289719626168225,gemini,mimiciii,radiology_report,PROMPT1_entailment
466,69,15,10,5,0.6666666666666666,31,20,11,0.6451612903225806,0.6557377049180327,gemini,mimiciii,radiology_report,PROMPT1_entailment
467,7,12,11,1,0.9166666666666666,16,11,5,0.6875,0.7857142857142857,gemini,mimiciii,radiology_report,PROMPT1_entailment
468,70,8,7,1,0.875,17,16,1,0.9411764705882352,0.9068825910931174,gemini,mimiciii,radiology_report,PROMPT1_entailment
469,71,9,6,3,0.6666666666666666,18,12,6,0.6666666666666666,0.6666666666666666,gemini,mimiciii,radiology_report,PROMPT1_entailment
470,72,12,10,2,0.8333333333333334,13,11,2,0.8461538461538461,0.8396946564885497,gemini,mimiciii,radiology_report,PROMPT1_entailment
471,73,16,14,2,0.875,34,17,17,0.5,0.6363636363636364,gemini,mimiciii,radiology_report,PROMPT1_entailment
472,74,10,6,4,0.6,18,13,5,0.7222222222222222,0.6554621848739496,gemini,mimiciii,radiology_report,PROMPT1_entailment
473,75,14,9,5,0.6428571428571429,12,11,1,0.9166666666666666,0.7557251908396947,gemini,mimiciii,radiology_report,PROMPT1_entailment
474,76,9,6,3,0.6666666666666666,14,12,2,0.8571428571428571,0.75,gemini,mimiciii,radiology_report,PROMPT1_entailment
475,77,11,10,1,0.9090909090909092,26,19,7,0.7307692307692307,0.8102345415778252,gemini,mimiciii,radiology_report,PROMPT1_entailment
476,78,15,12,3,0.8,33,25,8,0.7575757575757576,0.7782101167315175,gemini,mimiciii,radiology_report,PROMPT1_entailment
477,79,11,9,2,0.8181818181818182,17,12,5,0.7058823529411765,0.7578947368421053,gemini,mimiciii,radiology_report,PROMPT1_entailment
478,8,9,8,1,0.8888888888888888,15,12,3,0.8,0.8421052631578948,gemini,mimiciii,radiology_report,PROMPT1_entailment
479,80,12,7,5,0.5833333333333334,25,21,4,0.84,0.6885245901639344,gemini,mimiciii,radiology_report,PROMPT1_entailment
480,81,9,5,4,0.5555555555555556,15,9,6,0.6,0.576923076923077,gemini,mimiciii,radiology_report,PROMPT1_entailment
481,82,4,3,1,0.75,14,10,4,0.7142857142857143,0.7317073170731706,gemini,mimiciii,radiology_report,PROMPT1_entailment
482,83,12,7,5,0.5833333333333334,17,14,3,0.8235294117647058,0.6829268292682927,gemini,mimiciii,radiology_report,PROMPT1_entailment
483,84,21,18,3,0.8571428571428571,20,14,6,0.7,0.7706422018348624,gemini,mimiciii,radiology_report,PROMPT1_entailment
484,85,15,13,2,0.8666666666666667,14,11,3,0.7857142857142857,0.8242074927953891,gemini,mimiciii,radiology_report,PROMPT1_entailment
485,86,9,7,2,0.7777777777777778,10,9,1,0.9,0.8344370860927153,gemini,mimiciii,radiology_report,PROMPT1_entailment
486,87,11,11,0,1.0,14,9,5,0.6428571428571429,0.782608695652174,gemini,mimiciii,radiology_report,PROMPT1_entailment
487,88,11,11,0,1.0,19,15,4,0.7894736842105263,0.8823529411764706,gemini,mimiciii,radiology_report,PROMPT1_entailment
488,89,14,12,2,0.8571428571428571,18,16,2,0.8888888888888888,0.8727272727272727,gemini,mimiciii,radiology_report,PROMPT1_entailment
489,9,7,5,2,0.7142857142857143,13,10,3,0.7692307692307693,0.7407407407407408,gemini,mimiciii,radiology_report,PROMPT1_entailment
490,90,11,8,3,0.7272727272727273,14,11,3,0.7857142857142857,0.7553648068669527,gemini,mimiciii,radiology_report,PROMPT1_entailment
491,91,10,8,2,0.8,13,9,4,0.6923076923076923,0.7422680412371134,gemini,mimiciii,radiology_report,PROMPT1_entailment
492,92,12,9,3,0.75,21,14,7,0.6666666666666666,0.7058823529411765,gemini,mimiciii,radiology_report,PROMPT1_entailment
493,93,3,3,0,1.0,15,12,3,0.8,0.888888888888889,gemini,mimiciii,radiology_report,PROMPT1_entailment
494,94,15,7,8,0.4666666666666667,28,25,3,0.8928571428571429,0.6129597197898424,gemini,mimiciii,radiology_report,PROMPT1_entailment
495,95,15,13,2,0.8666666666666667,18,11,7,0.6111111111111112,0.7167919799498748,gemini,mimiciii,radiology_report,PROMPT1_entailment
496,96,11,8,3,0.7272727272727273,21,14,7,0.6666666666666666,0.6956521739130435,gemini,mimiciii,radiology_report,PROMPT1_entailment
497,97,11,8,3,0.7272727272727273,23,11,12,0.4782608695652174,0.5770491803278689,gemini,mimiciii,radiology_report,PROMPT1_entailment
498,98,20,18,2,0.9,19,13,6,0.6842105263157895,0.7774086378737541,gemini,mimiciii,radiology_report,PROMPT1_entailment
499,99,12,11,1,0.9166666666666666,13,8,5,0.6153846153846154,0.7364016736401674,gemini,mimiciii,radiology_report,PROMPT1_entailment
0,0,23,14,9,0.6086956521739131,21,16,5,0.7619047619047619,0.676737160120846,gemini,mimiciii,radiology_report,PROMPT1_ICL_entailment
1,1,19,15,4,0.7894736842105263,15,12,3,0.8,0.794701986754967,gemini,mimiciii,radiology_report,PROMPT1_ICL_entailment
2,10,16,12,4,0.75,18,14,4,0.7777777777777778,0.7636363636363638,gemini,mimiciii,radiology_report,PROMPT1_ICL_entailment
3,100,11,10,1,0.9090909090909092,9,9,0,1.0,0.9523809523809524,gemini,mimiciii,radiology_report,PROMPT1_ICL_entailment
4,101,19,13,6,0.6842105263157895,15,12,3,0.8,0.7375886524822695,gemini,mimiciii,radiology_report,PROMPT1_ICL_entailment
5,102,12,11,1,0.9166666666666666,16,11,5,0.6875,0.7857142857142857,gemini,mimiciii,radiology_report,PROMPT1_ICL_entailment
6,103,20,16,4,0.8,19,14,5,0.7368421052631579,0.7671232876712328,gemini,mimiciii,radiology_report,PROMPT1_ICL_entailment
7,104,15,8,7,0.5333333333333333,17,10,7,0.5882352941176471,0.5594405594405595,gemini,mimiciii,radiology_report,PROMPT1_ICL_entailment
8,105,7,6,1,0.8571428571428571,8,6,2,0.75,0.7999999999999999,gemini,mimiciii,radiology_report,PROMPT1_ICL_entailment
9,106,13,11,2,0.8461538461538461,12,11,1,0.9166666666666666,0.8799999999999999,gemini,mimiciii,radiology_report,PROMPT1_ICL_entailment
10,107,12,11,1,0.9166666666666666,19,11,8,0.5789473684210527,0.7096774193548387,gemini,mimiciii,radiology_report,PROMPT1_ICL_entailment
11,108,13,12,1,0.9230769230769232,13,10,3,0.7692307692307693,0.8391608391608392,gemini,mimiciii,radiology_report,PROMPT1_ICL_entailment
12,109,15,8,7,0.5333333333333333,20,15,5,0.75,0.6233766233766235,gemini,mimiciii,radiology_report,PROMPT1_ICL_entailment
13,11,14,13,1,0.9285714285714286,24,15,9,0.625,0.7471264367816093,gemini,mimiciii,radiology_report,PROMPT1_ICL_entailment
14,110,13,11,2,0.8461538461538461,17,10,7,0.5882352941176471,0.694006309148265,gemini,mimiciii,radiology_report,PROMPT1_ICL_entailment
15,111,15,9,6,0.6,20,16,4,0.8,0.6857142857142857,gemini,mimiciii,radiology_report,PROMPT1_ICL_entailment
16,112,13,13,0,1.0,14,10,4,0.7142857142857143,0.8333333333333333,gemini,mimiciii,radiology_report,PROMPT1_ICL_entailment
17,113,18,8,10,0.4444444444444444,20,15,5,0.75,0.5581395348837209,gemini,mimiciii,radiology_report,PROMPT1_ICL_entailment
18,114,22,11,11,0.5,23,19,4,0.8260869565217391,0.6229508196721311,gemini,mimiciii,radiology_report,PROMPT1_ICL_entailment
19,115,16,15,1,0.9375,20,15,5,0.75,0.8333333333333334,gemini,mimiciii,radiology_report,PROMPT1_ICL_entailment
20,116,11,11,0,1.0,13,10,3,0.7692307692307693,0.8695652173913044,gemini,mimiciii,radiology_report,PROMPT1_ICL_entailment
21,117,14,10,4,0.7142857142857143,16,14,2,0.875,0.7865168539325842,gemini,mimiciii,radiology_report,PROMPT1_ICL_entailment
22,118,19,9,10,0.4736842105263157,24,16,8,0.6666666666666666,0.5538461538461538,gemini,mimiciii,radiology_report,PROMPT1_ICL_entailment
23,119,18,17,1,0.9444444444444444,17,14,3,0.8235294117647058,0.8798521256931607,gemini,mimiciii,radiology_report,PROMPT1_ICL_entailment
24,12,18,18,0,1.0,17,15,2,0.8823529411764706,0.9375,gemini,mimiciii,radiology_report,PROMPT1_ICL_entailment
25,120,13,8,5,0.6153846153846154,16,12,4,0.75,0.676056338028169,gemini,mimiciii,radiology_report,PROMPT1_ICL_entailment
26,121,18,11,7,0.6111111111111112,26,20,6,0.7692307692307693,0.6811145510835914,gemini,mimiciii,radiology_report,PROMPT1_ICL_entailment
27,122,12,8,4,0.6666666666666666,20,16,4,0.8,0.7272727272727272,gemini,mimiciii,radiology_report,PROMPT1_ICL_entailment
28,123,12,11,1,0.9166666666666666,13,11,2,0.8461538461538461,0.8799999999999999,gemini,mimiciii,radiology_report,PROMPT1_ICL_entailment
29,124,9,7,2,0.7777777777777778,12,8,4,0.6666666666666666,0.717948717948718,gemini,mimiciii,radiology_report,PROMPT1_ICL_entailment
30,125,13,7,6,0.5384615384615384,23,14,9,0.6086956521739131,0.5714285714285715,gemini,mimiciii,radiology_report,PROMPT1_ICL_entailment
31,126,9,8,1,0.8888888888888888,9,7,2,0.7777777777777778,0.8296296296296296,gemini,mimiciii,radiology_report,PROMPT1_ICL_entailment
32,127,45,41,4,0.9111111111111112,50,37,13,0.74,0.8166890982503364,gemini,mimiciii,radiology_report,PROMPT1_ICL_entailment
33,128,13,9,4,0.6923076923076923,14,9,5,0.6428571428571429,0.6666666666666666,gemini,mimiciii,radiology_report,PROMPT1_ICL_entailment
34,129,14,10,4,0.7142857142857143,16,10,6,0.625,0.6666666666666666,gemini,mimiciii,radiology_report,PROMPT1_ICL_entailment
35,13,13,11,2,0.8461538461538461,17,16,1,0.9411764705882352,0.8911392405063291,gemini,mimiciii,radiology_report,PROMPT1_ICL_entailment
36,130,15,15,0,1.0,29,22,7,0.7586206896551724,0.8627450980392156,gemini,mimiciii,radiology_report,PROMPT1_ICL_entailment
37,131,9,8,1,0.8888888888888888,45,35,10,0.7777777777777778,0.8296296296296296,gemini,mimiciii,radiology_report,PROMPT1_ICL_entailment
38,132,12,6,6,0.5,23,16,7,0.6956521739130435,0.5818181818181818,gemini,mimiciii,radiology_report,PROMPT1_ICL_entailment
39,133,16,12,4,0.75,21,15,6,0.7142857142857143,0.7317073170731706,gemini,mimiciii,radiology_report,PROMPT1_ICL_entailment
40,134,13,10,3,0.7692307692307693,23,15,8,0.6521739130434783,0.7058823529411764,gemini,mimiciii,radiology_report,PROMPT1_ICL_entailment
41,135,15,14,1,0.9333333333333332,20,16,4,0.8,0.8615384615384616,gemini,mimiciii,radiology_report,PROMPT1_ICL_entailment
42,136,11,10,1,0.9090909090909092,14,11,3,0.7857142857142857,0.842911877394636,gemini,mimiciii,radiology_report,PROMPT1_ICL_entailment
43,137,10,8,2,0.8,10,7,3,0.7,0.7466666666666666,gemini,mimiciii,radiology_report,PROMPT1_ICL_entailment
44,138,15,11,4,0.7333333333333333,14,8,6,0.5714285714285714,0.6423357664233577,gemini,mimiciii,radiology_report,PROMPT1_ICL_entailment
45,139,11,8,3,0.7272727272727273,13,10,3,0.7692307692307693,0.7476635514018691,gemini,mimiciii,radiology_report,PROMPT1_ICL_entailment
46,14,11,11,0,1.0,12,9,3,0.75,0.8571428571428571,gemini,mimiciii,radiology_report,PROMPT1_ICL_entailment
47,140,11,9,2,0.8181818181818182,18,12,6,0.6666666666666666,0.7346938775510203,gemini,mimiciii,radiology_report,PROMPT1_ICL_entailment
48,141,13,10,3,0.7692307692307693,16,11,5,0.6875,0.7260726072607261,gemini,mimiciii,radiology_report,PROMPT1_ICL_entailment
49,142,13,9,4,0.6923076923076923,14,11,3,0.7857142857142857,0.7360594795539033,gemini,mimiciii,radiology_report,PROMPT1_ICL_entailment
50,143,22,18,4,0.8181818181818182,32,19,13,0.59375,0.6881287726358148,gemini,mimiciii,radiology_report,PROMPT1_ICL_entailment
51,144,15,12,3,0.8,26,19,7,0.7307692307692307,0.763819095477387,gemini,mimiciii,radiology_report,PROMPT1_ICL_entailment
52,145,22,19,3,0.8636363636363636,18,15,3,0.8333333333333334,0.8482142857142857,gemini,mimiciii,radiology_report,PROMPT1_ICL_entailment
53,146,9,8,1,0.8888888888888888,11,6,5,0.5454545454545454,0.676056338028169,gemini,mimiciii,radiology_report,PROMPT1_ICL_entailment
54,147,12,9,3,0.75,10,5,5,0.5,0.6,gemini,mimiciii,radiology_report,PROMPT1_ICL_entailment
55,148,24,20,4,0.8333333333333334,32,24,8,0.75,0.7894736842105262,gemini,mimiciii,radiology_report,PROMPT1_ICL_entailment
56,149,12,8,4,0.6666666666666666,20,13,7,0.65,0.6582278481012659,gemini,mimiciii,radiology_report,PROMPT1_ICL_entailment
57,15,26,19,7,0.7307692307692307,29,21,8,0.7241379310344828,0.7274384685505925,gemini,mimiciii,radiology_report,PROMPT1_ICL_entailment
58,150,21,12,9,0.5714285714285714,14,12,2,0.8571428571428571,0.6857142857142857,gemini,mimiciii,radiology_report,PROMPT1_ICL_entailment
59,151,15,11,4,0.7333333333333333,15,7,8,0.4666666666666667,0.5703703703703704,gemini,mimiciii,radiology_report,PROMPT1_ICL_entailment
60,152,20,12,8,0.6,18,14,4,0.7777777777777778,0.6774193548387097,gemini,mimiciii,radiology_report,PROMPT1_ICL_entailment
61,153,16,8,8,0.5,16,12,4,0.75,0.6,gemini,mimiciii,radiology_report,PROMPT1_ICL_entailment
62,154,18,13,5,0.7222222222222222,23,17,6,0.7391304347826086,0.7305785123966942,gemini,mimiciii,radiology_report,PROMPT1_ICL_entailment
63,155,31,31,0,1.0,47,37,10,0.7872340425531915,0.880952380952381,gemini,mimiciii,radiology_report,PROMPT1_ICL_entailment
64,156,16,10,6,0.625,20,13,7,0.65,0.6372549019607844,gemini,mimiciii,radiology_report,PROMPT1_ICL_entailment
65,157,16,15,1,0.9375,12,10,2,0.8333333333333334,0.8823529411764706,gemini,mimiciii,radiology_report,PROMPT1_ICL_entailment
66,158,6,6,0,1.0,6,3,3,0.5,0.6666666666666666,gemini,mimiciii,radiology_report,PROMPT1_ICL_entailment
67,159,14,9,5,0.6428571428571429,13,11,2,0.8461538461538461,0.7306273062730628,gemini,mimiciii,radiology_report,PROMPT1_ICL_entailment
68,16,15,12,3,0.8,17,11,6,0.6470588235294118,0.7154471544715447,gemini,mimiciii,radiology_report,PROMPT1_ICL_entailment
69,160,15,11,4,0.7333333333333333,12,11,1,0.9166666666666666,0.8148148148148148,gemini,mimiciii,radiology_report,PROMPT1_ICL_entailment
70,161,16,13,3,0.8125,13,9,4,0.6923076923076923,0.7476038338658147,gemini,mimiciii,radiology_report,PROMPT1_ICL_entailment
71,162,13,12,1,0.9230769230769232,11,8,3,0.7272727272727273,0.8135593220338984,gemini,mimiciii,radiology_report,PROMPT1_ICL_entailment
72,163,10,10,0,1.0,8,4,4,0.5,0.6666666666666666,gemini,mimiciii,radiology_report,PROMPT1_ICL_entailment
73,164,12,12,0,1.0,8,8,0,1.0,1.0,gemini,mimiciii,radiology_report,PROMPT1_ICL_entailment
74,165,15,13,2,0.8666666666666667,31,20,11,0.6451612903225806,0.7396870554765292,gemini,mimiciii,radiology_report,PROMPT1_ICL_entailment
75,166,23,16,7,0.6956521739130435,26,21,5,0.8076923076923077,0.7474972191323692,gemini,mimiciii,radiology_report,PROMPT1_ICL_entailment
76,167,8,8,0,1.0,10,8,2,0.8,0.888888888888889,gemini,mimiciii,radiology_report,PROMPT1_ICL_entailment
77,168,14,13,1,0.9285714285714286,13,10,3,0.7692307692307693,0.8414239482200646,gemini,mimiciii,radiology_report,PROMPT1_ICL_entailment
78,169,14,11,3,0.7857142857142857,22,14,8,0.6363636363636364,0.7031963470319634,gemini,mimiciii,radiology_report,PROMPT1_ICL_entailment
79,17,8,8,0,1.0,12,7,5,0.5833333333333334,0.7368421052631579,gemini,mimiciii,radiology_report,PROMPT1_ICL_entailment
80,170,22,16,6,0.7272727272727273,24,19,5,0.7916666666666666,0.7581047381546134,gemini,mimiciii,radiology_report,PROMPT1_ICL_entailment
81,171,7,7,0,1.0,7,6,1,0.8571428571428571,0.923076923076923,gemini,mimiciii,radiology_report,PROMPT1_ICL_entailment
82,172,11,9,2,0.8181818181818182,14,11,3,0.7857142857142857,0.8016194331983806,gemini,mimiciii,radiology_report,PROMPT1_ICL_entailment
83,173,13,12,1,0.9230769230769232,12,11,1,0.9166666666666666,0.9198606271777002,gemini,mimiciii,radiology_report,PROMPT1_ICL_entailment
84,174,14,12,2,0.8571428571428571,20,15,5,0.75,0.7999999999999999,gemini,mimiciii,radiology_report,PROMPT1_ICL_entailment
85,175,7,7,0,1.0,8,7,1,0.875,0.9333333333333332,gemini,mimiciii,radiology_report,PROMPT1_ICL_entailment
86,176,15,8,7,0.5333333333333333,19,12,7,0.631578947368421,0.5783132530120482,gemini,mimiciii,radiology_report,PROMPT1_ICL_entailment
87,177,21,18,3,0.8571428571428571,16,12,4,0.75,0.7999999999999999,gemini,mimiciii,radiology_report,PROMPT1_ICL_entailment
88,178,20,8,12,0.4,25,20,5,0.8,0.5333333333333333,gemini,mimiciii,radiology_report,PROMPT1_ICL_entailment
89,179,10,9,1,0.9,20,14,6,0.7,0.7875,gemini,mimiciii,radiology_report,PROMPT1_ICL_entailment
90,18,14,12,2,0.8571428571428571,17,12,5,0.7058823529411765,0.7741935483870968,gemini,mimiciii,radiology_report,PROMPT1_ICL_entailment
91,180,12,10,2,0.8333333333333334,11,10,1,0.9090909090909092,0.8695652173913043,gemini,mimiciii,radiology_report,PROMPT1_ICL_entailment
92,181,20,12,8,0.6,26,20,6,0.7692307692307693,0.6741573033707865,gemini,mimiciii,radiology_report,PROMPT1_ICL_entailment
93,182,15,9,6,0.6,23,19,4,0.8260869565217391,0.6951219512195121,gemini,mimiciii,radiology_report,PROMPT1_ICL_entailment
94,183,17,15,2,0.8823529411764706,17,14,3,0.8235294117647058,0.8519269776876267,gemini,mimiciii,radiology_report,PROMPT1_ICL_entailment
95,184,9,9,0,1.0,15,12,3,0.8,0.888888888888889,gemini,mimiciii,radiology_report,PROMPT1_ICL_entailment
96,185,5,4,1,0.8,6,4,2,0.6666666666666666,0.7272727272727272,gemini,mimiciii,radiology_report,PROMPT1_ICL_entailment
97,186,16,8,8,0.5,26,18,8,0.6923076923076923,0.5806451612903226,gemini,mimiciii,radiology_report,PROMPT1_ICL_entailment
98,187,18,16,2,0.8888888888888888,14,11,3,0.7857142857142857,0.8341232227488152,gemini,mimiciii,radiology_report,PROMPT1_ICL_entailment
99,188,24,20,4,0.8333333333333334,22,17,5,0.7727272727272727,0.8018867924528302,gemini,mimiciii,radiology_report,PROMPT1_ICL_entailment
100,189,10,8,2,0.8,15,12,3,0.8,0.8000000000000002,gemini,mimiciii,radiology_report,PROMPT1_ICL_entailment
101,19,17,16,1,0.9411764705882352,14,13,1,0.9285714285714286,0.9348314606741572,gemini,mimiciii,radiology_report,PROMPT1_ICL_entailment
102,190,13,12,1,0.9230769230769232,17,13,4,0.7647058823529411,0.8364611260053619,gemini,mimiciii,radiology_report,PROMPT1_ICL_entailment
103,191,15,10,5,0.6666666666666666,15,11,4,0.7333333333333333,0.6984126984126984,gemini,mimiciii,radiology_report,PROMPT1_ICL_entailment
104,192,28,17,11,0.6071428571428571,28,22,6,0.7857142857142857,0.684981684981685,gemini,mimiciii,radiology_report,PROMPT1_ICL_entailment
105,193,14,14,0,1.0,14,11,3,0.7857142857142857,0.88,gemini,mimiciii,radiology_report,PROMPT1_ICL_entailment
106,194,26,26,0,1.0,49,31,18,0.6326530612244898,0.775,gemini,mimiciii,radiology_report,PROMPT1_ICL_entailment
107,195,18,13,5,0.7222222222222222,21,16,5,0.7619047619047619,0.7415329768270944,gemini,mimiciii,radiology_report,PROMPT1_ICL_entailment
108,196,13,8,5,0.6153846153846154,18,14,4,0.7777777777777778,0.6871165644171779,gemini,mimiciii,radiology_report,PROMPT1_ICL_entailment
109,197,12,10,2,0.8333333333333334,15,13,2,0.8666666666666667,0.8496732026143791,gemini,mimiciii,radiology_report,PROMPT1_ICL_entailment
110,198,9,8,1,0.8888888888888888,9,5,4,0.5555555555555556,0.6837606837606838,gemini,mimiciii,radiology_report,PROMPT1_ICL_entailment
111,199,22,12,10,0.5454545454545454,23,19,4,0.8260869565217391,0.6570605187319883,gemini,mimiciii,radiology_report,PROMPT1_ICL_entailment
112,2,12,8,4,0.6666666666666666,15,9,6,0.6,0.631578947368421,gemini,mimiciii,radiology_report,PROMPT1_ICL_entailment
113,20,21,20,1,0.9523809523809524,42,34,8,0.8095238095238095,0.8751608751608752,gemini,mimiciii,radiology_report,PROMPT1_ICL_entailment
114,200,17,13,4,0.7647058823529411,14,12,2,0.8571428571428571,0.8082901554404144,gemini,mimiciii,radiology_report,PROMPT1_ICL_entailment
115,201,14,10,4,0.7142857142857143,18,12,6,0.6666666666666666,0.689655172413793,gemini,mimiciii,radiology_report,PROMPT1_ICL_entailment
116,202,18,14,4,0.7777777777777778,25,11,14,0.44,0.5620437956204379,gemini,mimiciii,radiology_report,PROMPT1_ICL_entailment
117,203,24,11,13,0.4583333333333333,19,14,5,0.7368421052631579,0.5651376146788991,gemini,mimiciii,radiology_report,PROMPT1_ICL_entailment
118,204,19,13,6,0.6842105263157895,23,20,3,0.8695652173913043,0.7658321060382915,gemini,mimiciii,radiology_report,PROMPT1_ICL_entailment
119,205,16,15,1,0.9375,14,12,2,0.8571428571428571,0.8955223880597014,gemini,mimiciii,radiology_report,PROMPT1_ICL_entailment
120,206,16,12,4,0.75,13,11,2,0.8461538461538461,0.7951807228915662,gemini,mimiciii,radiology_report,PROMPT1_ICL_entailment
121,207,9,8,1,0.8888888888888888,9,8,1,0.8888888888888888,0.8888888888888888,gemini,mimiciii,radiology_report,PROMPT1_ICL_entailment
122,208,23,18,5,0.782608695652174,18,14,4,0.7777777777777778,0.7801857585139319,gemini,mimiciii,radiology_report,PROMPT1_ICL_entailment
123,209,16,13,3,0.8125,16,14,2,0.875,0.8425925925925926,gemini,mimiciii,radiology_report,PROMPT1_ICL_entailment
124,21,25,20,5,0.8,27,22,5,0.8148148148148148,0.8073394495412846,gemini,mimiciii,radiology_report,PROMPT1_ICL_entailment
125,210,14,13,1,0.9285714285714286,14,12,2,0.8571428571428571,0.8914285714285715,gemini,mimiciii,radiology_report,PROMPT1_ICL_entailment
126,211,11,11,0,1.0,13,10,3,0.7692307692307693,0.8695652173913044,gemini,mimiciii,radiology_report,PROMPT1_ICL_entailment
127,212,17,9,8,0.5294117647058824,19,13,6,0.6842105263157895,0.5969387755102041,gemini,mimiciii,radiology_report,PROMPT1_ICL_entailment
128,213,13,10,3,0.7692307692307693,22,14,8,0.6363636363636364,0.6965174129353234,gemini,mimiciii,radiology_report,PROMPT1_ICL_entailment
129,214,26,11,15,0.4230769230769231,23,17,6,0.7391304347826086,0.5381294964028777,gemini,mimiciii,radiology_report,PROMPT1_ICL_entailment
130,215,9,8,1,0.8888888888888888,10,8,2,0.8,0.8421052631578948,gemini,mimiciii,radiology_report,PROMPT1_ICL_entailment
131,216,10,8,2,0.8,19,15,4,0.7894736842105263,0.794701986754967,gemini,mimiciii,radiology_report,PROMPT1_ICL_entailment
132,217,17,12,5,0.7058823529411765,20,14,6,0.7,0.7029288702928871,gemini,mimiciii,radiology_report,PROMPT1_ICL_entailment
133,218,18,16,2,0.8888888888888888,15,12,3,0.8,0.8421052631578948,gemini,mimiciii,radiology_report,PROMPT1_ICL_entailment
134,219,16,11,5,0.6875,13,8,5,0.6153846153846154,0.6494464944649447,gemini,mimiciii,radiology_report,PROMPT1_ICL_entailment
135,22,19,13,6,0.6842105263157895,19,18,1,0.9473684210526316,0.7945670628183362,gemini,mimiciii,radiology_report,PROMPT1_ICL_entailment
136,220,17,12,5,0.7058823529411765,19,16,3,0.8421052631578947,0.7679999999999999,gemini,mimiciii,radiology_report,PROMPT1_ICL_entailment
137,221,18,12,6,0.6666666666666666,27,21,6,0.7777777777777778,0.717948717948718,gemini,mimiciii,radiology_report,PROMPT1_ICL_entailment
138,222,16,11,5,0.6875,16,12,4,0.75,0.717391304347826,gemini,mimiciii,radiology_report,PROMPT1_ICL_entailment
139,223,16,12,4,0.75,21,13,8,0.6190476190476191,0.6782608695652174,gemini,mimiciii,radiology_report,PROMPT1_ICL_entailment
140,224,24,17,7,0.7083333333333334,17,16,1,0.9411764705882352,0.8083209509658248,gemini,mimiciii,radiology_report,PROMPT1_ICL_entailment
141,225,11,9,2,0.8181818181818182,11,9,2,0.8181818181818182,0.8181818181818182,gemini,mimiciii,radiology_report,PROMPT1_ICL_entailment
142,226,18,14,4,0.7777777777777778,18,15,3,0.8333333333333334,0.8045977011494253,gemini,mimiciii,radiology_report,PROMPT1_ICL_entailment
143,227,15,14,1,0.9333333333333332,18,15,3,0.8333333333333334,0.8805031446540881,gemini,mimiciii,radiology_report,PROMPT1_ICL_entailment
144,228,12,9,3,0.75,17,13,4,0.7647058823529411,0.7572815533980582,gemini,mimiciii,radiology_report,PROMPT1_ICL_entailment
145,229,21,17,4,0.8095238095238095,49,29,20,0.5918367346938775,0.6837725381414702,gemini,mimiciii,radiology_report,PROMPT1_ICL_entailment
146,23,16,15,1,0.9375,15,11,4,0.7333333333333333,0.8229426433915211,gemini,mimiciii,radiology_report,PROMPT1_ICL_entailment
147,230,11,8,3,0.7272727272727273,17,15,2,0.8823529411764706,0.7973421926910299,gemini,mimiciii,radiology_report,PROMPT1_ICL_entailment
148,231,13,13,0,1.0,13,11,2,0.8461538461538461,0.9166666666666666,gemini,mimiciii,radiology_report,PROMPT1_ICL_entailment
149,232,16,12,4,0.75,18,15,3,0.8333333333333334,0.7894736842105262,gemini,mimiciii,radiology_report,PROMPT1_ICL_entailment
150,233,20,13,7,0.65,17,12,5,0.7058823529411765,0.6767895878524945,gemini,mimiciii,radiology_report,PROMPT1_ICL_entailment
151,234,10,9,1,0.9,11,9,2,0.8181818181818182,0.8571428571428572,gemini,mimiciii,radiology_report,PROMPT1_ICL_entailment
152,235,13,12,1,0.9230769230769232,14,10,4,0.7142857142857143,0.8053691275167787,gemini,mimiciii,radiology_report,PROMPT1_ICL_entailment
153,236,18,15,3,0.8333333333333334,11,8,3,0.7272727272727273,0.7766990291262137,gemini,mimiciii,radiology_report,PROMPT1_ICL_entailment
154,237,15,7,8,0.4666666666666667,17,10,7,0.5882352941176471,0.5204460966542751,gemini,mimiciii,radiology_report,PROMPT1_ICL_entailment
155,238,24,15,9,0.625,20,19,1,0.95,0.753968253968254,gemini,mimiciii,radiology_report,PROMPT1_ICL_entailment
156,239,12,5,7,0.4166666666666667,17,14,3,0.8235294117647058,0.5533596837944664,gemini,mimiciii,radiology_report,PROMPT1_ICL_entailment
157,24,10,10,0,1.0,18,13,5,0.7222222222222222,0.8387096774193548,gemini,mimiciii,radiology_report,PROMPT1_ICL_entailment
158,240,9,8,1,0.8888888888888888,13,11,2,0.8461538461538461,0.8669950738916256,gemini,mimiciii,radiology_report,PROMPT1_ICL_entailment
159,241,12,10,2,0.8333333333333334,16,12,4,0.75,0.7894736842105262,gemini,mimiciii,radiology_report,PROMPT1_ICL_entailment
160,242,20,18,2,0.9,18,14,4,0.7777777777777778,0.8344370860927153,gemini,mimiciii,radiology_report,PROMPT1_ICL_entailment
161,243,16,13,3,0.8125,13,9,4,0.6923076923076923,0.7476038338658147,gemini,mimiciii,radiology_report,PROMPT1_ICL_entailment
162,244,15,9,6,0.6,17,14,3,0.8235294117647058,0.6942148760330579,gemini,mimiciii,radiology_report,PROMPT1_ICL_entailment
163,245,20,11,9,0.55,28,22,6,0.7857142857142857,0.6470588235294117,gemini,mimiciii,radiology_report,PROMPT1_ICL_entailment
164,246,9,8,1,0.8888888888888888,12,8,4,0.6666666666666666,0.761904761904762,gemini,mimiciii,radiology_report,PROMPT1_ICL_entailment
165,247,13,8,5,0.6153846153846154,12,11,1,0.9166666666666666,0.7364016736401674,gemini,mimiciii,radiology_report,PROMPT1_ICL_entailment
166,248,17,13,4,0.7647058823529411,17,13,4,0.7647058823529411,0.7647058823529412,gemini,mimiciii,radiology_report,PROMPT1_ICL_entailment
167,249,21,15,6,0.7142857142857143,23,17,6,0.7391304347826086,0.7264957264957266,gemini,mimiciii,radiology_report,PROMPT1_ICL_entailment
168,25,22,15,7,0.6818181818181818,27,14,13,0.5185185185185185,0.5890603085553997,gemini,mimiciii,radiology_report,PROMPT1_ICL_entailment
169,250,12,10,2,0.8333333333333334,8,8,0,1.0,0.9090909090909092,gemini,mimiciii,radiology_report,PROMPT1_ICL_entailment
170,251,17,8,9,0.4705882352941176,22,17,5,0.7727272727272727,0.5849462365591399,gemini,mimiciii,radiology_report,PROMPT1_ICL_entailment
171,252,9,7,2,0.7777777777777778,10,8,2,0.8,0.7887323943661971,gemini,mimiciii,radiology_report,PROMPT1_ICL_entailment
172,253,20,10,10,0.5,24,22,2,0.9166666666666666,0.6470588235294118,gemini,mimiciii,radiology_report,PROMPT1_ICL_entailment
173,254,1,1,0,1.0,13,8,5,0.6153846153846154,0.761904761904762,gemini,mimiciii,radiology_report,PROMPT1_ICL_entailment
174,255,14,12,2,0.8571428571428571,16,14,2,0.875,0.8659793814432989,gemini,mimiciii,radiology_report,PROMPT1_ICL_entailment
175,256,12,5,7,0.4166666666666667,19,9,10,0.4736842105263157,0.4433497536945813,gemini,mimiciii,radiology_report,PROMPT1_ICL_entailment
176,257,13,9,4,0.6923076923076923,15,10,5,0.6666666666666666,0.6792452830188679,gemini,mimiciii,radiology_report,PROMPT1_ICL_entailment
177,258,14,9,5,0.6428571428571429,20,13,7,0.65,0.6464088397790057,gemini,mimiciii,radiology_report,PROMPT1_ICL_entailment
178,259,11,7,4,0.6363636363636364,17,12,5,0.7058823529411765,0.6693227091633466,gemini,mimiciii,radiology_report,PROMPT1_ICL_entailment
179,26,19,17,2,0.8947368421052632,18,14,4,0.7777777777777778,0.8321678321678322,gemini,mimiciii,radiology_report,PROMPT1_ICL_entailment
180,260,20,16,4,0.8,20,13,7,0.65,0.7172413793103448,gemini,mimiciii,radiology_report,PROMPT1_ICL_entailment
181,261,18,11,7,0.6111111111111112,31,28,3,0.9032258064516128,0.7289940828402366,gemini,mimiciii,radiology_report,PROMPT1_ICL_entailment
182,262,19,13,6,0.6842105263157895,23,20,3,0.8695652173913043,0.7658321060382915,gemini,mimiciii,radiology_report,PROMPT1_ICL_entailment
183,263,14,10,4,0.7142857142857143,27,16,11,0.5925925925925926,0.6477732793522266,gemini,mimiciii,radiology_report,PROMPT1_ICL_entailment
184,264,20,13,7,0.65,20,16,4,0.8,0.7172413793103448,gemini,mimiciii,radiology_report,PROMPT1_ICL_entailment
185,265,10,7,3,0.7,9,8,1,0.8888888888888888,0.7832167832167831,gemini,mimiciii,radiology_report,PROMPT1_ICL_entailment
186,266,16,13,3,0.8125,18,15,3,0.8333333333333334,0.8227848101265822,gemini,mimiciii,radiology_report,PROMPT1_ICL_entailment
187,267,15,13,2,0.8666666666666667,16,13,3,0.8125,0.8387096774193549,gemini,mimiciii,radiology_report,PROMPT1_ICL_entailment
188,268,11,7,4,0.6363636363636364,20,13,7,0.65,0.6431095406360424,gemini,mimiciii,radiology_report,PROMPT1_ICL_entailment
189,269,13,13,0,1.0,30,17,13,0.5666666666666667,0.7234042553191489,gemini,mimiciii,radiology_report,PROMPT1_ICL_entailment
190,27,17,17,0,1.0,14,10,4,0.7142857142857143,0.8333333333333333,gemini,mimiciii,radiology_report,PROMPT1_ICL_entailment
191,270,19,14,5,0.7368421052631579,17,15,2,0.8823529411764706,0.8030592734225621,gemini,mimiciii,radiology_report,PROMPT1_ICL_entailment
192,271,14,12,2,0.8571428571428571,20,13,7,0.65,0.7393364928909953,gemini,mimiciii,radiology_report,PROMPT1_ICL_entailment
193,272,25,18,7,0.72,17,14,3,0.8235294117647058,0.7682926829268293,gemini,mimiciii,radiology_report,PROMPT1_ICL_entailment
194,273,11,11,0,1.0,12,5,7,0.4166666666666667,0.5882352941176471,gemini,mimiciii,radiology_report,PROMPT1_ICL_entailment
195,274,19,13,6,0.6842105263157895,20,15,5,0.75,0.7155963302752295,gemini,mimiciii,radiology_report,PROMPT1_ICL_entailment
196,275,14,14,0,1.0,12,11,1,0.9166666666666666,0.9565217391304348,gemini,mimiciii,radiology_report,PROMPT1_ICL_entailment
197,276,16,15,1,0.9375,29,24,5,0.8275862068965517,0.8791208791208792,gemini,mimiciii,radiology_report,PROMPT1_ICL_entailment
198,277,18,14,4,0.7777777777777778,25,17,8,0.68,0.7256097560975611,gemini,mimiciii,radiology_report,PROMPT1_ICL_entailment
199,278,17,11,6,0.6470588235294118,16,13,3,0.8125,0.7204030226700252,gemini,mimiciii,radiology_report,PROMPT1_ICL_entailment
200,279,12,11,1,0.9166666666666666,10,7,3,0.7,0.7938144329896907,gemini,mimiciii,radiology_report,PROMPT1_ICL_entailment
201,28,17,11,6,0.6470588235294118,30,21,9,0.7,0.6724890829694322,gemini,mimiciii,radiology_report,PROMPT1_ICL_entailment
202,280,12,9,3,0.75,12,7,5,0.5833333333333334,0.6562499999999999,gemini,mimiciii,radiology_report,PROMPT1_ICL_entailment
203,281,17,10,7,0.5882352941176471,24,17,7,0.7083333333333334,0.6427221172022685,gemini,mimiciii,radiology_report,PROMPT1_ICL_entailment
204,282,15,14,1,0.9333333333333332,12,11,1,0.9166666666666666,0.9249249249249248,gemini,mimiciii,radiology_report,PROMPT1_ICL_entailment
205,283,8,8,0,1.0,28,14,14,0.5,0.6666666666666666,gemini,mimiciii,radiology_report,PROMPT1_ICL_entailment
206,284,15,11,4,0.7333333333333333,14,12,2,0.8571428571428571,0.7904191616766466,gemini,mimiciii,radiology_report,PROMPT1_ICL_entailment
207,285,15,11,4,0.7333333333333333,18,13,5,0.7222222222222222,0.727735368956743,gemini,mimiciii,radiology_report,PROMPT1_ICL_entailment
208,286,8,8,0,1.0,6,6,0,1.0,1.0,gemini,mimiciii,radiology_report,PROMPT1_ICL_entailment
209,287,19,16,3,0.8421052631578947,18,14,4,0.7777777777777778,0.8086642599277979,gemini,mimiciii,radiology_report,PROMPT1_ICL_entailment
210,288,21,15,6,0.7142857142857143,32,26,6,0.8125,0.7602339181286549,gemini,mimiciii,radiology_report,PROMPT1_ICL_entailment
211,289,12,11,1,0.9166666666666666,20,13,7,0.65,0.7606382978723404,gemini,mimiciii,radiology_report,PROMPT1_ICL_entailment
212,29,13,12,1,0.9230769230769232,8,7,1,0.875,0.8983957219251337,gemini,mimiciii,radiology_report,PROMPT1_ICL_entailment
213,290,11,10,1,0.9090909090909092,11,9,2,0.8181818181818182,0.861244019138756,gemini,mimiciii,radiology_report,PROMPT1_ICL_entailment
214,291,21,10,11,0.4761904761904761,24,14,10,0.5833333333333334,0.5243445692883896,gemini,mimiciii,radiology_report,PROMPT1_ICL_entailment
215,292,20,10,10,0.5,21,19,2,0.9047619047619048,0.6440677966101696,gemini,mimiciii,radiology_report,PROMPT1_ICL_entailment
216,293,11,8,3,0.7272727272727273,18,14,4,0.7777777777777778,0.7516778523489932,gemini,mimiciii,radiology_report,PROMPT1_ICL_entailment
217,294,17,7,10,0.4117647058823529,22,13,9,0.5909090909090909,0.4853333333333333,gemini,mimiciii,radiology_report,PROMPT1_ICL_entailment
218,295,10,7,3,0.7,39,28,11,0.717948717948718,0.708860759493671,gemini,mimiciii,radiology_report,PROMPT1_ICL_entailment
219,296,14,6,8,0.4285714285714285,17,15,2,0.8823529411764706,0.5769230769230769,gemini,mimiciii,radiology_report,PROMPT1_ICL_entailment
220,297,14,9,5,0.6428571428571429,24,17,7,0.7083333333333334,0.6740088105726872,gemini,mimiciii,radiology_report,PROMPT1_ICL_entailment
221,298,15,11,4,0.7333333333333333,20,13,7,0.65,0.689156626506024,gemini,mimiciii,radiology_report,PROMPT1_ICL_entailment
222,299,17,15,2,0.8823529411764706,32,21,11,0.65625,0.7526881720430106,gemini,mimiciii,radiology_report,PROMPT1_ICL_entailment
223,3,13,8,5,0.6153846153846154,20,14,6,0.7,0.6549707602339182,gemini,mimiciii,radiology_report,PROMPT1_ICL_entailment
224,30,10,7,3,0.7,25,13,12,0.52,0.5967213114754099,gemini,mimiciii,radiology_report,PROMPT1_ICL_entailment
225,300,14,12,2,0.8571428571428571,13,8,5,0.6153846153846154,0.7164179104477612,gemini,mimiciii,radiology_report,PROMPT1_ICL_entailment
226,301,13,12,1,0.9230769230769232,19,12,7,0.631578947368421,0.7499999999999999,gemini,mimiciii,radiology_report,PROMPT1_ICL_entailment
227,302,20,16,4,0.8,15,13,2,0.8666666666666667,0.832,gemini,mimiciii,radiology_report,PROMPT1_ICL_entailment
228,303,28,16,12,0.5714285714285714,24,17,7,0.7083333333333334,0.6325581395348838,gemini,mimiciii,radiology_report,PROMPT1_ICL_entailment
229,304,19,16,3,0.8421052631578947,21,19,2,0.9047619047619048,0.8723098995695839,gemini,mimiciii,radiology_report,PROMPT1_ICL_entailment
230,305,16,8,8,0.5,24,12,12,0.5,0.5,gemini,mimiciii,radiology_report,PROMPT1_ICL_entailment
231,306,18,12,6,0.6666666666666666,14,10,4,0.7142857142857143,0.689655172413793,gemini,mimiciii,radiology_report,PROMPT1_ICL_entailment
232,307,18,16,2,0.8888888888888888,17,13,4,0.7647058823529411,0.8221343873517786,gemini,mimiciii,radiology_report,PROMPT1_ICL_entailment
233,308,13,9,4,0.6923076923076923,15,11,4,0.7333333333333333,0.7122302158273381,gemini,mimiciii,radiology_report,PROMPT1_ICL_entailment
234,309,14,11,3,0.7857142857142857,29,16,13,0.5517241379310345,0.6482504604051564,gemini,mimiciii,radiology_report,PROMPT1_ICL_entailment
235,31,15,11,4,0.7333333333333333,19,12,7,0.631578947368421,0.6786632390745502,gemini,mimiciii,radiology_report,PROMPT1_ICL_entailment
236,310,17,10,7,0.5882352941176471,24,18,6,0.75,0.6593406593406592,gemini,mimiciii,radiology_report,PROMPT1_ICL_entailment
237,311,15,12,3,0.8,15,12,3,0.8,0.8000000000000002,gemini,mimiciii,radiology_report,PROMPT1_ICL_entailment
238,312,20,20,0,1.0,18,15,3,0.8333333333333334,0.9090909090909092,gemini,mimiciii,radiology_report,PROMPT1_ICL_entailment
239,313,15,12,3,0.8,17,13,4,0.7647058823529411,0.7819548872180452,gemini,mimiciii,radiology_report,PROMPT1_ICL_entailment
240,314,22,13,9,0.5909090909090909,15,10,5,0.6666666666666666,0.6265060240963856,gemini,mimiciii,radiology_report,PROMPT1_ICL_entailment
241,315,34,22,12,0.6470588235294118,25,17,8,0.68,0.6631205673758865,gemini,mimiciii,radiology_report,PROMPT1_ICL_entailment
242,316,9,8,1,0.8888888888888888,10,8,2,0.8,0.8421052631578948,gemini,mimiciii,radiology_report,PROMPT1_ICL_entailment
243,317,17,10,7,0.5882352941176471,26,19,7,0.7307692307692307,0.6518010291595197,gemini,mimiciii,radiology_report,PROMPT1_ICL_entailment
244,318,13,10,3,0.7692307692307693,21,14,7,0.6666666666666666,0.7142857142857142,gemini,mimiciii,radiology_report,PROMPT1_ICL_entailment
245,319,17,15,2,0.8823529411764706,12,11,1,0.9166666666666666,0.8991825613079019,gemini,mimiciii,radiology_report,PROMPT1_ICL_entailment
246,32,14,13,1,0.9285714285714286,15,13,2,0.8666666666666667,0.896551724137931,gemini,mimiciii,radiology_report,PROMPT1_ICL_entailment
247,320,11,11,0,1.0,11,8,3,0.7272727272727273,0.8421052631578948,gemini,mimiciii,radiology_report,PROMPT1_ICL_entailment
248,321,16,12,4,0.75,21,16,5,0.7619047619047619,0.7559055118110236,gemini,mimiciii,radiology_report,PROMPT1_ICL_entailment
249,322,10,7,3,0.7,8,7,1,0.875,0.7777777777777777,gemini,mimiciii,radiology_report,PROMPT1_ICL_entailment
250,323,17,15,2,0.8823529411764706,29,18,11,0.6206896551724138,0.728744939271255,gemini,mimiciii,radiology_report,PROMPT1_ICL_entailment
251,324,17,12,5,0.7058823529411765,18,13,5,0.7222222222222222,0.71395881006865,gemini,mimiciii,radiology_report,PROMPT1_ICL_entailment
252,325,18,13,5,0.7222222222222222,22,18,4,0.8181818181818182,0.7672131147540984,gemini,mimiciii,radiology_report,PROMPT1_ICL_entailment
253,326,16,8,8,0.5,23,19,4,0.8260869565217391,0.6229508196721311,gemini,mimiciii,radiology_report,PROMPT1_ICL_entailment
254,327,8,8,0,1.0,9,8,1,0.8888888888888888,0.9411764705882352,gemini,mimiciii,radiology_report,PROMPT1_ICL_entailment
255,328,18,16,2,0.8888888888888888,17,14,3,0.8235294117647058,0.8549618320610687,gemini,mimiciii,radiology_report,PROMPT1_ICL_entailment
256,329,24,20,4,0.8333333333333334,28,18,10,0.6428571428571429,0.7258064516129034,gemini,mimiciii,radiology_report,PROMPT1_ICL_entailment
257,33,6,6,0,1.0,9,7,2,0.7777777777777778,0.8750000000000001,gemini,mimiciii,radiology_report,PROMPT1_ICL_entailment
258,330,14,11,3,0.7857142857142857,11,10,1,0.9090909090909092,0.842911877394636,gemini,mimiciii,radiology_report,PROMPT1_ICL_entailment
259,331,10,9,1,0.9,15,13,2,0.8666666666666667,0.8830188679245283,gemini,mimiciii,radiology_report,PROMPT1_ICL_entailment
260,332,15,12,3,0.8,20,14,6,0.7,0.7466666666666666,gemini,mimiciii,radiology_report,PROMPT1_ICL_entailment
261,333,12,12,0,1.0,13,11,2,0.8461538461538461,0.9166666666666666,gemini,mimiciii,radiology_report,PROMPT1_ICL_entailment
262,334,23,21,2,0.9130434782608696,20,19,1,0.95,0.9311551925320888,gemini,mimiciii,radiology_report,PROMPT1_ICL_entailment
263,335,20,17,3,0.85,17,13,4,0.7647058823529411,0.8051001821493623,gemini,mimiciii,radiology_report,PROMPT1_ICL_entailment
264,336,24,17,7,0.7083333333333334,16,14,2,0.875,0.7828947368421053,gemini,mimiciii,radiology_report,PROMPT1_ICL_entailment
265,34,14,11,3,0.7857142857142857,14,12,2,0.8571428571428571,0.8198757763975155,gemini,mimiciii,radiology_report,PROMPT1_ICL_entailment
266,35,20,10,10,0.5,21,18,3,0.8571428571428571,0.631578947368421,gemini,mimiciii,radiology_report,PROMPT1_ICL_entailment
267,36,15,12,3,0.8,22,17,5,0.7727272727272727,0.7861271676300577,gemini,mimiciii,radiology_report,PROMPT1_ICL_entailment
268,37,10,9,1,0.9,21,15,6,0.7142857142857143,0.7964601769911505,gemini,mimiciii,radiology_report,PROMPT1_ICL_entailment
269,38,17,10,7,0.5882352941176471,19,15,4,0.7894736842105263,0.6741573033707866,gemini,mimiciii,radiology_report,PROMPT1_ICL_entailment
270,39,10,10,0,1.0,10,7,3,0.7,0.8235294117647058,gemini,mimiciii,radiology_report,PROMPT1_ICL_entailment
271,4,15,13,2,0.8666666666666667,16,14,2,0.875,0.8708133971291866,gemini,mimiciii,radiology_report,PROMPT1_ICL_entailment
272,40,14,11,3,0.7857142857142857,17,10,7,0.5882352941176471,0.672782874617737,gemini,mimiciii,radiology_report,PROMPT1_ICL_entailment
273,41,19,15,4,0.7894736842105263,26,17,9,0.6538461538461539,0.7152875175315568,gemini,mimiciii,radiology_report,PROMPT1_ICL_entailment
274,42,12,10,2,0.8333333333333334,14,9,5,0.6428571428571429,0.7258064516129034,gemini,mimiciii,radiology_report,PROMPT1_ICL_entailment
275,43,13,11,2,0.8461538461538461,7,7,0,1.0,0.9166666666666666,gemini,mimiciii,radiology_report,PROMPT1_ICL_entailment
276,44,12,12,0,1.0,16,12,4,0.75,0.8571428571428571,gemini,mimiciii,radiology_report,PROMPT1_ICL_entailment
277,45,15,8,7,0.5333333333333333,20,13,7,0.65,0.5859154929577465,gemini,mimiciii,radiology_report,PROMPT1_ICL_entailment
278,46,14,10,4,0.7142857142857143,26,16,10,0.6153846153846154,0.6611570247933884,gemini,mimiciii,radiology_report,PROMPT1_ICL_entailment
279,47,15,11,4,0.7333333333333333,15,10,5,0.6666666666666666,0.6984126984126984,gemini,mimiciii,radiology_report,PROMPT1_ICL_entailment
280,48,16,10,6,0.625,21,18,3,0.8571428571428571,0.7228915662650602,gemini,mimiciii,radiology_report,PROMPT1_ICL_entailment
281,49,15,14,1,0.9333333333333332,24,16,8,0.6666666666666666,0.7777777777777778,gemini,mimiciii,radiology_report,PROMPT1_ICL_entailment
282,5,18,13,5,0.7222222222222222,22,16,6,0.7272727272727273,0.7247386759581883,gemini,mimiciii,radiology_report,PROMPT1_ICL_entailment
283,50,11,8,3,0.7272727272727273,15,11,4,0.7333333333333333,0.7302904564315353,gemini,mimiciii,radiology_report,PROMPT1_ICL_entailment
284,51,14,13,1,0.9285714285714286,13,10,3,0.7692307692307693,0.8414239482200646,gemini,mimiciii,radiology_report,PROMPT1_ICL_entailment
285,52,17,10,7,0.5882352941176471,21,15,6,0.7142857142857143,0.6451612903225806,gemini,mimiciii,radiology_report,PROMPT1_ICL_entailment
286,53,11,11,0,1.0,12,9,3,0.75,0.8571428571428571,gemini,mimiciii,radiology_report,PROMPT1_ICL_entailment
287,54,9,7,2,0.7777777777777778,10,6,4,0.6,0.6774193548387097,gemini,mimiciii,radiology_report,PROMPT1_ICL_entailment
288,55,15,10,5,0.6666666666666666,18,12,6,0.6666666666666666,0.6666666666666666,gemini,mimiciii,radiology_report,PROMPT1_ICL_entailment
289,56,11,9,2,0.8181818181818182,21,15,6,0.7142857142857143,0.7627118644067797,gemini,mimiciii,radiology_report,PROMPT1_ICL_entailment
290,57,7,7,0,1.0,10,5,5,0.5,0.6666666666666666,gemini,mimiciii,radiology_report,PROMPT1_ICL_entailment
291,58,17,17,0,1.0,16,11,5,0.6875,0.8148148148148148,gemini,mimiciii,radiology_report,PROMPT1_ICL_entailment
292,59,11,11,0,1.0,16,13,3,0.8125,0.896551724137931,gemini,mimiciii,radiology_report,PROMPT1_ICL_entailment
293,6,10,9,1,0.9,8,7,1,0.875,0.8873239436619719,gemini,mimiciii,radiology_report,PROMPT1_ICL_entailment
294,60,13,11,2,0.8461538461538461,19,10,9,0.5263157894736842,0.6489675516224189,gemini,mimiciii,radiology_report,PROMPT1_ICL_entailment
295,61,16,12,4,0.75,22,16,6,0.7272727272727273,0.7384615384615384,gemini,mimiciii,radiology_report,PROMPT1_ICL_entailment
296,62,15,9,6,0.6,13,10,3,0.7692307692307693,0.6741573033707865,gemini,mimiciii,radiology_report,PROMPT1_ICL_entailment
297,63,16,14,2,0.875,15,11,4,0.7333333333333333,0.7979274611398963,gemini,mimiciii,radiology_report,PROMPT1_ICL_entailment
298,64,23,16,7,0.6956521739130435,20,17,3,0.85,0.7651195499296763,gemini,mimiciii,radiology_report,PROMPT1_ICL_entailment
299,65,20,15,5,0.75,18,15,3,0.8333333333333334,0.7894736842105262,gemini,mimiciii,radiology_report,PROMPT1_ICL_entailment
300,66,12,9,3,0.75,34,24,10,0.7058823529411765,0.7272727272727272,gemini,mimiciii,radiology_report,PROMPT1_ICL_entailment
301,67,27,20,7,0.7407407407407407,28,25,3,0.8928571428571429,0.8097165991902834,gemini,mimiciii,radiology_report,PROMPT1_ICL_entailment
302,68,15,13,2,0.8666666666666667,35,27,8,0.7714285714285715,0.8162790697674419,gemini,mimiciii,radiology_report,PROMPT1_ICL_entailment
303,69,16,10,6,0.625,31,20,11,0.6451612903225806,0.634920634920635,gemini,mimiciii,radiology_report,PROMPT1_ICL_entailment
304,7,14,12,2,0.8571428571428571,16,13,3,0.8125,0.8342245989304812,gemini,mimiciii,radiology_report,PROMPT1_ICL_entailment
305,70,8,6,2,0.75,17,14,3,0.8235294117647058,0.7850467289719627,gemini,mimiciii,radiology_report,PROMPT1_ICL_entailment
306,71,14,8,6,0.5714285714285714,18,10,8,0.5555555555555556,0.5633802816901409,gemini,mimiciii,radiology_report,PROMPT1_ICL_entailment
307,72,16,15,1,0.9375,13,12,1,0.9230769230769232,0.9302325581395348,gemini,mimiciii,radiology_report,PROMPT1_ICL_entailment
308,73,23,14,9,0.6086956521739131,34,19,15,0.5588235294117647,0.5826944140197152,gemini,mimiciii,radiology_report,PROMPT1_ICL_entailment
309,74,13,8,5,0.6153846153846154,18,11,7,0.6111111111111112,0.613240418118467,gemini,mimiciii,radiology_report,PROMPT1_ICL_entailment
310,75,13,9,4,0.6923076923076923,12,10,2,0.8333333333333334,0.7563025210084034,gemini,mimiciii,radiology_report,PROMPT1_ICL_entailment
311,76,13,12,1,0.9230769230769232,14,10,4,0.7142857142857143,0.8053691275167787,gemini,mimiciii,radiology_report,PROMPT1_ICL_entailment
312,77,21,18,3,0.8571428571428571,26,21,5,0.8076923076923077,0.8316831683168318,gemini,mimiciii,radiology_report,PROMPT1_ICL_entailment
313,78,22,16,6,0.7272727272727273,33,21,12,0.6363636363636364,0.6787878787878787,gemini,mimiciii,radiology_report,PROMPT1_ICL_entailment
314,79,18,16,2,0.8888888888888888,17,15,2,0.8823529411764706,0.8856088560885608,gemini,mimiciii,radiology_report,PROMPT1_ICL_entailment
315,8,22,21,1,0.9545454545454546,15,13,2,0.8666666666666667,0.9084858569051582,gemini,mimiciii,radiology_report,PROMPT1_ICL_entailment
316,80,20,12,8,0.6,25,20,5,0.8,0.6857142857142857,gemini,mimiciii,radiology_report,PROMPT1_ICL_entailment
317,81,19,13,6,0.6842105263157895,15,10,5,0.6666666666666666,0.6753246753246753,gemini,mimiciii,radiology_report,PROMPT1_ICL_entailment
318,82,15,11,4,0.7333333333333333,14,12,2,0.8571428571428571,0.7904191616766466,gemini,mimiciii,radiology_report,PROMPT1_ICL_entailment
319,83,24,14,10,0.5833333333333334,17,16,1,0.9411764705882352,0.7202572347266882,gemini,mimiciii,radiology_report,PROMPT1_ICL_entailment
320,84,16,12,4,0.75,20,16,4,0.8,0.7741935483870969,gemini,mimiciii,radiology_report,PROMPT1_ICL_entailment
321,85,14,13,1,0.9285714285714286,14,11,3,0.7857142857142857,0.851190476190476,gemini,mimiciii,radiology_report,PROMPT1_ICL_entailment
322,86,13,11,2,0.8461538461538461,10,8,2,0.8,0.8224299065420562,gemini,mimiciii,radiology_report,PROMPT1_ICL_entailment
323,87,15,12,3,0.8,14,11,3,0.7857142857142857,0.7927927927927927,gemini,mimiciii,radiology_report,PROMPT1_ICL_entailment
324,88,17,11,6,0.6470588235294118,19,17,2,0.8947368421052632,0.751004016064257,gemini,mimiciii,radiology_report,PROMPT1_ICL_entailment
325,89,17,13,4,0.7647058823529411,18,17,1,0.9444444444444444,0.8451242829827915,gemini,mimiciii,radiology_report,PROMPT1_ICL_entailment
326,9,12,12,0,1.0,13,9,4,0.6923076923076923,0.8181818181818181,gemini,mimiciii,radiology_report,PROMPT1_ICL_entailment
327,90,14,14,0,1.0,14,14,0,1.0,1.0,gemini,mimiciii,radiology_report,PROMPT1_ICL_entailment
328,91,12,11,1,0.9166666666666666,13,7,6,0.5384615384615384,0.6784140969162995,gemini,mimiciii,radiology_report,PROMPT1_ICL_entailment
329,92,18,15,3,0.8333333333333334,21,14,7,0.6666666666666666,0.7407407407407408,gemini,mimiciii,radiology_report,PROMPT1_ICL_entailment
330,93,20,17,3,0.85,15,12,3,0.8,0.8242424242424243,gemini,mimiciii,radiology_report,PROMPT1_ICL_entailment
331,94,17,11,6,0.6470588235294118,28,17,11,0.6071428571428571,0.626465661641541,gemini,mimiciii,radiology_report,PROMPT1_ICL_entailment
332,95,15,14,1,0.9333333333333332,18,12,6,0.6666666666666666,0.7777777777777778,gemini,mimiciii,radiology_report,PROMPT1_ICL_entailment
333,96,17,12,5,0.7058823529411765,21,19,2,0.9047619047619048,0.7930434782608696,gemini,mimiciii,radiology_report,PROMPT1_ICL_entailment
334,97,16,10,6,0.625,23,19,4,0.8260869565217391,0.7116104868913856,gemini,mimiciii,radiology_report,PROMPT1_ICL_entailment
335,98,15,10,5,0.6666666666666666,19,13,6,0.6842105263157895,0.6753246753246753,gemini,mimiciii,radiology_report,PROMPT1_ICL_entailment
336,99,18,15,3,0.8333333333333334,13,13,0,1.0,0.9090909090909092,gemini,mimiciii,radiology_report,PROMPT1_ICL_entailment
0,0,21,13,8,0.6190476190476191,21,12,9,0.5714285714285714,0.5942857142857143,gemini,mimiciii,radiology_report,PROMPT2_ICL_entailment
1,1,20,15,5,0.75,15,11,4,0.7333333333333333,0.7415730337078651,gemini,mimiciii,radiology_report,PROMPT2_ICL_entailment
2,10,12,8,4,0.6666666666666666,18,12,6,0.6666666666666666,0.6666666666666666,gemini,mimiciii,radiology_report,PROMPT2_ICL_entailment
3,100,12,12,0,1.0,9,9,0,1.0,1.0,gemini,mimiciii,radiology_report,PROMPT2_ICL_entailment
4,101,19,13,6,0.6842105263157895,15,11,4,0.7333333333333333,0.707920792079208,gemini,mimiciii,radiology_report,PROMPT2_ICL_entailment
5,102,1,0,1,0.0,16,3,13,0.1875,0.0,gemini,mimiciii,radiology_report,PROMPT2_ICL_entailment
6,103,18,12,6,0.6666666666666666,19,14,5,0.7368421052631579,0.7,gemini,mimiciii,radiology_report,PROMPT2_ICL_entailment
7,104,17,6,11,0.3529411764705882,17,11,6,0.6470588235294118,0.4567474048442907,gemini,mimiciii,radiology_report,PROMPT2_ICL_entailment
8,105,7,6,1,0.8571428571428571,8,6,2,0.75,0.7999999999999999,gemini,mimiciii,radiology_report,PROMPT2_ICL_entailment
9,106,15,14,1,0.9333333333333332,12,9,3,0.75,0.8316831683168316,gemini,mimiciii,radiology_report,PROMPT2_ICL_entailment
10,107,16,14,2,0.875,19,12,7,0.631578947368421,0.7336244541484715,gemini,mimiciii,radiology_report,PROMPT2_ICL_entailment
11,108,13,13,0,1.0,13,8,5,0.6153846153846154,0.761904761904762,gemini,mimiciii,radiology_report,PROMPT2_ICL_entailment
12,109,18,10,8,0.5555555555555556,20,16,4,0.8,0.6557377049180328,gemini,mimiciii,radiology_report,PROMPT2_ICL_entailment
13,11,13,12,1,0.9230769230769232,20,13,7,0.65,0.762836185819071,gemini,mimiciii,radiology_report,PROMPT2_ICL_entailment
14,110,18,11,7,0.6111111111111112,17,13,4,0.7647058823529411,0.6793349168646081,gemini,mimiciii,radiology_report,PROMPT2_ICL_entailment
15,111,18,10,8,0.5555555555555556,20,18,2,0.9,0.6870229007633587,gemini,mimiciii,radiology_report,PROMPT2_ICL_entailment
16,112,15,15,0,1.0,14,11,3,0.7857142857142857,0.88,gemini,mimiciii,radiology_report,PROMPT2_ICL_entailment
17,113,20,9,11,0.45,20,13,7,0.65,0.5318181818181819,gemini,mimiciii,radiology_report,PROMPT2_ICL_entailment
18,114,21,14,7,0.6666666666666666,23,20,3,0.8695652173913043,0.7547169811320754,gemini,mimiciii,radiology_report,PROMPT2_ICL_entailment
19,115,16,15,1,0.9375,20,16,4,0.8,0.8633093525179856,gemini,mimiciii,radiology_report,PROMPT2_ICL_entailment
20,116,13,11,2,0.8461538461538461,13,11,2,0.8461538461538461,0.8461538461538461,gemini,mimiciii,radiology_report,PROMPT2_ICL_entailment
21,117,18,12,6,0.6666666666666666,16,13,3,0.8125,0.7323943661971831,gemini,mimiciii,radiology_report,PROMPT2_ICL_entailment
22,118,17,12,5,0.7058823529411765,24,17,7,0.7083333333333334,0.7071057192374351,gemini,mimiciii,radiology_report,PROMPT2_ICL_entailment
23,119,18,16,2,0.8888888888888888,17,13,4,0.7647058823529411,0.8221343873517786,gemini,mimiciii,radiology_report,PROMPT2_ICL_entailment
24,12,14,14,0,1.0,17,13,4,0.7647058823529411,0.8666666666666666,gemini,mimiciii,radiology_report,PROMPT2_ICL_entailment
25,120,12,9,3,0.75,16,10,6,0.625,0.6818181818181818,gemini,mimiciii,radiology_report,PROMPT2_ICL_entailment
26,121,21,13,8,0.6190476190476191,26,20,6,0.7692307692307693,0.6860158311345647,gemini,mimiciii,radiology_report,PROMPT2_ICL_entailment
27,122,9,7,2,0.7777777777777778,20,14,6,0.7,0.7368421052631577,gemini,mimiciii,radiology_report,PROMPT2_ICL_entailment
28,123,12,11,1,0.9166666666666666,13,12,1,0.9230769230769232,0.9198606271777002,gemini,mimiciii,radiology_report,PROMPT2_ICL_entailment
29,124,12,11,1,0.9166666666666666,12,9,3,0.75,0.8250000000000001,gemini,mimiciii,radiology_report,PROMPT2_ICL_entailment
30,125,13,9,4,0.6923076923076923,23,16,7,0.6956521739130435,0.6939759036144578,gemini,mimiciii,radiology_report,PROMPT2_ICL_entailment
31,126,12,7,5,0.5833333333333334,9,6,3,0.6666666666666666,0.6222222222222222,gemini,mimiciii,radiology_report,PROMPT2_ICL_entailment
32,127,45,43,2,0.9555555555555556,43,32,11,0.7441860465116279,0.8367284889024019,gemini,mimiciii,radiology_report,PROMPT2_ICL_entailment
33,128,16,12,4,0.75,14,11,3,0.7857142857142857,0.7674418604651163,gemini,mimiciii,radiology_report,PROMPT2_ICL_entailment
34,129,15,12,3,0.8,16,13,3,0.8125,0.8062015503875969,gemini,mimiciii,radiology_report,PROMPT2_ICL_entailment
35,13,16,12,4,0.75,17,12,5,0.7058823529411765,0.7272727272727272,gemini,mimiciii,radiology_report,PROMPT2_ICL_entailment
36,130,20,17,3,0.85,25,17,8,0.68,0.7555555555555556,gemini,mimiciii,radiology_report,PROMPT2_ICL_entailment
37,131,10,9,1,0.9,32,23,9,0.71875,0.7992277992277993,gemini,mimiciii,radiology_report,PROMPT2_ICL_entailment
38,132,17,7,10,0.4117647058823529,23,14,9,0.6086956521739131,0.4912280701754386,gemini,mimiciii,radiology_report,PROMPT2_ICL_entailment
39,133,11,11,0,1.0,21,12,9,0.5714285714285714,0.7272727272727273,gemini,mimiciii,radiology_report,PROMPT2_ICL_entailment
40,134,11,9,2,0.8181818181818182,23,17,6,0.7391304347826086,0.7766497461928934,gemini,mimiciii,radiology_report,PROMPT2_ICL_entailment
41,135,17,16,1,0.9411764705882352,20,13,7,0.65,0.7689463955637708,gemini,mimiciii,radiology_report,PROMPT2_ICL_entailment
42,136,10,9,1,0.9,14,10,4,0.7142857142857143,0.7964601769911505,gemini,mimiciii,radiology_report,PROMPT2_ICL_entailment
43,137,14,12,2,0.8571428571428571,10,9,1,0.9,0.8780487804878048,gemini,mimiciii,radiology_report,PROMPT2_ICL_entailment
44,138,11,11,0,1.0,14,8,6,0.5714285714285714,0.7272727272727273,gemini,mimiciii,radiology_report,PROMPT2_ICL_entailment
45,139,13,10,3,0.7692307692307693,13,9,4,0.6923076923076923,0.728744939271255,gemini,mimiciii,radiology_report,PROMPT2_ICL_entailment
46,14,13,13,0,1.0,12,9,3,0.75,0.8571428571428571,gemini,mimiciii,radiology_report,PROMPT2_ICL_entailment
47,140,13,10,3,0.7692307692307693,18,15,3,0.8333333333333334,0.8,gemini,mimiciii,radiology_report,PROMPT2_ICL_entailment
48,141,14,12,2,0.8571428571428571,16,9,7,0.5625,0.6792452830188678,gemini,mimiciii,radiology_report,PROMPT2_ICL_entailment
49,142,13,8,5,0.6153846153846154,14,10,4,0.7142857142857143,0.6611570247933884,gemini,mimiciii,radiology_report,PROMPT2_ICL_entailment
50,143,23,17,6,0.7391304347826086,28,17,11,0.6071428571428571,0.6666666666666666,gemini,mimiciii,radiology_report,PROMPT2_ICL_entailment
51,144,15,12,3,0.8,23,14,9,0.6086956521739131,0.6913580246913581,gemini,mimiciii,radiology_report,PROMPT2_ICL_entailment
52,145,19,17,2,0.8947368421052632,18,17,1,0.9444444444444444,0.918918918918919,gemini,mimiciii,radiology_report,PROMPT2_ICL_entailment
53,146,7,7,0,1.0,11,7,4,0.6363636363636364,0.7777777777777778,gemini,mimiciii,radiology_report,PROMPT2_ICL_entailment
54,147,13,13,0,1.0,10,8,2,0.8,0.888888888888889,gemini,mimiciii,radiology_report,PROMPT2_ICL_entailment
55,148,24,17,7,0.7083333333333334,26,18,8,0.6923076923076923,0.7002288329519452,gemini,mimiciii,radiology_report,PROMPT2_ICL_entailment
56,149,15,10,5,0.6666666666666666,20,14,6,0.7,0.6829268292682926,gemini,mimiciii,radiology_report,PROMPT2_ICL_entailment
57,15,31,19,12,0.6129032258064516,29,21,8,0.7241379310344828,0.6638935108153079,gemini,mimiciii,radiology_report,PROMPT2_ICL_entailment
58,150,14,10,4,0.7142857142857143,14,11,3,0.7857142857142857,0.7482993197278911,gemini,mimiciii,radiology_report,PROMPT2_ICL_entailment
59,151,15,8,7,0.5333333333333333,15,7,8,0.4666666666666667,0.4977777777777777,gemini,mimiciii,radiology_report,PROMPT2_ICL_entailment
60,152,16,7,9,0.4375,18,12,6,0.6666666666666666,0.5283018867924528,gemini,mimiciii,radiology_report,PROMPT2_ICL_entailment
61,153,13,8,5,0.6153846153846154,16,11,5,0.6875,0.6494464944649447,gemini,mimiciii,radiology_report,PROMPT2_ICL_entailment
62,154,26,14,12,0.5384615384615384,23,18,5,0.782608695652174,0.6379746835443038,gemini,mimiciii,radiology_report,PROMPT2_ICL_entailment
63,155,35,34,1,0.9714285714285714,47,35,12,0.7446808510638298,0.843074743181013,gemini,mimiciii,radiology_report,PROMPT2_ICL_entailment
64,156,18,10,8,0.5555555555555556,20,11,9,0.55,0.5527638190954774,gemini,mimiciii,radiology_report,PROMPT2_ICL_entailment
65,157,17,15,2,0.8823529411764706,12,8,4,0.6666666666666666,0.7594936708860759,gemini,mimiciii,radiology_report,PROMPT2_ICL_entailment
66,158,8,7,1,0.875,6,4,2,0.6666666666666666,0.7567567567567567,gemini,mimiciii,radiology_report,PROMPT2_ICL_entailment
67,159,14,11,3,0.7857142857142857,13,11,2,0.8461538461538461,0.8148148148148148,gemini,mimiciii,radiology_report,PROMPT2_ICL_entailment
68,16,13,9,4,0.6923076923076923,17,10,7,0.5882352941176471,0.6360424028268552,gemini,mimiciii,radiology_report,PROMPT2_ICL_entailment
69,160,14,13,1,0.9285714285714286,12,9,3,0.75,0.8297872340425532,gemini,mimiciii,radiology_report,PROMPT2_ICL_entailment
70,161,16,14,2,0.875,13,6,7,0.4615384615384615,0.6043165467625898,gemini,mimiciii,radiology_report,PROMPT2_ICL_entailment
71,162,14,13,1,0.9285714285714286,11,8,3,0.7272727272727273,0.8156862745098039,gemini,mimiciii,radiology_report,PROMPT2_ICL_entailment
72,163,10,9,1,0.9,8,4,4,0.5,0.6428571428571429,gemini,mimiciii,radiology_report,PROMPT2_ICL_entailment
73,164,13,13,0,1.0,10,10,0,1.0,1.0,gemini,mimiciii,radiology_report,PROMPT2_ICL_entailment
74,165,20,17,3,0.85,28,23,5,0.8214285714285714,0.8354700854700855,gemini,mimiciii,radiology_report,PROMPT2_ICL_entailment
75,166,18,12,6,0.6666666666666666,26,17,9,0.6538461538461539,0.6601941747572816,gemini,mimiciii,radiology_report,PROMPT2_ICL_entailment
76,167,7,7,0,1.0,10,9,1,0.9,0.9473684210526316,gemini,mimiciii,radiology_report,PROMPT2_ICL_entailment
77,168,16,14,2,0.875,13,8,5,0.6153846153846154,0.7225806451612904,gemini,mimiciii,radiology_report,PROMPT2_ICL_entailment
78,169,17,13,4,0.7647058823529411,22,14,8,0.6363636363636364,0.6946564885496184,gemini,mimiciii,radiology_report,PROMPT2_ICL_entailment
79,17,13,12,1,0.9230769230769232,12,8,4,0.6666666666666666,0.7741935483870968,gemini,mimiciii,radiology_report,PROMPT2_ICL_entailment
80,170,17,15,2,0.8823529411764706,24,15,9,0.625,0.7317073170731708,gemini,mimiciii,radiology_report,PROMPT2_ICL_entailment
81,171,10,8,2,0.8,7,5,2,0.7142857142857143,0.7547169811320756,gemini,mimiciii,radiology_report,PROMPT2_ICL_entailment
82,172,11,5,6,0.4545454545454545,14,10,4,0.7142857142857143,0.5555555555555556,gemini,mimiciii,radiology_report,PROMPT2_ICL_entailment
83,173,15,14,1,0.9333333333333332,12,8,4,0.6666666666666666,0.7777777777777778,gemini,mimiciii,radiology_report,PROMPT2_ICL_entailment
84,174,9,8,1,0.8888888888888888,20,10,10,0.5,0.64,gemini,mimiciii,radiology_report,PROMPT2_ICL_entailment
85,175,11,10,1,0.9090909090909092,8,6,2,0.75,0.821917808219178,gemini,mimiciii,radiology_report,PROMPT2_ICL_entailment
86,176,29,11,18,0.3793103448275862,19,17,2,0.8947368421052632,0.5327635327635327,gemini,mimiciii,radiology_report,PROMPT2_ICL_entailment
87,177,16,15,1,0.9375,16,10,6,0.625,0.75,gemini,mimiciii,radiology_report,PROMPT2_ICL_entailment
88,178,18,12,6,0.6666666666666666,25,17,8,0.68,0.6732673267326733,gemini,mimiciii,radiology_report,PROMPT2_ICL_entailment
89,179,14,14,0,1.0,17,10,7,0.5882352941176471,0.7407407407407407,gemini,mimiciii,radiology_report,PROMPT2_ICL_entailment
90,18,16,15,1,0.9375,17,11,6,0.6470588235294118,0.7656612529002321,gemini,mimiciii,radiology_report,PROMPT2_ICL_entailment
91,180,15,15,0,1.0,11,9,2,0.8181818181818182,0.9,gemini,mimiciii,radiology_report,PROMPT2_ICL_entailment
92,181,19,7,12,0.3684210526315789,26,15,11,0.5769230769230769,0.449678800856531,gemini,mimiciii,radiology_report,PROMPT2_ICL_entailment
93,182,14,11,3,0.7857142857142857,23,15,8,0.6521739130434783,0.712742980561555,gemini,mimiciii,radiology_report,PROMPT2_ICL_entailment
94,183,16,13,3,0.8125,17,13,4,0.7647058823529411,0.787878787878788,gemini,mimiciii,radiology_report,PROMPT2_ICL_entailment
95,184,12,12,0,1.0,15,13,2,0.8666666666666667,0.9285714285714286,gemini,mimiciii,radiology_report,PROMPT2_ICL_entailment
96,185,10,9,1,0.9,6,5,1,0.8333333333333334,0.8653846153846153,gemini,mimiciii,radiology_report,PROMPT2_ICL_entailment
97,186,18,14,4,0.7777777777777778,26,15,11,0.5769230769230769,0.6624605678233437,gemini,mimiciii,radiology_report,PROMPT2_ICL_entailment
98,187,13,10,3,0.7692307692307693,14,7,7,0.5,0.6060606060606061,gemini,mimiciii,radiology_report,PROMPT2_ICL_entailment
99,188,29,21,8,0.7241379310344828,22,12,10,0.5454545454545454,0.6222222222222222,gemini,mimiciii,radiology_report,PROMPT2_ICL_entailment
100,189,15,14,1,0.9333333333333332,15,13,2,0.8666666666666667,0.8987654320987654,gemini,mimiciii,radiology_report,PROMPT2_ICL_entailment
101,19,17,17,0,1.0,14,13,1,0.9285714285714286,0.962962962962963,gemini,mimiciii,radiology_report,PROMPT2_ICL_entailment
102,190,14,12,2,0.8571428571428571,17,13,4,0.7647058823529411,0.8082901554404144,gemini,mimiciii,radiology_report,PROMPT2_ICL_entailment
103,191,18,10,8,0.5555555555555556,15,11,4,0.7333333333333333,0.632183908045977,gemini,mimiciii,radiology_report,PROMPT2_ICL_entailment
104,192,34,21,13,0.6176470588235294,28,23,5,0.8214285714285714,0.7051094890510948,gemini,mimiciii,radiology_report,PROMPT2_ICL_entailment
105,193,14,13,1,0.9285714285714286,14,13,1,0.9285714285714286,0.9285714285714286,gemini,mimiciii,radiology_report,PROMPT2_ICL_entailment
106,194,37,30,7,0.8108108108108109,38,30,8,0.7894736842105263,0.8,gemini,mimiciii,radiology_report,PROMPT2_ICL_entailment
107,195,20,16,4,0.8,21,16,5,0.7619047619047619,0.7804878048780488,gemini,mimiciii,radiology_report,PROMPT2_ICL_entailment
108,196,14,8,6,0.5714285714285714,18,13,5,0.7222222222222222,0.638036809815951,gemini,mimiciii,radiology_report,PROMPT2_ICL_entailment
109,197,12,10,2,0.8333333333333334,15,9,6,0.6,0.6976744186046512,gemini,mimiciii,radiology_report,PROMPT2_ICL_entailment
110,198,10,7,3,0.7,9,5,4,0.5555555555555556,0.6194690265486726,gemini,mimiciii,radiology_report,PROMPT2_ICL_entailment
111,199,24,17,7,0.7083333333333334,23,21,2,0.9130434782608696,0.7977653631284916,gemini,mimiciii,radiology_report,PROMPT2_ICL_entailment
112,2,12,10,2,0.8333333333333334,15,10,5,0.6666666666666666,0.7407407407407408,gemini,mimiciii,radiology_report,PROMPT2_ICL_entailment
113,20,31,28,3,0.9032258064516128,36,30,6,0.8333333333333334,0.8668730650154799,gemini,mimiciii,radiology_report,PROMPT2_ICL_entailment
114,200,13,12,1,0.9230769230769232,14,11,3,0.7857142857142857,0.8488745980707394,gemini,mimiciii,radiology_report,PROMPT2_ICL_entailment
115,201,14,9,5,0.6428571428571429,18,9,9,0.5,0.5625000000000001,gemini,mimiciii,radiology_report,PROMPT2_ICL_entailment
116,202,19,16,3,0.8421052631578947,24,13,11,0.5416666666666666,0.659270998415214,gemini,mimiciii,radiology_report,PROMPT2_ICL_entailment
117,203,23,11,12,0.4782608695652174,19,14,5,0.7368421052631579,0.5800376647834274,gemini,mimiciii,radiology_report,PROMPT2_ICL_entailment
118,204,25,18,7,0.72,23,14,9,0.6086956521739131,0.6596858638743456,gemini,mimiciii,radiology_report,PROMPT2_ICL_entailment
119,205,23,19,4,0.8260869565217391,14,10,4,0.7142857142857143,0.7661290322580645,gemini,mimiciii,radiology_report,PROMPT2_ICL_entailment
120,206,20,17,3,0.85,13,12,1,0.9230769230769232,0.8850325379609545,gemini,mimiciii,radiology_report,PROMPT2_ICL_entailment
121,207,10,10,0,1.0,9,6,3,0.6666666666666666,0.8,gemini,mimiciii,radiology_report,PROMPT2_ICL_entailment
122,208,19,13,6,0.6842105263157895,18,15,3,0.8333333333333334,0.7514450867052023,gemini,mimiciii,radiology_report,PROMPT2_ICL_entailment
123,209,15,12,3,0.8,16,16,0,1.0,0.888888888888889,gemini,mimiciii,radiology_report,PROMPT2_ICL_entailment
124,21,35,31,4,0.8857142857142857,27,19,8,0.7037037037037037,0.7842876165113183,gemini,mimiciii,radiology_report,PROMPT2_ICL_entailment
125,210,13,11,2,0.8461538461538461,14,8,6,0.5714285714285714,0.6821705426356589,gemini,mimiciii,radiology_report,PROMPT2_ICL_entailment
126,211,16,15,1,0.9375,13,11,2,0.8461538461538461,0.8894878706199459,gemini,mimiciii,radiology_report,PROMPT2_ICL_entailment
127,212,17,10,7,0.5882352941176471,19,14,5,0.7368421052631579,0.6542056074766356,gemini,mimiciii,radiology_report,PROMPT2_ICL_entailment
128,213,15,13,2,0.8666666666666667,22,14,8,0.6363636363636364,0.7338709677419355,gemini,mimiciii,radiology_report,PROMPT2_ICL_entailment
129,214,11,6,5,0.5454545454545454,23,15,8,0.6521739130434783,0.594059405940594,gemini,mimiciii,radiology_report,PROMPT2_ICL_entailment
130,215,10,6,4,0.6,10,9,1,0.9,0.7200000000000001,gemini,mimiciii,radiology_report,PROMPT2_ICL_entailment
131,216,16,9,7,0.5625,19,13,6,0.6842105263157895,0.6174142480211082,gemini,mimiciii,radiology_report,PROMPT2_ICL_entailment
132,217,17,12,5,0.7058823529411765,20,11,9,0.55,0.6182669789227168,gemini,mimiciii,radiology_report,PROMPT2_ICL_entailment
133,218,19,15,4,0.7894736842105263,15,8,7,0.5333333333333333,0.6366047745358089,gemini,mimiciii,radiology_report,PROMPT2_ICL_entailment
134,219,16,10,6,0.625,13,6,7,0.4615384615384615,0.5309734513274336,gemini,mimiciii,radiology_report,PROMPT2_ICL_entailment
135,22,13,10,3,0.7692307692307693,19,13,6,0.6842105263157895,0.7242339832869081,gemini,mimiciii,radiology_report,PROMPT2_ICL_entailment
136,220,17,15,2,0.8823529411764706,19,16,3,0.8421052631578947,0.8617594254937163,gemini,mimiciii,radiology_report,PROMPT2_ICL_entailment
137,221,20,16,4,0.8,27,20,7,0.7407407407407407,0.7692307692307692,gemini,mimiciii,radiology_report,PROMPT2_ICL_entailment
138,222,14,8,6,0.5714285714285714,16,8,8,0.5,0.5333333333333333,gemini,mimiciii,radiology_report,PROMPT2_ICL_entailment
139,223,20,10,10,0.5,21,11,10,0.5238095238095238,0.5116279069767442,gemini,mimiciii,radiology_report,PROMPT2_ICL_entailment
140,224,17,12,5,0.7058823529411765,17,7,10,0.4117647058823529,0.5201238390092879,gemini,mimiciii,radiology_report,PROMPT2_ICL_entailment
141,225,12,11,1,0.9166666666666666,11,9,2,0.8181818181818182,0.8646288209606987,gemini,mimiciii,radiology_report,PROMPT2_ICL_entailment
142,226,15,13,2,0.8666666666666667,18,17,1,0.9444444444444444,0.9038854805725972,gemini,mimiciii,radiology_report,PROMPT2_ICL_entailment
143,227,17,14,3,0.8235294117647058,18,15,3,0.8333333333333334,0.8284023668639053,gemini,mimiciii,radiology_report,PROMPT2_ICL_entailment
144,228,14,9,5,0.6428571428571429,17,15,2,0.8823529411764706,0.7438016528925621,gemini,mimiciii,radiology_report,PROMPT2_ICL_entailment
145,229,31,30,1,0.967741935483871,44,29,15,0.6590909090909091,0.7841369986480395,gemini,mimiciii,radiology_report,PROMPT2_ICL_entailment
146,23,16,14,2,0.875,15,11,4,0.7333333333333333,0.7979274611398963,gemini,mimiciii,radiology_report,PROMPT2_ICL_entailment
147,230,14,9,5,0.6428571428571429,17,12,5,0.7058823529411765,0.6728971962616823,gemini,mimiciii,radiology_report,PROMPT2_ICL_entailment
148,231,11,10,1,0.9090909090909092,13,12,1,0.9230769230769232,0.9160305343511452,gemini,mimiciii,radiology_report,PROMPT2_ICL_entailment
149,232,11,6,5,0.5454545454545454,18,12,6,0.6666666666666666,0.6,gemini,mimiciii,radiology_report,PROMPT2_ICL_entailment
150,233,15,13,2,0.8666666666666667,17,11,6,0.6470588235294118,0.7409326424870467,gemini,mimiciii,radiology_report,PROMPT2_ICL_entailment
151,234,10,10,0,1.0,11,8,3,0.7272727272727273,0.8421052631578948,gemini,mimiciii,radiology_report,PROMPT2_ICL_entailment
152,235,14,13,1,0.9285714285714286,14,11,3,0.7857142857142857,0.851190476190476,gemini,mimiciii,radiology_report,PROMPT2_ICL_entailment
153,236,15,12,3,0.8,11,9,2,0.8181818181818182,0.8089887640449439,gemini,mimiciii,radiology_report,PROMPT2_ICL_entailment
154,237,12,10,2,0.8333333333333334,17,12,5,0.7058823529411765,0.7643312101910827,gemini,mimiciii,radiology_report,PROMPT2_ICL_entailment
155,238,28,12,16,0.4285714285714285,20,17,3,0.85,0.5698324022346369,gemini,mimiciii,radiology_report,PROMPT2_ICL_entailment
156,239,16,7,9,0.4375,17,13,4,0.7647058823529411,0.5565749235474006,gemini,mimiciii,radiology_report,PROMPT2_ICL_entailment
157,24,9,9,0,1.0,18,13,5,0.7222222222222222,0.8387096774193548,gemini,mimiciii,radiology_report,PROMPT2_ICL_entailment
158,240,12,11,1,0.9166666666666666,13,13,0,1.0,0.9565217391304348,gemini,mimiciii,radiology_report,PROMPT2_ICL_entailment
159,241,13,13,0,1.0,16,9,7,0.5625,0.72,gemini,mimiciii,radiology_report,PROMPT2_ICL_entailment
160,242,19,14,5,0.7368421052631579,18,13,5,0.7222222222222222,0.7294589178356713,gemini,mimiciii,radiology_report,PROMPT2_ICL_entailment
161,243,16,13,3,0.8125,13,9,4,0.6923076923076923,0.7476038338658147,gemini,mimiciii,radiology_report,PROMPT2_ICL_entailment
162,244,13,8,5,0.6153846153846154,17,17,0,1.0,0.761904761904762,gemini,mimiciii,radiology_report,PROMPT2_ICL_entailment
163,245,22,15,7,0.6818181818181818,28,24,4,0.8571428571428571,0.759493670886076,gemini,mimiciii,radiology_report,PROMPT2_ICL_entailment
164,246,14,13,1,0.9285714285714286,12,8,4,0.6666666666666666,0.7761194029850746,gemini,mimiciii,radiology_report,PROMPT2_ICL_entailment
165,247,14,10,4,0.7142857142857143,12,9,3,0.75,0.7317073170731706,gemini,mimiciii,radiology_report,PROMPT2_ICL_entailment
166,248,13,12,1,0.9230769230769232,17,15,2,0.8823529411764706,0.9022556390977444,gemini,mimiciii,radiology_report,PROMPT2_ICL_entailment
167,249,15,11,4,0.7333333333333333,23,12,11,0.5217391304347826,0.6096997690531177,gemini,mimiciii,radiology_report,PROMPT2_ICL_entailment
168,25,17,13,4,0.7647058823529411,27,14,13,0.5185185185185185,0.6179966044142614,gemini,mimiciii,radiology_report,PROMPT2_ICL_entailment
169,250,10,9,1,0.9,8,7,1,0.875,0.8873239436619719,gemini,mimiciii,radiology_report,PROMPT2_ICL_entailment
170,251,30,18,12,0.6,22,19,3,0.8636363636363636,0.7080745341614907,gemini,mimiciii,radiology_report,PROMPT2_ICL_entailment
171,252,9,7,2,0.7777777777777778,10,7,3,0.7,0.7368421052631577,gemini,mimiciii,radiology_report,PROMPT2_ICL_entailment
172,253,23,15,8,0.6521739130434783,24,21,3,0.875,0.7473309608540925,gemini,mimiciii,radiology_report,PROMPT2_ICL_entailment
173,254,15,11,4,0.7333333333333333,13,8,5,0.6153846153846154,0.6692015209125475,gemini,mimiciii,radiology_report,PROMPT2_ICL_entailment
174,255,13,12,1,0.9230769230769232,16,11,5,0.6875,0.7880597014925373,gemini,mimiciii,radiology_report,PROMPT2_ICL_entailment
175,256,12,7,5,0.5833333333333334,19,11,8,0.5789473684210527,0.5811320754716981,gemini,mimiciii,radiology_report,PROMPT2_ICL_entailment
176,257,19,14,5,0.7368421052631579,15,10,5,0.6666666666666666,0.7,gemini,mimiciii,radiology_report,PROMPT2_ICL_entailment
177,258,16,13,3,0.8125,20,12,8,0.6,0.6902654867256637,gemini,mimiciii,radiology_report,PROMPT2_ICL_entailment
178,259,17,10,7,0.5882352941176471,17,11,6,0.6470588235294118,0.6162464985994398,gemini,mimiciii,radiology_report,PROMPT2_ICL_entailment
179,26,15,11,4,0.7333333333333333,18,12,6,0.6666666666666666,0.6984126984126984,gemini,mimiciii,radiology_report,PROMPT2_ICL_entailment
180,260,16,14,2,0.875,20,12,8,0.6,0.711864406779661,gemini,mimiciii,radiology_report,PROMPT2_ICL_entailment
181,261,37,21,16,0.5675675675675675,30,26,4,0.8666666666666667,0.685929648241206,gemini,mimiciii,radiology_report,PROMPT2_ICL_entailment
182,262,27,13,14,0.4814814814814814,23,19,4,0.8260869565217391,0.6083743842364532,gemini,mimiciii,radiology_report,PROMPT2_ICL_entailment
183,263,27,23,4,0.8518518518518519,27,23,4,0.8518518518518519,0.8518518518518519,gemini,mimiciii,radiology_report,PROMPT2_ICL_entailment
184,264,19,12,7,0.631578947368421,20,15,5,0.75,0.6857142857142857,gemini,mimiciii,radiology_report,PROMPT2_ICL_entailment
185,265,12,9,3,0.75,9,7,2,0.7777777777777778,0.7636363636363638,gemini,mimiciii,radiology_report,PROMPT2_ICL_entailment
186,266,15,9,6,0.6,18,12,6,0.6666666666666666,0.631578947368421,gemini,mimiciii,radiology_report,PROMPT2_ICL_entailment
187,267,17,15,2,0.8823529411764706,16,16,0,1.0,0.9375,gemini,mimiciii,radiology_report,PROMPT2_ICL_entailment
188,268,18,15,3,0.8333333333333334,20,17,3,0.85,0.8415841584158417,gemini,mimiciii,radiology_report,PROMPT2_ICL_entailment
189,269,18,18,0,1.0,25,19,6,0.76,0.8636363636363636,gemini,mimiciii,radiology_report,PROMPT2_ICL_entailment
190,27,14,11,3,0.7857142857142857,14,9,5,0.6428571428571429,0.7071428571428572,gemini,mimiciii,radiology_report,PROMPT2_ICL_entailment
191,270,18,12,6,0.6666666666666666,17,12,5,0.7058823529411765,0.6857142857142857,gemini,mimiciii,radiology_report,PROMPT2_ICL_entailment
192,271,13,11,2,0.8461538461538461,17,9,8,0.5294117647058824,0.6513157894736843,gemini,mimiciii,radiology_report,PROMPT2_ICL_entailment
193,272,14,13,1,0.9285714285714286,17,12,5,0.7058823529411765,0.802056555269923,gemini,mimiciii,radiology_report,PROMPT2_ICL_entailment
194,273,11,7,4,0.6363636363636364,12,6,6,0.5,0.56,gemini,mimiciii,radiology_report,PROMPT2_ICL_entailment
195,274,22,17,5,0.7727272727272727,20,14,6,0.7,0.7345679012345679,gemini,mimiciii,radiology_report,PROMPT2_ICL_entailment
196,275,11,9,2,0.8181818181818182,12,8,4,0.6666666666666666,0.7346938775510203,gemini,mimiciii,radiology_report,PROMPT2_ICL_entailment
197,276,19,19,0,1.0,24,14,10,0.5833333333333334,0.7368421052631579,gemini,mimiciii,radiology_report,PROMPT2_ICL_entailment
198,277,22,15,7,0.6818181818181818,25,21,4,0.84,0.7526881720430106,gemini,mimiciii,radiology_report,PROMPT2_ICL_entailment
199,278,15,12,3,0.8,16,13,3,0.8125,0.8062015503875969,gemini,mimiciii,radiology_report,PROMPT2_ICL_entailment
200,279,11,11,0,1.0,10,6,4,0.6,0.7499999999999999,gemini,mimiciii,radiology_report,PROMPT2_ICL_entailment
201,28,25,18,7,0.72,30,21,9,0.7,0.7098591549295775,gemini,mimiciii,radiology_report,PROMPT2_ICL_entailment
202,280,12,7,5,0.5833333333333334,12,8,4,0.6666666666666666,0.6222222222222222,gemini,mimiciii,radiology_report,PROMPT2_ICL_entailment
203,281,22,16,6,0.7272727272727273,24,21,3,0.875,0.7943262411347517,gemini,mimiciii,radiology_report,PROMPT2_ICL_entailment
204,282,16,14,2,0.875,12,11,1,0.9166666666666666,0.8953488372093024,gemini,mimiciii,radiology_report,PROMPT2_ICL_entailment
205,283,11,7,4,0.6363636363636364,25,16,9,0.64,0.6381766381766382,gemini,mimiciii,radiology_report,PROMPT2_ICL_entailment
206,284,7,6,1,0.8571428571428571,14,7,7,0.5,0.631578947368421,gemini,mimiciii,radiology_report,PROMPT2_ICL_entailment
207,285,21,16,5,0.7619047619047619,18,15,3,0.8333333333333334,0.7960199004975124,gemini,mimiciii,radiology_report,PROMPT2_ICL_entailment
208,286,10,10,0,1.0,6,6,0,1.0,1.0,gemini,mimiciii,radiology_report,PROMPT2_ICL_entailment
209,287,21,20,1,0.9523809523809524,18,14,4,0.7777777777777778,0.856269113149847,gemini,mimiciii,radiology_report,PROMPT2_ICL_entailment
210,288,23,17,6,0.7391304347826086,32,23,9,0.71875,0.7287977632805219,gemini,mimiciii,radiology_report,PROMPT2_ICL_entailment
211,289,13,11,2,0.8461538461538461,20,13,7,0.65,0.7352185089974294,gemini,mimiciii,radiology_report,PROMPT2_ICL_entailment
212,29,13,11,2,0.8461538461538461,8,7,1,0.875,0.8603351955307262,gemini,mimiciii,radiology_report,PROMPT2_ICL_entailment
213,290,12,11,1,0.9166666666666666,11,8,3,0.7272727272727273,0.8110599078341013,gemini,mimiciii,radiology_report,PROMPT2_ICL_entailment
214,291,22,11,11,0.5,23,14,9,0.6086956521739131,0.5490196078431373,gemini,mimiciii,radiology_report,PROMPT2_ICL_entailment
215,292,19,14,5,0.7368421052631579,21,15,6,0.7142857142857143,0.7253886010362695,gemini,mimiciii,radiology_report,PROMPT2_ICL_entailment
216,293,10,5,5,0.5,18,14,4,0.7777777777777778,0.6086956521739131,gemini,mimiciii,radiology_report,PROMPT2_ICL_entailment
217,294,15,9,6,0.6,22,13,9,0.5909090909090909,0.5954198473282443,gemini,mimiciii,radiology_report,PROMPT2_ICL_entailment
218,295,20,13,7,0.65,32,24,8,0.75,0.6964285714285715,gemini,mimiciii,radiology_report,PROMPT2_ICL_entailment
219,296,23,10,13,0.4347826086956521,17,14,3,0.8235294117647058,0.5691056910569107,gemini,mimiciii,radiology_report,PROMPT2_ICL_entailment
220,297,12,11,1,0.9166666666666666,24,15,9,0.625,0.7432432432432433,gemini,mimiciii,radiology_report,PROMPT2_ICL_entailment
221,298,19,13,6,0.6842105263157895,20,14,6,0.7,0.6920152091254752,gemini,mimiciii,radiology_report,PROMPT2_ICL_entailment
222,299,18,15,3,0.8333333333333334,28,19,9,0.6785714285714286,0.7480314960629922,gemini,mimiciii,radiology_report,PROMPT2_ICL_entailment
223,3,12,9,3,0.75,20,13,7,0.65,0.6964285714285715,gemini,mimiciii,radiology_report,PROMPT2_ICL_entailment
224,30,10,7,3,0.7,21,14,7,0.6666666666666666,0.6829268292682926,gemini,mimiciii,radiology_report,PROMPT2_ICL_entailment
225,300,11,11,0,1.0,13,7,6,0.5384615384615384,0.7000000000000001,gemini,mimiciii,radiology_report,PROMPT2_ICL_entailment
226,301,16,14,2,0.875,16,14,2,0.875,0.875,gemini,mimiciii,radiology_report,PROMPT2_ICL_entailment
227,302,15,13,2,0.8666666666666667,15,9,6,0.6,0.7090909090909091,gemini,mimiciii,radiology_report,PROMPT2_ICL_entailment
228,303,36,23,13,0.6388888888888888,24,18,6,0.75,0.69,gemini,mimiciii,radiology_report,PROMPT2_ICL_entailment
229,304,17,16,1,0.9411764705882352,19,13,6,0.6842105263157895,0.7923809523809523,gemini,mimiciii,radiology_report,PROMPT2_ICL_entailment
230,305,12,10,2,0.8333333333333334,24,11,13,0.4583333333333333,0.5913978494623655,gemini,mimiciii,radiology_report,PROMPT2_ICL_entailment
231,306,12,10,2,0.8333333333333334,14,8,6,0.5714285714285714,0.6779661016949152,gemini,mimiciii,radiology_report,PROMPT2_ICL_entailment
232,307,18,17,1,0.9444444444444444,17,13,4,0.7647058823529411,0.8451242829827915,gemini,mimiciii,radiology_report,PROMPT2_ICL_entailment
233,308,14,11,3,0.7857142857142857,15,10,5,0.6666666666666666,0.721311475409836,gemini,mimiciii,radiology_report,PROMPT2_ICL_entailment
234,309,22,18,4,0.8181818181818182,26,18,8,0.6923076923076923,0.7500000000000001,gemini,mimiciii,radiology_report,PROMPT2_ICL_entailment
235,31,18,9,9,0.5,19,13,6,0.6842105263157895,0.5777777777777778,gemini,mimiciii,radiology_report,PROMPT2_ICL_entailment
236,310,14,12,2,0.8571428571428571,24,14,10,0.5833333333333334,0.6942148760330579,gemini,mimiciii,radiology_report,PROMPT2_ICL_entailment
237,311,18,16,2,0.8888888888888888,15,10,5,0.6666666666666666,0.761904761904762,gemini,mimiciii,radiology_report,PROMPT2_ICL_entailment
238,312,12,10,2,0.8333333333333334,18,8,10,0.4444444444444444,0.5797101449275363,gemini,mimiciii,radiology_report,PROMPT2_ICL_entailment
239,313,16,13,3,0.8125,17,13,4,0.7647058823529411,0.787878787878788,gemini,mimiciii,radiology_report,PROMPT2_ICL_entailment
240,314,15,11,4,0.7333333333333333,15,11,4,0.7333333333333333,0.7333333333333333,gemini,mimiciii,radiology_report,PROMPT2_ICL_entailment
241,315,26,18,8,0.6923076923076923,25,14,11,0.56,0.6191646191646192,gemini,mimiciii,radiology_report,PROMPT2_ICL_entailment
242,316,4,4,0,1.0,10,8,2,0.8,0.888888888888889,gemini,mimiciii,radiology_report,PROMPT2_ICL_entailment
243,317,19,12,7,0.631578947368421,26,17,9,0.6538461538461539,0.64251968503937,gemini,mimiciii,radiology_report,PROMPT2_ICL_entailment
244,318,16,8,8,0.5,21,14,7,0.6666666666666666,0.5714285714285715,gemini,mimiciii,radiology_report,PROMPT2_ICL_entailment
245,319,11,9,2,0.8181818181818182,12,10,2,0.8333333333333334,0.8256880733944955,gemini,mimiciii,radiology_report,PROMPT2_ICL_entailment
246,32,13,11,2,0.8461538461538461,15,11,4,0.7333333333333333,0.7857142857142856,gemini,mimiciii,radiology_report,PROMPT2_ICL_entailment
247,320,11,9,2,0.8181818181818182,11,8,3,0.7272727272727273,0.770053475935829,gemini,mimiciii,radiology_report,PROMPT2_ICL_entailment
248,321,20,16,4,0.8,21,17,4,0.8095238095238095,0.8047337278106509,gemini,mimiciii,radiology_report,PROMPT2_ICL_entailment
249,322,9,7,2,0.7777777777777778,8,8,0,1.0,0.8750000000000001,gemini,mimiciii,radiology_report,PROMPT2_ICL_entailment
250,323,20,16,4,0.8,25,21,4,0.84,0.8195121951219512,gemini,mimiciii,radiology_report,PROMPT2_ICL_entailment
251,324,21,15,6,0.7142857142857143,18,13,5,0.7222222222222222,0.7182320441988951,gemini,mimiciii,radiology_report,PROMPT2_ICL_entailment
252,325,18,11,7,0.6111111111111112,22,11,11,0.5,0.55,gemini,mimiciii,radiology_report,PROMPT2_ICL_entailment
253,326,17,14,3,0.8235294117647058,23,15,8,0.6521739130434783,0.7279029462738302,gemini,mimiciii,radiology_report,PROMPT2_ICL_entailment
254,327,11,11,0,1.0,9,8,1,0.8888888888888888,0.9411764705882352,gemini,mimiciii,radiology_report,PROMPT2_ICL_entailment
255,328,17,12,5,0.7058823529411765,17,8,9,0.4705882352941176,0.5647058823529412,gemini,mimiciii,radiology_report,PROMPT2_ICL_entailment
256,329,20,17,3,0.85,24,15,9,0.625,0.7203389830508474,gemini,mimiciii,radiology_report,PROMPT2_ICL_entailment
257,33,12,12,0,1.0,9,7,2,0.7777777777777778,0.8750000000000001,gemini,mimiciii,radiology_report,PROMPT2_ICL_entailment
258,330,14,10,4,0.7142857142857143,11,5,6,0.4545454545454545,0.5555555555555556,gemini,mimiciii,radiology_report,PROMPT2_ICL_entailment
259,331,17,14,3,0.8235294117647058,15,13,2,0.8666666666666667,0.8445475638051044,gemini,mimiciii,radiology_report,PROMPT2_ICL_entailment
260,332,14,10,4,0.7142857142857143,20,14,6,0.7,0.7070707070707072,gemini,mimiciii,radiology_report,PROMPT2_ICL_entailment
261,333,13,11,2,0.8461538461538461,13,10,3,0.7692307692307693,0.8058608058608059,gemini,mimiciii,radiology_report,PROMPT2_ICL_entailment
262,334,19,15,4,0.7894736842105263,20,17,3,0.85,0.8186195826645265,gemini,mimiciii,radiology_report,PROMPT2_ICL_entailment
263,335,18,16,2,0.8888888888888888,17,12,5,0.7058823529411765,0.7868852459016393,gemini,mimiciii,radiology_report,PROMPT2_ICL_entailment
264,336,10,6,4,0.6,16,10,6,0.625,0.6122448979591836,gemini,mimiciii,radiology_report,PROMPT2_ICL_entailment
265,337,17,16,1,0.9411764705882352,16,11,5,0.6875,0.7945823927765238,gemini,mimiciii,radiology_report,PROMPT2_ICL_entailment
266,338,12,9,3,0.75,13,8,5,0.6153846153846154,0.676056338028169,gemini,mimiciii,radiology_report,PROMPT2_ICL_entailment
267,339,19,13,6,0.6842105263157895,28,19,9,0.6785714285714286,0.6813793103448276,gemini,mimiciii,radiology_report,PROMPT2_ICL_entailment
268,34,13,12,1,0.9230769230769232,14,10,4,0.7142857142857143,0.8053691275167787,gemini,mimiciii,radiology_report,PROMPT2_ICL_entailment
269,340,21,6,15,0.2857142857142857,15,12,3,0.8,0.4210526315789473,gemini,mimiciii,radiology_report,PROMPT2_ICL_entailment
270,341,10,10,0,1.0,6,5,1,0.8333333333333334,0.9090909090909092,gemini,mimiciii,radiology_report,PROMPT2_ICL_entailment
271,342,14,10,4,0.7142857142857143,15,12,3,0.8,0.7547169811320756,gemini,mimiciii,radiology_report,PROMPT2_ICL_entailment
272,343,16,13,3,0.8125,22,13,9,0.5909090909090909,0.6842105263157896,gemini,mimiciii,radiology_report,PROMPT2_ICL_entailment
273,344,10,4,6,0.4,19,10,9,0.5263157894736842,0.4545454545454545,gemini,mimiciii,radiology_report,PROMPT2_ICL_entailment
274,345,22,14,8,0.6363636363636364,22,15,7,0.6818181818181818,0.658307210031348,gemini,mimiciii,radiology_report,PROMPT2_ICL_entailment
275,346,18,18,0,1.0,15,10,5,0.6666666666666666,0.8,gemini,mimiciii,radiology_report,PROMPT2_ICL_entailment
276,347,14,10,4,0.7142857142857143,15,13,2,0.8666666666666667,0.7831325301204819,gemini,mimiciii,radiology_report,PROMPT2_ICL_entailment
277,348,14,12,2,0.8571428571428571,12,8,4,0.6666666666666666,0.75,gemini,mimiciii,radiology_report,PROMPT2_ICL_entailment
278,349,11,10,1,0.9090909090909092,16,9,7,0.5625,0.6949806949806949,gemini,mimiciii,radiology_report,PROMPT2_ICL_entailment
279,35,22,9,13,0.4090909090909091,21,16,5,0.7619047619047619,0.532347504621072,gemini,mimiciii,radiology_report,PROMPT2_ICL_entailment
280,350,19,18,1,0.9473684210526316,21,11,10,0.5238095238095238,0.6746166950596252,gemini,mimiciii,radiology_report,PROMPT2_ICL_entailment
281,351,24,14,10,0.5833333333333334,21,18,3,0.8571428571428571,0.6942148760330579,gemini,mimiciii,radiology_report,PROMPT2_ICL_entailment
282,352,10,8,2,0.8,22,11,11,0.5,0.6153846153846154,gemini,mimiciii,radiology_report,PROMPT2_ICL_entailment
283,353,18,7,11,0.3888888888888889,23,18,5,0.782608695652174,0.5195876288659794,gemini,mimiciii,radiology_report,PROMPT2_ICL_entailment
284,354,21,12,9,0.5714285714285714,26,20,6,0.7692307692307693,0.6557377049180327,gemini,mimiciii,radiology_report,PROMPT2_ICL_entailment
285,355,25,17,8,0.68,18,16,2,0.8888888888888888,0.7705382436260623,gemini,mimiciii,radiology_report,PROMPT2_ICL_entailment
286,356,14,10,4,0.7142857142857143,22,12,10,0.5454545454545454,0.6185567010309277,gemini,mimiciii,radiology_report,PROMPT2_ICL_entailment
287,357,12,4,8,0.3333333333333333,15,9,6,0.6,0.4285714285714285,gemini,mimiciii,radiology_report,PROMPT2_ICL_entailment
288,358,12,10,2,0.8333333333333334,12,7,5,0.5833333333333334,0.6862745098039216,gemini,mimiciii,radiology_report,PROMPT2_ICL_entailment
289,359,17,12,5,0.7058823529411765,18,15,3,0.8333333333333334,0.7643312101910827,gemini,mimiciii,radiology_report,PROMPT2_ICL_entailment
290,36,19,12,7,0.631578947368421,22,16,6,0.7272727272727273,0.676056338028169,gemini,mimiciii,radiology_report,PROMPT2_ICL_entailment
291,360,14,12,2,0.8571428571428571,15,7,8,0.4666666666666667,0.60431654676259,gemini,mimiciii,radiology_report,PROMPT2_ICL_entailment
292,361,21,12,9,0.5714285714285714,23,14,9,0.6086956521739131,0.5894736842105263,gemini,mimiciii,radiology_report,PROMPT2_ICL_entailment
293,362,19,10,9,0.5263157894736842,24,15,9,0.625,0.5714285714285714,gemini,mimiciii,radiology_report,PROMPT2_ICL_entailment
294,363,20,12,8,0.6,22,17,5,0.7727272727272727,0.6754966887417219,gemini,mimiciii,radiology_report,PROMPT2_ICL_entailment
295,364,7,7,0,1.0,11,9,2,0.8181818181818182,0.9,gemini,mimiciii,radiology_report,PROMPT2_ICL_entailment
296,365,29,19,10,0.6551724137931034,29,19,10,0.6551724137931034,0.6551724137931034,gemini,mimiciii,radiology_report,PROMPT2_ICL_entailment
297,366,12,10,2,0.8333333333333334,13,9,4,0.6923076923076923,0.7563025210084034,gemini,mimiciii,radiology_report,PROMPT2_ICL_entailment
298,367,11,7,4,0.6363636363636364,16,9,7,0.5625,0.5971563981042655,gemini,mimiciii,radiology_report,PROMPT2_ICL_entailment
299,368,16,8,8,0.5,20,14,6,0.7,0.5833333333333334,gemini,mimiciii,radiology_report,PROMPT2_ICL_entailment
300,369,19,15,4,0.7894736842105263,20,16,4,0.8,0.794701986754967,gemini,mimiciii,radiology_report,PROMPT2_ICL_entailment
301,37,13,11,2,0.8461538461538461,21,12,9,0.5714285714285714,0.6821705426356589,gemini,mimiciii,radiology_report,PROMPT2_ICL_entailment
302,370,13,8,5,0.6153846153846154,19,11,8,0.5789473684210527,0.5966101694915255,gemini,mimiciii,radiology_report,PROMPT2_ICL_entailment
303,371,13,6,7,0.4615384615384615,17,15,2,0.8823529411764706,0.606060606060606,gemini,mimiciii,radiology_report,PROMPT2_ICL_entailment
304,372,16,16,0,1.0,27,14,13,0.5185185185185185,0.6829268292682926,gemini,mimiciii,radiology_report,PROMPT2_ICL_entailment
305,373,18,14,4,0.7777777777777778,23,16,7,0.6956521739130435,0.7344262295081967,gemini,mimiciii,radiology_report,PROMPT2_ICL_entailment
306,374,10,10,0,1.0,11,8,3,0.7272727272727273,0.8421052631578948,gemini,mimiciii,radiology_report,PROMPT2_ICL_entailment
307,375,12,11,1,0.9166666666666666,16,10,6,0.625,0.7432432432432433,gemini,mimiciii,radiology_report,PROMPT2_ICL_entailment
308,376,22,15,7,0.6818181818181818,18,13,5,0.7222222222222222,0.7014388489208633,gemini,mimiciii,radiology_report,PROMPT2_ICL_entailment
309,377,11,10,1,0.9090909090909092,10,7,3,0.7,0.7909604519774012,gemini,mimiciii,radiology_report,PROMPT2_ICL_entailment
310,378,22,13,9,0.5909090909090909,24,19,5,0.7916666666666666,0.6767123287671233,gemini,mimiciii,radiology_report,PROMPT2_ICL_entailment
311,379,19,10,9,0.5263157894736842,18,13,5,0.7222222222222222,0.6088992974238876,gemini,mimiciii,radiology_report,PROMPT2_ICL_entailment
312,38,17,12,5,0.7058823529411765,19,10,9,0.5263157894736842,0.6030150753768845,gemini,mimiciii,radiology_report,PROMPT2_ICL_entailment
313,380,9,8,1,0.8888888888888888,8,7,1,0.875,0.8818897637795274,gemini,mimiciii,radiology_report,PROMPT2_ICL_entailment
314,381,14,9,5,0.6428571428571429,14,9,5,0.6428571428571429,0.6428571428571429,gemini,mimiciii,radiology_report,PROMPT2_ICL_entailment
315,382,11,10,1,0.9090909090909092,13,7,6,0.5384615384615384,0.6763285024154589,gemini,mimiciii,radiology_report,PROMPT2_ICL_entailment
316,383,15,7,8,0.4666666666666667,17,14,3,0.8235294117647058,0.5957446808510638,gemini,mimiciii,radiology_report,PROMPT2_ICL_entailment
317,384,16,14,2,0.875,13,12,1,0.9230769230769232,0.8983957219251337,gemini,mimiciii,radiology_report,PROMPT2_ICL_entailment
318,385,15,8,7,0.5333333333333333,27,17,10,0.6296296296296297,0.5774946921443737,gemini,mimiciii,radiology_report,PROMPT2_ICL_entailment
319,386,20,17,3,0.85,18,15,3,0.8333333333333334,0.8415841584158417,gemini,mimiciii,radiology_report,PROMPT2_ICL_entailment
320,387,21,20,1,0.9523809523809524,19,11,8,0.5789473684210527,0.7201309328968903,gemini,mimiciii,radiology_report,PROMPT2_ICL_entailment
321,388,20,15,5,0.75,33,25,8,0.7575757575757576,0.7537688442211055,gemini,mimiciii,radiology_report,PROMPT2_ICL_entailment
322,389,10,7,3,0.7,12,9,3,0.75,0.7241379310344827,gemini,mimiciii,radiology_report,PROMPT2_ICL_entailment
323,39,13,9,4,0.6923076923076923,10,7,3,0.7,0.6961325966850829,gemini,mimiciii,radiology_report,PROMPT2_ICL_entailment
324,390,10,6,4,0.6,14,12,2,0.8571428571428571,0.7058823529411764,gemini,mimiciii,radiology_report,PROMPT2_ICL_entailment
325,391,13,12,1,0.9230769230769232,13,9,4,0.6923076923076923,0.7912087912087913,gemini,mimiciii,radiology_report,PROMPT2_ICL_entailment
326,392,17,15,2,0.8823529411764706,15,13,2,0.8666666666666667,0.8744394618834082,gemini,mimiciii,radiology_report,PROMPT2_ICL_entailment
327,393,19,12,7,0.631578947368421,19,14,5,0.7368421052631579,0.680161943319838,gemini,mimiciii,radiology_report,PROMPT2_ICL_entailment
328,394,22,20,2,0.9090909090909092,18,15,3,0.8333333333333334,0.8695652173913043,gemini,mimiciii,radiology_report,PROMPT2_ICL_entailment
329,395,14,12,2,0.8571428571428571,16,11,5,0.6875,0.7630057803468208,gemini,mimiciii,radiology_report,PROMPT2_ICL_entailment
330,396,11,10,1,0.9090909090909092,19,12,7,0.631578947368421,0.7453416149068324,gemini,mimiciii,radiology_report,PROMPT2_ICL_entailment
331,397,20,16,4,0.8,18,14,4,0.7777777777777778,0.7887323943661971,gemini,mimiciii,radiology_report,PROMPT2_ICL_entailment
332,398,24,12,12,0.5,21,13,8,0.6190476190476191,0.5531914893617021,gemini,mimiciii,radiology_report,PROMPT2_ICL_entailment
333,399,11,9,2,0.8181818181818182,19,11,8,0.5789473684210527,0.6780821917808219,gemini,mimiciii,radiology_report,PROMPT2_ICL_entailment
334,4,11,10,1,0.9090909090909092,16,11,5,0.6875,0.7829181494661921,gemini,mimiciii,radiology_report,PROMPT2_ICL_entailment
335,40,13,11,2,0.8461538461538461,17,11,6,0.6470588235294118,0.7333333333333334,gemini,mimiciii,radiology_report,PROMPT2_ICL_entailment
336,400,14,11,3,0.7857142857142857,13,6,7,0.4615384615384615,0.5814977973568282,gemini,mimiciii,radiology_report,PROMPT2_ICL_entailment
337,401,10,7,3,0.7,9,7,2,0.7777777777777778,0.7368421052631577,gemini,mimiciii,radiology_report,PROMPT2_ICL_entailment
338,402,19,7,12,0.3684210526315789,20,13,7,0.65,0.4702842377260982,gemini,mimiciii,radiology_report,PROMPT2_ICL_entailment
339,403,18,17,1,0.9444444444444444,18,13,5,0.7222222222222222,0.8185185185185185,gemini,mimiciii,radiology_report,PROMPT2_ICL_entailment
340,404,17,13,4,0.7647058823529411,19,14,5,0.7368421052631579,0.7505154639175257,gemini,mimiciii,radiology_report,PROMPT2_ICL_entailment
341,405,18,12,6,0.6666666666666666,14,10,4,0.7142857142857143,0.689655172413793,gemini,mimiciii,radiology_report,PROMPT2_ICL_entailment
342,406,24,16,8,0.6666666666666666,25,20,5,0.8,0.7272727272727272,gemini,mimiciii,radiology_report,PROMPT2_ICL_entailment
343,407,18,16,2,0.8888888888888888,20,12,8,0.6,0.7164179104477612,gemini,mimiciii,radiology_report,PROMPT2_ICL_entailment
344,408,17,13,4,0.7647058823529411,20,12,8,0.6,0.6724137931034482,gemini,mimiciii,radiology_report,PROMPT2_ICL_entailment
345,409,8,6,2,0.75,18,10,8,0.5555555555555556,0.6382978723404256,gemini,mimiciii,radiology_report,PROMPT2_ICL_entailment
346,41,32,24,8,0.75,26,18,8,0.6923076923076923,0.7199999999999999,gemini,mimiciii,radiology_report,PROMPT2_ICL_entailment
347,410,18,15,3,0.8333333333333334,20,13,7,0.65,0.7303370786516855,gemini,mimiciii,radiology_report,PROMPT2_ICL_entailment
348,411,7,7,0,1.0,6,5,1,0.8333333333333334,0.9090909090909092,gemini,mimiciii,radiology_report,PROMPT2_ICL_entailment
349,412,17,14,3,0.8235294117647058,26,17,9,0.6538461538461539,0.7289433384379785,gemini,mimiciii,radiology_report,PROMPT2_ICL_entailment
350,413,16,11,5,0.6875,14,12,2,0.8571428571428571,0.7630057803468208,gemini,mimiciii,radiology_report,PROMPT2_ICL_entailment
351,414,14,10,4,0.7142857142857143,28,17,11,0.6071428571428571,0.6563706563706564,gemini,mimiciii,radiology_report,PROMPT2_ICL_entailment
352,415,11,8,3,0.7272727272727273,20,9,11,0.45,0.555984555984556,gemini,mimiciii,radiology_report,PROMPT2_ICL_entailment
353,416,17,15,2,0.8823529411764706,17,14,3,0.8235294117647058,0.8519269776876267,gemini,mimiciii,radiology_report,PROMPT2_ICL_entailment
354,417,19,12,7,0.631578947368421,20,15,5,0.75,0.6857142857142857,gemini,mimiciii,radiology_report,PROMPT2_ICL_entailment
355,418,12,11,1,0.9166666666666666,14,10,4,0.7142857142857143,0.8029197080291971,gemini,mimiciii,radiology_report,PROMPT2_ICL_entailment
356,419,15,8,7,0.5333333333333333,16,10,6,0.625,0.5755395683453237,gemini,mimiciii,radiology_report,PROMPT2_ICL_entailment
357,42,15,11,4,0.7333333333333333,14,8,6,0.5714285714285714,0.6423357664233577,gemini,mimiciii,radiology_report,PROMPT2_ICL_entailment
358,420,13,4,9,0.3076923076923077,15,7,8,0.4666666666666667,0.3708609271523179,gemini,mimiciii,radiology_report,PROMPT2_ICL_entailment
359,421,18,11,7,0.6111111111111112,23,17,6,0.7391304347826086,0.669051878354204,gemini,mimiciii,radiology_report,PROMPT2_ICL_entailment
360,422,13,9,4,0.6923076923076923,20,13,7,0.65,0.670487106017192,gemini,mimiciii,radiology_report,PROMPT2_ICL_entailment
361,423,9,9,0,1.0,12,5,7,0.4166666666666667,0.5882352941176471,gemini,mimiciii,radiology_report,PROMPT2_ICL_entailment
362,424,7,7,0,1.0,9,7,2,0.7777777777777778,0.8750000000000001,gemini,mimiciii,radiology_report,PROMPT2_ICL_entailment
363,425,13,10,3,0.7692307692307693,19,12,7,0.631578947368421,0.6936416184971097,gemini,mimiciii,radiology_report,PROMPT2_ICL_entailment
364,426,16,10,6,0.625,16,10,6,0.625,0.625,gemini,mimiciii,radiology_report,PROMPT2_ICL_entailment
365,427,14,12,2,0.8571428571428571,15,11,4,0.7333333333333333,0.7904191616766466,gemini,mimiciii,radiology_report,PROMPT2_ICL_entailment
366,428,13,11,2,0.8461538461538461,15,12,3,0.8,0.8224299065420562,gemini,mimiciii,radiology_report,PROMPT2_ICL_entailment
367,429,13,9,4,0.6923076923076923,13,10,3,0.7692307692307693,0.728744939271255,gemini,mimiciii,radiology_report,PROMPT2_ICL_entailment
368,43,11,10,1,0.9090909090909092,7,7,0,1.0,0.9523809523809524,gemini,mimiciii,radiology_report,PROMPT2_ICL_entailment
369,430,10,10,0,1.0,7,6,1,0.8571428571428571,0.923076923076923,gemini,mimiciii,radiology_report,PROMPT2_ICL_entailment
370,431,16,10,6,0.625,18,14,4,0.7777777777777778,0.6930693069306931,gemini,mimiciii,radiology_report,PROMPT2_ICL_entailment
371,432,12,9,3,0.75,13,7,6,0.5384615384615384,0.6268656716417911,gemini,mimiciii,radiology_report,PROMPT2_ICL_entailment
372,433,18,15,3,0.8333333333333334,18,16,2,0.8888888888888888,0.8602150537634408,gemini,mimiciii,radiology_report,PROMPT2_ICL_entailment
373,434,23,13,10,0.5652173913043478,27,20,7,0.7407407407407407,0.6411837237977804,gemini,mimiciii,radiology_report,PROMPT2_ICL_entailment
374,435,16,12,4,0.75,13,12,1,0.9230769230769232,0.8275862068965517,gemini,mimiciii,radiology_report,PROMPT2_ICL_entailment
375,436,23,20,3,0.8695652173913043,25,18,7,0.72,0.7877461706783369,gemini,mimiciii,radiology_report,PROMPT2_ICL_entailment
376,437,10,5,5,0.5,7,5,2,0.7142857142857143,0.588235294117647,gemini,mimiciii,radiology_report,PROMPT2_ICL_entailment
377,438,18,16,2,0.8888888888888888,19,14,5,0.7368421052631579,0.8057553956834532,gemini,mimiciii,radiology_report,PROMPT2_ICL_entailment
378,439,19,12,7,0.631578947368421,22,17,5,0.7727272727272727,0.6950596252129472,gemini,mimiciii,radiology_report,PROMPT2_ICL_entailment
379,44,12,12,0,1.0,16,8,8,0.5,0.6666666666666666,gemini,mimiciii,radiology_report,PROMPT2_ICL_entailment
380,440,18,14,4,0.7777777777777778,19,12,7,0.631578947368421,0.6970954356846473,gemini,mimiciii,radiology_report,PROMPT2_ICL_entailment
381,441,18,9,9,0.5,17,14,3,0.8235294117647058,0.6222222222222222,gemini,mimiciii,radiology_report,PROMPT2_ICL_entailment
382,442,11,10,1,0.9090909090909092,12,6,6,0.5,0.6451612903225806,gemini,mimiciii,radiology_report,PROMPT2_ICL_entailment
383,443,14,9,5,0.6428571428571429,21,10,11,0.4761904761904761,0.547112462006079,gemini,mimiciii,radiology_report,PROMPT2_ICL_entailment
384,444,11,11,0,1.0,8,6,2,0.75,0.8571428571428571,gemini,mimiciii,radiology_report,PROMPT2_ICL_entailment
385,445,14,11,3,0.7857142857142857,22,17,5,0.7727272727272727,0.7791666666666666,gemini,mimiciii,radiology_report,PROMPT2_ICL_entailment
386,446,17,13,4,0.7647058823529411,22,17,5,0.7727272727272727,0.768695652173913,gemini,mimiciii,radiology_report,PROMPT2_ICL_entailment
387,447,17,13,4,0.7647058823529411,14,13,1,0.9285714285714286,0.8387096774193549,gemini,mimiciii,radiology_report,PROMPT2_ICL_entailment
388,448,17,15,2,0.8823529411764706,36,17,19,0.4722222222222222,0.6151990349819059,gemini,mimiciii,radiology_report,PROMPT2_ICL_entailment
389,449,16,13,3,0.8125,9,6,3,0.6666666666666666,0.7323943661971831,gemini,mimiciii,radiology_report,PROMPT2_ICL_entailment
390,45,17,9,8,0.5294117647058824,20,15,5,0.75,0.6206896551724139,gemini,mimiciii,radiology_report,PROMPT2_ICL_entailment
391,450,13,11,2,0.8461538461538461,21,15,6,0.7142857142857143,0.7746478873239436,gemini,mimiciii,radiology_report,PROMPT2_ICL_entailment
392,451,10,7,3,0.7,10,7,3,0.7,0.7,gemini,mimiciii,radiology_report,PROMPT2_ICL_entailment
393,452,17,14,3,0.8235294117647058,16,12,4,0.75,0.7850467289719627,gemini,mimiciii,radiology_report,PROMPT2_ICL_entailment
394,453,11,9,2,0.8181818181818182,14,11,3,0.7857142857142857,0.8016194331983806,gemini,mimiciii,radiology_report,PROMPT2_ICL_entailment
395,454,13,11,2,0.8461538461538461,10,7,3,0.7,0.7661691542288558,gemini,mimiciii,radiology_report,PROMPT2_ICL_entailment
396,455,20,14,6,0.7,16,13,3,0.8125,0.7520661157024793,gemini,mimiciii,radiology_report,PROMPT2_ICL_entailment
397,456,17,14,3,0.8235294117647058,21,20,1,0.9523809523809524,0.8832807570977917,gemini,mimiciii,radiology_report,PROMPT2_ICL_entailment
398,457,15,14,1,0.9333333333333332,12,9,3,0.75,0.8316831683168316,gemini,mimiciii,radiology_report,PROMPT2_ICL_entailment
399,458,9,8,1,0.8888888888888888,16,11,5,0.6875,0.7753303964757708,gemini,mimiciii,radiology_report,PROMPT2_ICL_entailment
400,459,9,7,2,0.7777777777777778,13,8,5,0.6153846153846154,0.6871165644171779,gemini,mimiciii,radiology_report,PROMPT2_ICL_entailment
401,46,13,11,2,0.8461538461538461,22,14,8,0.6363636363636364,0.7264150943396226,gemini,mimiciii,radiology_report,PROMPT2_ICL_entailment
402,460,18,14,4,0.7777777777777778,20,15,5,0.75,0.7636363636363638,gemini,mimiciii,radiology_report,PROMPT2_ICL_entailment
403,461,21,6,15,0.2857142857142857,22,12,10,0.5454545454545454,0.3749999999999999,gemini,mimiciii,radiology_report,PROMPT2_ICL_entailment
404,462,21,14,7,0.6666666666666666,20,17,3,0.85,0.7472527472527473,gemini,mimiciii,radiology_report,PROMPT2_ICL_entailment
405,463,10,8,2,0.8,12,8,4,0.6666666666666666,0.7272727272727272,gemini,mimiciii,radiology_report,PROMPT2_ICL_entailment
406,464,21,18,3,0.8571428571428571,25,19,6,0.76,0.8056537102473498,gemini,mimiciii,radiology_report,PROMPT2_ICL_entailment
407,465,23,22,1,0.9565217391304348,33,24,9,0.7272727272727273,0.8262910798122066,gemini,mimiciii,radiology_report,PROMPT2_ICL_entailment
408,466,13,10,3,0.7692307692307693,22,12,10,0.5454545454545454,0.6382978723404256,gemini,mimiciii,radiology_report,PROMPT2_ICL_entailment
409,467,12,12,0,1.0,14,12,2,0.8571428571428571,0.923076923076923,gemini,mimiciii,radiology_report,PROMPT2_ICL_entailment
410,468,12,11,1,0.9166666666666666,18,14,4,0.7777777777777778,0.8415300546448087,gemini,mimiciii,radiology_report,PROMPT2_ICL_entailment
411,469,20,12,8,0.6,25,17,8,0.68,0.6375000000000001,gemini,mimiciii,radiology_report,PROMPT2_ICL_entailment
412,47,19,13,6,0.6842105263157895,15,9,6,0.6,0.639344262295082,gemini,mimiciii,radiology_report,PROMPT2_ICL_entailment
413,470,15,13,2,0.8666666666666667,15,12,3,0.8,0.832,gemini,mimiciii,radiology_report,PROMPT2_ICL_entailment
414,471,17,14,3,0.8235294117647058,18,14,4,0.7777777777777778,0.7999999999999999,gemini,mimiciii,radiology_report,PROMPT2_ICL_entailment
415,472,16,14,2,0.875,16,10,6,0.625,0.7291666666666666,gemini,mimiciii,radiology_report,PROMPT2_ICL_entailment
416,473,11,7,4,0.6363636363636364,11,11,0,1.0,0.7777777777777778,gemini,mimiciii,radiology_report,PROMPT2_ICL_entailment
417,474,23,18,5,0.782608695652174,25,15,10,0.6,0.6792452830188679,gemini,mimiciii,radiology_report,PROMPT2_ICL_entailment
418,475,7,7,0,1.0,7,5,2,0.7142857142857143,0.8333333333333333,gemini,mimiciii,radiology_report,PROMPT2_ICL_entailment
419,476,17,10,7,0.5882352941176471,12,11,1,0.9166666666666666,0.7166123778501629,gemini,mimiciii,radiology_report,PROMPT2_ICL_entailment
420,477,18,14,4,0.7777777777777778,16,11,5,0.6875,0.7298578199052133,gemini,mimiciii,radiology_report,PROMPT2_ICL_entailment
421,478,18,15,3,0.8333333333333334,21,12,9,0.5714285714285714,0.6779661016949152,gemini,mimiciii,radiology_report,PROMPT2_ICL_entailment
422,479,11,10,1,0.9090909090909092,22,16,6,0.7272727272727273,0.8080808080808082,gemini,mimiciii,radiology_report,PROMPT2_ICL_entailment
423,48,10,9,1,0.9,21,12,9,0.5714285714285714,0.6990291262135921,gemini,mimiciii,radiology_report,PROMPT2_ICL_entailment
424,480,11,11,0,1.0,10,8,2,0.8,0.888888888888889,gemini,mimiciii,radiology_report,PROMPT2_ICL_entailment
425,481,15,5,10,0.3333333333333333,17,11,6,0.6470588235294118,0.44,gemini,mimiciii,radiology_report,PROMPT2_ICL_entailment
426,482,19,9,10,0.4736842105263157,19,16,3,0.8421052631578947,0.6063157894736843,gemini,mimiciii,radiology_report,PROMPT2_ICL_entailment
427,483,20,19,1,0.95,23,13,10,0.5652173913043478,0.7087517934002868,gemini,mimiciii,radiology_report,PROMPT2_ICL_entailment
428,484,14,13,1,0.9285714285714286,13,10,3,0.7692307692307693,0.8414239482200646,gemini,mimiciii,radiology_report,PROMPT2_ICL_entailment
429,485,17,12,5,0.7058823529411765,24,12,12,0.5,0.5853658536585366,gemini,mimiciii,radiology_report,PROMPT2_ICL_entailment
430,486,8,7,1,0.875,11,7,4,0.6363636363636364,0.7368421052631579,gemini,mimiciii,radiology_report,PROMPT2_ICL_entailment
431,487,15,11,4,0.7333333333333333,20,12,8,0.6,0.6599999999999999,gemini,mimiciii,radiology_report,PROMPT2_ICL_entailment
432,488,11,8,3,0.7272727272727273,15,6,9,0.4,0.5161290322580645,gemini,mimiciii,radiology_report,PROMPT2_ICL_entailment
433,489,17,15,2,0.8823529411764706,18,9,9,0.5,0.6382978723404256,gemini,mimiciii,radiology_report,PROMPT2_ICL_entailment
434,49,16,14,2,0.875,24,14,10,0.5833333333333334,0.7000000000000001,gemini,mimiciii,radiology_report,PROMPT2_ICL_entailment
435,490,7,6,1,0.8571428571428571,8,3,5,0.375,0.5217391304347825,gemini,mimiciii,radiology_report,PROMPT2_ICL_entailment
436,491,14,14,0,1.0,17,7,10,0.4117647058823529,0.5833333333333334,gemini,mimiciii,radiology_report,PROMPT2_ICL_entailment
437,492,11,11,0,1.0,13,10,3,0.7692307692307693,0.8695652173913044,gemini,mimiciii,radiology_report,PROMPT2_ICL_entailment
438,493,14,12,2,0.8571428571428571,9,6,3,0.6666666666666666,0.75,gemini,mimiciii,radiology_report,PROMPT2_ICL_entailment
439,494,11,9,2,0.8181818181818182,8,5,3,0.625,0.7086614173228345,gemini,mimiciii,radiology_report,PROMPT2_ICL_entailment
440,495,13,12,1,0.9230769230769232,12,10,2,0.8333333333333334,0.8759124087591241,gemini,mimiciii,radiology_report,PROMPT2_ICL_entailment
441,496,38,38,0,1.0,32,24,8,0.75,0.8571428571428571,gemini,mimiciii,radiology_report,PROMPT2_ICL_entailment
442,497,10,6,4,0.6,22,16,6,0.7272727272727273,0.6575342465753425,gemini,mimiciii,radiology_report,PROMPT2_ICL_entailment
443,498,18,15,3,0.8333333333333334,22,16,6,0.7272727272727273,0.7766990291262137,gemini,mimiciii,radiology_report,PROMPT2_ICL_entailment
444,499,17,12,5,0.7058823529411765,17,13,4,0.7647058823529411,0.7341176470588234,gemini,mimiciii,radiology_report,PROMPT2_ICL_entailment
445,5,20,17,3,0.85,22,16,6,0.7272727272727273,0.7838616714697406,gemini,mimiciii,radiology_report,PROMPT2_ICL_entailment
446,50,12,9,3,0.75,15,10,5,0.6666666666666666,0.7058823529411765,gemini,mimiciii,radiology_report,PROMPT2_ICL_entailment
447,51,12,11,1,0.9166666666666666,13,7,6,0.5384615384615384,0.6784140969162995,gemini,mimiciii,radiology_report,PROMPT2_ICL_entailment
448,52,16,14,2,0.875,21,14,7,0.6666666666666666,0.7567567567567567,gemini,mimiciii,radiology_report,PROMPT2_ICL_entailment
449,53,16,13,3,0.8125,12,8,4,0.6666666666666666,0.7323943661971831,gemini,mimiciii,radiology_report,PROMPT2_ICL_entailment
450,54,12,10,2,0.8333333333333334,10,8,2,0.8,0.816326530612245,gemini,mimiciii,radiology_report,PROMPT2_ICL_entailment
451,55,18,9,9,0.5,18,16,2,0.8888888888888888,0.64,gemini,mimiciii,radiology_report,PROMPT2_ICL_entailment
452,56,17,10,7,0.5882352941176471,21,15,6,0.7142857142857143,0.6451612903225806,gemini,mimiciii,radiology_report,PROMPT2_ICL_entailment
453,57,9,7,2,0.7777777777777778,10,5,5,0.5,0.6086956521739131,gemini,mimiciii,radiology_report,PROMPT2_ICL_entailment
454,58,16,16,0,1.0,16,14,2,0.875,0.9333333333333332,gemini,mimiciii,radiology_report,PROMPT2_ICL_entailment
455,59,14,14,0,1.0,16,14,2,0.875,0.9333333333333332,gemini,mimiciii,radiology_report,PROMPT2_ICL_entailment
456,6,8,7,1,0.875,8,6,2,0.75,0.8076923076923077,gemini,mimiciii,radiology_report,PROMPT2_ICL_entailment
457,60,13,12,1,0.9230769230769232,19,10,9,0.5263157894736842,0.6703910614525139,gemini,mimiciii,radiology_report,PROMPT2_ICL_entailment
458,61,12,6,6,0.5,22,12,10,0.5454545454545454,0.5217391304347826,gemini,mimiciii,radiology_report,PROMPT2_ICL_entailment
459,62,8,2,6,0.25,13,11,2,0.8461538461538461,0.3859649122807017,gemini,mimiciii,radiology_report,PROMPT2_ICL_entailment
460,63,10,10,0,1.0,15,7,8,0.4666666666666667,0.6363636363636364,gemini,mimiciii,radiology_report,PROMPT2_ICL_entailment
461,64,16,13,3,0.8125,20,12,8,0.6,0.6902654867256637,gemini,mimiciii,radiology_report,PROMPT2_ICL_entailment
462,65,12,9,3,0.75,18,13,5,0.7222222222222222,0.7358490566037735,gemini,mimiciii,radiology_report,PROMPT2_ICL_entailment
463,66,28,22,6,0.7857142857142857,29,23,6,0.7931034482758621,0.7893915756630265,gemini,mimiciii,radiology_report,PROMPT2_ICL_entailment
464,67,27,21,6,0.7777777777777778,28,22,6,0.7857142857142857,0.7817258883248731,gemini,mimiciii,radiology_report,PROMPT2_ICL_entailment
465,68,28,23,5,0.8214285714285714,30,22,8,0.7333333333333333,0.7748851454823891,gemini,mimiciii,radiology_report,PROMPT2_ICL_entailment
466,69,25,19,6,0.76,31,19,12,0.6129032258064516,0.6785714285714285,gemini,mimiciii,radiology_report,PROMPT2_ICL_entailment
467,7,19,14,5,0.7368421052631579,16,11,5,0.6875,0.7113163972286374,gemini,mimiciii,radiology_report,PROMPT2_ICL_entailment
468,70,11,8,3,0.7272727272727273,17,13,4,0.7647058823529411,0.7455197132616488,gemini,mimiciii,radiology_report,PROMPT2_ICL_entailment
469,71,12,9,3,0.75,18,8,10,0.4444444444444444,0.5581395348837209,gemini,mimiciii,radiology_report,PROMPT2_ICL_entailment
470,72,15,12,3,0.8,13,10,3,0.7692307692307693,0.7843137254901961,gemini,mimiciii,radiology_report,PROMPT2_ICL_entailment
471,73,21,14,7,0.6666666666666666,29,18,11,0.6206896551724138,0.6428571428571429,gemini,mimiciii,radiology_report,PROMPT2_ICL_entailment
472,74,11,11,0,1.0,18,10,8,0.5555555555555556,0.7142857142857143,gemini,mimiciii,radiology_report,PROMPT2_ICL_entailment
473,75,13,9,4,0.6923076923076923,12,10,2,0.8333333333333334,0.7563025210084034,gemini,mimiciii,radiology_report,PROMPT2_ICL_entailment
474,76,11,8,3,0.7272727272727273,14,12,2,0.8571428571428571,0.7868852459016394,gemini,mimiciii,radiology_report,PROMPT2_ICL_entailment
475,77,23,17,6,0.7391304347826086,26,18,8,0.6923076923076923,0.7149532710280374,gemini,mimiciii,radiology_report,PROMPT2_ICL_entailment
476,78,31,21,10,0.6774193548387096,33,26,7,0.7878787878787878,0.7284856571047365,gemini,mimiciii,radiology_report,PROMPT2_ICL_entailment
477,79,20,17,3,0.85,17,12,5,0.7058823529411765,0.771266540642722,gemini,mimiciii,radiology_report,PROMPT2_ICL_entailment
478,8,15,13,2,0.8666666666666667,15,10,5,0.6666666666666666,0.7536231884057971,gemini,mimiciii,radiology_report,PROMPT2_ICL_entailment
479,80,15,11,4,0.7333333333333333,25,19,6,0.76,0.7464285714285716,gemini,mimiciii,radiology_report,PROMPT2_ICL_entailment
480,81,15,8,7,0.5333333333333333,15,9,6,0.6,0.5647058823529412,gemini,mimiciii,radiology_report,PROMPT2_ICL_entailment
481,82,16,11,5,0.6875,14,13,1,0.9285714285714286,0.7900552486187846,gemini,mimiciii,radiology_report,PROMPT2_ICL_entailment
482,83,25,16,9,0.64,17,14,3,0.8235294117647058,0.7202572347266882,gemini,mimiciii,radiology_report,PROMPT2_ICL_entailment
483,84,18,13,5,0.7222222222222222,20,16,4,0.8,0.759124087591241,gemini,mimiciii,radiology_report,PROMPT2_ICL_entailment
484,85,21,15,6,0.7142857142857143,14,10,4,0.7142857142857143,0.7142857142857143,gemini,mimiciii,radiology_report,PROMPT2_ICL_entailment
485,86,14,11,3,0.7857142857142857,10,8,2,0.8,0.7927927927927927,gemini,mimiciii,radiology_report,PROMPT2_ICL_entailment
486,87,14,12,2,0.8571428571428571,14,10,4,0.7142857142857143,0.7792207792207793,gemini,mimiciii,radiology_report,PROMPT2_ICL_entailment
487,88,16,8,8,0.5,19,14,5,0.7368421052631579,0.5957446808510638,gemini,mimiciii,radiology_report,PROMPT2_ICL_entailment
488,89,23,15,8,0.6521739130434783,18,17,1,0.9444444444444444,0.7715582450832073,gemini,mimiciii,radiology_report,PROMPT2_ICL_entailment
489,9,15,15,0,1.0,13,11,2,0.8461538461538461,0.9166666666666666,gemini,mimiciii,radiology_report,PROMPT2_ICL_entailment
490,90,14,14,0,1.0,14,13,1,0.9285714285714286,0.962962962962963,gemini,mimiciii,radiology_report,PROMPT2_ICL_entailment
491,91,12,12,0,1.0,13,9,4,0.6923076923076923,0.8181818181818181,gemini,mimiciii,radiology_report,PROMPT2_ICL_entailment
492,92,19,15,4,0.7894736842105263,21,18,3,0.8571428571428571,0.8219178082191781,gemini,mimiciii,radiology_report,PROMPT2_ICL_entailment
493,93,16,15,1,0.9375,15,11,4,0.7333333333333333,0.8229426433915211,gemini,mimiciii,radiology_report,PROMPT2_ICL_entailment
494,94,21,14,7,0.6666666666666666,28,18,10,0.6428571428571429,0.6545454545454545,gemini,mimiciii,radiology_report,PROMPT2_ICL_entailment
495,95,21,19,2,0.9047619047619048,18,13,5,0.7222222222222222,0.8032520325203253,gemini,mimiciii,radiology_report,PROMPT2_ICL_entailment
496,96,9,7,2,0.7777777777777778,21,14,7,0.6666666666666666,0.717948717948718,gemini,mimiciii,radiology_report,PROMPT2_ICL_entailment
497,97,14,9,5,0.6428571428571429,23,17,6,0.7391304347826086,0.6876404494382022,gemini,mimiciii,radiology_report,PROMPT2_ICL_entailment
498,98,15,11,4,0.7333333333333333,19,13,6,0.6842105263157895,0.707920792079208,gemini,mimiciii,radiology_report,PROMPT2_ICL_entailment
499,99,18,16,2,0.8888888888888888,13,13,0,1.0,0.9411764705882352,gemini,mimiciii,radiology_report,PROMPT2_ICL_entailment
0,0,17,10,7,0.5882352941176471,21,10,11,0.4761904761904761,0.5263157894736842,gemini,mimiciii,radiology_report,PROMPT2_entailment
1,1,11,11,0,1.0,15,10,5,0.6666666666666666,0.8,gemini,mimiciii,radiology_report,PROMPT2_entailment
2,10,12,8,4,0.6666666666666666,18,10,8,0.5555555555555556,0.606060606060606,gemini,mimiciii,radiology_report,PROMPT2_entailment
3,100,10,10,0,1.0,9,8,1,0.8888888888888888,0.9411764705882352,gemini,mimiciii,radiology_report,PROMPT2_entailment
4,101,18,13,5,0.7222222222222222,15,11,4,0.7333333333333333,0.727735368956743,gemini,mimiciii,radiology_report,PROMPT2_entailment
5,102,12,9,3,0.75,16,9,7,0.5625,0.6428571428571429,gemini,mimiciii,radiology_report,PROMPT2_entailment
6,103,16,12,4,0.75,19,10,9,0.5263157894736842,0.6185567010309279,gemini,mimiciii,radiology_report,PROMPT2_entailment
7,104,22,11,11,0.5,17,13,4,0.7647058823529411,0.6046511627906976,gemini,mimiciii,radiology_report,PROMPT2_entailment
8,105,6,6,0,1.0,8,6,2,0.75,0.8571428571428571,gemini,mimiciii,radiology_report,PROMPT2_entailment
9,106,11,8,3,0.7272727272727273,12,9,3,0.75,0.7384615384615384,gemini,mimiciii,radiology_report,PROMPT2_entailment
10,107,18,14,4,0.7777777777777778,19,13,6,0.6842105263157895,0.728,gemini,mimiciii,radiology_report,PROMPT2_entailment
11,108,11,11,0,1.0,13,9,4,0.6923076923076923,0.8181818181818181,gemini,mimiciii,radiology_report,PROMPT2_entailment
12,109,14,8,6,0.5714285714285714,20,17,3,0.85,0.6834170854271356,gemini,mimiciii,radiology_report,PROMPT2_entailment
13,11,14,10,4,0.7142857142857143,20,17,3,0.85,0.776255707762557,gemini,mimiciii,radiology_report,PROMPT2_entailment
14,110,11,6,5,0.5454545454545454,17,9,8,0.5294117647058824,0.5373134328358209,gemini,mimiciii,radiology_report,PROMPT2_entailment
15,111,10,8,2,0.8,20,15,5,0.75,0.7741935483870969,gemini,mimiciii,radiology_report,PROMPT2_entailment
16,112,11,11,0,1.0,14,10,4,0.7142857142857143,0.8333333333333333,gemini,mimiciii,radiology_report,PROMPT2_entailment
17,113,13,2,11,0.1538461538461538,20,13,7,0.65,0.2488038277511961,gemini,mimiciii,radiology_report,PROMPT2_entailment
18,114,19,7,12,0.3684210526315789,23,17,6,0.7391304347826086,0.4917355371900825,gemini,mimiciii,radiology_report,PROMPT2_entailment
19,115,18,17,1,0.9444444444444444,20,16,4,0.8,0.8662420382165604,gemini,mimiciii,radiology_report,PROMPT2_entailment
20,116,12,10,2,0.8333333333333334,13,9,4,0.6923076923076923,0.7563025210084034,gemini,mimiciii,radiology_report,PROMPT2_entailment
21,117,13,10,3,0.7692307692307693,16,11,5,0.6875,0.7260726072607261,gemini,mimiciii,radiology_report,PROMPT2_entailment
22,118,14,11,3,0.7857142857142857,24,17,7,0.7083333333333334,0.7450199203187251,gemini,mimiciii,radiology_report,PROMPT2_entailment
23,119,12,9,3,0.75,17,11,6,0.6470588235294118,0.6947368421052633,gemini,mimiciii,radiology_report,PROMPT2_entailment
24,12,13,13,0,1.0,17,12,5,0.7058823529411765,0.8275862068965517,gemini,mimiciii,radiology_report,PROMPT2_entailment
25,120,12,10,2,0.8333333333333334,16,10,6,0.625,0.7142857142857143,gemini,mimiciii,radiology_report,PROMPT2_entailment
26,121,13,9,4,0.6923076923076923,26,17,9,0.6538461538461539,0.6725274725274725,gemini,mimiciii,radiology_report,PROMPT2_entailment
27,122,13,9,4,0.6923076923076923,20,16,4,0.8,0.7422680412371134,gemini,mimiciii,radiology_report,PROMPT2_entailment
28,123,9,7,2,0.7777777777777778,13,8,5,0.6153846153846154,0.6871165644171779,gemini,mimiciii,radiology_report,PROMPT2_entailment
29,124,7,6,1,0.8571428571428571,12,9,3,0.75,0.7999999999999999,gemini,mimiciii,radiology_report,PROMPT2_entailment
30,125,12,12,0,1.0,23,17,6,0.7391304347826086,0.85,gemini,mimiciii,radiology_report,PROMPT2_entailment
31,126,7,5,2,0.7142857142857143,9,7,2,0.7777777777777778,0.7446808510638298,gemini,mimiciii,radiology_report,PROMPT2_entailment
32,127,31,27,4,0.8709677419354839,43,31,12,0.7209302325581395,0.7888784165881244,gemini,mimiciii,radiology_report,PROMPT2_entailment
33,128,10,8,2,0.8,14,10,4,0.7142857142857143,0.7547169811320756,gemini,mimiciii,radiology_report,PROMPT2_entailment
34,129,15,13,2,0.8666666666666667,16,10,6,0.625,0.7262569832402236,gemini,mimiciii,radiology_report,PROMPT2_entailment
35,13,17,12,5,0.7058823529411765,17,14,3,0.8235294117647058,0.7601809954751132,gemini,mimiciii,radiology_report,PROMPT2_entailment
36,130,13,13,0,1.0,25,9,16,0.36,0.5294117647058824,gemini,mimiciii,radiology_report,PROMPT2_entailment
37,131,8,5,3,0.625,32,21,11,0.65625,0.6402439024390244,gemini,mimiciii,radiology_report,PROMPT2_entailment
38,132,13,4,9,0.3076923076923077,23,11,12,0.4782608695652174,0.374468085106383,gemini,mimiciii,radiology_report,PROMPT2_entailment
39,133,16,14,2,0.875,21,16,5,0.7619047619047619,0.8145454545454546,gemini,mimiciii,radiology_report,PROMPT2_entailment
40,134,25,22,3,0.88,23,18,5,0.782608695652174,0.8284518828451882,gemini,mimiciii,radiology_report,PROMPT2_entailment
41,135,14,14,0,1.0,20,16,4,0.8,0.888888888888889,gemini,mimiciii,radiology_report,PROMPT2_entailment
42,136,11,8,3,0.7272727272727273,14,10,4,0.7142857142857143,0.7207207207207208,gemini,mimiciii,radiology_report,PROMPT2_entailment
43,137,8,7,1,0.875,10,7,3,0.7,0.7777777777777777,gemini,mimiciii,radiology_report,PROMPT2_entailment
44,138,10,10,0,1.0,14,10,4,0.7142857142857143,0.8333333333333333,gemini,mimiciii,radiology_report,PROMPT2_entailment
45,139,9,7,2,0.7777777777777778,13,8,5,0.6153846153846154,0.6871165644171779,gemini,mimiciii,radiology_report,PROMPT2_entailment
46,14,7,6,1,0.8571428571428571,12,8,4,0.6666666666666666,0.75,gemini,mimiciii,radiology_report,PROMPT2_entailment
47,140,14,11,3,0.7857142857142857,18,11,7,0.6111111111111112,0.6875000000000001,gemini,mimiciii,radiology_report,PROMPT2_entailment
48,141,13,11,2,0.8461538461538461,16,7,9,0.4375,0.5767790262172284,gemini,mimiciii,radiology_report,PROMPT2_entailment
49,142,12,9,3,0.75,14,11,3,0.7857142857142857,0.7674418604651163,gemini,mimiciii,radiology_report,PROMPT2_entailment
50,143,25,22,3,0.88,28,18,10,0.6428571428571429,0.7429643527204502,gemini,mimiciii,radiology_report,PROMPT2_entailment
51,144,14,10,4,0.7142857142857143,23,15,8,0.6521739130434783,0.6818181818181819,gemini,mimiciii,radiology_report,PROMPT2_entailment
52,145,18,17,1,0.9444444444444444,18,14,4,0.7777777777777778,0.8530465949820788,gemini,mimiciii,radiology_report,PROMPT2_entailment
53,146,6,5,1,0.8333333333333334,11,7,4,0.6363636363636364,0.7216494845360825,gemini,mimiciii,radiology_report,PROMPT2_entailment
54,147,8,8,0,1.0,10,8,2,0.8,0.888888888888889,gemini,mimiciii,radiology_report,PROMPT2_entailment
55,148,15,8,7,0.5333333333333333,26,16,10,0.6153846153846154,0.5714285714285715,gemini,mimiciii,radiology_report,PROMPT2_entailment
56,149,17,11,6,0.6470588235294118,20,16,4,0.8,0.7154471544715447,gemini,mimiciii,radiology_report,PROMPT2_entailment
57,15,21,16,5,0.7619047619047619,29,22,7,0.7586206896551724,0.7602591792656588,gemini,mimiciii,radiology_report,PROMPT2_entailment
58,150,16,7,9,0.4375,14,10,4,0.7142857142857143,0.5426356589147286,gemini,mimiciii,radiology_report,PROMPT2_entailment
59,151,19,14,5,0.7368421052631579,15,10,5,0.6666666666666666,0.7,gemini,mimiciii,radiology_report,PROMPT2_entailment
60,152,12,8,4,0.6666666666666666,18,12,6,0.6666666666666666,0.6666666666666666,gemini,mimiciii,radiology_report,PROMPT2_entailment
61,153,15,12,3,0.8,16,13,3,0.8125,0.8062015503875969,gemini,mimiciii,radiology_report,PROMPT2_entailment
62,154,20,11,9,0.55,23,19,4,0.8260869565217391,0.6603475513428121,gemini,mimiciii,radiology_report,PROMPT2_entailment
63,155,36,32,4,0.8888888888888888,47,31,16,0.6595744680851063,0.7572519083969466,gemini,mimiciii,radiology_report,PROMPT2_entailment
64,156,14,6,8,0.4285714285714285,20,15,5,0.75,0.5454545454545454,gemini,mimiciii,radiology_report,PROMPT2_entailment
65,157,11,9,2,0.8181818181818182,12,8,4,0.6666666666666666,0.7346938775510203,gemini,mimiciii,radiology_report,PROMPT2_entailment
66,158,5,5,0,1.0,6,3,3,0.5,0.6666666666666666,gemini,mimiciii,radiology_report,PROMPT2_entailment
67,159,9,7,2,0.7777777777777778,13,10,3,0.7692307692307693,0.7734806629834255,gemini,mimiciii,radiology_report,PROMPT2_entailment
68,16,14,11,3,0.7857142857142857,17,13,4,0.7647058823529411,0.7750677506775069,gemini,mimiciii,radiology_report,PROMPT2_entailment
69,160,13,13,0,1.0,12,10,2,0.8333333333333334,0.9090909090909092,gemini,mimiciii,radiology_report,PROMPT2_entailment
70,161,10,8,2,0.8,13,7,6,0.5384615384615384,0.6436781609195402,gemini,mimiciii,radiology_report,PROMPT2_entailment
71,162,13,11,2,0.8461538461538461,11,8,3,0.7272727272727273,0.7822222222222223,gemini,mimiciii,radiology_report,PROMPT2_entailment
72,163,9,9,0,1.0,8,5,3,0.625,0.7692307692307693,gemini,mimiciii,radiology_report,PROMPT2_entailment
73,164,10,8,2,0.8,10,10,0,1.0,0.888888888888889,gemini,mimiciii,radiology_report,PROMPT2_entailment
74,165,14,9,5,0.6428571428571429,28,22,6,0.7857142857142857,0.7071428571428572,gemini,mimiciii,radiology_report,PROMPT2_entailment
75,166,14,11,3,0.7857142857142857,26,17,9,0.6538461538461539,0.7137404580152671,gemini,mimiciii,radiology_report,PROMPT2_entailment
76,167,7,6,1,0.8571428571428571,10,7,3,0.7,0.7706422018348624,gemini,mimiciii,radiology_report,PROMPT2_entailment
77,168,10,7,3,0.7,13,5,8,0.3846153846153846,0.4964539007092198,gemini,mimiciii,radiology_report,PROMPT2_entailment
78,169,23,14,9,0.6086956521739131,22,19,3,0.8636363636363636,0.7140939597315437,gemini,mimiciii,radiology_report,PROMPT2_entailment
79,17,9,8,1,0.8888888888888888,12,8,4,0.6666666666666666,0.761904761904762,gemini,mimiciii,radiology_report,PROMPT2_entailment
80,170,24,18,6,0.75,24,19,5,0.7916666666666666,0.7702702702702704,gemini,mimiciii,radiology_report,PROMPT2_entailment
81,171,7,7,0,1.0,7,5,2,0.7142857142857143,0.8333333333333333,gemini,mimiciii,radiology_report,PROMPT2_entailment
82,172,11,7,4,0.6363636363636364,14,10,4,0.7142857142857143,0.673076923076923,gemini,mimiciii,radiology_report,PROMPT2_entailment
83,173,9,9,0,1.0,12,9,3,0.75,0.8571428571428571,gemini,mimiciii,radiology_report,PROMPT2_entailment
84,174,13,11,2,0.8461538461538461,20,12,8,0.6,0.7021276595744681,gemini,mimiciii,radiology_report,PROMPT2_entailment
85,175,7,7,0,1.0,8,6,2,0.75,0.8571428571428571,gemini,mimiciii,radiology_report,PROMPT2_entailment
86,176,24,11,13,0.4583333333333333,19,14,5,0.7368421052631579,0.5651376146788991,gemini,mimiciii,radiology_report,PROMPT2_entailment
87,177,20,16,4,0.8,16,13,3,0.8125,0.8062015503875969,gemini,mimiciii,radiology_report,PROMPT2_entailment
88,178,18,7,11,0.3888888888888889,25,20,5,0.8,0.5233644859813085,gemini,mimiciii,radiology_report,PROMPT2_entailment
89,179,11,11,0,1.0,17,11,6,0.6470588235294118,0.7857142857142858,gemini,mimiciii,radiology_report,PROMPT2_entailment
90,18,11,8,3,0.7272727272727273,17,11,6,0.6470588235294118,0.6848249027237354,gemini,mimiciii,radiology_report,PROMPT2_entailment
91,180,9,9,0,1.0,11,9,2,0.8181818181818182,0.9,gemini,mimiciii,radiology_report,PROMPT2_entailment
92,181,16,11,5,0.6875,26,18,8,0.6923076923076923,0.6898954703832753,gemini,mimiciii,radiology_report,PROMPT2_entailment
93,182,17,14,3,0.8235294117647058,23,17,6,0.7391304347826086,0.779050736497545,gemini,mimiciii,radiology_report,PROMPT2_entailment
94,183,17,13,4,0.7647058823529411,17,11,6,0.6470588235294118,0.7009803921568628,gemini,mimiciii,radiology_report,PROMPT2_entailment
95,184,14,11,3,0.7857142857142857,15,11,4,0.7333333333333333,0.7586206896551724,gemini,mimiciii,radiology_report,PROMPT2_entailment
96,185,6,6,0,1.0,6,3,3,0.5,0.6666666666666666,gemini,mimiciii,radiology_report,PROMPT2_entailment
97,186,18,12,6,0.6666666666666666,26,19,7,0.7307692307692307,0.6972477064220183,gemini,mimiciii,radiology_report,PROMPT2_entailment
98,187,16,14,2,0.875,14,10,4,0.7142857142857143,0.7865168539325842,gemini,mimiciii,radiology_report,PROMPT2_entailment
99,188,22,18,4,0.8181818181818182,22,13,9,0.5909090909090909,0.686217008797654,gemini,mimiciii,radiology_report,PROMPT2_entailment
100,189,11,10,1,0.9090909090909092,15,13,2,0.8666666666666667,0.887372013651877,gemini,mimiciii,radiology_report,PROMPT2_entailment
101,19,11,11,0,1.0,14,10,4,0.7142857142857143,0.8333333333333333,gemini,mimiciii,radiology_report,PROMPT2_entailment
102,190,8,6,2,0.75,17,10,7,0.5882352941176471,0.6593406593406592,gemini,mimiciii,radiology_report,PROMPT2_entailment
103,191,15,6,9,0.4,15,5,10,0.3333333333333333,0.3636363636363636,gemini,mimiciii,radiology_report,PROMPT2_entailment
104,192,19,12,7,0.631578947368421,28,19,9,0.6785714285714286,0.6542324246771879,gemini,mimiciii,radiology_report,PROMPT2_entailment
105,193,14,14,0,1.0,14,9,5,0.6428571428571429,0.782608695652174,gemini,mimiciii,radiology_report,PROMPT2_entailment
106,194,27,22,5,0.8148148148148148,38,24,14,0.631578947368421,0.711590296495957,gemini,mimiciii,radiology_report,PROMPT2_entailment
107,195,19,13,6,0.6842105263157895,21,14,7,0.6666666666666666,0.6753246753246753,gemini,mimiciii,radiology_report,PROMPT2_entailment
108,196,15,10,5,0.6666666666666666,18,14,4,0.7777777777777778,0.717948717948718,gemini,mimiciii,radiology_report,PROMPT2_entailment
109,197,9,8,1,0.8888888888888888,15,9,6,0.6,0.7164179104477612,gemini,mimiciii,radiology_report,PROMPT2_entailment
110,198,10,9,1,0.9,9,4,5,0.4444444444444444,0.5950413223140495,gemini,mimiciii,radiology_report,PROMPT2_entailment
111,199,19,13,6,0.6842105263157895,23,18,5,0.782608695652174,0.7301092043681747,gemini,mimiciii,radiology_report,PROMPT2_entailment
112,2,11,9,2,0.8181818181818182,15,8,7,0.5333333333333333,0.6457399103139013,gemini,mimiciii,radiology_report,PROMPT2_entailment
113,20,21,20,1,0.9523809523809524,36,28,8,0.7777777777777778,0.856269113149847,gemini,mimiciii,radiology_report,PROMPT2_entailment
114,200,13,12,1,0.9230769230769232,14,11,3,0.7857142857142857,0.8488745980707394,gemini,mimiciii,radiology_report,PROMPT2_entailment
115,201,15,10,5,0.6666666666666666,18,12,6,0.6666666666666666,0.6666666666666666,gemini,mimiciii,radiology_report,PROMPT2_entailment
116,202,18,12,6,0.6666666666666666,24,18,6,0.75,0.7058823529411765,gemini,mimiciii,radiology_report,PROMPT2_entailment
117,203,14,6,8,0.4285714285714285,19,14,5,0.7368421052631579,0.5419354838709678,gemini,mimiciii,radiology_report,PROMPT2_entailment
118,204,18,12,6,0.6666666666666666,23,19,4,0.8260869565217391,0.7378640776699029,gemini,mimiciii,radiology_report,PROMPT2_entailment
119,205,13,10,3,0.7692307692307693,14,8,6,0.5714285714285714,0.6557377049180327,gemini,mimiciii,radiology_report,PROMPT2_entailment
120,206,16,14,2,0.875,13,10,3,0.7692307692307693,0.8187134502923977,gemini,mimiciii,radiology_report,PROMPT2_entailment
121,207,6,6,0,1.0,9,6,3,0.6666666666666666,0.8,gemini,mimiciii,radiology_report,PROMPT2_entailment
122,208,16,10,6,0.625,18,15,3,0.8333333333333334,0.7142857142857143,gemini,mimiciii,radiology_report,PROMPT2_entailment
123,209,11,10,1,0.9090909090909092,16,12,4,0.75,0.821917808219178,gemini,mimiciii,radiology_report,PROMPT2_entailment
124,21,26,22,4,0.8461538461538461,27,16,11,0.5925925925925926,0.6970297029702969,gemini,mimiciii,radiology_report,PROMPT2_entailment
125,210,11,8,3,0.7272727272727273,14,10,4,0.7142857142857143,0.7207207207207208,gemini,mimiciii,radiology_report,PROMPT2_entailment
126,211,14,13,1,0.9285714285714286,13,8,5,0.6153846153846154,0.7402135231316727,gemini,mimiciii,radiology_report,PROMPT2_entailment
127,212,19,10,9,0.5263157894736842,19,17,2,0.8947368421052632,0.6627680311890838,gemini,mimiciii,radiology_report,PROMPT2_entailment
128,213,15,12,3,0.8,22,16,6,0.7272727272727273,0.761904761904762,gemini,mimiciii,radiology_report,PROMPT2_entailment
129,214,27,13,14,0.4814814814814814,23,16,7,0.6956521739130435,0.5690834473324213,gemini,mimiciii,radiology_report,PROMPT2_entailment
130,215,9,6,3,0.6666666666666666,10,9,1,0.9,0.7659574468085106,gemini,mimiciii,radiology_report,PROMPT2_entailment
131,216,13,10,3,0.7692307692307693,19,11,8,0.5789473684210527,0.6606606606606608,gemini,mimiciii,radiology_report,PROMPT2_entailment
132,217,18,12,6,0.6666666666666666,20,11,9,0.55,0.6027397260273972,gemini,mimiciii,radiology_report,PROMPT2_entailment
133,218,17,14,3,0.8235294117647058,15,12,3,0.8,0.8115942028985507,gemini,mimiciii,radiology_report,PROMPT2_entailment
134,219,14,9,5,0.6428571428571429,13,8,5,0.6153846153846154,0.62882096069869,gemini,mimiciii,radiology_report,PROMPT2_entailment
135,22,12,11,1,0.9166666666666666,19,15,4,0.7894736842105263,0.8483290488431876,gemini,mimiciii,radiology_report,PROMPT2_entailment
136,220,16,15,1,0.9375,19,18,1,0.9473684210526316,0.9424083769633508,gemini,mimiciii,radiology_report,PROMPT2_entailment
137,221,16,9,7,0.5625,27,18,9,0.6666666666666666,0.6101694915254238,gemini,mimiciii,radiology_report,PROMPT2_entailment
138,222,14,10,4,0.7142857142857143,16,11,5,0.6875,0.7006369426751592,gemini,mimiciii,radiology_report,PROMPT2_entailment
139,223,17,12,5,0.7058823529411765,21,16,5,0.7619047619047619,0.7328244274809159,gemini,mimiciii,radiology_report,PROMPT2_entailment
140,224,16,11,5,0.6875,17,11,6,0.6470588235294118,0.6666666666666667,gemini,mimiciii,radiology_report,PROMPT2_entailment
141,225,7,7,0,1.0,11,8,3,0.7272727272727273,0.8421052631578948,gemini,mimiciii,radiology_report,PROMPT2_entailment
142,226,15,12,3,0.8,18,14,4,0.7777777777777778,0.7887323943661971,gemini,mimiciii,radiology_report,PROMPT2_entailment
143,227,15,14,1,0.9333333333333332,18,14,4,0.7777777777777778,0.8484848484848485,gemini,mimiciii,radiology_report,PROMPT2_entailment
144,228,10,8,2,0.8,17,14,3,0.8235294117647058,0.8115942028985507,gemini,mimiciii,radiology_report,PROMPT2_entailment
145,229,26,26,0,1.0,44,30,14,0.6818181818181818,0.8108108108108109,gemini,mimiciii,radiology_report,PROMPT2_entailment
146,23,15,13,2,0.8666666666666667,15,11,4,0.7333333333333333,0.7944444444444444,gemini,mimiciii,radiology_report,PROMPT2_entailment
147,230,11,7,4,0.6363636363636364,17,13,4,0.7647058823529411,0.6946564885496184,gemini,mimiciii,radiology_report,PROMPT2_entailment
148,231,11,11,0,1.0,13,10,3,0.7692307692307693,0.8695652173913044,gemini,mimiciii,radiology_report,PROMPT2_entailment
149,232,12,6,6,0.5,18,12,6,0.6666666666666666,0.5714285714285715,gemini,mimiciii,radiology_report,PROMPT2_entailment
150,233,17,13,4,0.7647058823529411,17,12,5,0.7058823529411765,0.7341176470588234,gemini,mimiciii,radiology_report,PROMPT2_entailment
151,234,9,8,1,0.8888888888888888,11,9,2,0.8181818181818182,0.8520710059171598,gemini,mimiciii,radiology_report,PROMPT2_entailment
152,235,13,12,1,0.9230769230769232,14,10,4,0.7142857142857143,0.8053691275167787,gemini,mimiciii,radiology_report,PROMPT2_entailment
153,236,16,12,4,0.75,11,10,1,0.9090909090909092,0.821917808219178,gemini,mimiciii,radiology_report,PROMPT2_entailment
154,237,15,9,6,0.6,17,11,6,0.6470588235294118,0.6226415094339622,gemini,mimiciii,radiology_report,PROMPT2_entailment
155,238,21,15,6,0.7142857142857143,20,17,3,0.85,0.776255707762557,gemini,mimiciii,radiology_report,PROMPT2_entailment
156,239,13,8,5,0.6153846153846154,17,13,4,0.7647058823529411,0.6819672131147541,gemini,mimiciii,radiology_report,PROMPT2_entailment
157,24,10,8,2,0.8,18,13,5,0.7222222222222222,0.759124087591241,gemini,mimiciii,radiology_report,PROMPT2_entailment
158,240,12,10,2,0.8333333333333334,13,11,2,0.8461538461538461,0.8396946564885497,gemini,mimiciii,radiology_report,PROMPT2_entailment
159,241,13,11,2,0.8461538461538461,16,13,3,0.8125,0.8289855072463768,gemini,mimiciii,radiology_report,PROMPT2_entailment
160,242,16,13,3,0.8125,18,11,7,0.6111111111111112,0.697560975609756,gemini,mimiciii,radiology_report,PROMPT2_entailment
161,243,12,11,1,0.9166666666666666,13,10,3,0.7692307692307693,0.8365019011406845,gemini,mimiciii,radiology_report,PROMPT2_entailment
162,244,18,11,7,0.6111111111111112,17,16,1,0.9411764705882352,0.7410526315789474,gemini,mimiciii,radiology_report,PROMPT2_entailment
163,245,20,12,8,0.6,28,21,7,0.75,0.6666666666666665,gemini,mimiciii,radiology_report,PROMPT2_entailment
164,246,7,7,0,1.0,12,11,1,0.9166666666666666,0.9565217391304348,gemini,mimiciii,radiology_report,PROMPT2_entailment
165,247,12,8,4,0.6666666666666666,12,9,3,0.75,0.7058823529411765,gemini,mimiciii,radiology_report,PROMPT2_entailment
166,248,14,10,4,0.7142857142857143,17,12,5,0.7058823529411765,0.7100591715976332,gemini,mimiciii,radiology_report,PROMPT2_entailment
167,249,13,9,4,0.6923076923076923,23,11,12,0.4782608695652174,0.5657142857142856,gemini,mimiciii,radiology_report,PROMPT2_entailment
168,25,23,14,9,0.6086956521739131,27,20,7,0.7407407407407407,0.6682577565632458,gemini,mimiciii,radiology_report,PROMPT2_entailment
169,250,9,9,0,1.0,8,6,2,0.75,0.8571428571428571,gemini,mimiciii,radiology_report,PROMPT2_entailment
170,251,20,11,9,0.55,22,18,4,0.8181818181818182,0.6578073089700998,gemini,mimiciii,radiology_report,PROMPT2_entailment
171,252,8,6,2,0.75,10,7,3,0.7,0.7241379310344827,gemini,mimiciii,radiology_report,PROMPT2_entailment
172,253,22,9,13,0.4090909090909091,24,21,3,0.875,0.5575221238938053,gemini,mimiciii,radiology_report,PROMPT2_entailment
173,254,9,8,1,0.8888888888888888,13,7,6,0.5384615384615384,0.6706586826347306,gemini,mimiciii,radiology_report,PROMPT2_entailment
174,255,12,11,1,0.9166666666666666,16,12,4,0.75,0.8250000000000001,gemini,mimiciii,radiology_report,PROMPT2_entailment
175,256,16,12,4,0.75,19,12,7,0.631578947368421,0.6857142857142857,gemini,mimiciii,radiology_report,PROMPT2_entailment
176,257,13,11,2,0.8461538461538461,15,10,5,0.6666666666666666,0.7457627118644068,gemini,mimiciii,radiology_report,PROMPT2_entailment
177,258,13,11,2,0.8461538461538461,20,12,8,0.6,0.7021276595744681,gemini,mimiciii,radiology_report,PROMPT2_entailment
178,259,13,11,2,0.8461538461538461,17,12,5,0.7058823529411765,0.7696793002915452,gemini,mimiciii,radiology_report,PROMPT2_entailment
179,26,18,17,1,0.9444444444444444,18,13,5,0.7222222222222222,0.8185185185185185,gemini,mimiciii,radiology_report,PROMPT2_entailment
180,260,15,9,6,0.6,20,9,11,0.45,0.5142857142857143,gemini,mimiciii,radiology_report,PROMPT2_entailment
181,261,18,14,4,0.7777777777777778,30,23,7,0.7666666666666667,0.7721822541966427,gemini,mimiciii,radiology_report,PROMPT2_entailment
182,262,21,14,7,0.6666666666666666,23,21,2,0.9130434782608696,0.7706422018348623,gemini,mimiciii,radiology_report,PROMPT2_entailment
183,263,13,7,6,0.5384615384615384,27,17,10,0.6296296296296297,0.5804878048780487,gemini,mimiciii,radiology_report,PROMPT2_entailment
184,264,14,11,3,0.7857142857142857,20,15,5,0.75,0.7674418604651163,gemini,mimiciii,radiology_report,PROMPT2_entailment
185,265,9,9,0,1.0,9,7,2,0.7777777777777778,0.8750000000000001,gemini,mimiciii,radiology_report,PROMPT2_entailment
186,266,12,8,4,0.6666666666666666,18,12,6,0.6666666666666666,0.6666666666666666,gemini,mimiciii,radiology_report,PROMPT2_entailment
187,267,9,8,1,0.8888888888888888,16,12,4,0.75,0.8135593220338982,gemini,mimiciii,radiology_report,PROMPT2_entailment
188,268,17,13,4,0.7647058823529411,20,15,5,0.75,0.7572815533980582,gemini,mimiciii,radiology_report,PROMPT2_entailment
189,269,23,22,1,0.9565217391304348,25,23,2,0.92,0.93790546802595,gemini,mimiciii,radiology_report,PROMPT2_entailment
190,27,13,10,3,0.7692307692307693,14,10,4,0.7142857142857143,0.7407407407407408,gemini,mimiciii,radiology_report,PROMPT2_entailment
191,270,18,15,3,0.8333333333333334,17,15,2,0.8823529411764706,0.8571428571428571,gemini,mimiciii,radiology_report,PROMPT2_entailment
192,271,11,10,1,0.9090909090909092,17,11,6,0.6470588235294118,0.7560137457044673,gemini,mimiciii,radiology_report,PROMPT2_entailment
193,272,12,8,4,0.6666666666666666,17,10,7,0.5882352941176471,0.625,gemini,mimiciii,radiology_report,PROMPT2_entailment
194,273,10,8,2,0.8,12,8,4,0.6666666666666666,0.7272727272727272,gemini,mimiciii,radiology_report,PROMPT2_entailment
195,274,14,9,5,0.6428571428571429,20,10,10,0.5,0.5625000000000001,gemini,mimiciii,radiology_report,PROMPT2_entailment
196,275,10,10,0,1.0,12,8,4,0.6666666666666666,0.8,gemini,mimiciii,radiology_report,PROMPT2_entailment
197,276,17,14,3,0.8235294117647058,24,16,8,0.6666666666666666,0.7368421052631577,gemini,mimiciii,radiology_report,PROMPT2_entailment
198,277,18,15,3,0.8333333333333334,25,17,8,0.68,0.748898678414097,gemini,mimiciii,radiology_report,PROMPT2_entailment
199,278,11,10,1,0.9090909090909092,16,10,6,0.625,0.7407407407407406,gemini,mimiciii,radiology_report,PROMPT2_entailment
200,279,9,8,1,0.8888888888888888,10,7,3,0.7,0.7832167832167831,gemini,mimiciii,radiology_report,PROMPT2_entailment
201,28,18,13,5,0.7222222222222222,30,23,7,0.7666666666666667,0.7437810945273632,gemini,mimiciii,radiology_report,PROMPT2_entailment
202,280,11,9,2,0.8181818181818182,12,8,4,0.6666666666666666,0.7346938775510203,gemini,mimiciii,radiology_report,PROMPT2_entailment
203,281,16,13,3,0.8125,24,15,9,0.625,0.7065217391304348,gemini,mimiciii,radiology_report,PROMPT2_entailment
204,282,18,16,2,0.8888888888888888,12,9,3,0.75,0.8135593220338982,gemini,mimiciii,radiology_report,PROMPT2_entailment
205,283,19,17,2,0.8947368421052632,25,18,7,0.72,0.7979139504563234,gemini,mimiciii,radiology_report,PROMPT2_entailment
206,284,11,6,5,0.5454545454545454,14,10,4,0.7142857142857143,0.6185567010309277,gemini,mimiciii,radiology_report,PROMPT2_entailment
207,285,23,18,5,0.782608695652174,18,18,0,1.0,0.878048780487805,gemini,mimiciii,radiology_report,PROMPT2_entailment
208,286,5,5,0,1.0,6,5,1,0.8333333333333334,0.9090909090909092,gemini,mimiciii,radiology_report,PROMPT2_entailment
209,287,13,11,2,0.8461538461538461,18,13,5,0.7222222222222222,0.779291553133515,gemini,mimiciii,radiology_report,PROMPT2_entailment
210,288,22,16,6,0.7272727272727273,32,24,8,0.75,0.7384615384615384,gemini,mimiciii,radiology_report,PROMPT2_entailment
211,289,23,18,5,0.782608695652174,20,14,6,0.7,0.7390029325513195,gemini,mimiciii,radiology_report,PROMPT2_entailment
212,29,9,9,0,1.0,8,5,3,0.625,0.7692307692307693,gemini,mimiciii,radiology_report,PROMPT2_entailment
213,290,12,10,2,0.8333333333333334,11,9,2,0.8181818181818182,0.8256880733944955,gemini,mimiciii,radiology_report,PROMPT2_entailment
214,291,17,12,5,0.7058823529411765,23,12,11,0.5217391304347826,0.6,gemini,mimiciii,radiology_report,PROMPT2_entailment
215,292,19,13,6,0.6842105263157895,21,16,5,0.7619047619047619,0.7209705372616985,gemini,mimiciii,radiology_report,PROMPT2_entailment
216,293,8,4,4,0.5,18,13,5,0.7222222222222222,0.5909090909090908,gemini,mimiciii,radiology_report,PROMPT2_entailment
217,294,17,15,2,0.8823529411764706,22,14,8,0.6363636363636364,0.73943661971831,gemini,mimiciii,radiology_report,PROMPT2_entailment
218,295,6,2,4,0.3333333333333333,32,9,23,0.28125,0.3050847457627119,gemini,mimiciii,radiology_report,PROMPT2_entailment
219,296,18,8,10,0.4444444444444444,17,11,6,0.6470588235294118,0.5269461077844311,gemini,mimiciii,radiology_report,PROMPT2_entailment
220,297,15,9,6,0.6,24,21,3,0.875,0.711864406779661,gemini,mimiciii,radiology_report,PROMPT2_entailment
221,298,15,13,2,0.8666666666666667,20,9,11,0.45,0.5924050632911393,gemini,mimiciii,radiology_report,PROMPT2_entailment
222,299,23,19,4,0.8260869565217391,28,24,4,0.8571428571428571,0.8413284132841329,gemini,mimiciii,radiology_report,PROMPT2_entailment
223,3,11,6,5,0.5454545454545454,20,13,7,0.65,0.5931558935361217,gemini,mimiciii,radiology_report,PROMPT2_entailment
224,30,12,8,4,0.6666666666666666,21,15,6,0.7142857142857143,0.689655172413793,gemini,mimiciii,radiology_report,PROMPT2_entailment
225,300,12,12,0,1.0,13,7,6,0.5384615384615384,0.7000000000000001,gemini,mimiciii,radiology_report,PROMPT2_entailment
226,301,11,11,0,1.0,16,11,5,0.6875,0.8148148148148148,gemini,mimiciii,radiology_report,PROMPT2_entailment
227,302,11,9,2,0.8181818181818182,15,11,4,0.7333333333333333,0.7734375,gemini,mimiciii,radiology_report,PROMPT2_entailment
228,303,27,15,12,0.5555555555555556,24,14,10,0.5833333333333334,0.5691056910569107,gemini,mimiciii,radiology_report,PROMPT2_entailment
229,304,18,15,3,0.8333333333333334,19,18,1,0.9473684210526316,0.8866995073891626,gemini,mimiciii,radiology_report,PROMPT2_entailment
230,305,16,13,3,0.8125,24,12,12,0.5,0.6190476190476191,gemini,mimiciii,radiology_report,PROMPT2_entailment
231,306,13,8,5,0.6153846153846154,14,8,6,0.5714285714285714,0.5925925925925927,gemini,mimiciii,radiology_report,PROMPT2_entailment
232,307,15,12,3,0.8,17,13,4,0.7647058823529411,0.7819548872180452,gemini,mimiciii,radiology_report,PROMPT2_entailment
233,308,13,9,4,0.6923076923076923,15,6,9,0.4,0.5070422535211268,gemini,mimiciii,radiology_report,PROMPT2_entailment
234,309,16,13,3,0.8125,26,15,11,0.5769230769230769,0.6747404844290656,gemini,mimiciii,radiology_report,PROMPT2_entailment
235,31,12,4,8,0.3333333333333333,19,12,7,0.631578947368421,0.4363636363636364,gemini,mimiciii,radiology_report,PROMPT2_entailment
236,310,13,7,6,0.5384615384615384,24,18,6,0.75,0.6268656716417911,gemini,mimiciii,radiology_report,PROMPT2_entailment
237,311,15,11,4,0.7333333333333333,15,8,7,0.5333333333333333,0.6175438596491227,gemini,mimiciii,radiology_report,PROMPT2_entailment
238,312,15,12,3,0.8,18,13,5,0.7222222222222222,0.759124087591241,gemini,mimiciii,radiology_report,PROMPT2_entailment
239,313,13,11,2,0.8461538461538461,17,15,2,0.8823529411764706,0.8638743455497382,gemini,mimiciii,radiology_report,PROMPT2_entailment
240,314,16,11,5,0.6875,15,9,6,0.6,0.6407766990291262,gemini,mimiciii,radiology_report,PROMPT2_entailment
241,315,27,21,6,0.7777777777777778,25,13,12,0.52,0.6232876712328768,gemini,mimiciii,radiology_report,PROMPT2_entailment
242,316,9,5,4,0.5555555555555556,10,8,2,0.8,0.6557377049180328,gemini,mimiciii,radiology_report,PROMPT2_entailment
243,317,17,15,2,0.8823529411764706,26,23,3,0.8846153846153846,0.8834827144686299,gemini,mimiciii,radiology_report,PROMPT2_entailment
244,318,15,8,7,0.5333333333333333,21,16,5,0.7619047619047619,0.6274509803921569,gemini,mimiciii,radiology_report,PROMPT2_entailment
245,319,14,14,0,1.0,12,10,2,0.8333333333333334,0.9090909090909092,gemini,mimiciii,radiology_report,PROMPT2_entailment
246,32,13,11,2,0.8461538461538461,15,12,3,0.8,0.8224299065420562,gemini,mimiciii,radiology_report,PROMPT2_entailment
247,320,8,6,2,0.75,11,9,2,0.8181818181818182,0.7826086956521738,gemini,mimiciii,radiology_report,PROMPT2_entailment
248,321,20,16,4,0.8,21,19,2,0.9047619047619048,0.8491620111731844,gemini,mimiciii,radiology_report,PROMPT2_entailment
249,322,9,8,1,0.8888888888888888,8,6,2,0.75,0.8135593220338982,gemini,mimiciii,radiology_report,PROMPT2_entailment
250,323,14,13,1,0.9285714285714286,25,16,9,0.64,0.7577413479052824,gemini,mimiciii,radiology_report,PROMPT2_entailment
251,324,22,18,4,0.8181818181818182,18,13,5,0.7222222222222222,0.7672131147540984,gemini,mimiciii,radiology_report,PROMPT2_entailment
252,325,17,15,2,0.8823529411764706,22,15,7,0.6818181818181818,0.7692307692307693,gemini,mimiciii,radiology_report,PROMPT2_entailment
253,326,15,10,5,0.6666666666666666,23,18,5,0.782608695652174,0.72,gemini,mimiciii,radiology_report,PROMPT2_entailment
254,327,6,6,0,1.0,9,8,1,0.8888888888888888,0.9411764705882352,gemini,mimiciii,radiology_report,PROMPT2_entailment
255,328,19,12,7,0.631578947368421,17,14,3,0.8235294117647058,0.7148936170212765,gemini,mimiciii,radiology_report,PROMPT2_entailment
256,329,16,14,2,0.875,24,14,10,0.5833333333333334,0.7000000000000001,gemini,mimiciii,radiology_report,PROMPT2_entailment
257,33,6,6,0,1.0,9,6,3,0.6666666666666666,0.8,gemini,mimiciii,radiology_report,PROMPT2_entailment
258,330,10,9,1,0.9,11,8,3,0.7272727272727273,0.8044692737430167,gemini,mimiciii,radiology_report,PROMPT2_entailment
259,331,12,10,2,0.8333333333333334,15,13,2,0.8666666666666667,0.8496732026143791,gemini,mimiciii,radiology_report,PROMPT2_entailment
260,332,14,9,5,0.6428571428571429,20,14,6,0.7,0.6702127659574467,gemini,mimiciii,radiology_report,PROMPT2_entailment
261,333,11,10,1,0.9090909090909092,13,11,2,0.8461538461538461,0.8764940239043824,gemini,mimiciii,radiology_report,PROMPT2_entailment
262,334,16,13,3,0.8125,20,16,4,0.8,0.8062015503875969,gemini,mimiciii,radiology_report,PROMPT2_entailment
263,335,20,16,4,0.8,17,14,3,0.8235294117647058,0.8115942028985507,gemini,mimiciii,radiology_report,PROMPT2_entailment
264,336,15,10,5,0.6666666666666666,16,12,4,0.75,0.7058823529411765,gemini,mimiciii,radiology_report,PROMPT2_entailment
265,337,20,17,3,0.85,16,12,4,0.75,0.7968749999999999,gemini,mimiciii,radiology_report,PROMPT2_entailment
266,338,13,12,1,0.9230769230769232,13,8,5,0.6153846153846154,0.7384615384615384,gemini,mimiciii,radiology_report,PROMPT2_entailment
267,339,20,12,8,0.6,28,23,5,0.8214285714285714,0.6934673366834171,gemini,mimiciii,radiology_report,PROMPT2_entailment
268,34,13,11,2,0.8461538461538461,14,10,4,0.7142857142857143,0.7746478873239436,gemini,mimiciii,radiology_report,PROMPT2_entailment
269,340,18,11,7,0.6111111111111112,15,9,6,0.6,0.6055045871559633,gemini,mimiciii,radiology_report,PROMPT2_entailment
270,341,6,6,0,1.0,6,5,1,0.8333333333333334,0.9090909090909092,gemini,mimiciii,radiology_report,PROMPT2_entailment
271,342,7,6,1,0.8571428571428571,15,10,5,0.6666666666666666,0.75,gemini,mimiciii,radiology_report,PROMPT2_entailment
272,343,9,7,2,0.7777777777777778,22,12,10,0.5454545454545454,0.6412213740458015,gemini,mimiciii,radiology_report,PROMPT2_entailment
273,344,14,8,6,0.5714285714285714,19,12,7,0.631578947368421,0.6,gemini,mimiciii,radiology_report,PROMPT2_entailment
274,345,16,9,7,0.5625,22,17,5,0.7727272727272727,0.651063829787234,gemini,mimiciii,radiology_report,PROMPT2_entailment
275,346,10,9,1,0.9,15,10,5,0.6666666666666666,0.7659574468085106,gemini,mimiciii,radiology_report,PROMPT2_entailment
276,347,15,9,6,0.6,15,12,3,0.8,0.6857142857142857,gemini,mimiciii,radiology_report,PROMPT2_entailment
277,348,12,7,5,0.5833333333333334,12,9,3,0.75,0.6562499999999999,gemini,mimiciii,radiology_report,PROMPT2_entailment
278,349,12,11,1,0.9166666666666666,16,12,4,0.75,0.8250000000000001,gemini,mimiciii,radiology_report,PROMPT2_entailment
279,35,17,9,8,0.5294117647058824,21,14,7,0.6666666666666666,0.5901639344262295,gemini,mimiciii,radiology_report,PROMPT2_entailment
280,350,15,14,1,0.9333333333333332,21,15,6,0.7142857142857143,0.809248554913295,gemini,mimiciii,radiology_report,PROMPT2_entailment
281,351,19,9,10,0.4736842105263157,21,16,5,0.7619047619047619,0.5841784989858012,gemini,mimiciii,radiology_report,PROMPT2_entailment
282,352,15,9,6,0.6,22,12,10,0.5454545454545454,0.5714285714285713,gemini,mimiciii,radiology_report,PROMPT2_entailment
283,353,15,5,10,0.3333333333333333,23,16,7,0.6956521739130435,0.4507042253521127,gemini,mimiciii,radiology_report,PROMPT2_entailment
284,354,25,17,8,0.68,26,23,3,0.8846153846153846,0.7689282202556539,gemini,mimiciii,radiology_report,PROMPT2_entailment
285,355,15,11,4,0.7333333333333333,18,14,4,0.7777777777777778,0.7549019607843137,gemini,mimiciii,radiology_report,PROMPT2_entailment
286,356,10,8,2,0.8,22,16,6,0.7272727272727273,0.761904761904762,gemini,mimiciii,radiology_report,PROMPT2_entailment
287,357,10,8,2,0.8,15,9,6,0.6,0.6857142857142857,gemini,mimiciii,radiology_report,PROMPT2_entailment
288,358,15,12,3,0.8,12,7,5,0.5833333333333334,0.674698795180723,gemini,mimiciii,radiology_report,PROMPT2_entailment
289,359,8,8,0,1.0,18,15,3,0.8333333333333334,0.9090909090909092,gemini,mimiciii,radiology_report,PROMPT2_entailment
290,36,13,8,5,0.6153846153846154,22,13,9,0.5909090909090909,0.6028985507246378,gemini,mimiciii,radiology_report,PROMPT2_entailment
291,360,14,9,5,0.6428571428571429,15,10,5,0.6666666666666666,0.6545454545454545,gemini,mimiciii,radiology_report,PROMPT2_entailment
292,361,17,6,11,0.3529411764705882,23,15,8,0.6521739130434783,0.4580152671755725,gemini,mimiciii,radiology_report,PROMPT2_entailment
293,362,16,9,7,0.5625,24,17,7,0.7083333333333334,0.6270491803278688,gemini,mimiciii,radiology_report,PROMPT2_entailment
294,363,23,13,10,0.5652173913043478,22,18,4,0.8181818181818182,0.6685714285714286,gemini,mimiciii,radiology_report,PROMPT2_entailment
295,364,7,7,0,1.0,11,10,1,0.9090909090909092,0.9523809523809524,gemini,mimiciii,radiology_report,PROMPT2_entailment
296,365,20,14,6,0.7,29,17,12,0.5862068965517241,0.6380697050938338,gemini,mimiciii,radiology_report,PROMPT2_entailment
297,366,11,10,1,0.9090909090909092,13,8,5,0.6153846153846154,0.7339449541284404,gemini,mimiciii,radiology_report,PROMPT2_entailment
298,367,12,8,4,0.6666666666666666,16,11,5,0.6875,0.676923076923077,gemini,mimiciii,radiology_report,PROMPT2_entailment
299,368,18,11,7,0.6111111111111112,20,13,7,0.65,0.629955947136564,gemini,mimiciii,radiology_report,PROMPT2_entailment
300,369,20,16,4,0.8,20,17,3,0.85,0.8242424242424243,gemini,mimiciii,radiology_report,PROMPT2_entailment
301,37,9,7,2,0.7777777777777778,21,11,10,0.5238095238095238,0.6260162601626017,gemini,mimiciii,radiology_report,PROMPT2_entailment
302,370,18,11,7,0.6111111111111112,19,12,7,0.631578947368421,0.6211764705882353,gemini,mimiciii,radiology_report,PROMPT2_entailment
303,371,13,7,6,0.5384615384615384,17,13,4,0.7647058823529411,0.6319444444444444,gemini,mimiciii,radiology_report,PROMPT2_entailment
304,372,17,14,3,0.8235294117647058,27,16,11,0.5925925925925926,0.6892307692307692,gemini,mimiciii,radiology_report,PROMPT2_entailment
305,373,15,13,2,0.8666666666666667,23,16,7,0.6956521739130435,0.7717996289424861,gemini,mimiciii,radiology_report,PROMPT2_entailment
306,374,7,7,0,1.0,11,7,4,0.6363636363636364,0.7777777777777778,gemini,mimiciii,radiology_report,PROMPT2_entailment
307,375,10,10,0,1.0,16,12,4,0.75,0.8571428571428571,gemini,mimiciii,radiology_report,PROMPT2_entailment
308,376,20,14,6,0.7,18,15,3,0.8333333333333334,0.7608695652173915,gemini,mimiciii,radiology_report,PROMPT2_entailment
309,377,9,6,3,0.6666666666666666,10,8,2,0.8,0.7272727272727272,gemini,mimiciii,radiology_report,PROMPT2_entailment
310,378,22,18,4,0.8181818181818182,24,18,6,0.75,0.7826086956521738,gemini,mimiciii,radiology_report,PROMPT2_entailment
311,379,21,12,9,0.5714285714285714,18,14,4,0.7777777777777778,0.6588235294117646,gemini,mimiciii,radiology_report,PROMPT2_entailment
312,38,19,13,6,0.6842105263157895,19,14,5,0.7368421052631579,0.7095516569200779,gemini,mimiciii,radiology_report,PROMPT2_entailment
313,380,7,6,1,0.8571428571428571,8,7,1,0.875,0.8659793814432989,gemini,mimiciii,radiology_report,PROMPT2_entailment
314,381,10,6,4,0.6,14,10,4,0.7142857142857143,0.6521739130434783,gemini,mimiciii,radiology_report,PROMPT2_entailment
315,382,11,10,1,0.9090909090909092,13,8,5,0.6153846153846154,0.7339449541284404,gemini,mimiciii,radiology_report,PROMPT2_entailment
316,383,15,7,8,0.4666666666666667,17,14,3,0.8235294117647058,0.5957446808510638,gemini,mimiciii,radiology_report,PROMPT2_entailment
317,384,10,9,1,0.9,13,11,2,0.8461538461538461,0.8722466960352422,gemini,mimiciii,radiology_report,PROMPT2_entailment
318,385,16,12,4,0.75,27,14,13,0.5185185185185185,0.6131386861313868,gemini,mimiciii,radiology_report,PROMPT2_entailment
319,386,19,14,5,0.7368421052631579,18,10,8,0.5555555555555556,0.6334841628959277,gemini,mimiciii,radiology_report,PROMPT2_entailment
320,387,18,17,1,0.9444444444444444,19,13,6,0.6842105263157895,0.7935368043087971,gemini,mimiciii,radiology_report,PROMPT2_entailment
321,388,17,11,6,0.6470588235294118,33,20,13,0.6060606060606061,0.6258890469416786,gemini,mimiciii,radiology_report,PROMPT2_entailment
322,389,19,9,10,0.4736842105263157,12,8,4,0.6666666666666666,0.5538461538461538,gemini,mimiciii,radiology_report,PROMPT2_entailment
323,39,10,8,2,0.8,10,7,3,0.7,0.7466666666666666,gemini,mimiciii,radiology_report,PROMPT2_entailment
324,390,11,7,4,0.6363636363636364,14,9,5,0.6428571428571429,0.6395939086294417,gemini,mimiciii,radiology_report,PROMPT2_entailment
325,391,10,9,1,0.9,13,9,4,0.6923076923076923,0.7826086956521738,gemini,mimiciii,radiology_report,PROMPT2_entailment
326,392,10,9,1,0.9,15,13,2,0.8666666666666667,0.8830188679245283,gemini,mimiciii,radiology_report,PROMPT2_entailment
327,393,18,12,6,0.6666666666666666,19,12,7,0.631578947368421,0.6486486486486486,gemini,mimiciii,radiology_report,PROMPT2_entailment
328,394,14,13,1,0.9285714285714286,18,16,2,0.8888888888888888,0.9082969432314412,gemini,mimiciii,radiology_report,PROMPT2_entailment
329,395,12,11,1,0.9166666666666666,16,9,7,0.5625,0.6971830985915494,gemini,mimiciii,radiology_report,PROMPT2_entailment
330,396,18,12,6,0.6666666666666666,19,15,4,0.7894736842105263,0.7228915662650601,gemini,mimiciii,radiology_report,PROMPT2_entailment
331,397,16,12,4,0.75,18,12,6,0.6666666666666666,0.7058823529411765,gemini,mimiciii,radiology_report,PROMPT2_entailment
332,398,24,17,7,0.7083333333333334,21,14,7,0.6666666666666666,0.6868686868686869,gemini,mimiciii,radiology_report,PROMPT2_entailment
333,399,14,10,4,0.7142857142857143,19,11,8,0.5789473684210527,0.6395348837209303,gemini,mimiciii,radiology_report,PROMPT2_entailment
334,4,13,12,1,0.9230769230769232,16,12,4,0.75,0.8275862068965517,gemini,mimiciii,radiology_report,PROMPT2_entailment
335,40,18,17,1,0.9444444444444444,17,12,5,0.7058823529411765,0.8079207920792081,gemini,mimiciii,radiology_report,PROMPT2_entailment
336,400,11,9,2,0.8181818181818182,13,7,6,0.5384615384615384,0.6494845360824743,gemini,mimiciii,radiology_report,PROMPT2_entailment
337,401,7,6,1,0.8571428571428571,9,8,1,0.8888888888888888,0.8727272727272727,gemini,mimiciii,radiology_report,PROMPT2_entailment
338,402,17,10,7,0.5882352941176471,20,14,6,0.7,0.6392694063926941,gemini,mimiciii,radiology_report,PROMPT2_entailment
339,403,15,13,2,0.8666666666666667,18,12,6,0.6666666666666666,0.7536231884057971,gemini,mimiciii,radiology_report,PROMPT2_entailment
340,404,17,12,5,0.7058823529411765,19,14,5,0.7368421052631579,0.721030042918455,gemini,mimiciii,radiology_report,PROMPT2_entailment
341,405,14,11,3,0.7857142857142857,14,10,4,0.7142857142857143,0.7482993197278911,gemini,mimiciii,radiology_report,PROMPT2_entailment
342,406,15,13,2,0.8666666666666667,25,16,9,0.64,0.736283185840708,gemini,mimiciii,radiology_report,PROMPT2_entailment
343,407,16,12,4,0.75,20,11,9,0.55,0.6346153846153847,gemini,mimiciii,radiology_report,PROMPT2_entailment
344,408,22,18,4,0.8181818181818182,20,15,5,0.75,0.7826086956521738,gemini,mimiciii,radiology_report,PROMPT2_entailment
345,409,19,12,7,0.631578947368421,18,15,3,0.8333333333333334,0.718562874251497,gemini,mimiciii,radiology_report,PROMPT2_entailment
346,41,21,14,7,0.6666666666666666,26,15,11,0.5769230769230769,0.6185567010309277,gemini,mimiciii,radiology_report,PROMPT2_entailment
347,410,20,18,2,0.9,20,16,4,0.8,0.8470588235294118,gemini,mimiciii,radiology_report,PROMPT2_entailment
348,411,5,5,0,1.0,6,5,1,0.8333333333333334,0.9090909090909092,gemini,mimiciii,radiology_report,PROMPT2_entailment
349,412,19,13,6,0.6842105263157895,26,15,11,0.5769230769230769,0.6260032102728731,gemini,mimiciii,radiology_report,PROMPT2_entailment
350,413,10,10,0,1.0,14,13,1,0.9285714285714286,0.962962962962963,gemini,mimiciii,radiology_report,PROMPT2_entailment
351,414,14,12,2,0.8571428571428571,28,17,11,0.6071428571428571,0.7108013937282229,gemini,mimiciii,radiology_report,PROMPT2_entailment
352,415,14,10,4,0.7142857142857143,20,17,3,0.85,0.776255707762557,gemini,mimiciii,radiology_report,PROMPT2_entailment
353,416,17,17,0,1.0,17,12,5,0.7058823529411765,0.8275862068965517,gemini,mimiciii,radiology_report,PROMPT2_entailment
354,417,19,11,8,0.5789473684210527,20,16,4,0.8,0.6717557251908397,gemini,mimiciii,radiology_report,PROMPT2_entailment
355,418,12,11,1,0.9166666666666666,14,8,6,0.5714285714285714,0.7039999999999998,gemini,mimiciii,radiology_report,PROMPT2_entailment
356,419,13,8,5,0.6153846153846154,16,11,5,0.6875,0.6494464944649447,gemini,mimiciii,radiology_report,PROMPT2_entailment
357,42,11,9,2,0.8181818181818182,14,7,7,0.5,0.6206896551724137,gemini,mimiciii,radiology_report,PROMPT2_entailment
358,420,13,7,6,0.5384615384615384,15,11,4,0.7333333333333333,0.6209677419354838,gemini,mimiciii,radiology_report,PROMPT2_entailment
359,421,21,11,10,0.5238095238095238,23,17,6,0.7391304347826086,0.6131147540983606,gemini,mimiciii,radiology_report,PROMPT2_entailment
360,422,14,12,2,0.8571428571428571,20,13,7,0.65,0.7393364928909953,gemini,mimiciii,radiology_report,PROMPT2_entailment
361,423,9,9,0,1.0,12,10,2,0.8333333333333334,0.9090909090909092,gemini,mimiciii,radiology_report,PROMPT2_entailment
362,424,5,5,0,1.0,9,7,2,0.7777777777777778,0.8750000000000001,gemini,mimiciii,radiology_report,PROMPT2_entailment
363,425,15,9,6,0.6,19,12,7,0.631578947368421,0.6153846153846154,gemini,mimiciii,radiology_report,PROMPT2_entailment
364,426,18,11,7,0.6111111111111112,16,12,4,0.75,0.6734693877551021,gemini,mimiciii,radiology_report,PROMPT2_entailment
365,427,12,10,2,0.8333333333333334,15,12,3,0.8,0.816326530612245,gemini,mimiciii,radiology_report,PROMPT2_entailment
366,428,9,9,0,1.0,15,11,4,0.7333333333333333,0.846153846153846,gemini,mimiciii,radiology_report,PROMPT2_entailment
367,429,12,9,3,0.75,13,7,6,0.5384615384615384,0.6268656716417911,gemini,mimiciii,radiology_report,PROMPT2_entailment
368,43,8,8,0,1.0,7,4,3,0.5714285714285714,0.7272727272727273,gemini,mimiciii,radiology_report,PROMPT2_entailment
369,430,8,7,1,0.875,7,5,2,0.7142857142857143,0.7865168539325842,gemini,mimiciii,radiology_report,PROMPT2_entailment
370,431,12,3,9,0.25,18,13,5,0.7222222222222222,0.3714285714285714,gemini,mimiciii,radiology_report,PROMPT2_entailment
371,432,16,12,4,0.75,13,8,5,0.6153846153846154,0.676056338028169,gemini,mimiciii,radiology_report,PROMPT2_entailment
372,433,15,13,2,0.8666666666666667,18,14,4,0.7777777777777778,0.81981981981982,gemini,mimiciii,radiology_report,PROMPT2_entailment
373,434,21,13,8,0.6190476190476191,27,19,8,0.7037037037037037,0.6586666666666667,gemini,mimiciii,radiology_report,PROMPT2_entailment
374,435,12,11,1,0.9166666666666666,13,12,1,0.9230769230769232,0.9198606271777002,gemini,mimiciii,radiology_report,PROMPT2_entailment
375,436,15,11,4,0.7333333333333333,25,17,8,0.68,0.7056603773584905,gemini,mimiciii,radiology_report,PROMPT2_entailment
376,437,6,5,1,0.8333333333333334,7,6,1,0.8571428571428571,0.8450704225352113,gemini,mimiciii,radiology_report,PROMPT2_entailment
377,438,18,14,4,0.7777777777777778,19,13,6,0.6842105263157895,0.728,gemini,mimiciii,radiology_report,PROMPT2_entailment
378,439,16,11,5,0.6875,22,15,7,0.6818181818181818,0.6846473029045643,gemini,mimiciii,radiology_report,PROMPT2_entailment
379,44,10,10,0,1.0,16,11,5,0.6875,0.8148148148148148,gemini,mimiciii,radiology_report,PROMPT2_entailment
380,440,17,14,3,0.8235294117647058,19,13,6,0.6842105263157895,0.7474332648870635,gemini,mimiciii,radiology_report,PROMPT2_entailment
381,441,18,8,10,0.4444444444444444,17,15,2,0.8823529411764706,0.5911330049261083,gemini,mimiciii,radiology_report,PROMPT2_entailment
382,442,11,10,1,0.9090909090909092,12,7,5,0.5833333333333334,0.7106598984771573,gemini,mimiciii,radiology_report,PROMPT2_entailment
383,443,13,9,4,0.6923076923076923,21,18,3,0.8571428571428571,0.7659574468085107,gemini,mimiciii,radiology_report,PROMPT2_entailment
384,444,7,7,0,1.0,8,4,4,0.5,0.6666666666666666,gemini,mimiciii,radiology_report,PROMPT2_entailment
385,445,17,13,4,0.7647058823529411,22,18,4,0.8181818181818182,0.7905405405405405,gemini,mimiciii,radiology_report,PROMPT2_entailment
386,446,18,11,7,0.6111111111111112,22,18,4,0.8181818181818182,0.6996466431095407,gemini,mimiciii,radiology_report,PROMPT2_entailment
387,447,12,10,2,0.8333333333333334,14,12,2,0.8571428571428571,0.8450704225352113,gemini,mimiciii,radiology_report,PROMPT2_entailment
388,448,17,7,10,0.4117647058823529,36,23,13,0.6388888888888888,0.5007776049766719,gemini,mimiciii,radiology_report,PROMPT2_entailment
389,449,11,9,2,0.8181818181818182,9,4,5,0.4444444444444444,0.5760000000000001,gemini,mimiciii,radiology_report,PROMPT2_entailment
390,45,15,7,8,0.4666666666666667,20,14,6,0.7,0.56,gemini,mimiciii,radiology_report,PROMPT2_entailment
391,450,16,11,5,0.6875,21,16,5,0.7619047619047619,0.7227926078028747,gemini,mimiciii,radiology_report,PROMPT2_entailment
392,451,9,4,5,0.4444444444444444,10,7,3,0.7,0.5436893203883495,gemini,mimiciii,radiology_report,PROMPT2_entailment
393,452,16,14,2,0.875,16,13,3,0.8125,0.8425925925925926,gemini,mimiciii,radiology_report,PROMPT2_entailment
394,453,8,5,3,0.625,14,10,4,0.7142857142857143,0.6666666666666666,gemini,mimiciii,radiology_report,PROMPT2_entailment
395,454,9,7,2,0.7777777777777778,10,7,3,0.7,0.7368421052631577,gemini,mimiciii,radiology_report,PROMPT2_entailment
396,455,17,14,3,0.8235294117647058,16,11,5,0.6875,0.7493917274939172,gemini,mimiciii,radiology_report,PROMPT2_entailment
397,456,18,14,4,0.7777777777777778,21,18,3,0.8571428571428571,0.8155339805825242,gemini,mimiciii,radiology_report,PROMPT2_entailment
398,457,10,9,1,0.9,12,9,3,0.75,0.8181818181818182,gemini,mimiciii,radiology_report,PROMPT2_entailment
399,458,13,10,3,0.7692307692307693,16,14,2,0.875,0.8187134502923977,gemini,mimiciii,radiology_report,PROMPT2_entailment
400,459,8,7,1,0.875,13,9,4,0.6923076923076923,0.7730061349693251,gemini,mimiciii,radiology_report,PROMPT2_entailment
401,46,14,10,4,0.7142857142857143,22,14,8,0.6363636363636364,0.673076923076923,gemini,mimiciii,radiology_report,PROMPT2_entailment
402,460,14,6,8,0.4285714285714285,20,16,4,0.8,0.5581395348837209,gemini,mimiciii,radiology_report,PROMPT2_entailment
403,461,20,11,9,0.55,22,15,7,0.6818181818181818,0.6088560885608856,gemini,mimiciii,radiology_report,PROMPT2_entailment
404,462,21,15,6,0.7142857142857143,20,16,4,0.8,0.7547169811320756,gemini,mimiciii,radiology_report,PROMPT2_entailment
405,463,8,8,0,1.0,12,7,5,0.5833333333333334,0.7368421052631579,gemini,mimiciii,radiology_report,PROMPT2_entailment
406,464,18,8,10,0.4444444444444444,25,16,9,0.64,0.5245901639344263,gemini,mimiciii,radiology_report,PROMPT2_entailment
407,465,14,11,3,0.7857142857142857,33,19,14,0.5757575757575758,0.6645468998410174,gemini,mimiciii,radiology_report,PROMPT2_entailment
408,466,15,10,5,0.6666666666666666,22,15,7,0.6818181818181818,0.6741573033707865,gemini,mimiciii,radiology_report,PROMPT2_entailment
409,467,12,12,0,1.0,14,13,1,0.9285714285714286,0.962962962962963,gemini,mimiciii,radiology_report,PROMPT2_entailment
410,468,10,10,0,1.0,18,13,5,0.7222222222222222,0.8387096774193548,gemini,mimiciii,radiology_report,PROMPT2_entailment
411,469,23,14,9,0.6086956521739131,25,20,5,0.8,0.6913580246913581,gemini,mimiciii,radiology_report,PROMPT2_entailment
412,47,11,10,1,0.9090909090909092,15,10,5,0.6666666666666666,0.7692307692307692,gemini,mimiciii,radiology_report,PROMPT2_entailment
413,470,11,9,2,0.8181818181818182,15,14,1,0.9333333333333332,0.8719723183391004,gemini,mimiciii,radiology_report,PROMPT2_entailment
414,471,20,17,3,0.85,18,14,4,0.7777777777777778,0.8122866894197952,gemini,mimiciii,radiology_report,PROMPT2_entailment
415,472,13,11,2,0.8461538461538461,16,11,5,0.6875,0.7586206896551724,gemini,mimiciii,radiology_report,PROMPT2_entailment
416,473,7,6,1,0.8571428571428571,11,7,4,0.6363636363636364,0.7304347826086957,gemini,mimiciii,radiology_report,PROMPT2_entailment
417,474,19,18,1,0.9473684210526316,25,21,4,0.84,0.8904593639575972,gemini,mimiciii,radiology_report,PROMPT2_entailment
418,475,5,4,1,0.8,7,4,3,0.5714285714285714,0.6666666666666666,gemini,mimiciii,radiology_report,PROMPT2_entailment
419,476,14,13,1,0.9285714285714286,12,9,3,0.75,0.8297872340425532,gemini,mimiciii,radiology_report,PROMPT2_entailment
420,477,15,8,7,0.5333333333333333,16,12,4,0.75,0.6233766233766235,gemini,mimiciii,radiology_report,PROMPT2_entailment
421,478,16,10,6,0.625,21,14,7,0.6666666666666666,0.6451612903225806,gemini,mimiciii,radiology_report,PROMPT2_entailment
422,479,14,11,3,0.7857142857142857,22,16,6,0.7272727272727273,0.7553648068669527,gemini,mimiciii,radiology_report,PROMPT2_entailment
423,48,13,11,2,0.8461538461538461,21,18,3,0.8571428571428571,0.8516129032258064,gemini,mimiciii,radiology_report,PROMPT2_entailment
424,480,15,13,2,0.8666666666666667,10,7,3,0.7,0.774468085106383,gemini,mimiciii,radiology_report,PROMPT2_entailment
425,481,13,7,6,0.5384615384615384,17,11,6,0.6470588235294118,0.5877862595419847,gemini,mimiciii,radiology_report,PROMPT2_entailment
426,482,22,15,7,0.6818181818181818,19,14,5,0.7368421052631579,0.7082630691399663,gemini,mimiciii,radiology_report,PROMPT2_entailment
427,483,17,14,3,0.8235294117647058,23,14,9,0.6086956521739131,0.7,gemini,mimiciii,radiology_report,PROMPT2_entailment
428,484,9,7,2,0.7777777777777778,13,10,3,0.7692307692307693,0.7734806629834255,gemini,mimiciii,radiology_report,PROMPT2_entailment
429,485,16,14,2,0.875,24,17,7,0.7083333333333334,0.7828947368421053,gemini,mimiciii,radiology_report,PROMPT2_entailment
430,486,11,9,2,0.8181818181818182,11,9,2,0.8181818181818182,0.8181818181818182,gemini,mimiciii,radiology_report,PROMPT2_entailment
431,487,22,12,10,0.5454545454545454,20,15,5,0.75,0.631578947368421,gemini,mimiciii,radiology_report,PROMPT2_entailment
432,488,18,12,6,0.6666666666666666,15,9,6,0.6,0.631578947368421,gemini,mimiciii,radiology_report,PROMPT2_entailment
433,489,18,13,5,0.7222222222222222,18,12,6,0.6666666666666666,0.6933333333333334,gemini,mimiciii,radiology_report,PROMPT2_entailment
434,49,13,11,2,0.8461538461538461,24,17,7,0.7083333333333334,0.7711340206185566,gemini,mimiciii,radiology_report,PROMPT2_entailment
435,490,5,4,1,0.8,8,3,5,0.375,0.5106382978723405,gemini,mimiciii,radiology_report,PROMPT2_entailment
436,491,12,10,2,0.8333333333333334,17,9,8,0.5294117647058824,0.6474820143884893,gemini,mimiciii,radiology_report,PROMPT2_entailment
437,492,14,13,1,0.9285714285714286,13,7,6,0.5384615384615384,0.6816479400749064,gemini,mimiciii,radiology_report,PROMPT2_entailment
438,493,9,6,3,0.6666666666666666,9,5,4,0.5555555555555556,0.606060606060606,gemini,mimiciii,radiology_report,PROMPT2_entailment
439,494,7,7,0,1.0,8,6,2,0.75,0.8571428571428571,gemini,mimiciii,radiology_report,PROMPT2_entailment
440,495,9,9,0,1.0,12,11,1,0.9166666666666666,0.9565217391304348,gemini,mimiciii,radiology_report,PROMPT2_entailment
441,496,22,22,0,1.0,32,22,10,0.6875,0.8148148148148148,gemini,mimiciii,radiology_report,PROMPT2_entailment
442,497,13,9,4,0.6923076923076923,22,14,8,0.6363636363636364,0.663157894736842,gemini,mimiciii,radiology_report,PROMPT2_entailment
443,498,13,8,5,0.6153846153846154,22,14,8,0.6363636363636364,0.6256983240223464,gemini,mimiciii,radiology_report,PROMPT2_entailment
444,499,17,14,3,0.8235294117647058,17,12,5,0.7058823529411765,0.7601809954751132,gemini,mimiciii,radiology_report,PROMPT2_entailment
445,5,19,14,5,0.7368421052631579,22,16,6,0.7272727272727273,0.7320261437908497,gemini,mimiciii,radiology_report,PROMPT2_entailment
446,50,8,7,1,0.875,15,10,5,0.6666666666666666,0.7567567567567567,gemini,mimiciii,radiology_report,PROMPT2_entailment
447,51,13,12,1,0.9230769230769232,13,12,1,0.9230769230769232,0.9230769230769232,gemini,mimiciii,radiology_report,PROMPT2_entailment
448,52,15,11,4,0.7333333333333333,21,15,6,0.7142857142857143,0.7236842105263158,gemini,mimiciii,radiology_report,PROMPT2_entailment
449,53,10,7,3,0.7,12,7,5,0.5833333333333334,0.6363636363636365,gemini,mimiciii,radiology_report,PROMPT2_entailment
450,54,8,7,1,0.875,10,6,4,0.6,0.711864406779661,gemini,mimiciii,radiology_report,PROMPT2_entailment
451,55,15,10,5,0.6666666666666666,18,12,6,0.6666666666666666,0.6666666666666666,gemini,mimiciii,radiology_report,PROMPT2_entailment
452,56,17,9,8,0.5294117647058824,21,14,7,0.6666666666666666,0.5901639344262295,gemini,mimiciii,radiology_report,PROMPT2_entailment
453,57,10,9,1,0.9,10,5,5,0.5,0.6428571428571429,gemini,mimiciii,radiology_report,PROMPT2_entailment
454,58,16,15,1,0.9375,16,13,3,0.8125,0.8705357142857143,gemini,mimiciii,radiology_report,PROMPT2_entailment
455,59,12,12,0,1.0,16,12,4,0.75,0.8571428571428571,gemini,mimiciii,radiology_report,PROMPT2_entailment
456,6,7,7,0,1.0,8,5,3,0.625,0.7692307692307693,gemini,mimiciii,radiology_report,PROMPT2_entailment
457,60,13,10,3,0.7692307692307693,19,12,7,0.631578947368421,0.6936416184971097,gemini,mimiciii,radiology_report,PROMPT2_entailment
458,61,15,10,5,0.6666666666666666,22,18,4,0.8181818181818182,0.7346938775510203,gemini,mimiciii,radiology_report,PROMPT2_entailment
459,62,13,6,7,0.4615384615384615,13,5,8,0.3846153846153846,0.4195804195804196,gemini,mimiciii,radiology_report,PROMPT2_entailment
460,63,9,7,2,0.7777777777777778,15,9,6,0.6,0.6774193548387097,gemini,mimiciii,radiology_report,PROMPT2_entailment
461,64,15,12,3,0.8,20,13,7,0.65,0.7172413793103448,gemini,mimiciii,radiology_report,PROMPT2_entailment
462,65,22,15,7,0.6818181818181818,18,14,4,0.7777777777777778,0.726643598615917,gemini,mimiciii,radiology_report,PROMPT2_entailment
463,66,19,15,4,0.7894736842105263,29,20,9,0.6896551724137931,0.736196319018405,gemini,mimiciii,radiology_report,PROMPT2_entailment
464,67,23,17,6,0.7391304347826086,28,25,3,0.8928571428571429,0.8087535680304472,gemini,mimiciii,radiology_report,PROMPT2_entailment
465,68,12,8,4,0.6666666666666666,30,19,11,0.6333333333333333,0.6495726495726496,gemini,mimiciii,radiology_report,PROMPT2_entailment
466,69,14,9,5,0.6428571428571429,31,15,16,0.4838709677419355,0.5521472392638038,gemini,mimiciii,radiology_report,PROMPT2_entailment
467,7,13,11,2,0.8461538461538461,16,9,7,0.5625,0.6757679180887372,gemini,mimiciii,radiology_report,PROMPT2_entailment
468,70,10,8,2,0.8,17,14,3,0.8235294117647058,0.8115942028985507,gemini,mimiciii,radiology_report,PROMPT2_entailment
469,71,12,6,6,0.5,18,8,10,0.4444444444444444,0.4705882352941176,gemini,mimiciii,radiology_report,PROMPT2_entailment
470,72,16,12,4,0.75,13,9,4,0.6923076923076923,0.7199999999999999,gemini,mimiciii,radiology_report,PROMPT2_entailment
471,73,18,10,8,0.5555555555555556,29,19,10,0.6551724137931034,0.6012658227848101,gemini,mimiciii,radiology_report,PROMPT2_entailment
472,74,15,13,2,0.8666666666666667,18,15,3,0.8333333333333334,0.8496732026143791,gemini,mimiciii,radiology_report,PROMPT2_entailment
473,75,11,9,2,0.8181818181818182,12,11,1,0.9166666666666666,0.8646288209606987,gemini,mimiciii,radiology_report,PROMPT2_entailment
474,76,10,7,3,0.7,14,12,2,0.8571428571428571,0.7706422018348624,gemini,mimiciii,radiology_report,PROMPT2_entailment
475,77,21,17,4,0.8095238095238095,26,20,6,0.7692307692307693,0.7888631090487238,gemini,mimiciii,radiology_report,PROMPT2_entailment
476,78,19,8,11,0.4210526315789473,33,22,11,0.6666666666666666,0.5161290322580646,gemini,mimiciii,radiology_report,PROMPT2_entailment
477,79,10,7,3,0.7,17,12,5,0.7058823529411765,0.7029288702928871,gemini,mimiciii,radiology_report,PROMPT2_entailment
478,8,17,16,1,0.9411764705882352,15,11,4,0.7333333333333333,0.8243559718969555,gemini,mimiciii,radiology_report,PROMPT2_entailment
479,80,12,9,3,0.75,25,20,5,0.8,0.7741935483870969,gemini,mimiciii,radiology_report,PROMPT2_entailment
480,81,13,11,2,0.8461538461538461,15,8,7,0.5333333333333333,0.654275092936803,gemini,mimiciii,radiology_report,PROMPT2_entailment
481,82,16,10,6,0.625,14,10,4,0.7142857142857143,0.6666666666666666,gemini,mimiciii,radiology_report,PROMPT2_entailment
482,83,23,17,6,0.7391304347826086,17,12,5,0.7058823529411765,0.7221238938053097,gemini,mimiciii,radiology_report,PROMPT2_entailment
483,84,17,11,6,0.6470588235294118,20,15,5,0.75,0.6947368421052633,gemini,mimiciii,radiology_report,PROMPT2_entailment
484,85,12,10,2,0.8333333333333334,14,7,7,0.5,0.625,gemini,mimiciii,radiology_report,PROMPT2_entailment
485,86,14,11,3,0.7857142857142857,10,8,2,0.8,0.7927927927927927,gemini,mimiciii,radiology_report,PROMPT2_entailment
486,87,11,9,2,0.8181818181818182,14,7,7,0.5,0.6206896551724137,gemini,mimiciii,radiology_report,PROMPT2_entailment
487,88,15,13,2,0.8666666666666667,19,16,3,0.8421052631578947,0.8542094455852155,gemini,mimiciii,radiology_report,PROMPT2_entailment
488,89,22,19,3,0.8636363636363636,18,15,3,0.8333333333333334,0.8482142857142857,gemini,mimiciii,radiology_report,PROMPT2_entailment
489,9,10,10,0,1.0,13,11,2,0.8461538461538461,0.9166666666666666,gemini,mimiciii,radiology_report,PROMPT2_entailment
490,90,12,12,0,1.0,14,11,3,0.7857142857142857,0.88,gemini,mimiciii,radiology_report,PROMPT2_entailment
491,91,15,13,2,0.8666666666666667,13,9,4,0.6923076923076923,0.7697368421052632,gemini,mimiciii,radiology_report,PROMPT2_entailment
492,92,14,11,3,0.7857142857142857,21,13,8,0.6190476190476191,0.6924939467312349,gemini,mimiciii,radiology_report,PROMPT2_entailment
493,93,13,10,3,0.7692307692307693,15,8,7,0.5333333333333333,0.6299212598425197,gemini,mimiciii,radiology_report,PROMPT2_entailment
494,94,17,9,8,0.5294117647058824,28,22,6,0.7857142857142857,0.6325878594249201,gemini,mimiciii,radiology_report,PROMPT2_entailment
495,95,17,14,3,0.8235294117647058,18,10,8,0.5555555555555556,0.6635071090047393,gemini,mimiciii,radiology_report,PROMPT2_entailment
496,96,11,8,3,0.7272727272727273,21,15,6,0.7142857142857143,0.7207207207207208,gemini,mimiciii,radiology_report,PROMPT2_entailment
497,97,14,10,4,0.7142857142857143,23,13,10,0.5652173913043478,0.6310679611650485,gemini,mimiciii,radiology_report,PROMPT2_entailment
498,98,18,12,6,0.6666666666666666,19,11,8,0.5789473684210527,0.619718309859155,gemini,mimiciii,radiology_report,PROMPT2_entailment
499,99,9,8,1,0.8888888888888888,13,9,4,0.6923076923076923,0.7783783783783783,gemini,mimiciii,radiology_report,PROMPT2_entailment
0,0,30,22,8,0.7333333333333333,118,101,17,0.8559322033898306,0.7899040170636331,gemini,mimiciii,progress_note,PROMPT1_entailment
1,1,74,52,22,0.7027027027027027,320,138,182,0.43125,0.5344853269775064,gemini,mimiciii,progress_note,PROMPT1_entailment
2,10,65,34,31,0.5230769230769231,230,67,163,0.2913043478260869,0.3742094455852155,gemini,mimiciii,progress_note,PROMPT1_entailment
3,100,12,11,1,0.9166666666666666,115,56,59,0.4869565217391304,0.6360351058337635,gemini,mimiciii,progress_note,PROMPT1_entailment
4,101,26,20,6,0.7692307692307693,49,24,25,0.4897959183673469,0.5985037406483791,gemini,mimiciii,progress_note,PROMPT1_entailment
5,102,42,21,21,0.5,67,53,14,0.7910447761194029,0.6127167630057804,gemini,mimiciii,progress_note,PROMPT1_entailment
6,103,64,43,21,0.671875,347,103,244,0.2968299711815562,0.4117510342583554,gemini,mimiciii,progress_note,PROMPT1_entailment
7,104,22,14,8,0.6363636363636364,57,53,4,0.9298245614035088,0.755600814663951,gemini,mimiciii,progress_note,PROMPT1_entailment
8,105,12,11,1,0.9166666666666666,28,14,14,0.5,0.6470588235294118,gemini,mimiciii,progress_note,PROMPT1_entailment
9,106,27,24,3,0.8888888888888888,58,33,25,0.5689655172413793,0.6938239159001315,gemini,mimiciii,progress_note,PROMPT1_entailment
10,107,22,20,2,0.9090909090909092,53,29,24,0.5471698113207547,0.6831566548881036,gemini,mimiciii,progress_note,PROMPT1_entailment
11,108,23,15,8,0.6521739130434783,94,74,20,0.7872340425531915,0.7133676092544987,gemini,mimiciii,progress_note,PROMPT1_entailment
12,109,13,11,2,0.8461538461538461,311,56,255,0.180064308681672,0.296939021450952,gemini,mimiciii,progress_note,PROMPT1_entailment
13,11,39,26,13,0.6666666666666666,233,69,164,0.296137339055794,0.4101040118870728,gemini,mimiciii,progress_note,PROMPT1_entailment
14,110,79,52,27,0.6582278481012658,358,248,110,0.6927374301675978,0.6750418760469012,gemini,mimiciii,progress_note,PROMPT1_entailment
15,111,14,10,4,0.7142857142857143,389,265,124,0.6812339331619537,0.6973684210526315,gemini,mimiciii,progress_note,PROMPT1_entailment
16,112,77,56,21,0.7272727272727273,400,226,174,0.565,0.6359479423144565,gemini,mimiciii,progress_note,PROMPT1_entailment
17,113,52,42,10,0.8076923076923077,340,237,103,0.6970588235294117,0.7483085250338295,gemini,mimiciii,progress_note,PROMPT1_entailment
18,114,107,56,51,0.5233644859813084,401,111,290,0.2768079800498753,0.3621006029184749,gemini,mimiciii,progress_note,PROMPT1_entailment
19,115,34,21,13,0.6176470588235294,479,113,366,0.2359081419624217,0.341414286741961,gemini,mimiciii,progress_note,PROMPT1_entailment
20,116,10,8,2,0.8,53,27,26,0.5094339622641509,0.622478386167147,gemini,mimiciii,progress_note,PROMPT1_entailment
21,117,26,21,5,0.8076923076923077,33,17,16,0.5151515151515151,0.6290748898678414,gemini,mimiciii,progress_note,PROMPT1_entailment
22,118,10,10,0,1.0,41,17,24,0.4146341463414634,0.5862068965517241,gemini,mimiciii,progress_note,PROMPT1_entailment
23,119,11,10,1,0.9090909090909092,21,19,2,0.9047619047619048,0.9069212410501194,gemini,mimiciii,progress_note,PROMPT1_entailment
24,12,50,33,17,0.66,388,271,117,0.6984536082474226,0.6786825529331412,gemini,mimiciii,progress_note,PROMPT1_entailment
25,120,32,27,5,0.84375,95,37,58,0.3894736842105263,0.5329421178981062,gemini,mimiciii,progress_note,PROMPT1_entailment
26,121,8,6,2,0.75,23,19,4,0.8260869565217391,0.786206896551724,gemini,mimiciii,progress_note,PROMPT1_entailment
27,122,40,22,18,0.55,71,55,16,0.7746478873239436,0.6432748538011696,gemini,mimiciii,progress_note,PROMPT1_entailment
28,123,27,25,2,0.925925925925926,72,49,23,0.6805555555555556,0.7845020813320527,gemini,mimiciii,progress_note,PROMPT1_entailment
29,124,6,6,0,1.0,96,42,54,0.4375,0.6086956521739131,gemini,mimiciii,progress_note,PROMPT1_entailment
30,125,18,13,5,0.7222222222222222,72,42,30,0.5833333333333334,0.6453900709219859,gemini,mimiciii,progress_note,PROMPT1_entailment
31,126,16,15,1,0.9375,41,18,23,0.4390243902439024,0.5980066445182725,gemini,mimiciii,progress_note,PROMPT1_entailment
32,127,16,13,3,0.8125,41,20,21,0.4878048780487805,0.6096131301289567,gemini,mimiciii,progress_note,PROMPT1_entailment
33,128,11,11,0,1.0,56,45,11,0.8035714285714286,0.8910891089108911,gemini,mimiciii,progress_note,PROMPT1_entailment
34,129,48,27,21,0.5625,100,49,51,0.49,0.5237529691211401,gemini,mimiciii,progress_note,PROMPT1_entailment
35,13,38,24,14,0.631578947368421,106,54,52,0.5094339622641509,0.5639686684073107,gemini,mimiciii,progress_note,PROMPT1_entailment
36,130,18,9,9,0.5,64,30,34,0.46875,0.4838709677419355,gemini,mimiciii,progress_note,PROMPT1_entailment
37,131,72,55,17,0.7638888888888888,343,222,121,0.6472303206997084,0.7007374673591781,gemini,mimiciii,progress_note,PROMPT1_entailment
38,132,76,52,24,0.6842105263157895,333,253,80,0.7597597597597597,0.7200087565674256,gemini,mimiciii,progress_note,PROMPT1_entailment
39,133,82,48,34,0.5853658536585366,271,196,75,0.7232472324723247,0.6470426409903713,gemini,mimiciii,progress_note,PROMPT1_entailment
40,134,11,7,4,0.6363636363636364,24,16,8,0.6666666666666666,0.6511627906976744,gemini,mimiciii,progress_note,PROMPT1_entailment
41,135,28,22,6,0.7857142857142857,50,36,14,0.72,0.7514231499051233,gemini,mimiciii,progress_note,PROMPT1_entailment
42,136,13,11,2,0.8461538461538461,58,30,28,0.5172413793103449,0.642023346303502,gemini,mimiciii,progress_note,PROMPT1_entailment
43,137,7,6,1,0.8571428571428571,36,23,13,0.6388888888888888,0.7320954907161803,gemini,mimiciii,progress_note,PROMPT1_entailment
44,138,16,16,0,1.0,66,31,35,0.4696969696969697,0.6391752577319588,gemini,mimiciii,progress_note,PROMPT1_entailment
45,139,27,24,3,0.8888888888888888,70,25,45,0.3571428571428571,0.5095541401273885,gemini,mimiciii,progress_note,PROMPT1_entailment
46,14,48,13,35,0.2708333333333333,63,31,32,0.492063492063492,0.3493714781100996,gemini,mimiciii,progress_note,PROMPT1_entailment
47,140,28,19,9,0.6785714285714286,39,19,20,0.4871794871794871,0.5671641791044776,gemini,mimiciii,progress_note,PROMPT1_entailment
48,141,35,30,5,0.8571428571428571,70,28,42,0.4,0.5454545454545455,gemini,mimiciii,progress_note,PROMPT1_entailment
49,142,18,18,0,1.0,72,41,31,0.5694444444444444,0.7256637168141593,gemini,mimiciii,progress_note,PROMPT1_entailment
50,143,1,0,1,0.0,16,8,8,0.5,0.0,gemini,mimiciii,progress_note,PROMPT1_entailment
51,144,35,30,5,0.8571428571428571,72,36,36,0.5,0.631578947368421,gemini,mimiciii,progress_note,PROMPT1_entailment
52,145,24,14,10,0.5833333333333334,63,24,39,0.3809523809523809,0.4609053497942387,gemini,mimiciii,progress_note,PROMPT1_entailment
53,146,10,9,1,0.9,50,19,31,0.38,0.534375,gemini,mimiciii,progress_note,PROMPT1_entailment
54,147,12,10,2,0.8333333333333334,80,53,27,0.6625,0.7381615598885795,gemini,mimiciii,progress_note,PROMPT1_entailment
55,148,7,5,2,0.7142857142857143,6,5,1,0.8333333333333334,0.7692307692307692,gemini,mimiciii,progress_note,PROMPT1_entailment
56,149,22,16,6,0.7272727272727273,46,23,23,0.5,0.5925925925925926,gemini,mimiciii,progress_note,PROMPT1_entailment
57,15,89,52,37,0.5842696629213483,275,96,179,0.3490909090909091,0.4370513045000876,gemini,mimiciii,progress_note,PROMPT1_entailment
58,150,27,22,5,0.8148148148148148,121,64,57,0.5289256198347108,0.6414578587699316,gemini,mimiciii,progress_note,PROMPT1_entailment
59,151,112,89,23,0.7946428571428571,340,170,170,0.5,0.6137931034482758,gemini,mimiciii,progress_note,PROMPT1_entailment
60,152,41,30,11,0.7317073170731707,65,42,23,0.6461538461538462,0.6862745098039216,gemini,mimiciii,progress_note,PROMPT1_entailment
61,153,85,65,20,0.7647058823529411,368,72,296,0.1956521739130435,0.3115845539280958,gemini,mimiciii,progress_note,PROMPT1_entailment
62,154,14,13,1,0.9285714285714286,23,13,10,0.5652173913043478,0.7027027027027025,gemini,mimiciii,progress_note,PROMPT1_entailment
63,155,21,18,3,0.8571428571428571,49,46,3,0.9387755102040816,0.8961038961038961,gemini,mimiciii,progress_note,PROMPT1_entailment
64,156,20,17,3,0.85,49,43,6,0.8775510204081632,0.863555818074424,gemini,mimiciii,progress_note,PROMPT1_entailment
65,157,22,18,4,0.8181818181818182,41,24,17,0.5853658536585366,0.6824644549763034,gemini,mimiciii,progress_note,PROMPT1_entailment
66,158,83,63,20,0.7590361445783133,411,105,306,0.2554744525547445,0.3822815533980583,gemini,mimiciii,progress_note,PROMPT1_entailment
67,159,16,13,3,0.8125,35,17,18,0.4857142857142857,0.607977991746905,gemini,mimiciii,progress_note,PROMPT1_entailment
68,16,13,13,0,1.0,41,19,22,0.4634146341463415,0.6333333333333334,gemini,mimiciii,progress_note,PROMPT1_entailment
69,160,27,23,4,0.8518518518518519,96,34,62,0.3541666666666667,0.5003198976327575,gemini,mimiciii,progress_note,PROMPT1_entailment
70,161,24,21,3,0.875,343,266,77,0.7755102040816326,0.82225656877898,gemini,mimiciii,progress_note,PROMPT1_entailment
71,162,68,45,23,0.6617647058823529,300,76,224,0.2533333333333333,0.3664023998285837,gemini,mimiciii,progress_note,PROMPT1_entailment
72,163,20,17,3,0.85,39,18,21,0.4615384615384615,0.5982404692082112,gemini,mimiciii,progress_note,PROMPT1_entailment
73,164,4,3,1,0.75,82,34,48,0.4146341463414634,0.5340314136125655,gemini,mimiciii,progress_note,PROMPT1_entailment
74,165,16,10,6,0.625,32,23,9,0.71875,0.6686046511627907,gemini,mimiciii,progress_note,PROMPT1_entailment
75,166,33,27,6,0.8181818181818182,59,30,29,0.5084745762711864,0.627177700348432,gemini,mimiciii,progress_note,PROMPT1_entailment
76,167,27,24,3,0.8888888888888888,85,28,57,0.3294117647058823,0.4806866952789699,gemini,mimiciii,progress_note,PROMPT1_entailment
77,168,89,59,30,0.6629213483146067,312,225,87,0.7211538461538461,0.6908125829365389,gemini,mimiciii,progress_note,PROMPT1_entailment
78,169,63,52,11,0.8253968253968254,377,138,239,0.3660477453580902,0.5071736518481872,gemini,mimiciii,progress_note,PROMPT1_entailment
79,17,8,6,2,0.75,20,18,2,0.9,0.8181818181818182,gemini,mimiciii,progress_note,PROMPT1_entailment
80,170,127,100,27,0.7874015748031497,318,83,235,0.2610062893081761,0.3920549821685837,gemini,mimiciii,progress_note,PROMPT1_entailment
81,171,23,20,3,0.8695652173913043,387,270,117,0.6976744186046512,0.7741935483870968,gemini,mimiciii,progress_note,PROMPT1_entailment
82,172,81,65,16,0.8024691358024691,342,99,243,0.2894736842105263,0.4254686105325796,gemini,mimiciii,progress_note,PROMPT1_entailment
83,173,84,52,32,0.6190476190476191,299,148,151,0.4949832775919732,0.5501072194424589,gemini,mimiciii,progress_note,PROMPT1_entailment
84,174,63,48,15,0.7619047619047619,351,78,273,0.2222222222222222,0.3440860215053763,gemini,mimiciii,progress_note,PROMPT1_entailment
85,175,19,16,3,0.8421052631578947,354,212,142,0.5988700564971752,0.6999587288485348,gemini,mimiciii,progress_note,PROMPT1_entailment
86,176,29,21,8,0.7241379310344828,330,209,121,0.6333333333333333,0.6756985605419137,gemini,mimiciii,progress_note,PROMPT1_entailment
87,177,82,51,31,0.6219512195121951,330,247,83,0.7484848484848485,0.679376550533923,gemini,mimiciii,progress_note,PROMPT1_entailment
88,178,13,11,2,0.8461538461538461,23,11,12,0.4782608695652174,0.6111111111111112,gemini,mimiciii,progress_note,PROMPT1_entailment
89,179,57,35,22,0.6140350877192983,341,81,260,0.2375366568914956,0.3425567907201546,gemini,mimiciii,progress_note,PROMPT1_entailment
90,18,8,8,0,1.0,29,16,13,0.5517241379310345,0.7111111111111111,gemini,mimiciii,progress_note,PROMPT1_entailment
91,180,22,15,7,0.6818181818181818,343,183,160,0.5335276967930029,0.5986261040235524,gemini,mimiciii,progress_note,PROMPT1_entailment
92,181,73,59,14,0.8082191780821918,366,279,87,0.7622950819672131,0.784585686709087,gemini,mimiciii,progress_note,PROMPT1_entailment
93,182,20,17,3,0.85,367,112,255,0.3051771117166212,0.4491095648071707,gemini,mimiciii,progress_note,PROMPT1_entailment
94,183,43,35,8,0.813953488372093,389,99,290,0.2544987146529563,0.3877573858549686,gemini,mimiciii,progress_note,PROMPT1_entailment
95,184,19,17,2,0.8947368421052632,330,115,215,0.3484848484848485,0.5016035920461835,gemini,mimiciii,progress_note,PROMPT1_entailment
96,185,17,11,6,0.6470588235294118,69,35,34,0.5072463768115942,0.5686853766617431,gemini,mimiciii,progress_note,PROMPT1_entailment
97,186,108,83,25,0.7685185185185185,352,265,87,0.7528409090909091,0.7605989349194272,gemini,mimiciii,progress_note,PROMPT1_entailment
98,187,78,44,34,0.5641025641025641,295,226,69,0.7661016949152543,0.6497647673810768,gemini,mimiciii,progress_note,PROMPT1_entailment
99,188,73,53,20,0.726027397260274,357,87,270,0.2436974789915966,0.3649097815764482,gemini,mimiciii,progress_note,PROMPT1_entailment
100,189,91,78,13,0.8571428571428571,394,123,271,0.3121827411167512,0.4576744186046511,gemini,mimiciii,progress_note,PROMPT1_entailment
101,19,26,19,7,0.7307692307692307,54,26,28,0.4814814814814814,0.5804935370152761,gemini,mimiciii,progress_note,PROMPT1_entailment
102,190,74,61,13,0.8243243243243243,390,89,301,0.2282051282051282,0.3574532525678166,gemini,mimiciii,progress_note,PROMPT1_entailment
103,191,19,17,2,0.8947368421052632,359,94,265,0.2618384401114206,0.4051210546330334,gemini,mimiciii,progress_note,PROMPT1_entailment
104,192,87,74,13,0.8505747126436781,360,94,266,0.2611111111111111,0.3995634441955311,gemini,mimiciii,progress_note,PROMPT1_entailment
105,193,100,75,25,0.75,415,138,277,0.3325301204819277,0.4607679465776293,gemini,mimiciii,progress_note,PROMPT1_entailment
106,194,21,18,3,0.8571428571428571,365,107,258,0.2931506849315068,0.4368832936372915,gemini,mimiciii,progress_note,PROMPT1_entailment
107,195,14,13,1,0.9285714285714286,60,28,32,0.4666666666666667,0.621160409556314,gemini,mimiciii,progress_note,PROMPT1_entailment
108,196,18,12,6,0.6666666666666666,61,35,26,0.5737704918032787,0.6167400881057269,gemini,mimiciii,progress_note,PROMPT1_entailment
109,197,59,51,8,0.864406779661017,137,119,18,0.8686131386861314,0.8665048543689321,gemini,mimiciii,progress_note,PROMPT1_entailment
110,198,35,30,5,0.8571428571428571,47,33,14,0.7021276595744681,0.7719298245614036,gemini,mimiciii,progress_note,PROMPT1_entailment
111,199,40,33,7,0.825,76,60,16,0.7894736842105263,0.8068459657701711,gemini,mimiciii,progress_note,PROMPT1_entailment
112,2,61,40,21,0.6557377049180327,242,69,173,0.2851239669421487,0.3974368205054359,gemini,mimiciii,progress_note,PROMPT1_entailment
113,20,18,15,3,0.8333333333333334,47,30,17,0.6382978723404256,0.7228915662650603,gemini,mimiciii,progress_note,PROMPT1_entailment
114,200,90,48,42,0.5333333333333333,276,183,93,0.6630434782608695,0.5911568746214416,gemini,mimiciii,progress_note,PROMPT1_entailment
115,201,18,17,1,0.9444444444444444,343,208,135,0.6064139941690962,0.7385900783289817,gemini,mimiciii,progress_note,PROMPT1_entailment
116,202,17,13,4,0.7647058823529411,295,96,199,0.3254237288135593,0.4565575269800622,gemini,mimiciii,progress_note,PROMPT1_entailment
117,203,59,41,18,0.6949152542372882,367,84,283,0.2288828337874659,0.3443483477478378,gemini,mimiciii,progress_note,PROMPT1_entailment
118,204,18,13,5,0.7222222222222222,349,245,104,0.7020057306590258,0.7119704929026489,gemini,mimiciii,progress_note,PROMPT1_entailment
119,205,91,72,19,0.7912087912087912,329,94,235,0.2857142857142857,0.4198250728862974,gemini,mimiciii,progress_note,PROMPT1_entailment
120,206,55,44,11,0.8,421,283,138,0.672209026128266,0.7305582445950307,gemini,mimiciii,progress_note,PROMPT1_entailment
121,207,116,84,32,0.7241379310344828,403,119,284,0.2952853598014888,0.4195064629847239,gemini,mimiciii,progress_note,PROMPT1_entailment
122,208,61,38,23,0.6229508196721312,395,72,323,0.1822784810126582,0.2820327801257603,gemini,mimiciii,progress_note,PROMPT1_entailment
123,209,16,13,3,0.8125,351,272,79,0.7749287749287749,0.7932697700504766,gemini,mimiciii,progress_note,PROMPT1_entailment
124,21,112,87,25,0.7767857142857143,373,118,255,0.3163538873994638,0.4496025576455646,gemini,mimiciii,progress_note,PROMPT1_entailment
125,210,20,17,3,0.85,45,22,23,0.4888888888888889,0.620746887966805,gemini,mimiciii,progress_note,PROMPT1_entailment
126,211,18,14,4,0.7777777777777778,89,38,51,0.4269662921348314,0.5512953367875647,gemini,mimiciii,progress_note,PROMPT1_entailment
127,212,8,7,1,0.875,22,21,1,0.9545454545454546,0.9130434782608696,gemini,mimiciii,progress_note,PROMPT1_entailment
128,213,31,27,4,0.8709677419354839,62,33,29,0.532258064516129,0.6607341490545049,gemini,mimiciii,progress_note,PROMPT1_entailment
129,214,9,7,2,0.7777777777777778,39,30,9,0.7692307692307693,0.7734806629834255,gemini,mimiciii,progress_note,PROMPT1_entailment
130,215,16,9,7,0.5625,101,42,59,0.4158415841584158,0.4781783681214421,gemini,mimiciii,progress_note,PROMPT1_entailment
131,216,51,34,17,0.6666666666666666,103,80,23,0.7766990291262136,0.7174887892376681,gemini,mimiciii,progress_note,PROMPT1_entailment
132,217,53,38,15,0.7169811320754716,114,91,23,0.7982456140350878,0.7554341889677773,gemini,mimiciii,progress_note,PROMPT1_entailment
133,218,7,7,0,1.0,41,22,19,0.5365853658536586,0.6984126984126985,gemini,mimiciii,progress_note,PROMPT1_entailment
134,219,11,8,3,0.7272727272727273,22,11,11,0.5,0.5925925925925926,gemini,mimiciii,progress_note,PROMPT1_entailment
135,22,12,9,3,0.75,56,26,30,0.4642857142857143,0.5735294117647058,gemini,mimiciii,progress_note,PROMPT1_entailment
136,220,48,39,9,0.8125,50,26,24,0.52,0.6341463414634146,gemini,mimiciii,progress_note,PROMPT1_entailment
137,221,77,53,24,0.6883116883116883,333,249,84,0.7477477477477478,0.7167997392862963,gemini,mimiciii,progress_note,PROMPT1_entailment
138,222,38,35,3,0.9210526315789472,458,278,180,0.6069868995633187,0.7317440024065579,gemini,mimiciii,progress_note,PROMPT1_entailment
139,223,41,32,9,0.7804878048780488,45,20,25,0.4444444444444444,0.5663716814159292,gemini,mimiciii,progress_note,PROMPT1_entailment
140,224,15,12,3,0.8,50,26,24,0.52,0.6303030303030304,gemini,mimiciii,progress_note,PROMPT1_entailment
141,225,18,14,4,0.7777777777777778,56,44,12,0.7857142857142857,0.7817258883248731,gemini,mimiciii,progress_note,PROMPT1_entailment
142,226,17,16,1,0.9411764705882352,50,22,28,0.44,0.5996592844974447,gemini,mimiciii,progress_note,PROMPT1_entailment
143,227,21,15,6,0.7142857142857143,18,9,9,0.5,0.588235294117647,gemini,mimiciii,progress_note,PROMPT1_entailment
144,228,6,4,2,0.6666666666666666,18,2,16,0.1111111111111111,0.1904761904761905,gemini,mimiciii,progress_note,PROMPT1_entailment
145,229,10,5,5,0.5,18,2,16,0.1111111111111111,0.1818181818181818,gemini,mimiciii,progress_note,PROMPT1_entailment
146,23,18,16,2,0.8888888888888888,56,35,21,0.625,0.7339449541284404,gemini,mimiciii,progress_note,PROMPT1_entailment
147,230,17,13,4,0.7647058823529411,40,14,26,0.35,0.4802110817941951,gemini,mimiciii,progress_note,PROMPT1_entailment
148,231,30,28,2,0.9333333333333332,152,63,89,0.4144736842105263,0.5740318906605923,gemini,mimiciii,progress_note,PROMPT1_entailment
149,232,15,12,3,0.8,108,43,65,0.3981481481481481,0.5316846986089645,gemini,mimiciii,progress_note,PROMPT1_entailment
150,233,37,24,13,0.6486486486486487,116,91,25,0.7844827586206896,0.7101284344009104,gemini,mimiciii,progress_note,PROMPT1_entailment
151,234,6,6,0,1.0,59,31,28,0.5254237288135594,0.688888888888889,gemini,mimiciii,progress_note,PROMPT1_entailment
152,24,8,6,2,0.75,33,14,19,0.4242424242424242,0.5419354838709677,gemini,mimiciii,progress_note,PROMPT1_entailment
153,25,16,11,5,0.6875,35,13,22,0.3714285714285714,0.4822934232715008,gemini,mimiciii,progress_note,PROMPT1_entailment
154,26,15,10,5,0.6666666666666666,35,26,9,0.7428571428571429,0.7027027027027027,gemini,mimiciii,progress_note,PROMPT1_entailment
155,27,11,8,3,0.7272727272727273,32,16,16,0.5,0.5925925925925926,gemini,mimiciii,progress_note,PROMPT1_entailment
156,28,39,35,4,0.8974358974358975,85,51,34,0.6,0.7191780821917808,gemini,mimiciii,progress_note,PROMPT1_entailment
157,29,34,31,3,0.9117647058823528,76,32,44,0.4210526315789473,0.5760743321718932,gemini,mimiciii,progress_note,PROMPT1_entailment
158,3,19,16,3,0.8421052631578947,273,200,73,0.7326007326007326,0.7835455435847207,gemini,mimiciii,progress_note,PROMPT1_entailment
159,30,24,23,1,0.9583333333333334,29,22,7,0.7586206896551724,0.8468619246861926,gemini,mimiciii,progress_note,PROMPT1_entailment
160,31,21,18,3,0.8571428571428571,26,25,1,0.9615384615384616,0.9063444108761328,gemini,mimiciii,progress_note,PROMPT1_entailment
161,32,35,31,4,0.8857142857142857,152,60,92,0.3947368421052631,0.546095126247798,gemini,mimiciii,progress_note,PROMPT1_entailment
162,33,16,13,3,0.8125,106,79,27,0.7452830188679245,0.7774413323239969,gemini,mimiciii,progress_note,PROMPT1_entailment
163,34,36,29,7,0.8055555555555556,98,45,53,0.4591836734693877,0.5849394890183774,gemini,mimiciii,progress_note,PROMPT1_entailment
164,35,8,6,2,0.75,26,10,16,0.3846153846153846,0.5084745762711865,gemini,mimiciii,progress_note,PROMPT1_entailment
165,36,16,10,6,0.625,60,30,30,0.5,0.5555555555555556,gemini,mimiciii,progress_note,PROMPT1_entailment
166,37,76,63,13,0.8289473684210527,344,267,77,0.7761627906976745,0.8016871604232199,gemini,mimiciii,progress_note,PROMPT1_entailment
167,38,15,13,2,0.8666666666666667,278,78,200,0.2805755395683453,0.4239130434782608,gemini,mimiciii,progress_note,PROMPT1_entailment
168,39,28,25,3,0.8928571428571429,117,101,16,0.8632478632478633,0.8778028854510691,gemini,mimiciii,progress_note,PROMPT1_entailment
169,4,22,19,3,0.8636363636363636,282,199,83,0.7056737588652482,0.7767050123253904,gemini,mimiciii,progress_note,PROMPT1_entailment
170,40,44,39,5,0.8863636363636364,117,94,23,0.8034188034188035,0.8428555006322566,gemini,mimiciii,progress_note,PROMPT1_entailment
171,41,49,42,7,0.8571428571428571,119,65,54,0.5462184873949579,0.6672369546621043,gemini,mimiciii,progress_note,PROMPT1_entailment
172,42,40,37,3,0.925,119,66,53,0.5546218487394958,0.6934544938236548,gemini,mimiciii,progress_note,PROMPT1_entailment
173,43,65,39,26,0.6,117,58,59,0.4957264957264957,0.5429017160686427,gemini,mimiciii,progress_note,PROMPT1_entailment
174,44,36,35,1,0.9722222222222222,149,74,75,0.4966442953020134,0.657443838050514,gemini,mimiciii,progress_note,PROMPT1_entailment
175,45,18,15,3,0.8333333333333334,125,65,60,0.52,0.6403940886699507,gemini,mimiciii,progress_note,PROMPT1_entailment
176,46,24,20,4,0.8333333333333334,52,27,25,0.5192307692307693,0.6398104265402844,gemini,mimiciii,progress_note,PROMPT1_entailment
177,47,14,8,6,0.5714285714285714,12,8,4,0.6666666666666666,0.6153846153846153,gemini,mimiciii,progress_note,PROMPT1_entailment
178,48,16,16,0,1.0,49,22,27,0.4489795918367347,0.6197183098591549,gemini,mimiciii,progress_note,PROMPT1_entailment
179,49,28,22,6,0.7857142857142857,87,50,37,0.5747126436781609,0.663850331925166,gemini,mimiciii,progress_note,PROMPT1_entailment
180,5,15,13,2,0.8666666666666667,300,208,92,0.6933333333333334,0.7703703703703704,gemini,mimiciii,progress_note,PROMPT1_entailment
181,50,80,73,7,0.9125,176,81,95,0.4602272727272727,0.6118584437086093,gemini,mimiciii,progress_note,PROMPT1_entailment
182,51,46,41,5,0.8913043478260869,302,99,203,0.3278145695364238,0.4793339631554086,gemini,mimiciii,progress_note,PROMPT1_entailment
183,52,17,13,4,0.7647058823529411,302,179,123,0.5927152317880795,0.6678146075477113,gemini,mimiciii,progress_note,PROMPT1_entailment
184,53,98,64,34,0.6530612244897959,382,275,107,0.7198952879581152,0.6848515506439938,gemini,mimiciii,progress_note,PROMPT1_entailment
185,54,81,34,47,0.419753086419753,219,75,144,0.3424657534246575,0.3771910361659641,gemini,mimiciii,progress_note,PROMPT1_entailment
186,55,101,51,50,0.504950495049505,286,209,77,0.7307692307692307,0.597226502311248,gemini,mimiciii,progress_note,PROMPT1_entailment
187,56,3,3,0,1.0,48,7,41,0.1458333333333333,0.2545454545454546,gemini,mimiciii,progress_note,PROMPT1_entailment
188,57,16,16,0,1.0,46,24,22,0.5217391304347826,0.6857142857142856,gemini,mimiciii,progress_note,PROMPT1_entailment
189,58,7,6,1,0.8571428571428571,39,23,16,0.5897435897435898,0.6987341772151898,gemini,mimiciii,progress_note,PROMPT1_entailment
190,59,20,12,8,0.6,39,21,18,0.5384615384615384,0.5675675675675675,gemini,mimiciii,progress_note,PROMPT1_entailment
191,6,34,21,13,0.6176470588235294,331,40,291,0.120845921450151,0.2021417398628324,gemini,mimiciii,progress_note,PROMPT1_entailment
192,60,12,9,3,0.75,276,183,93,0.6630434782608695,0.7038461538461537,gemini,mimiciii,progress_note,PROMPT1_entailment
193,61,20,13,7,0.65,56,46,10,0.8214285714285714,0.7257281553398057,gemini,mimiciii,progress_note,PROMPT1_entailment
194,62,21,15,6,0.7142857142857143,56,27,29,0.4821428571428571,0.5756929637526653,gemini,mimiciii,progress_note,PROMPT1_entailment
195,63,13,11,2,0.8461538461538461,142,69,73,0.4859154929577465,0.6173241154941033,gemini,mimiciii,progress_note,PROMPT1_entailment
196,64,1,0,1,0.0,1,1,0,1.0,0.0,gemini,mimiciii,progress_note,PROMPT1_entailment
197,65,18,17,1,0.9444444444444444,12,7,5,0.5833333333333334,0.7212121212121213,gemini,mimiciii,progress_note,PROMPT1_entailment
198,66,23,18,5,0.782608695652174,68,40,28,0.5882352941176471,0.6716417910447762,gemini,mimiciii,progress_note,PROMPT1_entailment
199,67,123,78,45,0.6341463414634146,490,153,337,0.3122448979591837,0.4184505338452637,gemini,mimiciii,progress_note,PROMPT1_entailment
200,68,107,61,46,0.5700934579439252,348,258,90,0.7413793103448276,0.6445509276323873,gemini,mimiciii,progress_note,PROMPT1_entailment
201,69,88,63,25,0.7159090909090909,373,241,132,0.646112600536193,0.6792224931218824,gemini,mimiciii,progress_note,PROMPT1_entailment
202,7,91,69,22,0.7582417582417582,331,223,108,0.6737160120845922,0.71348418807382,gemini,mimiciii,progress_note,PROMPT1_entailment
203,70,15,14,1,0.9333333333333332,374,251,123,0.6711229946524064,0.7808021330963227,gemini,mimiciii,progress_note,PROMPT1_entailment
204,71,12,11,1,0.9166666666666666,372,272,100,0.7311827956989247,0.8134855899945622,gemini,mimiciii,progress_note,PROMPT1_entailment
205,72,7,7,0,1.0,20,8,12,0.4,0.5714285714285715,gemini,mimiciii,progress_note,PROMPT1_entailment
206,73,17,11,6,0.6470588235294118,460,112,348,0.2434782608695652,0.353819643882826,gemini,mimiciii,progress_note,PROMPT1_entailment
207,74,65,46,19,0.7076923076923077,319,104,215,0.3260188087774294,0.4463935802929924,gemini,mimiciii,progress_note,PROMPT1_entailment
208,75,42,38,4,0.9047619047619048,62,54,8,0.8709677419354839,0.8875432525951558,gemini,mimiciii,progress_note,PROMPT1_entailment
209,76,31,24,7,0.7741935483870968,86,61,25,0.7093023255813954,0.7403286978508218,gemini,mimiciii,progress_note,PROMPT1_entailment
210,77,23,22,1,0.9565217391304348,38,19,19,0.5,0.6567164179104478,gemini,mimiciii,progress_note,PROMPT1_entailment
211,78,19,19,0,1.0,30,22,8,0.7333333333333333,0.846153846153846,gemini,mimiciii,progress_note,PROMPT1_entailment
212,79,20,15,5,0.75,67,28,39,0.417910447761194,0.5367412140575081,gemini,mimiciii,progress_note,PROMPT1_entailment
213,8,24,19,5,0.7916666666666666,118,57,61,0.4830508474576271,0.6,gemini,mimiciii,progress_note,PROMPT1_entailment
214,80,21,18,3,0.8571428571428571,32,13,19,0.40625,0.5512367491166077,gemini,mimiciii,progress_note,PROMPT1_entailment
215,81,12,11,1,0.9166666666666666,46,34,12,0.7391304347826086,0.8183807439824944,gemini,mimiciii,progress_note,PROMPT1_entailment
216,82,10,6,4,0.6,18,6,12,0.3333333333333333,0.4285714285714285,gemini,mimiciii,progress_note,PROMPT1_entailment
217,83,28,24,4,0.8571428571428571,66,36,30,0.5454545454545454,0.6666666666666665,gemini,mimiciii,progress_note,PROMPT1_entailment
218,84,21,16,5,0.7619047619047619,48,26,22,0.5416666666666666,0.6331811263318112,gemini,mimiciii,progress_note,PROMPT1_entailment
219,85,5,4,1,0.8,77,54,23,0.7012987012987013,0.7474048442906576,gemini,mimiciii,progress_note,PROMPT1_entailment
220,86,13,12,1,0.9230769230769232,52,25,27,0.4807692307692308,0.6322444678609063,gemini,mimiciii,progress_note,PROMPT1_entailment
221,87,10,7,3,0.7,15,9,6,0.6,0.6461538461538462,gemini,mimiciii,progress_note,PROMPT1_entailment
222,88,32,26,6,0.8125,105,46,59,0.4380952380952381,0.5692527367920038,gemini,mimiciii,progress_note,PROMPT1_entailment
223,89,70,45,25,0.6428571428571429,339,95,244,0.28023598820059,0.390321844327779,gemini,mimiciii,progress_note,PROMPT1_entailment
224,9,33,31,2,0.9393939393939394,61,53,8,0.8688524590163934,0.9027472527472528,gemini,mimiciii,progress_note,PROMPT1_entailment
225,90,8,8,0,1.0,4,3,1,0.75,0.8571428571428571,gemini,mimiciii,progress_note,PROMPT1_entailment
226,91,23,20,3,0.8695652173913043,112,87,25,0.7767857142857143,0.8205611883989625,gemini,mimiciii,progress_note,PROMPT1_entailment
227,92,45,34,11,0.7555555555555555,208,104,104,0.5,0.6017699115044248,gemini,mimiciii,progress_note,PROMPT1_entailment
228,93,24,21,3,0.875,38,12,26,0.3157894736842105,0.4640883977900552,gemini,mimiciii,progress_note,PROMPT1_entailment
229,94,45,31,14,0.6888888888888889,112,85,27,0.7589285714285714,0.7222146087433191,gemini,mimiciii,progress_note,PROMPT1_entailment
230,95,12,9,3,0.75,49,21,28,0.4285714285714285,0.5454545454545454,gemini,mimiciii,progress_note,PROMPT1_entailment
231,96,6,5,1,0.8333333333333334,14,13,1,0.9285714285714286,0.8783783783783784,gemini,mimiciii,progress_note,PROMPT1_entailment
232,97,9,9,0,1.0,20,12,8,0.6,0.7499999999999999,gemini,mimiciii,progress_note,PROMPT1_entailment
233,98,22,18,4,0.8181818181818182,35,15,20,0.4285714285714285,0.5625,gemini,mimiciii,progress_note,PROMPT1_entailment
234,99,36,29,7,0.8055555555555556,104,44,60,0.4230769230769231,0.5547826086956521,gemini,mimiciii,progress_note,PROMPT1_entailment
0,0,68,57,11,0.8382352941176471,118,104,14,0.8813559322033898,0.8592549644876069,gemini,mimiciii,progress_note,PROMPT1_ICL_entailment
1,1,104,89,15,0.8557692307692307,320,215,105,0.671875,0.7527537372147914,gemini,mimiciii,progress_note,PROMPT1_ICL_entailment
2,10,74,55,19,0.7432432432432432,230,167,63,0.7260869565217392,0.7345649392194498,gemini,mimiciii,progress_note,PROMPT1_ICL_entailment
3,100,49,41,8,0.8367346938775511,115,96,19,0.8347826086956521,0.8357575114131013,gemini,mimiciii,progress_note,PROMPT1_ICL_entailment
4,101,31,24,7,0.7741935483870968,49,27,22,0.5510204081632653,0.6438152011922503,gemini,mimiciii,progress_note,PROMPT1_ICL_entailment
5,102,45,36,9,0.8,67,62,5,0.9253731343283582,0.8581314878892734,gemini,mimiciii,progress_note,PROMPT1_ICL_entailment
6,103,129,74,55,0.5736434108527132,347,261,86,0.7521613832853026,0.6508837851955448,gemini,mimiciii,progress_note,PROMPT1_ICL_entailment
7,104,33,18,15,0.5454545454545454,57,27,30,0.4736842105263157,0.5070422535211268,gemini,mimiciii,progress_note,PROMPT1_ICL_entailment
8,105,28,25,3,0.8928571428571429,28,14,14,0.5,0.6410256410256411,gemini,mimiciii,progress_note,PROMPT1_ICL_entailment
9,106,24,21,3,0.875,58,32,26,0.5517241379310345,0.6767371601208458,gemini,mimiciii,progress_note,PROMPT1_ICL_entailment
10,107,33,29,4,0.8787878787878788,53,25,28,0.4716981132075472,0.6138865368331923,gemini,mimiciii,progress_note,PROMPT1_ICL_entailment
11,108,56,49,7,0.875,94,77,17,0.8191489361702128,0.8461538461538463,gemini,mimiciii,progress_note,PROMPT1_ICL_entailment
12,109,79,69,10,0.8734177215189873,311,218,93,0.7009646302250804,0.7777461802952353,gemini,mimiciii,progress_note,PROMPT1_ICL_entailment
13,11,95,73,22,0.7684210526315789,233,74,159,0.3175965665236051,0.4494363326261492,gemini,mimiciii,progress_note,PROMPT1_ICL_entailment
14,110,1,0,1,0.0,358,174,184,0.4860335195530726,0.0,gemini,mimiciii,progress_note,PROMPT1_ICL_entailment
15,111,83,67,16,0.8072289156626506,389,104,285,0.2673521850899742,0.4016717106211269,gemini,mimiciii,progress_note,PROMPT1_ICL_entailment
16,112,34,28,6,0.8235294117647058,400,98,302,0.245,0.3776493256262043,gemini,mimiciii,progress_note,PROMPT1_ICL_entailment
17,113,110,73,37,0.6636363636363637,340,229,111,0.6735294117647059,0.6685462907418517,gemini,mimiciii,progress_note,PROMPT1_ICL_entailment
18,114,48,38,10,0.7916666666666666,401,248,153,0.6184538653366584,0.6944219291135509,gemini,mimiciii,progress_note,PROMPT1_ICL_entailment
19,115,123,83,40,0.6747967479674797,479,295,184,0.615866388308977,0.6439862181426054,gemini,mimiciii,progress_note,PROMPT1_ICL_entailment
20,116,28,23,5,0.8214285714285714,53,20,33,0.3773584905660377,0.5171444631815627,gemini,mimiciii,progress_note,PROMPT1_ICL_entailment
21,117,18,17,1,0.9444444444444444,33,15,18,0.4545454545454545,0.6137184115523465,gemini,mimiciii,progress_note,PROMPT1_ICL_entailment
22,118,40,33,7,0.825,41,37,4,0.902439024390244,0.8619837627956229,gemini,mimiciii,progress_note,PROMPT1_ICL_entailment
23,119,14,14,0,1.0,21,11,10,0.5238095238095238,0.6875000000000001,gemini,mimiciii,progress_note,PROMPT1_ICL_entailment
24,12,148,65,83,0.4391891891891892,388,303,85,0.7809278350515464,0.5622002740351678,gemini,mimiciii,progress_note,PROMPT1_ICL_entailment
25,120,48,42,6,0.875,95,69,26,0.7263157894736842,0.7937551355792933,gemini,mimiciii,progress_note,PROMPT1_ICL_entailment
26,121,21,19,2,0.9047619047619048,23,18,5,0.782608695652174,0.8392638036809816,gemini,mimiciii,progress_note,PROMPT1_ICL_entailment
27,122,50,31,19,0.62,71,54,17,0.7605633802816901,0.6831258926749643,gemini,mimiciii,progress_note,PROMPT1_ICL_entailment
28,123,35,26,9,0.7428571428571429,72,50,22,0.6944444444444444,0.7178354500276092,gemini,mimiciii,progress_note,PROMPT1_ICL_entailment
29,124,42,34,8,0.8095238095238095,96,72,24,0.75,0.7786259541984734,gemini,mimiciii,progress_note,PROMPT1_ICL_entailment
30,125,40,33,7,0.825,72,32,40,0.4444444444444444,0.5776805251641137,gemini,mimiciii,progress_note,PROMPT1_ICL_entailment
31,126,27,19,8,0.7037037037037037,41,37,4,0.902439024390244,0.7907761529808774,gemini,mimiciii,progress_note,PROMPT1_ICL_entailment
32,127,28,24,4,0.8571428571428571,41,25,16,0.6097560975609756,0.7125890736342042,gemini,mimiciii,progress_note,PROMPT1_ICL_entailment
33,128,53,47,6,0.8867924528301887,56,48,8,0.8571428571428571,0.8717156105100462,gemini,mimiciii,progress_note,PROMPT1_ICL_entailment
34,129,49,34,15,0.6938775510204082,100,51,49,0.51,0.5878962536023055,gemini,mimiciii,progress_note,PROMPT1_ICL_entailment
35,13,38,31,7,0.8157894736842105,106,46,60,0.4339622641509434,0.5665474771553436,gemini,mimiciii,progress_note,PROMPT1_ICL_entailment
36,130,40,23,17,0.575,64,26,38,0.40625,0.4761146496815286,gemini,mimiciii,progress_note,PROMPT1_ICL_entailment
37,131,135,113,22,0.837037037037037,343,266,77,0.7755102040816326,0.8050998406299803,gemini,mimiciii,progress_note,PROMPT1_ICL_entailment
38,132,99,73,26,0.7373737373737373,333,254,79,0.7627627627627628,0.7498534020827013,gemini,mimiciii,progress_note,PROMPT1_ICL_entailment
39,133,82,53,29,0.6463414634146342,271,187,84,0.6900369003690037,0.6674748291073173,gemini,mimiciii,progress_note,PROMPT1_ICL_entailment
40,134,17,13,4,0.7647058823529411,24,13,11,0.5416666666666666,0.6341463414634146,gemini,mimiciii,progress_note,PROMPT1_ICL_entailment
41,135,38,30,8,0.7894736842105263,50,44,6,0.88,0.832282471626734,gemini,mimiciii,progress_note,PROMPT1_ICL_entailment
42,136,33,28,5,0.8484848484848485,58,32,26,0.5517241379310345,0.6686567164179105,gemini,mimiciii,progress_note,PROMPT1_ICL_entailment
43,137,25,21,4,0.84,36,21,15,0.5833333333333334,0.6885245901639344,gemini,mimiciii,progress_note,PROMPT1_ICL_entailment
44,138,36,33,3,0.9166666666666666,66,50,16,0.7575757575757576,0.8295625942684766,gemini,mimiciii,progress_note,PROMPT1_ICL_entailment
45,139,46,38,8,0.8260869565217391,70,55,15,0.7857142857142857,0.8053949903660885,gemini,mimiciii,progress_note,PROMPT1_ICL_entailment
46,14,40,38,2,0.95,63,38,25,0.6031746031746031,0.7378640776699029,gemini,mimiciii,progress_note,PROMPT1_ICL_entailment
47,140,25,14,11,0.56,39,24,15,0.6153846153846154,0.5863874345549739,gemini,mimiciii,progress_note,PROMPT1_ICL_entailment
48,141,45,43,2,0.9555555555555556,70,28,42,0.4,0.5639344262295082,gemini,mimiciii,progress_note,PROMPT1_ICL_entailment
49,142,55,47,8,0.8545454545454545,72,55,17,0.7638888888888888,0.8066781089093461,gemini,mimiciii,progress_note,PROMPT1_ICL_entailment
50,143,13,11,2,0.8461538461538461,16,6,10,0.375,0.5196850393700787,gemini,mimiciii,progress_note,PROMPT1_ICL_entailment
51,144,49,41,8,0.8367346938775511,72,60,12,0.8333333333333334,0.8350305498981672,gemini,mimiciii,progress_note,PROMPT1_ICL_entailment
52,145,31,22,9,0.7096774193548387,63,33,30,0.5238095238095238,0.6027397260273972,gemini,mimiciii,progress_note,PROMPT1_ICL_entailment
53,146,55,29,26,0.5272727272727272,50,32,18,0.64,0.5781931464174455,gemini,mimiciii,progress_note,PROMPT1_ICL_entailment
54,147,33,30,3,0.9090909090909092,80,43,37,0.5375,0.6755695208169678,gemini,mimiciii,progress_note,PROMPT1_ICL_entailment
55,148,9,8,1,0.8888888888888888,6,3,3,0.5,0.64,gemini,mimiciii,progress_note,PROMPT1_ICL_entailment
56,149,34,29,5,0.8529411764705882,46,25,21,0.5434782608695652,0.6639194139194139,gemini,mimiciii,progress_note,PROMPT1_ICL_entailment
57,15,118,93,25,0.788135593220339,275,199,76,0.7236363636363636,0.7545100597264407,gemini,mimiciii,progress_note,PROMPT1_ICL_entailment
58,150,64,53,11,0.828125,121,111,10,0.9173553719008264,0.8704594214692609,gemini,mimiciii,progress_note,PROMPT1_ICL_entailment
59,151,117,112,5,0.9572649572649572,340,244,96,0.7176470588235294,0.8203157831542295,gemini,mimiciii,progress_note,PROMPT1_ICL_entailment
60,152,32,26,6,0.8125,65,34,31,0.5230769230769231,0.6364290856731463,gemini,mimiciii,progress_note,PROMPT1_ICL_entailment
61,153,92,86,6,0.9347826086956522,368,237,131,0.6440217391304348,0.7626281523609969,gemini,mimiciii,progress_note,PROMPT1_ICL_entailment
62,154,20,19,1,0.95,23,23,0,1.0,0.9743589743589745,gemini,mimiciii,progress_note,PROMPT1_ICL_entailment
63,155,26,21,5,0.8076923076923077,49,25,24,0.5102040816326531,0.6253722453841573,gemini,mimiciii,progress_note,PROMPT1_ICL_entailment
64,156,23,15,8,0.6521739130434783,49,26,23,0.5306122448979592,0.5851462865716429,gemini,mimiciii,progress_note,PROMPT1_ICL_entailment
65,157,26,22,4,0.8461538461538461,41,23,18,0.5609756097560976,0.6746666666666666,gemini,mimiciii,progress_note,PROMPT1_ICL_entailment
66,158,186,156,30,0.8387096774193549,411,117,294,0.2846715328467153,0.4250681198910082,gemini,mimiciii,progress_note,PROMPT1_ICL_entailment
67,159,17,14,3,0.8235294117647058,35,15,20,0.4285714285714285,0.5637583892617449,gemini,mimiciii,progress_note,PROMPT1_ICL_entailment
68,16,23,17,6,0.7391304347826086,41,18,23,0.4390243902439024,0.5508550855085509,gemini,mimiciii,progress_note,PROMPT1_ICL_entailment
69,160,48,40,8,0.8333333333333334,96,74,22,0.7708333333333334,0.8008658008658008,gemini,mimiciii,progress_note,PROMPT1_ICL_entailment
70,161,84,75,9,0.8928571428571429,343,241,102,0.7026239067055393,0.786399530118123,gemini,mimiciii,progress_note,PROMPT1_ICL_entailment
71,162,32,26,6,0.8125,300,51,249,0.17,0.2811704834605598,gemini,mimiciii,progress_note,PROMPT1_ICL_entailment
72,163,18,17,1,0.9444444444444444,39,20,19,0.5128205128205128,0.6647116324535679,gemini,mimiciii,progress_note,PROMPT1_ICL_entailment
73,164,25,19,6,0.76,82,39,43,0.4756097560975609,0.5850769838136597,gemini,mimiciii,progress_note,PROMPT1_ICL_entailment
74,165,13,12,1,0.9230769230769232,32,13,19,0.40625,0.5641952983725136,gemini,mimiciii,progress_note,PROMPT1_ICL_entailment
75,166,28,24,4,0.8571428571428571,59,38,21,0.6440677966101694,0.7354838709677418,gemini,mimiciii,progress_note,PROMPT1_ICL_entailment
76,167,39,32,7,0.8205128205128205,85,69,16,0.8117647058823529,0.8161153206431343,gemini,mimiciii,progress_note,PROMPT1_ICL_entailment
77,168,64,50,14,0.78125,312,232,80,0.7435897435897436,0.7619548081975828,gemini,mimiciii,progress_note,PROMPT1_ICL_entailment
78,169,170,156,14,0.9176470588235294,377,99,278,0.2625994694960212,0.4083445704767192,gemini,mimiciii,progress_note,PROMPT1_ICL_entailment
79,17,9,9,0,1.0,20,16,4,0.8,0.888888888888889,gemini,mimiciii,progress_note,PROMPT1_ICL_entailment
80,170,147,104,43,0.7074829931972789,318,68,250,0.2138364779874214,0.328410885111916,gemini,mimiciii,progress_note,PROMPT1_ICL_entailment
81,171,94,82,12,0.8723404255319149,387,294,93,0.7596899224806202,0.8121273370389086,gemini,mimiciii,progress_note,PROMPT1_ICL_entailment
82,172,105,94,11,0.8952380952380953,342,246,96,0.7192982456140351,0.7976818793335404,gemini,mimiciii,progress_note,PROMPT1_ICL_entailment
83,173,83,58,25,0.6987951807228916,299,92,207,0.3076923076923077,0.427255985267035,gemini,mimiciii,progress_note,PROMPT1_ICL_entailment
84,174,73,60,13,0.821917808219178,351,251,100,0.7150997150997151,0.7647969936266917,gemini,mimiciii,progress_note,PROMPT1_ICL_entailment
85,175,166,137,29,0.8253012048192772,178,132,46,0.7415730337078652,0.7812000518380924,gemini,mimiciii,progress_note,PROMPT1_ICL_entailment
86,176,127,86,41,0.6771653543307087,192,86,106,0.4479166666666667,0.5391849529780565,gemini,mimiciii,progress_note,PROMPT1_ICL_entailment
87,177,116,72,44,0.6206896551724138,192,94,98,0.4895833333333333,0.5473956648333872,gemini,mimiciii,progress_note,PROMPT1_ICL_entailment
88,178,20,18,2,0.9,17,12,5,0.7058823529411765,0.7912087912087913,gemini,mimiciii,progress_note,PROMPT1_ICL_entailment
89,179,78,64,14,0.8205128205128205,197,96,101,0.4873096446700508,0.6114649681528663,gemini,mimiciii,progress_note,PROMPT1_ICL_entailment
90,18,24,16,8,0.6666666666666666,29,25,4,0.8620689655172413,0.7518796992481203,gemini,mimiciii,progress_note,PROMPT1_ICL_entailment
91,180,100,82,18,0.82,201,105,96,0.5223880597014925,0.6382032466088503,gemini,mimiciii,progress_note,PROMPT1_ICL_entailment
92,181,98,77,21,0.7857142857142857,208,113,95,0.5432692307692307,0.6423772609819122,gemini,mimiciii,progress_note,PROMPT1_ICL_entailment
93,182,88,80,8,0.9090909090909092,214,115,99,0.5373831775700935,0.6754772393538913,gemini,mimiciii,progress_note,PROMPT1_ICL_entailment
94,183,57,39,18,0.6842105263157895,226,100,126,0.4424778761061947,0.5374121537825548,gemini,mimiciii,progress_note,PROMPT1_ICL_entailment
95,184,29,28,1,0.9655172413793104,194,61,133,0.3144329896907216,0.474378558533537,gemini,mimiciii,progress_note,PROMPT1_ICL_entailment
96,185,41,31,10,0.7560975609756098,48,27,21,0.5625,0.6450867052023121,gemini,mimiciii,progress_note,PROMPT1_ICL_entailment
97,186,48,37,11,0.7708333333333334,205,80,125,0.3902439024390244,0.5181619256017506,gemini,mimiciii,progress_note,PROMPT1_ICL_entailment
98,187,65,49,16,0.7538461538461538,170,69,101,0.4058823529411764,0.5276628950448694,gemini,mimiciii,progress_note,PROMPT1_ICL_entailment
99,188,130,117,13,0.9,202,95,107,0.4702970297029702,0.6177745664739884,gemini,mimiciii,progress_note,PROMPT1_ICL_entailment
100,189,122,111,11,0.9098360655737704,225,119,106,0.5288888888888889,0.6689286709037044,gemini,mimiciii,progress_note,PROMPT1_ICL_entailment
101,19,32,24,8,0.75,54,38,16,0.7037037037037037,0.7261146496815287,gemini,mimiciii,progress_note,PROMPT1_ICL_entailment
102,190,123,108,15,0.8780487804878049,223,126,97,0.5650224215246636,0.6875852660300136,gemini,mimiciii,progress_note,PROMPT1_ICL_entailment
103,191,120,101,19,0.8416666666666667,206,117,89,0.5679611650485437,0.6782414050393158,gemini,mimiciii,progress_note,PROMPT1_ICL_entailment
104,192,85,79,6,0.9294117647058824,208,124,84,0.5961538461538461,0.7263829156161946,gemini,mimiciii,progress_note,PROMPT1_ICL_entailment
105,193,180,135,45,0.75,243,125,118,0.51440329218107,0.6102522375915378,gemini,mimiciii,progress_note,PROMPT1_ICL_entailment
106,194,35,30,5,0.8571428571428571,211,86,125,0.4075829383886256,0.5524625267665952,gemini,mimiciii,progress_note,PROMPT1_ICL_entailment
107,195,38,33,5,0.868421052631579,44,38,6,0.8636363636363636,0.8660220994475138,gemini,mimiciii,progress_note,PROMPT1_ICL_entailment
108,196,50,34,16,0.68,42,30,12,0.7142857142857143,0.6967213114754098,gemini,mimiciii,progress_note,PROMPT1_ICL_entailment
109,197,82,68,14,0.8292682926829268,90,72,18,0.8,0.8143712574850299,gemini,mimiciii,progress_note,PROMPT1_ICL_entailment
110,198,38,32,6,0.8421052631578947,34,27,7,0.7941176470588235,0.8174077578051089,gemini,mimiciii,progress_note,PROMPT1_ICL_entailment
111,199,1,0,1,0.0,52,23,29,0.4423076923076923,0.0,gemini,mimiciii,progress_note,PROMPT1_ICL_entailment
112,2,68,46,22,0.6764705882352942,242,69,173,0.2851239669421487,0.4011627906976744,gemini,mimiciii,progress_note,PROMPT1_ICL_entailment
113,20,1,1,0,1.0,47,26,21,0.5531914893617021,0.7123287671232876,gemini,mimiciii,progress_note,PROMPT1_ICL_entailment
114,200,110,73,37,0.6636363636363637,164,71,93,0.4329268292682927,0.5240117278333839,gemini,mimiciii,progress_note,PROMPT1_ICL_entailment
115,201,141,121,20,0.8581560283687943,200,86,114,0.43,0.5729229752794143,gemini,mimiciii,progress_note,PROMPT1_ICL_entailment
116,202,114,84,30,0.7368421052631579,176,76,100,0.4318181818181818,0.5445240532241556,gemini,mimiciii,progress_note,PROMPT1_ICL_entailment
117,203,94,87,7,0.925531914893617,211,133,78,0.6303317535545023,0.7499270877215722,gemini,mimiciii,progress_note,PROMPT1_ICL_entailment
118,204,151,98,53,0.6490066225165563,201,86,115,0.4278606965174129,0.5157263492840534,gemini,mimiciii,progress_note,PROMPT1_ICL_entailment
119,205,102,88,14,0.8627450980392157,195,98,97,0.5025641025641026,0.6351450876417735,gemini,mimiciii,progress_note,PROMPT1_ICL_entailment
120,206,113,99,14,0.8761061946902655,239,121,118,0.5062761506276151,0.6417206835592222,gemini,mimiciii,progress_note,PROMPT1_ICL_entailment
121,207,138,107,31,0.7753623188405797,233,123,110,0.5278969957081545,0.6281350674143896,gemini,mimiciii,progress_note,PROMPT1_ICL_entailment
122,208,140,115,25,0.8214285714285714,229,84,145,0.3668122270742358,0.5071531697073106,gemini,mimiciii,progress_note,PROMPT1_ICL_entailment
123,209,76,49,27,0.6447368421052632,205,90,115,0.4390243902439024,0.522357121705656,gemini,mimiciii,progress_note,PROMPT1_ICL_entailment
124,21,181,130,51,0.7182320441988951,373,253,120,0.67828418230563,0.6976867515883034,gemini,mimiciii,progress_note,PROMPT1_ICL_entailment
125,210,36,28,8,0.7777777777777778,28,24,4,0.8571428571428571,0.8155339805825242,gemini,mimiciii,progress_note,PROMPT1_ICL_entailment
126,211,1,0,1,0.0,54,18,36,0.3333333333333333,0.0,gemini,mimiciii,progress_note,PROMPT1_ICL_entailment
127,212,23,18,5,0.782608695652174,14,12,2,0.8571428571428571,0.8181818181818182,gemini,mimiciii,progress_note,PROMPT1_ICL_entailment
128,213,38,32,6,0.8421052631578947,41,30,11,0.7317073170731707,0.7830342577487764,gemini,mimiciii,progress_note,PROMPT1_ICL_entailment
129,214,25,23,2,0.92,27,16,11,0.5925925925925926,0.7208619000979433,gemini,mimiciii,progress_note,PROMPT1_ICL_entailment
130,215,70,37,33,0.5285714285714286,66,46,20,0.696969696969697,0.6012009890498057,gemini,mimiciii,progress_note,PROMPT1_ICL_entailment
131,216,64,51,13,0.796875,67,51,16,0.7611940298507462,0.7786259541984732,gemini,mimiciii,progress_note,PROMPT1_ICL_entailment
132,217,62,51,11,0.8225806451612904,73,56,17,0.7671232876712328,0.7938846421125781,gemini,mimiciii,progress_note,PROMPT1_ICL_entailment
133,218,30,25,5,0.8333333333333334,27,23,4,0.8518518518518519,0.8424908424908426,gemini,mimiciii,progress_note,PROMPT1_ICL_entailment
134,219,18,15,3,0.8333333333333334,17,12,5,0.7058823529411765,0.7643312101910827,gemini,mimiciii,progress_note,PROMPT1_ICL_entailment
135,22,48,40,8,0.8333333333333334,56,38,18,0.6785714285714286,0.7480314960629922,gemini,mimiciii,progress_note,PROMPT1_ICL_entailment
136,220,58,48,10,0.8275862068965517,34,25,9,0.7352941176470589,0.7787151200519145,gemini,mimiciii,progress_note,PROMPT1_ICL_entailment
137,221,103,71,32,0.6893203883495146,188,99,89,0.526595744680851,0.5970694414950095,gemini,mimiciii,progress_note,PROMPT1_ICL_entailment
138,222,139,106,33,0.762589928057554,263,150,113,0.5703422053231939,0.6526021999671647,gemini,mimiciii,progress_note,PROMPT1_ICL_entailment
139,223,29,28,1,0.9655172413793104,30,25,5,0.8333333333333334,0.8945686900958466,gemini,mimiciii,progress_note,PROMPT1_ICL_entailment
140,224,26,21,5,0.8076923076923077,33,21,12,0.6363636363636364,0.7118644067796609,gemini,mimiciii,progress_note,PROMPT1_ICL_entailment
141,225,21,14,7,0.6666666666666666,37,27,10,0.7297297297297297,0.6967741935483871,gemini,mimiciii,progress_note,PROMPT1_ICL_entailment
142,226,27,23,4,0.8518518518518519,33,27,6,0.8181818181818182,0.8346774193548387,gemini,mimiciii,progress_note,PROMPT1_ICL_entailment
143,227,7,6,1,0.8571428571428571,15,4,11,0.2666666666666666,0.4067796610169491,gemini,mimiciii,progress_note,PROMPT1_ICL_entailment
144,228,7,6,1,0.8571428571428571,15,3,12,0.2,0.3243243243243243,gemini,mimiciii,progress_note,PROMPT1_ICL_entailment
145,229,5,5,0,1.0,15,6,9,0.4,0.5714285714285715,gemini,mimiciii,progress_note,PROMPT1_ICL_entailment
146,23,26,16,10,0.6153846153846154,56,32,24,0.5714285714285714,0.5925925925925927,gemini,mimiciii,progress_note,PROMPT1_ICL_entailment
147,230,25,22,3,0.88,26,20,6,0.7692307692307693,0.8208955223880597,gemini,mimiciii,progress_note,PROMPT1_ICL_entailment
148,231,62,59,3,0.9516129032258064,102,76,26,0.7450980392156863,0.8357875116495807,gemini,mimiciii,progress_note,PROMPT1_ICL_entailment
149,232,60,53,7,0.8833333333333333,72,41,31,0.5694444444444444,0.6924792861695347,gemini,mimiciii,progress_note,PROMPT1_ICL_entailment
150,233,53,42,11,0.7924528301886793,82,68,14,0.8292682926829268,0.8104426787741202,gemini,mimiciii,progress_note,PROMPT1_ICL_entailment
151,234,28,23,5,0.8214285714285714,42,36,6,0.8571428571428571,0.8389057750759878,gemini,mimiciii,progress_note,PROMPT1_ICL_entailment
152,24,23,14,9,0.6086956521739131,33,15,18,0.4545454545454545,0.5204460966542751,gemini,mimiciii,progress_note,PROMPT1_ICL_entailment
153,25,17,15,2,0.8823529411764706,35,13,22,0.3714285714285714,0.5227882037533512,gemini,mimiciii,progress_note,PROMPT1_ICL_entailment
154,26,19,15,4,0.7894736842105263,35,14,21,0.4,0.5309734513274337,gemini,mimiciii,progress_note,PROMPT1_ICL_entailment
155,27,26,17,9,0.6538461538461539,32,14,18,0.4375,0.5242290748898678,gemini,mimiciii,progress_note,PROMPT1_ICL_entailment
156,28,61,45,16,0.7377049180327869,85,73,12,0.8588235294117647,0.7936699685914472,gemini,mimiciii,progress_note,PROMPT1_ICL_entailment
157,29,34,30,4,0.8823529411764706,76,34,42,0.4473684210526316,0.5937136204889406,gemini,mimiciii,progress_note,PROMPT1_ICL_entailment
158,3,91,67,24,0.7362637362637363,273,215,58,0.7875457875457875,0.761041842772612,gemini,mimiciii,progress_note,PROMPT1_ICL_entailment
159,30,26,25,1,0.9615384615384616,29,13,16,0.4482758620689655,0.6114769520225777,gemini,mimiciii,progress_note,PROMPT1_ICL_entailment
160,31,25,23,2,0.92,26,12,14,0.4615384615384615,0.6146993318485524,gemini,mimiciii,progress_note,PROMPT1_ICL_entailment
161,32,73,64,9,0.8767123287671232,152,129,23,0.8486842105263158,0.862470618960564,gemini,mimiciii,progress_note,PROMPT1_ICL_entailment
162,33,63,52,11,0.8253968253968254,106,94,12,0.8867924528301887,0.8549938779079937,gemini,mimiciii,progress_note,PROMPT1_ICL_entailment
163,34,36,28,8,0.7777777777777778,98,47,51,0.4795918367346938,0.5933273219116321,gemini,mimiciii,progress_note,PROMPT1_ICL_entailment
164,35,11,7,4,0.6363636363636364,26,9,17,0.3461538461538461,0.4483985765124554,gemini,mimiciii,progress_note,PROMPT1_ICL_entailment
165,36,42,29,13,0.6904761904761905,60,26,34,0.4333333333333333,0.5324858757062146,gemini,mimiciii,progress_note,PROMPT1_ICL_entailment
166,37,119,103,16,0.865546218487395,344,274,70,0.7965116279069767,0.829595226197125,gemini,mimiciii,progress_note,PROMPT1_ICL_entailment
167,38,29,26,3,0.896551724137931,278,79,199,0.2841726618705036,0.4315579367580628,gemini,mimiciii,progress_note,PROMPT1_ICL_entailment
168,39,64,55,9,0.859375,117,99,18,0.8461538461538461,0.8527131782945736,gemini,mimiciii,progress_note,PROMPT1_ICL_entailment
169,4,91,68,23,0.7472527472527473,282,203,79,0.7198581560283688,0.7332996892347737,gemini,mimiciii,progress_note,PROMPT1_ICL_entailment
170,40,66,57,9,0.8636363636363636,117,100,17,0.8547008547008547,0.8591453764413295,gemini,mimiciii,progress_note,PROMPT1_ICL_entailment
171,41,61,57,4,0.9344262295081968,119,100,19,0.8403361344537815,0.8848870604672825,gemini,mimiciii,progress_note,PROMPT1_ICL_entailment
172,42,56,50,6,0.8928571428571429,119,61,58,0.5126050420168067,0.6512919068972881,gemini,mimiciii,progress_note,PROMPT1_ICL_entailment
173,43,64,35,29,0.546875,117,55,62,0.4700854700854701,0.5055810899540379,gemini,mimiciii,progress_note,PROMPT1_ICL_entailment
174,44,70,64,6,0.9142857142857144,149,122,27,0.8187919463087249,0.8639079442354504,gemini,mimiciii,progress_note,PROMPT1_ICL_entailment
175,45,94,85,9,0.9042553191489362,125,113,12,0.904,0.9041276415493952,gemini,mimiciii,progress_note,PROMPT1_ICL_entailment
176,46,32,29,3,0.90625,52,40,12,0.7692307692307693,0.8321377331420374,gemini,mimiciii,progress_note,PROMPT1_ICL_entailment
177,47,5,4,1,0.8,12,4,8,0.3333333333333333,0.4705882352941176,gemini,mimiciii,progress_note,PROMPT1_ICL_entailment
178,48,56,53,3,0.9464285714285714,49,27,22,0.5510204081632653,0.696519834509613,gemini,mimiciii,progress_note,PROMPT1_ICL_entailment
179,49,66,50,16,0.7575757575757576,87,71,16,0.8160919540229885,0.7857459052678176,gemini,mimiciii,progress_note,PROMPT1_ICL_entailment
180,5,102,75,27,0.7352941176470589,300,91,209,0.3033333333333333,0.4294883896545214,gemini,mimiciii,progress_note,PROMPT1_ICL_entailment
181,50,50,44,6,0.88,176,93,83,0.5284090909090909,0.6603195094400517,gemini,mimiciii,progress_note,PROMPT1_ICL_entailment
182,51,106,66,40,0.6226415094339622,302,224,78,0.7417218543046358,0.6769850718930305,gemini,mimiciii,progress_note,PROMPT1_ICL_entailment
183,52,105,59,46,0.5619047619047619,302,222,80,0.7350993377483444,0.6369383388445827,gemini,mimiciii,progress_note,PROMPT1_ICL_entailment
184,53,75,59,16,0.7866666666666666,382,121,261,0.3167539267015706,0.4516496378072311,gemini,mimiciii,progress_note,PROMPT1_ICL_entailment
185,54,55,43,12,0.7818181818181819,219,63,156,0.2876712328767123,0.4205868653935724,gemini,mimiciii,progress_note,PROMPT1_ICL_entailment
186,55,109,80,29,0.7339449541284404,286,213,73,0.7447552447552448,0.7393105842028765,gemini,mimiciii,progress_note,PROMPT1_ICL_entailment
187,56,13,13,0,1.0,48,16,32,0.3333333333333333,0.5,gemini,mimiciii,progress_note,PROMPT1_ICL_entailment
188,57,1,1,0,1.0,46,29,17,0.6304347826086957,0.7733333333333333,gemini,mimiciii,progress_note,PROMPT1_ICL_entailment
189,58,25,13,12,0.52,39,24,15,0.6153846153846154,0.5636856368563685,gemini,mimiciii,progress_note,PROMPT1_ICL_entailment
190,59,26,17,9,0.6538461538461539,39,21,18,0.5384615384615384,0.5905707196029776,gemini,mimiciii,progress_note,PROMPT1_ICL_entailment
191,6,117,82,35,0.7008547008547008,331,217,114,0.6555891238670695,0.6774666387466448,gemini,mimiciii,progress_note,PROMPT1_ICL_entailment
192,60,100,61,39,0.61,276,203,73,0.7355072463768116,0.6669000430848773,gemini,mimiciii,progress_note,PROMPT1_ICL_entailment
193,61,27,20,7,0.7407407407407407,56,26,30,0.4642857142857143,0.570801317233809,gemini,mimiciii,progress_note,PROMPT1_ICL_entailment
194,62,23,14,9,0.6086956521739131,56,50,6,0.8928571428571429,0.7238883143743537,gemini,mimiciii,progress_note,PROMPT1_ICL_entailment
195,63,72,63,9,0.875,142,121,21,0.852112676056338,0.8634046890927625,gemini,mimiciii,progress_note,PROMPT1_ICL_entailment
196,64,1,0,1,0.0,1,1,0,1.0,0.0,gemini,mimiciii,progress_note,PROMPT1_ICL_entailment
197,65,17,17,0,1.0,12,8,4,0.6666666666666666,0.8,gemini,mimiciii,progress_note,PROMPT1_ICL_entailment
198,66,37,27,10,0.7297297297297297,68,38,30,0.5588235294117647,0.632942628007403,gemini,mimiciii,progress_note,PROMPT1_ICL_entailment
199,67,221,125,96,0.5656108597285068,490,311,179,0.6346938775510204,0.5981643470968834,gemini,mimiciii,progress_note,PROMPT1_ICL_entailment
200,68,1,0,1,0.0,348,168,180,0.4827586206896552,0.0,gemini,mimiciii,progress_note,PROMPT1_ICL_entailment
201,69,141,113,28,0.8014184397163121,373,281,92,0.7533512064343163,0.7766418001712119,gemini,mimiciii,progress_note,PROMPT1_ICL_entailment
202,7,108,76,32,0.7037037037037037,331,210,121,0.6344410876132931,0.6672798728990719,gemini,mimiciii,progress_note,PROMPT1_ICL_entailment
203,70,59,52,7,0.8813559322033898,374,112,262,0.2994652406417112,0.4470371507522259,gemini,mimiciii,progress_note,PROMPT1_ICL_entailment
204,71,117,111,6,0.9487179487179488,372,279,93,0.75,0.8377358490566037,gemini,mimiciii,progress_note,PROMPT1_ICL_entailment
205,72,10,9,1,0.9,20,9,11,0.45,0.6,gemini,mimiciii,progress_note,PROMPT1_ICL_entailment
206,73,197,126,71,0.6395939086294417,460,123,337,0.2673913043478261,0.3771215826550352,gemini,mimiciii,progress_note,PROMPT1_ICL_entailment
207,74,134,104,30,0.7761194029850746,319,246,73,0.7711598746081505,0.773631690353795,gemini,mimiciii,progress_note,PROMPT1_ICL_entailment
208,75,48,43,5,0.8958333333333334,62,51,11,0.8225806451612904,0.8576456785295268,gemini,mimiciii,progress_note,PROMPT1_ICL_entailment
209,76,40,33,7,0.825,86,35,51,0.4069767441860465,0.5450684285040113,gemini,mimiciii,progress_note,PROMPT1_ICL_entailment
210,77,21,20,1,0.9523809523809524,38,31,7,0.8157894736842105,0.8788093550673282,gemini,mimiciii,progress_note,PROMPT1_ICL_entailment
211,78,24,18,6,0.75,30,12,18,0.4,0.5217391304347827,gemini,mimiciii,progress_note,PROMPT1_ICL_entailment
212,79,32,28,4,0.875,67,26,41,0.3880597014925373,0.5376661742983753,gemini,mimiciii,progress_note,PROMPT1_ICL_entailment
213,8,65,52,13,0.8,118,67,51,0.5677966101694916,0.6641883519206939,gemini,mimiciii,progress_note,PROMPT1_ICL_entailment
214,80,27,24,3,0.8888888888888888,32,17,15,0.53125,0.6650366748166259,gemini,mimiciii,progress_note,PROMPT1_ICL_entailment
215,81,45,33,12,0.7333333333333333,46,38,8,0.8260869565217391,0.7769516728624535,gemini,mimiciii,progress_note,PROMPT1_ICL_entailment
216,82,7,7,0,1.0,18,8,10,0.4444444444444444,0.6153846153846153,gemini,mimiciii,progress_note,PROMPT1_ICL_entailment
217,83,35,25,10,0.7142857142857143,66,32,34,0.4848484848484848,0.5776173285198556,gemini,mimiciii,progress_note,PROMPT1_ICL_entailment
218,84,27,23,4,0.8518518518518519,48,28,20,0.5833333333333334,0.69247311827957,gemini,mimiciii,progress_note,PROMPT1_ICL_entailment
219,85,40,37,3,0.925,77,64,13,0.8311688311688312,0.8755777408023664,gemini,mimiciii,progress_note,PROMPT1_ICL_entailment
220,86,62,58,4,0.935483870967742,52,29,23,0.5576923076923077,0.6987951807228916,gemini,mimiciii,progress_note,PROMPT1_ICL_entailment
221,87,11,7,4,0.6363636363636364,15,8,7,0.5333333333333333,0.5803108808290155,gemini,mimiciii,progress_note,PROMPT1_ICL_entailment
222,88,66,58,8,0.8787878787878788,105,52,53,0.4952380952380952,0.6334803612686409,gemini,mimiciii,progress_note,PROMPT1_ICL_entailment
223,89,132,93,39,0.7045454545454546,339,71,268,0.2094395280235988,0.3228929802684662,gemini,mimiciii,progress_note,PROMPT1_ICL_entailment
224,9,53,45,8,0.8490566037735849,61,53,8,0.8688524590163934,0.8588404753330934,gemini,mimiciii,progress_note,PROMPT1_ICL_entailment
225,90,6,6,0,1.0,4,4,0,1.0,1.0,gemini,mimiciii,progress_note,PROMPT1_ICL_entailment
226,91,54,46,8,0.8518518518518519,112,91,21,0.8125,0.8317107093184979,gemini,mimiciii,progress_note,PROMPT1_ICL_entailment
227,92,54,48,6,0.8888888888888888,208,102,106,0.4903846153846153,0.6320681642137876,gemini,mimiciii,progress_note,PROMPT1_ICL_entailment
228,93,21,17,4,0.8095238095238095,38,20,18,0.5263157894736842,0.6378986866791744,gemini,mimiciii,progress_note,PROMPT1_ICL_entailment
229,94,59,46,13,0.7796610169491526,112,65,47,0.5803571428571429,0.6654055858462223,gemini,mimiciii,progress_note,PROMPT1_ICL_entailment
230,95,30,20,10,0.6666666666666666,49,20,29,0.4081632653061224,0.5063291139240507,gemini,mimiciii,progress_note,PROMPT1_ICL_entailment
231,96,9,8,1,0.8888888888888888,14,3,11,0.2142857142857142,0.3453237410071942,gemini,mimiciii,progress_note,PROMPT1_ICL_entailment
232,97,13,13,0,1.0,20,13,7,0.65,0.787878787878788,gemini,mimiciii,progress_note,PROMPT1_ICL_entailment
233,98,18,15,3,0.8333333333333334,35,14,21,0.4,0.5405405405405406,gemini,mimiciii,progress_note,PROMPT1_ICL_entailment
234,99,44,41,3,0.9318181818181818,104,31,73,0.2980769230769231,0.4516702203269368,gemini,mimiciii,progress_note,PROMPT1_ICL_entailment
0,0,64,52,12,0.8125,118,66,52,0.559322033898305,0.6625482625482626,gemini,mimiciii,progress_note,PROMPT2_ICL_entailment
1,1,82,58,24,0.7073170731707317,320,84,236,0.2625,0.3828984596038982,gemini,mimiciii,progress_note,PROMPT2_ICL_entailment
2,10,81,56,25,0.691358024691358,230,130,100,0.5652173913043478,0.6219564288765486,gemini,mimiciii,progress_note,PROMPT2_ICL_entailment
3,100,66,54,12,0.8181818181818182,77,60,17,0.7792207792207793,0.7982261640798227,gemini,mimiciii,progress_note,PROMPT2_ICL_entailment
4,101,36,28,8,0.7777777777777778,36,27,9,0.75,0.7636363636363638,gemini,mimiciii,progress_note,PROMPT2_ICL_entailment
5,102,72,56,16,0.7777777777777778,42,36,6,0.8571428571428571,0.8155339805825242,gemini,mimiciii,progress_note,PROMPT2_ICL_entailment
6,103,77,50,27,0.6493506493506493,204,101,103,0.4950980392156863,0.5618290037269845,gemini,mimiciii,progress_note,PROMPT2_ICL_entailment
7,104,51,29,22,0.5686274509803921,39,33,6,0.8461538461538461,0.6801705756929638,gemini,mimiciii,progress_note,PROMPT2_ICL_entailment
8,105,33,29,4,0.8787878787878788,17,15,2,0.8823529411764706,0.8805668016194331,gemini,mimiciii,progress_note,PROMPT2_ICL_entailment
9,106,30,25,5,0.8333333333333334,40,34,6,0.85,0.8415841584158417,gemini,mimiciii,progress_note,PROMPT2_ICL_entailment
10,107,31,26,5,0.8387096774193549,31,26,5,0.8387096774193549,0.8387096774193549,gemini,mimiciii,progress_note,PROMPT2_ICL_entailment
11,108,52,34,18,0.6538461538461539,68,48,20,0.7058823529411765,0.6788685524126457,gemini,mimiciii,progress_note,PROMPT2_ICL_entailment
12,109,98,90,8,0.9183673469387756,176,99,77,0.5625,0.6976744186046512,gemini,mimiciii,progress_note,PROMPT2_ICL_entailment
13,11,93,71,22,0.7634408602150538,233,69,164,0.296137339055794,0.4267421602787457,gemini,mimiciii,progress_note,PROMPT2_ICL_entailment
14,110,1,0,1,0.0,215,31,184,0.1441860465116279,0.0,gemini,mimiciii,progress_note,PROMPT2_ICL_entailment
15,111,86,63,23,0.7325581395348837,219,115,104,0.5251141552511416,0.6117279520412041,gemini,mimiciii,progress_note,PROMPT2_ICL_entailment
16,112,220,164,56,0.7454545454545455,234,52,182,0.2222222222222222,0.3423799582463465,gemini,mimiciii,progress_note,PROMPT2_ICL_entailment
17,113,79,55,24,0.6962025316455697,196,101,95,0.5153061224489796,0.5922490537875154,gemini,mimiciii,progress_note,PROMPT2_ICL_entailment
18,114,85,57,28,0.6705882352941176,225,91,134,0.4044444444444444,0.5045719844357975,gemini,mimiciii,progress_note,PROMPT2_ICL_entailment
19,115,249,186,63,0.7469879518072289,280,81,199,0.2892857142857143,0.4170576755387618,gemini,mimiciii,progress_note,PROMPT2_ICL_entailment
20,116,41,35,6,0.8536585365853658,35,23,12,0.6571428571428571,0.742619926199262,gemini,mimiciii,progress_note,PROMPT2_ICL_entailment
21,117,25,19,6,0.76,20,17,3,0.85,0.8024844720496895,gemini,mimiciii,progress_note,PROMPT2_ICL_entailment
22,118,53,46,7,0.8679245283018868,23,20,3,0.8695652173913043,0.8687440982058546,gemini,mimiciii,progress_note,PROMPT2_ICL_entailment
23,119,18,17,1,0.9444444444444444,14,12,2,0.8571428571428571,0.8986784140969163,gemini,mimiciii,progress_note,PROMPT2_ICL_entailment
24,12,94,55,39,0.5851063829787234,388,122,266,0.3144329896907216,0.4090465740063399,gemini,mimiciii,progress_note,PROMPT2_ICL_entailment
25,120,45,38,7,0.8444444444444444,64,41,23,0.640625,0.7285480476969838,gemini,mimiciii,progress_note,PROMPT2_ICL_entailment
26,121,23,20,3,0.8695652173913043,14,11,3,0.7857142857142857,0.8255159474671669,gemini,mimiciii,progress_note,PROMPT2_ICL_entailment
27,122,22,13,9,0.5909090909090909,47,28,19,0.5957446808510638,0.593317033414833,gemini,mimiciii,progress_note,PROMPT2_ICL_entailment
28,123,38,34,4,0.8947368421052632,50,28,22,0.56,0.6888567293777135,gemini,mimiciii,progress_note,PROMPT2_ICL_entailment
29,124,42,31,11,0.7380952380952381,65,42,23,0.6461538461538462,0.6890711828526066,gemini,mimiciii,progress_note,PROMPT2_ICL_entailment
30,125,45,32,13,0.7111111111111111,50,29,21,0.58,0.6388984509466438,gemini,mimiciii,progress_note,PROMPT2_ICL_entailment
31,126,27,25,2,0.925925925925926,27,23,4,0.8518518518518519,0.8873456790123457,gemini,mimiciii,progress_note,PROMPT2_ICL_entailment
32,127,21,15,6,0.7142857142857143,27,25,2,0.925925925925926,0.8064516129032259,gemini,mimiciii,progress_note,PROMPT2_ICL_entailment
33,128,49,45,4,0.9183673469387756,37,28,9,0.7567567567567568,0.8297662166611788,gemini,mimiciii,progress_note,PROMPT2_ICL_entailment
34,129,53,34,19,0.6415094339622641,66,54,12,0.8181818181818182,0.719153936545241,gemini,mimiciii,progress_note,PROMPT2_ICL_entailment
35,13,59,42,17,0.711864406779661,106,96,10,0.9056603773584906,0.797153024911032,gemini,mimiciii,progress_note,PROMPT2_ICL_entailment
36,130,52,37,15,0.7115384615384616,44,22,22,0.5,0.5873015873015872,gemini,mimiciii,progress_note,PROMPT2_ICL_entailment
37,131,148,120,28,0.8108108108108109,202,146,56,0.7227722772277227,0.7642645262606876,gemini,mimiciii,progress_note,PROMPT2_ICL_entailment
38,132,202,138,64,0.6831683168316832,193,77,116,0.3989637305699481,0.5037451407983312,gemini,mimiciii,progress_note,PROMPT2_ICL_entailment
39,133,62,49,13,0.7903225806451613,157,87,70,0.554140127388535,0.6514862076870177,gemini,mimiciii,progress_note,PROMPT2_ICL_entailment
40,134,17,13,4,0.7647058823529411,18,12,6,0.6666666666666666,0.7123287671232877,gemini,mimiciii,progress_note,PROMPT2_ICL_entailment
41,135,37,25,12,0.6756756756756757,35,21,14,0.6,0.635593220338983,gemini,mimiciii,progress_note,PROMPT2_ICL_entailment
42,136,37,33,4,0.8918918918918919,43,37,6,0.8604651162790697,0.875896700143472,gemini,mimiciii,progress_note,PROMPT2_ICL_entailment
43,137,25,23,2,0.92,26,24,2,0.9230769230769232,0.9215358931552587,gemini,mimiciii,progress_note,PROMPT2_ICL_entailment
44,138,42,39,3,0.9285714285714286,45,31,14,0.6888888888888889,0.7909715407262022,gemini,mimiciii,progress_note,PROMPT2_ICL_entailment
45,139,44,35,9,0.7954545454545454,45,26,19,0.5777777777777777,0.6693637366678925,gemini,mimiciii,progress_note,PROMPT2_ICL_entailment
46,14,38,35,3,0.9210526315789472,63,38,25,0.6031746031746031,0.7289668402301999,gemini,mimiciii,progress_note,PROMPT2_ICL_entailment
47,140,27,10,17,0.3703703703703703,25,24,1,0.96,0.534521158129176,gemini,mimiciii,progress_note,PROMPT2_ICL_entailment
48,141,48,39,9,0.8125,45,23,22,0.5111111111111111,0.6274921301154249,gemini,mimiciii,progress_note,PROMPT2_ICL_entailment
49,142,53,46,7,0.8679245283018868,50,37,13,0.74,0.7988735038723305,gemini,mimiciii,progress_note,PROMPT2_ICL_entailment
50,143,13,12,1,0.9230769230769232,11,7,4,0.6363636363636364,0.7533632286995515,gemini,mimiciii,progress_note,PROMPT2_ICL_entailment
51,144,62,53,9,0.8548387096774194,50,44,6,0.88,0.8672368910375605,gemini,mimiciii,progress_note,PROMPT2_ICL_entailment
52,145,42,30,12,0.7142857142857143,43,26,17,0.6046511627906976,0.6549118387909321,gemini,mimiciii,progress_note,PROMPT2_ICL_entailment
53,146,59,36,23,0.6101694915254238,32,26,6,0.8125,0.6969471332836932,gemini,mimiciii,progress_note,PROMPT2_ICL_entailment
54,147,52,47,5,0.903846153846154,56,38,18,0.6785714285714286,0.775173611111111,gemini,mimiciii,progress_note,PROMPT2_ICL_entailment
55,148,9,8,1,0.8888888888888888,4,3,1,0.75,0.8135593220338982,gemini,mimiciii,progress_note,PROMPT2_ICL_entailment
56,149,46,42,4,0.9130434782608696,29,24,5,0.8275862068965517,0.8682170542635659,gemini,mimiciii,progress_note,PROMPT2_ICL_entailment
57,15,111,82,29,0.7387387387387387,275,217,58,0.7890909090909091,0.7630851041018933,gemini,mimiciii,progress_note,PROMPT2_ICL_entailment
58,150,54,43,11,0.7962962962962963,83,63,20,0.7590361445783133,0.777219911060106,gemini,mimiciii,progress_note,PROMPT2_ICL_entailment
59,151,143,122,21,0.8531468531468531,201,109,92,0.5422885572139303,0.6630930713804881,gemini,mimiciii,progress_note,PROMPT2_ICL_entailment
60,152,1,0,1,0.0,45,4,41,0.0888888888888888,0.0,gemini,mimiciii,progress_note,PROMPT2_ICL_entailment
61,153,144,117,27,0.8125,219,77,142,0.3515981735159817,0.4908065702378033,gemini,mimiciii,progress_note,PROMPT2_ICL_entailment
62,154,23,23,0,1.0,15,15,0,1.0,1.0,gemini,mimiciii,progress_note,PROMPT2_ICL_entailment
63,155,45,39,6,0.8666666666666667,32,25,7,0.78125,0.8217446270543616,gemini,mimiciii,progress_note,PROMPT2_ICL_entailment
64,156,43,34,9,0.7906976744186046,32,27,5,0.84375,0.8163628279235214,gemini,mimiciii,progress_note,PROMPT2_ICL_entailment
65,157,28,26,2,0.9285714285714286,29,26,3,0.896551724137931,0.912280701754386,gemini,mimiciii,progress_note,PROMPT2_ICL_entailment
66,158,171,131,40,0.7660818713450293,242,111,131,0.4586776859504132,0.5738018665035615,gemini,mimiciii,progress_note,PROMPT2_ICL_entailment
67,159,16,14,2,0.875,22,16,6,0.7272727272727273,0.7943262411347517,gemini,mimiciii,progress_note,PROMPT2_ICL_entailment
68,16,19,15,4,0.7894736842105263,41,17,24,0.4146341463414634,0.5437100213219617,gemini,mimiciii,progress_note,PROMPT2_ICL_entailment
69,160,41,36,5,0.8780487804878049,65,36,29,0.5538461538461539,0.6792452830188679,gemini,mimiciii,progress_note,PROMPT2_ICL_entailment
70,161,90,73,17,0.8111111111111111,201,96,105,0.4776119402985074,0.6012096255308197,gemini,mimiciii,progress_note,PROMPT2_ICL_entailment
71,162,108,83,25,0.7685185185185185,177,72,105,0.4067796610169492,0.5319802376819336,gemini,mimiciii,progress_note,PROMPT2_ICL_entailment
72,163,17,15,2,0.8823529411764706,28,13,15,0.4642857142857143,0.6084243369734789,gemini,mimiciii,progress_note,PROMPT2_ICL_entailment
73,164,51,37,14,0.7254901960784313,57,47,10,0.8245614035087719,0.7718597425654682,gemini,mimiciii,progress_note,PROMPT2_ICL_entailment
74,165,11,10,1,0.9090909090909092,25,12,13,0.48,0.6282722513089004,gemini,mimiciii,progress_note,PROMPT2_ICL_entailment
75,166,36,30,6,0.8333333333333334,42,32,10,0.7619047619047619,0.7960199004975124,gemini,mimiciii,progress_note,PROMPT2_ICL_entailment
76,167,42,36,6,0.8571428571428571,52,35,17,0.6730769230769231,0.7540394973070019,gemini,mimiciii,progress_note,PROMPT2_ICL_entailment
77,168,104,70,34,0.6730769230769231,182,99,83,0.5439560439560439,0.6016669560687619,gemini,mimiciii,progress_note,PROMPT2_ICL_entailment
78,169,156,127,29,0.8141025641025641,219,117,102,0.5342465753424658,0.6451318788668186,gemini,mimiciii,progress_note,PROMPT2_ICL_entailment
79,17,13,12,1,0.9230769230769232,20,6,14,0.3,0.4528301886792453,gemini,mimiciii,progress_note,PROMPT2_ICL_entailment
80,170,134,113,21,0.8432835820895522,184,103,81,0.5597826086956522,0.6728912528184079,gemini,mimiciii,progress_note,PROMPT2_ICL_entailment
81,171,172,146,26,0.8488372093023255,222,104,118,0.4684684684684684,0.603737574552684,gemini,mimiciii,progress_note,PROMPT2_ICL_entailment
82,172,133,112,21,0.8421052631578947,198,116,82,0.5858585858585859,0.6909903201787044,gemini,mimiciii,progress_note,PROMPT2_ICL_entailment
83,173,101,65,36,0.6435643564356436,172,85,87,0.4941860465116279,0.5590690614722995,gemini,mimiciii,progress_note,PROMPT2_ICL_entailment
84,174,105,82,23,0.780952380952381,200,98,102,0.49,0.6021730985387785,gemini,mimiciii,progress_note,PROMPT2_ICL_entailment
85,175,164,137,27,0.8353658536585366,207,88,119,0.4251207729468599,0.5634829753920217,gemini,mimiciii,progress_note,PROMPT2_ICL_entailment
86,176,111,90,21,0.8108108108108109,192,105,87,0.546875,0.6531881804043546,gemini,mimiciii,progress_note,PROMPT2_ICL_entailment
87,177,113,89,24,0.7876106194690266,192,112,80,0.5833333333333334,0.6702528240989779,gemini,mimiciii,progress_note,PROMPT2_ICL_entailment
88,178,21,18,3,0.8571428571428571,17,9,8,0.5294117647058824,0.6545454545454545,gemini,mimiciii,progress_note,PROMPT2_ICL_entailment
89,179,47,34,13,0.723404255319149,197,105,92,0.5329949238578681,0.613771168228316,gemini,mimiciii,progress_note,PROMPT2_ICL_entailment
90,18,28,19,9,0.6785714285714286,29,28,1,0.9655172413793104,0.7970037453183522,gemini,mimiciii,progress_note,PROMPT2_ICL_entailment
91,180,150,99,51,0.66,201,97,104,0.4825870646766169,0.5575198118958461,gemini,mimiciii,progress_note,PROMPT2_ICL_entailment
92,181,148,100,48,0.6756756756756757,208,97,111,0.4663461538461538,0.5518261463192626,gemini,mimiciii,progress_note,PROMPT2_ICL_entailment
93,182,148,110,38,0.7432432432432432,214,112,102,0.5233644859813084,0.6142187655798186,gemini,mimiciii,progress_note,PROMPT2_ICL_entailment
94,183,149,83,66,0.5570469798657718,226,93,133,0.411504424778761,0.4733404875057488,gemini,mimiciii,progress_note,PROMPT2_ICL_entailment
95,184,80,73,7,0.9125,194,106,88,0.5463917525773195,0.6835085239819804,gemini,mimiciii,progress_note,PROMPT2_ICL_entailment
96,185,35,25,10,0.7142857142857143,48,32,16,0.6666666666666666,0.689655172413793,gemini,mimiciii,progress_note,PROMPT2_ICL_entailment
97,186,60,44,16,0.7333333333333333,205,112,93,0.5463414634146342,0.6261753494282083,gemini,mimiciii,progress_note,PROMPT2_ICL_entailment
98,187,109,70,39,0.6422018348623854,170,82,88,0.4823529411764706,0.5509165946827911,gemini,mimiciii,progress_note,PROMPT2_ICL_entailment
99,188,121,102,19,0.8429752066115702,202,101,101,0.5,0.6276923076923078,gemini,mimiciii,progress_note,PROMPT2_ICL_entailment
100,189,194,166,28,0.8556701030927835,225,105,120,0.4666666666666667,0.603950103950104,gemini,mimiciii,progress_note,PROMPT2_ICL_entailment
101,19,36,30,6,0.8333333333333334,54,40,14,0.7407407407407407,0.7843137254901961,gemini,mimiciii,progress_note,PROMPT2_ICL_entailment
102,190,156,134,22,0.8589743589743589,223,90,133,0.4035874439461883,0.5491553207959564,gemini,mimiciii,progress_note,PROMPT2_ICL_entailment
103,191,105,91,14,0.8666666666666667,206,113,93,0.5485436893203883,0.6718499885662017,gemini,mimiciii,progress_note,PROMPT2_ICL_entailment
104,192,113,98,15,0.8672566371681416,208,99,109,0.4759615384615384,0.6146146780273035,gemini,mimiciii,progress_note,PROMPT2_ICL_entailment
105,193,184,134,50,0.7282608695652174,243,84,159,0.345679012345679,0.4688241909284018,gemini,mimiciii,progress_note,PROMPT2_ICL_entailment
106,194,110,79,31,0.7181818181818181,211,122,89,0.5781990521327014,0.640632789391472,gemini,mimiciii,progress_note,PROMPT2_ICL_entailment
107,195,37,35,2,0.945945945945946,44,36,8,0.8181818181818182,0.8774373259052924,gemini,mimiciii,progress_note,PROMPT2_ICL_entailment
108,196,51,42,9,0.8235294117647058,42,29,13,0.6904761904761905,0.7511563367252544,gemini,mimiciii,progress_note,PROMPT2_ICL_entailment
109,197,102,93,9,0.9117647058823528,90,77,13,0.8555555555555555,0.882766272189349,gemini,mimiciii,progress_note,PROMPT2_ICL_entailment
110,198,35,28,7,0.8,34,31,3,0.9117647058823528,0.852233676975945,gemini,mimiciii,progress_note,PROMPT2_ICL_entailment
111,199,53,41,12,0.7735849056603774,52,39,13,0.75,0.7616099071207431,gemini,mimiciii,progress_note,PROMPT2_ICL_entailment
112,2,75,47,28,0.6266666666666667,242,170,72,0.7024793388429752,0.6624108771348036,gemini,mimiciii,progress_note,PROMPT2_ICL_entailment
113,20,34,23,11,0.6764705882352942,47,26,21,0.5531914893617021,0.6086513994910943,gemini,mimiciii,progress_note,PROMPT2_ICL_entailment
114,200,131,74,57,0.5648854961832062,164,66,98,0.4024390243902439,0.4700221345395053,gemini,mimiciii,progress_note,PROMPT2_ICL_entailment
115,201,111,92,19,0.8288288288288288,200,116,84,0.58,0.6824402097454917,gemini,mimiciii,progress_note,PROMPT2_ICL_entailment
116,202,76,61,15,0.8026315789473685,176,65,111,0.3693181818181818,0.5058688440928809,gemini,mimiciii,progress_note,PROMPT2_ICL_entailment
117,203,58,49,9,0.8448275862068966,211,115,96,0.5450236966824644,0.6625903933211829,gemini,mimiciii,progress_note,PROMPT2_ICL_entailment
118,204,117,89,28,0.7606837606837606,201,115,86,0.572139303482587,0.6530755487493619,gemini,mimiciii,progress_note,PROMPT2_ICL_entailment
119,205,149,121,28,0.8120805369127517,195,88,107,0.4512820512820513,0.5801618219958047,gemini,mimiciii,progress_note,PROMPT2_ICL_entailment
120,206,115,96,19,0.8347826086956521,239,119,120,0.497907949790795,0.6237680526358895,gemini,mimiciii,progress_note,PROMPT2_ICL_entailment
121,207,194,122,72,0.6288659793814433,233,86,147,0.3690987124463519,0.4651740190645089,gemini,mimiciii,progress_note,PROMPT2_ICL_entailment
122,208,149,122,27,0.8187919463087249,229,100,129,0.4366812227074236,0.5695877491946403,gemini,mimiciii,progress_note,PROMPT2_ICL_entailment
123,209,122,93,29,0.7622950819672131,205,93,112,0.4536585365853658,0.5688073394495412,gemini,mimiciii,progress_note,PROMPT2_ICL_entailment
124,21,167,115,52,0.688622754491018,373,74,299,0.1983914209115281,0.3080375726204911,gemini,mimiciii,progress_note,PROMPT2_ICL_entailment
125,210,44,40,4,0.9090909090909092,28,25,3,0.8928571428571429,0.9009009009009008,gemini,mimiciii,progress_note,PROMPT2_ICL_entailment
126,211,68,61,7,0.8970588235294118,54,40,14,0.7407407407407407,0.8114399733954106,gemini,mimiciii,progress_note,PROMPT2_ICL_entailment
127,212,23,18,5,0.782608695652174,14,12,2,0.8571428571428571,0.8181818181818182,gemini,mimiciii,progress_note,PROMPT2_ICL_entailment
128,213,27,22,5,0.8148148148148148,41,25,16,0.6097560975609756,0.6975269499048826,gemini,mimiciii,progress_note,PROMPT2_ICL_entailment
129,214,33,31,2,0.9393939393939394,27,20,7,0.7407407407407407,0.8283233132932533,gemini,mimiciii,progress_note,PROMPT2_ICL_entailment
130,215,69,40,29,0.5797101449275363,66,42,24,0.6363636363636364,0.6067172264355363,gemini,mimiciii,progress_note,PROMPT2_ICL_entailment
131,216,67,49,18,0.7313432835820896,67,47,20,0.7014925373134329,0.7161069651741293,gemini,mimiciii,progress_note,PROMPT2_ICL_entailment
132,217,65,56,9,0.8615384615384616,73,44,29,0.6027397260273972,0.7092688543465746,gemini,mimiciii,progress_note,PROMPT2_ICL_entailment
133,218,39,34,5,0.8717948717948718,27,17,10,0.6296296296296297,0.7311827956989246,gemini,mimiciii,progress_note,PROMPT2_ICL_entailment
134,219,22,20,2,0.9090909090909092,17,9,8,0.5294117647058824,0.6691449814126393,gemini,mimiciii,progress_note,PROMPT2_ICL_entailment
135,22,41,29,12,0.7073170731707317,56,48,8,0.8571428571428571,0.7750556792873051,gemini,mimiciii,progress_note,PROMPT2_ICL_entailment
136,220,61,45,16,0.7377049180327869,34,20,14,0.5882352941176471,0.6545454545454545,gemini,mimiciii,progress_note,PROMPT2_ICL_entailment
137,221,133,105,28,0.7894736842105263,188,89,99,0.4734042553191489,0.5918864996674795,gemini,mimiciii,progress_note,PROMPT2_ICL_entailment
138,222,173,131,42,0.7572254335260116,263,141,122,0.5361216730038023,0.627774190259321,gemini,mimiciii,progress_note,PROMPT2_ICL_entailment
139,223,33,31,2,0.9393939393939394,30,20,10,0.6666666666666666,0.779874213836478,gemini,mimiciii,progress_note,PROMPT2_ICL_entailment
140,224,37,31,6,0.8378378378378378,33,22,11,0.6666666666666666,0.7425149700598802,gemini,mimiciii,progress_note,PROMPT2_ICL_entailment
141,225,32,25,7,0.78125,37,24,13,0.6486486486486487,0.7088009450679268,gemini,mimiciii,progress_note,PROMPT2_ICL_entailment
142,226,37,31,6,0.8378378378378378,33,25,8,0.7575757575757576,0.7956878850102669,gemini,mimiciii,progress_note,PROMPT2_ICL_entailment
143,227,9,6,3,0.6666666666666666,15,6,9,0.4,0.5,gemini,mimiciii,progress_note,PROMPT2_ICL_entailment
144,228,1,0,1,0.0,15,9,6,0.6,0.0,gemini,mimiciii,progress_note,PROMPT2_ICL_entailment
145,229,8,8,0,1.0,15,6,9,0.4,0.5714285714285715,gemini,mimiciii,progress_note,PROMPT2_ICL_entailment
146,23,30,21,9,0.7,56,47,9,0.8392857142857143,0.763341067285383,gemini,mimiciii,progress_note,PROMPT2_ICL_entailment
147,230,27,21,6,0.7777777777777778,26,22,4,0.8461538461538461,0.8105263157894737,gemini,mimiciii,progress_note,PROMPT2_ICL_entailment
148,231,53,50,3,0.9433962264150944,102,75,27,0.7352941176470589,0.8264462809917356,gemini,mimiciii,progress_note,PROMPT2_ICL_entailment
149,232,63,51,12,0.8095238095238095,72,55,17,0.7638888888888888,0.7860445565363599,gemini,mimiciii,progress_note,PROMPT2_ICL_entailment
150,233,77,57,20,0.7402597402597403,82,58,24,0.7073170731707317,0.7234135667396061,gemini,mimiciii,progress_note,PROMPT2_ICL_entailment
151,234,48,38,10,0.7916666666666666,42,38,4,0.9047619047619048,0.8444444444444444,gemini,mimiciii,progress_note,PROMPT2_ICL_entailment
152,24,26,14,12,0.5384615384615384,33,15,18,0.4545454545454545,0.4929577464788732,gemini,mimiciii,progress_note,PROMPT2_ICL_entailment
153,25,22,17,5,0.7727272727272727,35,26,9,0.7428571428571429,0.7574978577549272,gemini,mimiciii,progress_note,PROMPT2_ICL_entailment
154,26,12,9,3,0.75,35,11,24,0.3142857142857143,0.4429530201342281,gemini,mimiciii,progress_note,PROMPT2_ICL_entailment
155,27,27,15,12,0.5555555555555556,32,29,3,0.90625,0.6888361045130641,gemini,mimiciii,progress_note,PROMPT2_ICL_entailment
156,28,54,40,14,0.7407407407407407,85,77,8,0.9058823529411764,0.8150304313310398,gemini,mimiciii,progress_note,PROMPT2_ICL_entailment
157,29,34,32,2,0.9411764705882352,76,28,48,0.3684210526315789,0.5295508274231677,gemini,mimiciii,progress_note,PROMPT2_ICL_entailment
158,3,101,61,40,0.6039603960396039,273,115,158,0.4212454212454212,0.496320928258101,gemini,mimiciii,progress_note,PROMPT2_ICL_entailment
159,30,32,29,3,0.90625,29,14,15,0.4827586206896552,0.6299456943366951,gemini,mimiciii,progress_note,PROMPT2_ICL_entailment
160,31,27,24,3,0.8888888888888888,26,16,10,0.6153846153846154,0.7272727272727274,gemini,mimiciii,progress_note,PROMPT2_ICL_entailment
161,32,87,80,7,0.9195402298850576,152,122,30,0.8026315789473685,0.8571177658733644,gemini,mimiciii,progress_note,PROMPT2_ICL_entailment
162,33,101,82,19,0.8118811881188119,106,48,58,0.4528301886792453,0.5813884785819793,gemini,mimiciii,progress_note,PROMPT2_ICL_entailment
163,34,47,35,12,0.7446808510638298,98,49,49,0.5,0.5982905982905983,gemini,mimiciii,progress_note,PROMPT2_ICL_entailment
164,35,17,14,3,0.8235294117647058,26,10,16,0.3846153846153846,0.5243445692883896,gemini,mimiciii,progress_note,PROMPT2_ICL_entailment
165,36,52,37,15,0.7115384615384616,60,43,17,0.7166666666666667,0.7140933572710952,gemini,mimiciii,progress_note,PROMPT2_ICL_entailment
166,37,118,102,16,0.864406779661017,344,274,70,0.7965116279069767,0.8290714921388312,gemini,mimiciii,progress_note,PROMPT2_ICL_entailment
167,38,83,57,26,0.6867469879518072,278,203,75,0.7302158273381295,0.7078146505581893,gemini,mimiciii,progress_note,PROMPT2_ICL_entailment
168,39,59,53,6,0.8983050847457628,117,108,9,0.9230769230769232,0.910522548317824,gemini,mimiciii,progress_note,PROMPT2_ICL_entailment
169,4,86,58,28,0.6744186046511628,282,179,103,0.6347517730496454,0.6539842519685038,gemini,mimiciii,progress_note,PROMPT2_ICL_entailment
170,40,33,27,6,0.8181818181818182,117,59,58,0.5042735042735043,0.6239717978848414,gemini,mimiciii,progress_note,PROMPT2_ICL_entailment
171,41,75,62,13,0.8266666666666667,119,65,54,0.5462184873949579,0.6577980902636089,gemini,mimiciii,progress_note,PROMPT2_ICL_entailment
172,42,66,58,8,0.8787878787878788,119,62,57,0.5210084033613446,0.6541750045479352,gemini,mimiciii,progress_note,PROMPT2_ICL_entailment
173,43,105,65,40,0.6190476190476191,117,82,35,0.7008547008547008,0.6574159728646315,gemini,mimiciii,progress_note,PROMPT2_ICL_entailment
174,44,76,70,6,0.9210526315789472,149,126,23,0.8456375838926175,0.8817354793561932,gemini,mimiciii,progress_note,PROMPT2_ICL_entailment
175,45,72,60,12,0.8333333333333334,125,102,23,0.816,0.824575586095392,gemini,mimiciii,progress_note,PROMPT2_ICL_entailment
176,46,41,37,4,0.902439024390244,52,29,23,0.5576923076923077,0.689367169932541,gemini,mimiciii,progress_note,PROMPT2_ICL_entailment
177,47,6,6,0,1.0,12,4,8,0.3333333333333333,0.5,gemini,mimiciii,progress_note,PROMPT2_ICL_entailment
178,48,64,59,5,0.921875,49,44,5,0.8979591836734694,0.9097599439285088,gemini,mimiciii,progress_note,PROMPT2_ICL_entailment
179,49,76,49,27,0.6447368421052632,87,73,14,0.8390804597701149,0.7291815309346651,gemini,mimiciii,progress_note,PROMPT2_ICL_entailment
180,5,102,75,27,0.7352941176470589,300,75,225,0.25,0.373134328358209,gemini,mimiciii,progress_note,PROMPT2_ICL_entailment
181,50,133,116,17,0.8721804511278195,176,105,71,0.5965909090909091,0.708530874610977,gemini,mimiciii,progress_note,PROMPT2_ICL_entailment
182,51,111,73,38,0.6576576576576577,302,239,63,0.7913907284768212,0.7183530622748329,gemini,mimiciii,progress_note,PROMPT2_ICL_entailment
183,52,115,72,43,0.6260869565217392,302,229,73,0.7582781456953642,0.6858711703654402,gemini,mimiciii,progress_note,PROMPT2_ICL_entailment
184,53,145,96,49,0.6620689655172414,382,263,119,0.6884816753926701,0.6750170438595319,gemini,mimiciii,progress_note,PROMPT2_ICL_entailment
185,54,79,55,24,0.6962025316455697,219,79,140,0.3607305936073059,0.4752269495789128,gemini,mimiciii,progress_note,PROMPT2_ICL_entailment
186,55,125,72,53,0.576,286,208,78,0.7272727272727273,0.6428571428571429,gemini,mimiciii,progress_note,PROMPT2_ICL_entailment
187,56,13,13,0,1.0,48,23,25,0.4791666666666667,0.647887323943662,gemini,mimiciii,progress_note,PROMPT2_ICL_entailment
188,57,37,34,3,0.918918918918919,46,40,6,0.8695652173913043,0.8935611038107754,gemini,mimiciii,progress_note,PROMPT2_ICL_entailment
189,58,29,16,13,0.5517241379310345,39,21,18,0.5384615384615384,0.5450121654501217,gemini,mimiciii,progress_note,PROMPT2_ICL_entailment
190,59,27,14,13,0.5185185185185185,39,20,19,0.5128205128205128,0.5156537753222835,gemini,mimiciii,progress_note,PROMPT2_ICL_entailment
191,6,111,85,26,0.7657657657657657,331,103,228,0.311178247734139,0.4425293166194905,gemini,mimiciii,progress_note,PROMPT2_ICL_entailment
192,60,111,63,48,0.5675675675675675,180,130,50,0.7222222222222222,0.6356228172293363,gemini,mimiciii,progress_note,PROMPT2_ICL_entailment
193,61,28,21,7,0.75,37,28,9,0.7567567567567568,0.7533632286995515,gemini,mimiciii,progress_note,PROMPT2_ICL_entailment
194,62,29,20,9,0.6896551724137931,37,33,4,0.8918918918918919,0.7778432527990572,gemini,mimiciii,progress_note,PROMPT2_ICL_entailment
195,63,71,58,13,0.8169014084507042,96,76,20,0.7916666666666666,0.8040860999635169,gemini,mimiciii,progress_note,PROMPT2_ICL_entailment
196,64,1,0,1,0.0,1,0,1,0.0,,gemini,mimiciii,progress_note,PROMPT2_ICL_entailment
197,65,20,18,2,0.9,8,8,0,1.0,0.9473684210526316,gemini,mimiciii,progress_note,PROMPT2_ICL_entailment
198,66,41,34,7,0.8292682926829268,48,37,11,0.7708333333333334,0.7989838043823436,gemini,mimiciii,progress_note,PROMPT2_ICL_entailment
199,67,238,115,123,0.4831932773109244,285,121,164,0.4245614035087719,0.4519838240787358,gemini,mimiciii,progress_note,PROMPT2_ICL_entailment
200,68,174,119,55,0.6839080459770115,206,96,110,0.4660194174757281,0.5543209277500121,gemini,mimiciii,progress_note,PROMPT2_ICL_entailment
201,69,64,55,9,0.859375,219,125,94,0.5707762557077626,0.6859565976552757,gemini,mimiciii,progress_note,PROMPT2_ICL_entailment
202,7,137,93,44,0.6788321167883211,331,234,97,0.7069486404833837,0.6926051463216689,gemini,mimiciii,progress_note,PROMPT2_ICL_entailment
203,70,101,80,21,0.7920792079207921,217,102,115,0.4700460829493088,0.5899790326079097,gemini,mimiciii,progress_note,PROMPT2_ICL_entailment
204,71,129,115,14,0.8914728682170543,213,106,107,0.4976525821596244,0.6387382430768425,gemini,mimiciii,progress_note,PROMPT2_ICL_entailment
205,72,6,5,1,0.8333333333333334,15,7,8,0.4666666666666667,0.5982905982905983,gemini,mimiciii,progress_note,PROMPT2_ICL_entailment
206,73,203,132,71,0.6502463054187192,264,104,160,0.3939393939393939,0.4906361686919227,gemini,mimiciii,progress_note,PROMPT2_ICL_entailment
207,74,122,93,29,0.7622950819672131,184,110,74,0.5978260869565217,0.6701165989781213,gemini,mimiciii,progress_note,PROMPT2_ICL_entailment
208,75,53,42,11,0.7924528301886793,40,22,18,0.55,0.6493323963457485,gemini,mimiciii,progress_note,PROMPT2_ICL_entailment
209,76,53,37,16,0.6981132075471698,58,43,15,0.7413793103448276,0.7190960451977402,gemini,mimiciii,progress_note,PROMPT2_ICL_entailment
210,77,22,21,1,0.9545454545454546,27,19,8,0.7037037037037037,0.8101522842639594,gemini,mimiciii,progress_note,PROMPT2_ICL_entailment
211,78,33,29,4,0.8787878787878788,20,16,4,0.8,0.8375451263537907,gemini,mimiciii,progress_note,PROMPT2_ICL_entailment
212,79,34,27,7,0.7941176470588235,43,30,13,0.6976744186046512,0.7427785419532325,gemini,mimiciii,progress_note,PROMPT2_ICL_entailment
213,8,74,57,17,0.7702702702702703,118,110,8,0.9322033898305084,0.8435355845553612,gemini,mimiciii,progress_note,PROMPT2_ICL_entailment
214,80,37,31,6,0.8378378378378378,21,16,5,0.7619047619047619,0.7980691874497184,gemini,mimiciii,progress_note,PROMPT2_ICL_entailment
215,81,49,39,10,0.7959183673469388,32,25,7,0.78125,0.7885159725030327,gemini,mimiciii,progress_note,PROMPT2_ICL_entailment
216,82,11,5,6,0.4545454545454545,15,2,13,0.1333333333333333,0.2061855670103092,gemini,mimiciii,progress_note,PROMPT2_ICL_entailment
217,83,44,35,9,0.7954545454545454,43,35,8,0.813953488372093,0.8045977011494252,gemini,mimiciii,progress_note,PROMPT2_ICL_entailment
218,84,31,22,9,0.7096774193548387,35,28,7,0.8,0.7521367521367521,gemini,mimiciii,progress_note,PROMPT2_ICL_entailment
219,85,47,42,5,0.8936170212765957,50,35,15,0.7,0.7850467289719626,gemini,mimiciii,progress_note,PROMPT2_ICL_entailment
220,86,67,62,5,0.9253731343283582,32,28,4,0.875,0.899481865284974,gemini,mimiciii,progress_note,PROMPT2_ICL_entailment
221,87,9,2,7,0.2222222222222222,12,0,12,0.0,0.0,gemini,mimiciii,progress_note,PROMPT2_ICL_entailment
222,88,75,58,17,0.7733333333333333,67,47,20,0.7014925373134329,0.7356632033463769,gemini,mimiciii,progress_note,PROMPT2_ICL_entailment
223,89,117,89,28,0.7606837606837606,199,87,112,0.4371859296482412,0.555252778773754,gemini,mimiciii,progress_note,PROMPT2_ICL_entailment
224,9,37,34,3,0.918918918918919,61,27,34,0.4426229508196721,0.5974617637487797,gemini,mimiciii,progress_note,PROMPT2_ICL_entailment
225,90,9,7,2,0.7777777777777778,3,3,0,1.0,0.8750000000000001,gemini,mimiciii,progress_note,PROMPT2_ICL_entailment
226,91,46,40,6,0.8695652173913043,79,58,21,0.7341772151898734,0.7961564859299932,gemini,mimiciii,progress_note,PROMPT2_ICL_entailment
227,92,75,58,17,0.7733333333333333,143,84,59,0.5874125874125874,0.6676716458818692,gemini,mimiciii,progress_note,PROMPT2_ICL_entailment
228,93,19,16,3,0.8421052631578947,27,21,6,0.7777777777777778,0.8086642599277979,gemini,mimiciii,progress_note,PROMPT2_ICL_entailment
229,94,50,42,8,0.84,80,47,33,0.5875,0.6914185639229422,gemini,mimiciii,progress_note,PROMPT2_ICL_entailment
230,95,39,25,14,0.6410256410256411,32,24,8,0.75,0.6912442396313365,gemini,mimiciii,progress_note,PROMPT2_ICL_entailment
231,96,8,7,1,0.875,11,4,7,0.3636363636363636,0.5137614678899082,gemini,mimiciii,progress_note,PROMPT2_ICL_entailment
232,97,14,13,1,0.9285714285714286,14,11,3,0.7857142857142857,0.851190476190476,gemini,mimiciii,progress_note,PROMPT2_ICL_entailment
233,98,24,19,5,0.7916666666666666,24,17,7,0.7083333333333334,0.7476851851851851,gemini,mimiciii,progress_note,PROMPT2_ICL_entailment
234,99,56,50,6,0.8928571428571429,70,41,29,0.5857142857142857,0.707384403036577,gemini,mimiciii,progress_note,PROMPT2_ICL_entailment
0,0,64,51,13,0.796875,118,108,10,0.9152542372881356,0.8519721577726218,gemini,mimiciii,progress_note,PROMPT2_entailment
1,1,119,87,32,0.7310924369747899,320,233,87,0.728125,0.7296057012255475,gemini,mimiciii,progress_note,PROMPT2_entailment
2,10,85,54,31,0.6352941176470588,230,164,66,0.7130434782608696,0.671927162367223,gemini,mimiciii,progress_note,PROMPT2_entailment
3,100,59,48,11,0.8135593220338984,115,99,16,0.8608695652173913,0.8365460786902563,gemini,mimiciii,progress_note,PROMPT2_entailment
4,101,34,23,11,0.6764705882352942,49,24,25,0.4897959183673469,0.5681935151827072,gemini,mimiciii,progress_note,PROMPT2_entailment
5,102,66,47,19,0.7121212121212122,67,58,9,0.8656716417910447,0.7814246810950264,gemini,mimiciii,progress_note,PROMPT2_entailment
6,103,97,67,30,0.6907216494845361,347,260,87,0.7492795389048992,0.7188099610060038,gemini,mimiciii,progress_note,PROMPT2_entailment
7,104,23,15,8,0.6521739130434783,57,43,14,0.7543859649122807,0.6995661605206075,gemini,mimiciii,progress_note,PROMPT2_entailment
8,105,34,29,5,0.8529411764705882,28,26,2,0.9285714285714286,0.8891509433962265,gemini,mimiciii,progress_note,PROMPT2_entailment
9,106,26,22,4,0.8461538461538461,58,52,6,0.896551724137931,0.8706240487062404,gemini,mimiciii,progress_note,PROMPT2_entailment
10,107,27,23,4,0.8518518518518519,53,23,30,0.4339622641509434,0.5750000000000001,gemini,mimiciii,progress_note,PROMPT2_entailment
11,108,52,43,9,0.8269230769230769,94,75,19,0.7978723404255319,0.8121380005036514,gemini,mimiciii,progress_note,PROMPT2_entailment
12,109,92,78,14,0.8478260869565217,311,248,63,0.797427652733119,0.8218549517780516,gemini,mimiciii,progress_note,PROMPT2_entailment
13,11,69,50,19,0.7246376811594203,233,164,69,0.703862660944206,0.7140991030218583,gemini,mimiciii,progress_note,PROMPT2_entailment
14,110,85,56,29,0.6588235294117647,358,282,76,0.7877094972067039,0.7175246490072243,gemini,mimiciii,progress_note,PROMPT2_entailment
15,111,74,43,31,0.581081081081081,389,258,131,0.6632390745501285,0.6194477791116446,gemini,mimiciii,progress_note,PROMPT2_entailment
16,112,45,33,12,0.7333333333333333,400,127,273,0.3175,0.4431403647898493,gemini,mimiciii,progress_note,PROMPT2_entailment
17,113,98,64,34,0.6530612244897959,340,118,222,0.3470588235294117,0.4532469091345577,gemini,mimiciii,progress_note,PROMPT2_entailment
18,114,74,55,19,0.7432432432432432,401,248,153,0.6184538653366584,0.6751305466874552,gemini,mimiciii,progress_note,PROMPT2_entailment
19,115,151,102,49,0.6754966887417219,479,310,169,0.6471816283924844,0.6610360831207928,gemini,mimiciii,progress_note,PROMPT2_entailment
20,116,39,34,5,0.8717948717948718,53,44,9,0.8301886792452831,0.8504832291074474,gemini,mimiciii,progress_note,PROMPT2_entailment
21,117,22,19,3,0.8636363636363636,33,18,15,0.5454545454545454,0.6686217008797654,gemini,mimiciii,progress_note,PROMPT2_entailment
22,118,43,37,6,0.8604651162790697,41,18,23,0.4390243902439024,0.5814054997817547,gemini,mimiciii,progress_note,PROMPT2_entailment
23,119,16,16,0,1.0,21,20,1,0.9523809523809524,0.975609756097561,gemini,mimiciii,progress_note,PROMPT2_entailment
24,12,145,94,51,0.6482758620689655,388,247,141,0.6365979381443299,0.6423838311176283,gemini,mimiciii,progress_note,PROMPT2_entailment
25,120,37,33,4,0.8918918918918919,95,42,53,0.4421052631578947,0.5911708253358925,gemini,mimiciii,progress_note,PROMPT2_entailment
26,121,19,17,2,0.8947368421052632,23,20,3,0.8695652173913043,0.8819714656290532,gemini,mimiciii,progress_note,PROMPT2_entailment
27,122,25,16,9,0.64,71,55,16,0.7746478873239436,0.700915969733174,gemini,mimiciii,progress_note,PROMPT2_entailment
28,123,29,24,5,0.8275862068965517,72,26,46,0.3611111111111111,0.5028203062046737,gemini,mimiciii,progress_note,PROMPT2_entailment
29,124,35,26,9,0.7428571428571429,96,46,50,0.4791666666666667,0.5825621042377009,gemini,mimiciii,progress_note,PROMPT2_entailment
30,125,21,15,6,0.7142857142857143,72,32,40,0.4444444444444444,0.5479452054794521,gemini,mimiciii,progress_note,PROMPT2_entailment
31,126,19,16,3,0.8421052631578947,41,33,8,0.8048780487804879,0.8230709275136399,gemini,mimiciii,progress_note,PROMPT2_entailment
32,127,20,15,5,0.75,41,37,4,0.902439024390244,0.8191881918819189,gemini,mimiciii,progress_note,PROMPT2_entailment
33,128,41,34,7,0.8292682926829268,56,30,26,0.5357142857142857,0.6509253350350989,gemini,mimiciii,progress_note,PROMPT2_entailment
34,129,50,24,26,0.48,100,89,11,0.89,0.6236496350364963,gemini,mimiciii,progress_note,PROMPT2_entailment
35,13,37,29,8,0.7837837837837838,106,94,12,0.8867924528301887,0.832112332112332,gemini,mimiciii,progress_note,PROMPT2_entailment
36,130,40,28,12,0.7,64,39,25,0.609375,0.6515513126491647,gemini,mimiciii,progress_note,PROMPT2_entailment
37,131,71,59,12,0.8309859154929577,343,247,96,0.7201166180758017,0.771588923598242,gemini,mimiciii,progress_note,PROMPT2_entailment
38,132,105,73,32,0.6952380952380952,333,257,76,0.7717717717717718,0.7315085585058682,gemini,mimiciii,progress_note,PROMPT2_entailment
39,133,88,59,29,0.6704545454545454,271,194,77,0.7158671586715867,0.6924170472762469,gemini,mimiciii,progress_note,PROMPT2_entailment
40,134,16,11,5,0.6875,24,14,10,0.5833333333333334,0.6311475409836065,gemini,mimiciii,progress_note,PROMPT2_entailment
41,135,31,28,3,0.9032258064516128,50,24,26,0.48,0.626865671641791,gemini,mimiciii,progress_note,PROMPT2_entailment
42,136,35,32,3,0.9142857142857144,58,41,17,0.7068965517241379,0.7973260407171073,gemini,mimiciii,progress_note,PROMPT2_entailment
43,137,24,23,1,0.9583333333333334,36,25,11,0.6944444444444444,0.8053221288515408,gemini,mimiciii,progress_note,PROMPT2_entailment
44,138,29,27,2,0.9310344827586208,66,44,22,0.6666666666666666,0.776978417266187,gemini,mimiciii,progress_note,PROMPT2_entailment
45,139,36,29,7,0.8055555555555556,70,36,34,0.5142857142857142,0.6277811184606134,gemini,mimiciii,progress_note,PROMPT2_entailment
46,14,1,0,1,0.0,63,0,63,0.0,,gemini,mimiciii,progress_note,PROMPT2_entailment
47,140,22,8,14,0.3636363636363636,39,22,17,0.5641025641025641,0.4422110552763819,gemini,mimiciii,progress_note,PROMPT2_entailment
48,141,35,27,8,0.7714285714285715,70,36,34,0.5142857142857142,0.6171428571428572,gemini,mimiciii,progress_note,PROMPT2_entailment
49,142,47,43,4,0.9148936170212766,72,57,15,0.7916666666666666,0.8488311688311687,gemini,mimiciii,progress_note,PROMPT2_entailment
50,143,7,7,0,1.0,16,12,4,0.75,0.8571428571428571,gemini,mimiciii,progress_note,PROMPT2_entailment
51,144,42,39,3,0.9285714285714286,72,65,7,0.9027777777777778,0.9154929577464788,gemini,mimiciii,progress_note,PROMPT2_entailment
52,145,24,16,8,0.6666666666666666,63,32,31,0.5079365079365079,0.5765765765765767,gemini,mimiciii,progress_note,PROMPT2_entailment
53,146,48,33,15,0.6875,50,46,4,0.92,0.786936236391913,gemini,mimiciii,progress_note,PROMPT2_entailment
54,147,41,35,6,0.8536585365853658,80,40,40,0.5,0.6306306306306306,gemini,mimiciii,progress_note,PROMPT2_entailment
55,148,6,5,1,0.8333333333333334,6,5,1,0.8333333333333334,0.8333333333333334,gemini,mimiciii,progress_note,PROMPT2_entailment
56,149,38,36,2,0.9473684210526316,46,43,3,0.9347826086956522,0.941033434650456,gemini,mimiciii,progress_note,PROMPT2_entailment
57,15,99,74,25,0.7474747474747475,275,226,49,0.8218181818181818,0.7828854976125832,gemini,mimiciii,progress_note,PROMPT2_entailment
58,150,55,43,12,0.7818181818181819,121,74,47,0.6115702479338843,0.686293540386067,gemini,mimiciii,progress_note,PROMPT2_entailment
59,151,100,91,9,0.91,340,115,225,0.3382352941176471,0.4931668237511781,gemini,mimiciii,progress_note,PROMPT2_entailment
60,152,1,0,1,0.0,65,2,63,0.0307692307692307,0.0,gemini,mimiciii,progress_note,PROMPT2_entailment
61,153,80,68,12,0.85,368,251,117,0.6820652173913043,0.7568286626463285,gemini,mimiciii,progress_note,PROMPT2_entailment
62,154,18,17,1,0.9444444444444444,23,22,1,0.9565217391304348,0.9504447268106736,gemini,mimiciii,progress_note,PROMPT2_entailment
63,155,19,15,4,0.7894736842105263,49,26,23,0.5306122448979592,0.6346623270951994,gemini,mimiciii,progress_note,PROMPT2_entailment
64,156,20,16,4,0.8,49,39,10,0.7959183673469388,0.7979539641943735,gemini,mimiciii,progress_note,PROMPT2_entailment
65,157,27,21,6,0.7777777777777778,41,25,16,0.6097560975609756,0.68359375,gemini,mimiciii,progress_note,PROMPT2_entailment
66,158,113,93,20,0.8230088495575221,411,278,133,0.6763990267639902,0.742536295360225,gemini,mimiciii,progress_note,PROMPT2_entailment
67,159,16,14,2,0.875,35,28,7,0.8,0.8358208955223881,gemini,mimiciii,progress_note,PROMPT2_entailment
68,16,25,19,6,0.76,41,23,18,0.5609756097560976,0.6454948301329395,gemini,mimiciii,progress_note,PROMPT2_entailment
69,160,30,18,12,0.6,96,74,22,0.7708333333333334,0.6747720364741642,gemini,mimiciii,progress_note,PROMPT2_entailment
70,161,95,78,17,0.8210526315789474,343,97,246,0.282798833819242,0.4206955989880174,gemini,mimiciii,progress_note,PROMPT2_entailment
71,162,66,57,9,0.8636363636363636,300,63,237,0.21,0.3378492802709568,gemini,mimiciii,progress_note,PROMPT2_entailment
72,163,21,17,4,0.8095238095238095,39,22,17,0.5641025641025641,0.6648888888888889,gemini,mimiciii,progress_note,PROMPT2_entailment
73,164,35,28,7,0.8,82,40,42,0.4878048780487805,0.6060606060606061,gemini,mimiciii,progress_note,PROMPT2_entailment
74,165,13,13,0,1.0,32,21,11,0.65625,0.7924528301886793,gemini,mimiciii,progress_note,PROMPT2_entailment
75,166,28,24,4,0.8571428571428571,59,54,5,0.9152542372881356,0.8852459016393444,gemini,mimiciii,progress_note,PROMPT2_entailment
76,167,32,27,5,0.84375,85,36,49,0.4235294117647059,0.5639686684073107,gemini,mimiciii,progress_note,PROMPT2_entailment
77,168,118,82,36,0.6949152542372882,312,81,231,0.2596153846153846,0.3780092197370667,gemini,mimiciii,progress_note,PROMPT2_entailment
78,169,102,91,11,0.8921568627450981,377,263,114,0.6976127320954907,0.7829813684916493,gemini,mimiciii,progress_note,PROMPT2_entailment
79,17,8,6,2,0.75,20,16,4,0.8,0.7741935483870969,gemini,mimiciii,progress_note,PROMPT2_entailment
80,170,143,92,51,0.6433566433566433,318,58,260,0.1823899371069182,0.2842077230359521,gemini,mimiciii,progress_note,PROMPT2_entailment
81,171,185,150,35,0.8108108108108109,387,73,314,0.1886304909560723,0.3060582768499755,gemini,mimiciii,progress_note,PROMPT2_entailment
82,172,119,105,14,0.8823529411764706,342,246,96,0.7192982456140351,0.7925257731958762,gemini,mimiciii,progress_note,PROMPT2_entailment
83,173,117,69,48,0.5897435897435898,299,221,78,0.7391304347826086,0.656040268456376,gemini,mimiciii,progress_note,PROMPT2_entailment
84,174,97,86,11,0.8865979381443299,351,126,225,0.358974358974359,0.5110356536502546,gemini,mimiciii,progress_note,PROMPT2_entailment
85,175,158,139,19,0.879746835443038,354,166,188,0.4689265536723164,0.611766577405414,gemini,mimiciii,progress_note,PROMPT2_entailment
86,176,97,80,17,0.8247422680412371,330,228,102,0.6909090909090909,0.751916893395993,gemini,mimiciii,progress_note,PROMPT2_entailment
87,177,117,77,40,0.6581196581196581,330,190,140,0.5757575757575758,0.6141897565071368,gemini,mimiciii,progress_note,PROMPT2_entailment
88,178,17,14,3,0.8235294117647058,23,14,9,0.6086956521739131,0.7,gemini,mimiciii,progress_note,PROMPT2_entailment
89,179,90,65,25,0.7222222222222222,341,247,94,0.7243401759530792,0.7232796486090777,gemini,mimiciii,progress_note,PROMPT2_entailment
90,18,24,18,6,0.75,29,27,2,0.9310344827586208,0.8307692307692308,gemini,mimiciii,progress_note,PROMPT2_entailment
91,180,132,96,36,0.7272727272727273,343,218,125,0.6355685131195336,0.678335278101906,gemini,mimiciii,progress_note,PROMPT2_entailment
92,181,130,85,45,0.6538461538461539,366,85,281,0.2322404371584699,0.342741935483871,gemini,mimiciii,progress_note,PROMPT2_entailment
93,182,119,93,26,0.7815126050420168,367,236,131,0.6430517711171662,0.7055533231535802,gemini,mimiciii,progress_note,PROMPT2_entailment
94,183,123,91,32,0.7398373983739838,389,114,275,0.2930591259640103,0.4198215333562656,gemini,mimiciii,progress_note,PROMPT2_entailment
95,184,82,74,8,0.902439024390244,330,115,215,0.3484848484848485,0.5028064992614476,gemini,mimiciii,progress_note,PROMPT2_entailment
96,185,35,24,11,0.6857142857142857,69,30,39,0.4347826086956521,0.5321507760532151,gemini,mimiciii,progress_note,PROMPT2_entailment
97,186,115,90,25,0.782608695652174,352,117,235,0.3323863636363636,0.4666001994017946,gemini,mimiciii,progress_note,PROMPT2_entailment
98,187,64,53,11,0.828125,295,215,80,0.7288135593220338,0.7753019220955945,gemini,mimiciii,progress_note,PROMPT2_entailment
99,188,103,90,13,0.8737864077669902,357,102,255,0.2857142857142857,0.4306220095693779,gemini,mimiciii,progress_note,PROMPT2_entailment
100,189,163,133,30,0.8159509202453987,394,293,101,0.7436548223350253,0.7781272151835543,gemini,mimiciii,progress_note,PROMPT2_entailment
101,19,28,25,3,0.8928571428571429,54,24,30,0.4444444444444444,0.5934718100890207,gemini,mimiciii,progress_note,PROMPT2_entailment
102,190,147,120,27,0.8163265306122449,390,179,211,0.4589743589743589,0.5875836034631324,gemini,mimiciii,progress_note,PROMPT2_entailment
103,191,97,90,7,0.9278350515463918,359,115,244,0.3203342618384401,0.4762452548027148,gemini,mimiciii,progress_note,PROMPT2_entailment
104,192,115,101,14,0.8782608695652174,360,268,92,0.7444444444444445,0.8058350699612981,gemini,mimiciii,progress_note,PROMPT2_entailment
105,193,165,130,35,0.7878787878787878,415,282,133,0.6795180722891566,0.7296974522292994,gemini,mimiciii,progress_note,PROMPT2_entailment
106,194,112,79,33,0.7053571428571429,365,95,270,0.2602739726027397,0.3802406586447118,gemini,mimiciii,progress_note,PROMPT2_entailment
107,195,29,28,1,0.9655172413793104,60,36,24,0.6,0.7400881057268723,gemini,mimiciii,progress_note,PROMPT2_entailment
108,196,44,36,8,0.8181818181818182,61,51,10,0.8360655737704918,0.8270270270270271,gemini,mimiciii,progress_note,PROMPT2_entailment
109,197,78,71,7,0.9102564102564102,137,114,23,0.8321167883211679,0.8694344486814544,gemini,mimiciii,progress_note,PROMPT2_entailment
110,198,39,34,5,0.8717948717948718,47,30,17,0.6382978723404256,0.7369942196531792,gemini,mimiciii,progress_note,PROMPT2_entailment
111,199,36,33,3,0.9166666666666666,76,63,13,0.8289473684210527,0.8706030150753769,gemini,mimiciii,progress_note,PROMPT2_entailment
112,2,67,43,24,0.6417910447761194,242,64,178,0.2644628099173554,0.3745746563223084,gemini,mimiciii,progress_note,PROMPT2_entailment
113,20,24,17,7,0.7083333333333334,47,27,20,0.574468085106383,0.6344160331720803,gemini,mimiciii,progress_note,PROMPT2_entailment
114,200,90,53,37,0.5888888888888889,276,71,205,0.2572463768115942,0.3580740317822818,gemini,mimiciii,progress_note,PROMPT2_entailment
115,201,27,25,2,0.925925925925926,343,245,98,0.7142857142857143,0.8064516129032259,gemini,mimiciii,progress_note,PROMPT2_entailment
116,202,114,79,35,0.6929824561403509,295,196,99,0.6644067796610169,0.6783938311901685,gemini,mimiciii,progress_note,PROMPT2_entailment
117,203,73,63,10,0.863013698630137,367,92,275,0.2506811989100817,0.3885109092737205,gemini,mimiciii,progress_note,PROMPT2_entailment
118,204,99,67,32,0.6767676767676768,349,218,131,0.6246418338108882,0.6496608473256977,gemini,mimiciii,progress_note,PROMPT2_entailment
119,205,127,98,29,0.7716535433070866,329,246,83,0.7477203647416414,0.7594984563039505,gemini,mimiciii,progress_note,PROMPT2_entailment
120,206,106,89,17,0.839622641509434,421,138,283,0.3277909738717339,0.4715050770677774,gemini,mimiciii,progress_note,PROMPT2_entailment
121,207,104,88,16,0.8461538461538461,403,159,244,0.3945409429280397,0.5381538461538462,gemini,mimiciii,progress_note,PROMPT2_entailment
122,208,120,100,20,0.8333333333333334,395,275,120,0.6962025316455697,0.7586206896551724,gemini,mimiciii,progress_note,PROMPT2_entailment
123,209,38,27,11,0.7105263157894737,351,116,235,0.3304843304843304,0.4511343176089304,gemini,mimiciii,progress_note,PROMPT2_entailment
124,21,56,45,11,0.8035714285714286,373,279,94,0.7479892761394102,0.7747847820049987,gemini,mimiciii,progress_note,PROMPT2_entailment
125,210,41,35,6,0.8536585365853658,45,26,19,0.5777777777777777,0.6891329042029534,gemini,mimiciii,progress_note,PROMPT2_entailment
126,211,28,20,8,0.7142857142857143,89,45,44,0.5056179775280899,0.5921052631578948,gemini,mimiciii,progress_note,PROMPT2_entailment
127,212,21,15,6,0.7142857142857143,22,13,9,0.5909090909090909,0.6467661691542289,gemini,mimiciii,progress_note,PROMPT2_entailment
128,213,41,36,5,0.8780487804878049,62,49,13,0.7903225806451613,0.8318792737561895,gemini,mimiciii,progress_note,PROMPT2_entailment
129,214,28,26,2,0.9285714285714286,39,14,25,0.358974358974359,0.5177809388335705,gemini,mimiciii,progress_note,PROMPT2_entailment
130,215,68,41,27,0.6029411764705882,101,82,19,0.8118811881188119,0.6919831223628693,gemini,mimiciii,progress_note,PROMPT2_entailment
131,216,64,52,12,0.8125,103,80,23,0.7766990291262136,0.7941962581137838,gemini,mimiciii,progress_note,PROMPT2_entailment
132,217,69,51,18,0.7391304347826086,114,84,30,0.7368421052631579,0.7379844961240309,gemini,mimiciii,progress_note,PROMPT2_entailment
133,218,38,35,3,0.9210526315789472,41,38,3,0.926829268292683,0.9239319208058354,gemini,mimiciii,progress_note,PROMPT2_entailment
134,219,19,17,2,0.8947368421052632,22,17,5,0.7727272727272727,0.8292682926829269,gemini,mimiciii,progress_note,PROMPT2_entailment
135,22,29,23,6,0.7931034482758621,56,46,10,0.8214285714285714,0.8070175438596492,gemini,mimiciii,progress_note,PROMPT2_entailment
136,220,37,30,7,0.8108108108108109,50,27,23,0.54,0.6482593037214887,gemini,mimiciii,progress_note,PROMPT2_entailment
137,221,89,66,23,0.7415730337078652,333,262,71,0.7867867867867868,0.7635111268103145,gemini,mimiciii,progress_note,PROMPT2_entailment
138,222,132,93,39,0.7045454545454546,458,348,110,0.759825327510917,0.7311419857675365,gemini,mimiciii,progress_note,PROMPT2_entailment
139,223,24,19,5,0.7916666666666666,45,19,26,0.4222222222222222,0.5507246376811594,gemini,mimiciii,progress_note,PROMPT2_entailment
140,224,34,28,6,0.8235294117647058,50,37,13,0.74,0.7795334838224228,gemini,mimiciii,progress_note,PROMPT2_entailment
141,225,18,16,2,0.8888888888888888,56,43,13,0.7678571428571429,0.8239520958083834,gemini,mimiciii,progress_note,PROMPT2_entailment
142,226,29,25,4,0.8620689655172413,50,25,25,0.5,0.6329113924050632,gemini,mimiciii,progress_note,PROMPT2_entailment
143,227,6,6,0,1.0,18,3,15,0.1666666666666666,0.2857142857142857,gemini,mimiciii,progress_note,PROMPT2_entailment
144,228,6,6,0,1.0,18,3,15,0.1666666666666666,0.2857142857142857,gemini,mimiciii,progress_note,PROMPT2_entailment
145,229,5,5,0,1.0,18,6,12,0.3333333333333333,0.5,gemini,mimiciii,progress_note,PROMPT2_entailment
146,23,26,18,8,0.6923076923076923,56,31,25,0.5535714285714286,0.6152149944873209,gemini,mimiciii,progress_note,PROMPT2_entailment
147,230,20,11,9,0.55,40,15,25,0.375,0.4459459459459459,gemini,mimiciii,progress_note,PROMPT2_entailment
148,231,39,37,2,0.9487179487179488,152,58,94,0.3815789473684211,0.5442556429114888,gemini,mimiciii,progress_note,PROMPT2_entailment
149,232,69,45,24,0.6521739130434783,108,44,64,0.4074074074074074,0.5015197568389058,gemini,mimiciii,progress_note,PROMPT2_entailment
150,233,54,36,18,0.6666666666666666,116,69,47,0.5948275862068966,0.6287015945330295,gemini,mimiciii,progress_note,PROMPT2_entailment
151,234,30,27,3,0.9,59,33,26,0.559322033898305,0.6898954703832751,gemini,mimiciii,progress_note,PROMPT2_entailment
152,24,26,19,7,0.7307692307692307,33,14,19,0.4242424242424242,0.5368314833501514,gemini,mimiciii,progress_note,PROMPT2_entailment
153,25,16,13,3,0.8125,35,13,22,0.3714285714285714,0.5098039215686275,gemini,mimiciii,progress_note,PROMPT2_entailment
154,26,19,14,5,0.7368421052631579,35,22,13,0.6285714285714286,0.6784140969162994,gemini,mimiciii,progress_note,PROMPT2_entailment
155,27,26,13,13,0.5,32,17,15,0.53125,0.5151515151515151,gemini,mimiciii,progress_note,PROMPT2_entailment
156,28,35,26,9,0.7428571428571429,85,74,11,0.8705882352941177,0.8016666666666666,gemini,mimiciii,progress_note,PROMPT2_entailment
157,29,33,31,2,0.9393939393939394,76,38,38,0.5,0.6526315789473685,gemini,mimiciii,progress_note,PROMPT2_entailment
158,3,70,45,25,0.6428571428571429,273,203,70,0.7435897435897436,0.6895640686922061,gemini,mimiciii,progress_note,PROMPT2_entailment
159,30,25,20,5,0.8,29,12,17,0.4137931034482758,0.5454545454545454,gemini,mimiciii,progress_note,PROMPT2_entailment
160,31,21,19,2,0.9047619047619048,26,22,4,0.8461538461538461,0.8744769874476986,gemini,mimiciii,progress_note,PROMPT2_entailment
161,32,95,85,10,0.8947368421052632,152,135,17,0.8881578947368421,0.8914352301417751,gemini,mimiciii,progress_note,PROMPT2_entailment
162,33,69,59,10,0.855072463768116,106,90,16,0.8490566037735849,0.8520539152759949,gemini,mimiciii,progress_note,PROMPT2_entailment
163,34,33,22,11,0.6666666666666666,98,44,54,0.4489795918367347,0.5365853658536586,gemini,mimiciii,progress_note,PROMPT2_entailment
164,35,11,9,2,0.8181818181818182,26,11,15,0.4230769230769231,0.5577464788732395,gemini,mimiciii,progress_note,PROMPT2_entailment
165,36,23,15,8,0.6521739130434783,60,38,22,0.6333333333333333,0.6426155580608793,gemini,mimiciii,progress_note,PROMPT2_entailment
166,37,106,89,17,0.839622641509434,344,267,77,0.7761627906976745,0.8066465256797584,gemini,mimiciii,progress_note,PROMPT2_entailment
167,38,95,52,43,0.5473684210526316,278,183,95,0.658273381294964,0.5977199208567571,gemini,mimiciii,progress_note,PROMPT2_entailment
168,39,34,30,4,0.8823529411764706,117,95,22,0.811965811965812,0.8456973293768546,gemini,mimiciii,progress_note,PROMPT2_entailment
169,4,52,37,15,0.7115384615384616,282,197,85,0.6985815602836879,0.7050004836057645,gemini,mimiciii,progress_note,PROMPT2_entailment
170,40,34,31,3,0.9117647058823528,117,100,17,0.8547008547008547,0.8823110858118685,gemini,mimiciii,progress_note,PROMPT2_entailment
171,41,78,66,12,0.8461538461538461,119,107,12,0.8991596638655462,0.8718518518518518,gemini,mimiciii,progress_note,PROMPT2_entailment
172,42,55,46,9,0.8363636363636363,119,103,16,0.865546218487395,0.8507047311248765,gemini,mimiciii,progress_note,PROMPT2_entailment
173,43,66,42,24,0.6363636363636364,117,49,68,0.4188034188034188,0.5051546391752577,gemini,mimiciii,progress_note,PROMPT2_entailment
174,44,58,52,6,0.896551724137931,149,122,27,0.8187919463087249,0.8559093362115489,gemini,mimiciii,progress_note,PROMPT2_entailment
175,45,63,60,3,0.9523809523809524,125,113,12,0.904,0.9275600246254871,gemini,mimiciii,progress_note,PROMPT2_entailment
176,46,27,21,6,0.7777777777777778,52,41,11,0.7884615384615384,0.7830832196452934,gemini,mimiciii,progress_note,PROMPT2_entailment
177,47,4,0,4,0.0,12,2,10,0.1666666666666666,0.0,gemini,mimiciii,progress_note,PROMPT2_entailment
178,48,55,51,4,0.9272727272727272,49,43,6,0.8775510204081632,0.9017269736842104,gemini,mimiciii,progress_note,PROMPT2_entailment
179,49,64,55,9,0.859375,87,75,12,0.8620689655172413,0.8607198748043817,gemini,mimiciii,progress_note,PROMPT2_entailment
180,5,110,71,39,0.6454545454545455,300,83,217,0.2766666666666666,0.3873151495234965,gemini,mimiciii,progress_note,PROMPT2_entailment
181,50,94,80,14,0.851063829787234,176,149,27,0.8465909090909091,0.848821476892402,gemini,mimiciii,progress_note,PROMPT2_entailment
182,51,112,74,38,0.6607142857142857,302,113,189,0.3741721854304636,0.4777739686892927,gemini,mimiciii,progress_note,PROMPT2_entailment
183,52,104,68,36,0.6538461538461539,302,97,205,0.3211920529801324,0.4307732497387669,gemini,mimiciii,progress_note,PROMPT2_entailment
184,53,124,73,51,0.5887096774193549,382,228,154,0.5968586387434555,0.5927561522846255,gemini,mimiciii,progress_note,PROMPT2_entailment
185,54,63,45,18,0.7142857142857143,219,154,65,0.7031963470319634,0.708697653014266,gemini,mimiciii,progress_note,PROMPT2_entailment
186,55,75,55,20,0.7333333333333333,286,201,85,0.7027972027972028,0.7177406265216685,gemini,mimiciii,progress_note,PROMPT2_entailment
187,56,15,14,1,0.9333333333333332,48,16,32,0.3333333333333333,0.4912280701754386,gemini,mimiciii,progress_note,PROMPT2_entailment
188,57,30,27,3,0.9,46,19,27,0.4130434782608695,0.5662251655629139,gemini,mimiciii,progress_note,PROMPT2_entailment
189,58,22,12,10,0.5454545454545454,39,23,16,0.5897435897435898,0.5667351129363449,gemini,mimiciii,progress_note,PROMPT2_entailment
190,59,23,13,10,0.5652173913043478,39,25,14,0.6410256410256411,0.6007393715341959,gemini,mimiciii,progress_note,PROMPT2_entailment
191,6,121,101,20,0.8347107438016529,331,134,197,0.404833836858006,0.5452311411018229,gemini,mimiciii,progress_note,PROMPT2_entailment
192,60,90,57,33,0.6333333333333333,276,81,195,0.2934782608695652,0.4010946051602815,gemini,mimiciii,progress_note,PROMPT2_entailment
193,61,25,23,2,0.92,56,19,37,0.3392857142857143,0.495745887691435,gemini,mimiciii,progress_note,PROMPT2_entailment
194,62,23,15,8,0.6521739130434783,56,30,26,0.5357142857142857,0.5882352941176471,gemini,mimiciii,progress_note,PROMPT2_entailment
195,63,69,57,12,0.8260869565217391,142,79,63,0.5563380281690141,0.6648947951273533,gemini,mimiciii,progress_note,PROMPT2_entailment
196,64,1,0,1,0.0,1,0,1,0.0,,gemini,mimiciii,progress_note,PROMPT2_entailment
197,65,15,14,1,0.9333333333333332,12,12,0,1.0,0.9655172413793104,gemini,mimiciii,progress_note,PROMPT2_entailment
198,66,31,25,6,0.8064516129032258,68,37,31,0.5441176470588235,0.6498068141903757,gemini,mimiciii,progress_note,PROMPT2_entailment
199,67,130,57,73,0.4384615384615384,490,360,130,0.7346938775510204,0.5491770373344038,gemini,mimiciii,progress_note,PROMPT2_entailment
200,68,1,0,1,0.0,348,169,179,0.4856321839080459,0.0,gemini,mimiciii,progress_note,PROMPT2_entailment
201,69,88,72,16,0.8181818181818182,373,110,263,0.2949061662198391,0.4335449967155682,gemini,mimiciii,progress_note,PROMPT2_entailment
202,7,97,82,15,0.845360824742268,331,91,240,0.2749244712990936,0.4149128416136117,gemini,mimiciii,progress_note,PROMPT2_entailment
203,70,136,97,39,0.7132352941176471,374,78,296,0.2085561497326203,0.3227402636181376,gemini,mimiciii,progress_note,PROMPT2_entailment
204,71,67,63,4,0.9402985074626866,372,258,114,0.6935483870967742,0.7982908501547076,gemini,mimiciii,progress_note,PROMPT2_entailment
205,72,8,8,0,1.0,20,10,10,0.5,0.6666666666666666,gemini,mimiciii,progress_note,PROMPT2_entailment
206,73,64,47,17,0.734375,460,110,350,0.2391304347826087,0.3607815771109561,gemini,mimiciii,progress_note,PROMPT2_entailment
207,74,82,63,19,0.7682926829268293,319,251,68,0.786833855799373,0.7774527397428649,gemini,mimiciii,progress_note,PROMPT2_entailment
208,75,47,39,8,0.8297872340425532,62,53,9,0.8548387096774194,0.8421267060501121,gemini,mimiciii,progress_note,PROMPT2_entailment
209,76,44,33,11,0.75,86,66,20,0.7674418604651163,0.7586206896551724,gemini,mimiciii,progress_note,PROMPT2_entailment
210,77,18,16,2,0.8888888888888888,38,19,19,0.5,0.64,gemini,mimiciii,progress_note,PROMPT2_entailment
211,78,31,27,4,0.8709677419354839,30,14,16,0.4666666666666667,0.607717041800643,gemini,mimiciii,progress_note,PROMPT2_entailment
212,79,28,22,6,0.7857142857142857,67,28,39,0.417910447761194,0.545615589016829,gemini,mimiciii,progress_note,PROMPT2_entailment
213,8,54,48,6,0.8888888888888888,118,106,12,0.8983050847457628,0.8935721812434141,gemini,mimiciii,progress_note,PROMPT2_entailment
214,80,29,24,5,0.8275862068965517,32,17,15,0.53125,0.6471054718477399,gemini,mimiciii,progress_note,PROMPT2_entailment
215,81,34,24,10,0.7058823529411765,46,41,5,0.8913043478260869,0.7878302642113691,gemini,mimiciii,progress_note,PROMPT2_entailment
216,82,6,6,0,1.0,18,9,9,0.5,0.6666666666666666,gemini,mimiciii,progress_note,PROMPT2_entailment
217,83,32,26,6,0.8125,66,54,12,0.8181818181818182,0.8153310104529616,gemini,mimiciii,progress_note,PROMPT2_entailment
218,84,29,24,5,0.8275862068965517,48,27,21,0.5625,0.6697674418604651,gemini,mimiciii,progress_note,PROMPT2_entailment
219,85,38,33,5,0.868421052631579,77,55,22,0.7142857142857143,0.7838479809976248,gemini,mimiciii,progress_note,PROMPT2_entailment
220,86,55,48,7,0.8727272727272727,52,49,3,0.9423076923076924,0.9061837796185706,gemini,mimiciii,progress_note,PROMPT2_entailment
221,87,8,7,1,0.875,15,3,12,0.2,0.3255813953488372,gemini,mimiciii,progress_note,PROMPT2_entailment
222,88,52,41,11,0.7884615384615384,105,85,20,0.8095238095238095,0.7988538681948423,gemini,mimiciii,progress_note,PROMPT2_entailment
223,89,90,74,16,0.8222222222222222,339,229,110,0.6755162241887905,0.7416841736694678,gemini,mimiciii,progress_note,PROMPT2_entailment
224,9,37,35,2,0.945945945945946,61,31,30,0.5081967213114754,0.6611822059719683,gemini,mimiciii,progress_note,PROMPT2_entailment
225,90,8,7,1,0.875,4,4,0,1.0,0.9333333333333332,gemini,mimiciii,progress_note,PROMPT2_entailment
226,91,39,36,3,0.9230769230769232,112,57,55,0.5089285714285714,0.656115107913669,gemini,mimiciii,progress_note,PROMPT2_entailment
227,92,47,41,6,0.8723404255319149,208,89,119,0.4278846153846153,0.574148375422862,gemini,mimiciii,progress_note,PROMPT2_entailment
228,93,20,17,3,0.85,38,22,16,0.5789473684210527,0.6887661141804788,gemini,mimiciii,progress_note,PROMPT2_entailment
229,94,42,30,12,0.7142857142857143,112,59,53,0.5267857142857143,0.6063720452209661,gemini,mimiciii,progress_note,PROMPT2_entailment
230,95,23,14,9,0.6086956521739131,49,24,25,0.4897959183673469,0.54281098546042,gemini,mimiciii,progress_note,PROMPT2_entailment
231,96,7,7,0,1.0,14,3,11,0.2142857142857142,0.3529411764705882,gemini,mimiciii,progress_note,PROMPT2_entailment
232,97,14,14,0,1.0,20,10,10,0.5,0.6666666666666666,gemini,mimiciii,progress_note,PROMPT2_entailment
233,98,23,17,6,0.7391304347826086,35,29,6,0.8285714285714286,0.7812995245641838,gemini,mimiciii,progress_note,PROMPT2_entailment
234,99,54,48,6,0.8888888888888888,104,38,66,0.3653846153846153,0.5178875638841567,gemini,mimiciii,progress_note,PROMPT2_entailment
0,0,14,11,3,0.7857142857142857,6,5,1,0.8333333333333334,0.8088235294117647,gemini,medalign,nursing_note,PROMPT1_entailment
1,1,6,6,0,1.0,1,1,0,1.0,1.0,gemini,medalign,nursing_note,PROMPT1_entailment
2,10,7,7,0,1.0,5,3,2,0.6,0.7499999999999999,gemini,medalign,nursing_note,PROMPT1_entailment
3,100,10,8,2,0.8,10,8,2,0.8,0.8000000000000002,gemini,medalign,nursing_note,PROMPT1_entailment
4,101,7,7,0,1.0,1,1,0,1.0,1.0,gemini,medalign,nursing_note,PROMPT1_entailment
5,102,8,8,0,1.0,4,4,0,1.0,1.0,gemini,medalign,nursing_note,PROMPT1_entailment
6,103,4,4,0,1.0,2,2,0,1.0,1.0,gemini,medalign,nursing_note,PROMPT1_entailment
7,104,13,12,1,0.9230769230769232,15,14,1,0.9333333333333332,0.9281767955801106,gemini,medalign,nursing_note,PROMPT1_entailment
8,105,4,4,0,1.0,1,1,0,1.0,1.0,gemini,medalign,nursing_note,PROMPT1_entailment
9,106,4,4,0,1.0,1,1,0,1.0,1.0,gemini,medalign,nursing_note,PROMPT1_entailment
10,107,8,7,1,0.875,4,4,0,1.0,0.9333333333333332,gemini,medalign,nursing_note,PROMPT1_entailment
11,108,3,2,1,0.6666666666666666,2,2,0,1.0,0.8,gemini,medalign,nursing_note,PROMPT1_entailment
12,109,8,8,0,1.0,5,5,0,1.0,1.0,gemini,medalign,nursing_note,PROMPT1_entailment
13,11,3,1,2,0.3333333333333333,1,1,0,1.0,0.5,gemini,medalign,nursing_note,PROMPT1_entailment
14,110,10,6,4,0.6,6,5,1,0.8333333333333334,0.6976744186046512,gemini,medalign,nursing_note,PROMPT1_entailment
15,111,4,3,1,0.75,1,1,0,1.0,0.8571428571428571,gemini,medalign,nursing_note,PROMPT1_entailment
16,112,8,7,1,0.875,2,2,0,1.0,0.9333333333333332,gemini,medalign,nursing_note,PROMPT1_entailment
17,113,3,3,0,1.0,1,1,0,1.0,1.0,gemini,medalign,nursing_note,PROMPT1_entailment
18,114,5,5,0,1.0,1,1,0,1.0,1.0,gemini,medalign,nursing_note,PROMPT1_entailment
19,115,11,10,1,0.9090909090909092,7,5,2,0.7142857142857143,0.8,gemini,medalign,nursing_note,PROMPT1_entailment
20,116,8,6,2,0.75,5,4,1,0.8,0.7741935483870969,gemini,medalign,nursing_note,PROMPT1_entailment
21,117,15,12,3,0.8,13,11,2,0.8461538461538461,0.8224299065420562,gemini,medalign,nursing_note,PROMPT1_entailment
22,118,7,5,2,0.7142857142857143,2,2,0,1.0,0.8333333333333333,gemini,medalign,nursing_note,PROMPT1_entailment
23,119,4,3,1,0.75,2,2,0,1.0,0.8571428571428571,gemini,medalign,nursing_note,PROMPT1_entailment
24,12,3,3,0,1.0,1,1,0,1.0,1.0,gemini,medalign,nursing_note,PROMPT1_entailment
25,120,10,10,0,1.0,7,6,1,0.8571428571428571,0.923076923076923,gemini,medalign,nursing_note,PROMPT1_entailment
26,121,2,1,1,0.5,1,1,0,1.0,0.6666666666666666,gemini,medalign,nursing_note,PROMPT1_entailment
27,122,2,1,1,0.5,1,1,0,1.0,0.6666666666666666,gemini,medalign,nursing_note,PROMPT1_entailment
28,123,4,4,0,1.0,4,4,0,1.0,1.0,gemini,medalign,nursing_note,PROMPT1_entailment
29,124,6,6,0,1.0,14,14,0,1.0,1.0,gemini,medalign,nursing_note,PROMPT1_entailment
30,125,11,11,0,1.0,9,8,1,0.8888888888888888,0.9411764705882352,gemini,medalign,nursing_note,PROMPT1_entailment
31,126,3,0,3,0.0,2,1,1,0.5,0.0,gemini,medalign,nursing_note,PROMPT1_entailment
32,127,7,1,6,0.1428571428571428,1,0,1,0.0,0.0,gemini,medalign,nursing_note,PROMPT1_entailment
33,128,5,4,1,0.8,2,2,0,1.0,0.888888888888889,gemini,medalign,nursing_note,PROMPT1_entailment
34,129,26,25,1,0.9615384615384616,20,18,2,0.9,0.9297520661157024,gemini,medalign,nursing_note,PROMPT1_entailment
35,13,8,8,0,1.0,5,5,0,1.0,1.0,gemini,medalign,nursing_note,PROMPT1_entailment
36,130,6,5,1,0.8333333333333334,2,2,0,1.0,0.9090909090909092,gemini,medalign,nursing_note,PROMPT1_entailment
37,131,4,4,0,1.0,1,1,0,1.0,1.0,gemini,medalign,nursing_note,PROMPT1_entailment
38,132,6,5,1,0.8333333333333334,2,1,1,0.5,0.625,gemini,medalign,nursing_note,PROMPT1_entailment
39,133,15,13,2,0.8666666666666667,14,12,2,0.8571428571428571,0.861878453038674,gemini,medalign,nursing_note,PROMPT1_entailment
40,134,6,5,1,0.8333333333333334,3,3,0,1.0,0.9090909090909092,gemini,medalign,nursing_note,PROMPT1_entailment
41,135,9,5,4,0.5555555555555556,2,2,0,1.0,0.7142857142857143,gemini,medalign,nursing_note,PROMPT1_entailment
42,136,35,24,11,0.6857142857142857,51,22,29,0.4313725490196078,0.5295887662988967,gemini,medalign,nursing_note,PROMPT1_entailment
43,137,15,15,0,1.0,6,6,0,1.0,1.0,gemini,medalign,nursing_note,PROMPT1_entailment
44,138,3,1,2,0.3333333333333333,1,1,0,1.0,0.5,gemini,medalign,nursing_note,PROMPT1_entailment
45,139,5,5,0,1.0,1,1,0,1.0,1.0,gemini,medalign,nursing_note,PROMPT1_entailment
46,14,4,2,2,0.5,1,1,0,1.0,0.6666666666666666,gemini,medalign,nursing_note,PROMPT1_entailment
47,140,6,5,1,0.8333333333333334,3,3,0,1.0,0.9090909090909092,gemini,medalign,nursing_note,PROMPT1_entailment
48,141,7,3,4,0.4285714285714285,1,1,0,1.0,0.6,gemini,medalign,nursing_note,PROMPT1_entailment
49,142,4,3,1,0.75,1,1,0,1.0,0.8571428571428571,gemini,medalign,nursing_note,PROMPT1_entailment
50,143,2,2,0,1.0,1,1,0,1.0,1.0,gemini,medalign,nursing_note,PROMPT1_entailment
51,144,4,0,4,0.0,1,1,0,1.0,0.0,gemini,medalign,nursing_note,PROMPT1_entailment
52,145,5,4,1,0.8,4,4,0,1.0,0.888888888888889,gemini,medalign,nursing_note,PROMPT1_entailment
53,146,7,6,1,0.8571428571428571,3,1,2,0.3333333333333333,0.48,gemini,medalign,nursing_note,PROMPT1_entailment
54,147,8,8,0,1.0,6,4,2,0.6666666666666666,0.8,gemini,medalign,nursing_note,PROMPT1_entailment
55,148,9,9,0,1.0,7,7,0,1.0,1.0,gemini,medalign,nursing_note,PROMPT1_entailment
56,149,4,3,1,0.75,1,1,0,1.0,0.8571428571428571,gemini,medalign,nursing_note,PROMPT1_entailment
57,15,4,3,1,0.75,1,1,0,1.0,0.8571428571428571,gemini,medalign,nursing_note,PROMPT1_entailment
58,150,4,3,1,0.75,1,1,0,1.0,0.8571428571428571,gemini,medalign,nursing_note,PROMPT1_entailment
59,151,16,15,1,0.9375,8,8,0,1.0,0.967741935483871,gemini,medalign,nursing_note,PROMPT1_entailment
60,152,5,5,0,1.0,4,4,0,1.0,1.0,gemini,medalign,nursing_note,PROMPT1_entailment
61,153,15,14,1,0.9333333333333332,14,13,1,0.9285714285714286,0.9309462915601024,gemini,medalign,nursing_note,PROMPT1_entailment
62,154,4,3,1,0.75,1,1,0,1.0,0.8571428571428571,gemini,medalign,nursing_note,PROMPT1_entailment
63,155,25,24,1,0.96,14,11,3,0.7857142857142857,0.8641571194762684,gemini,medalign,nursing_note,PROMPT1_entailment
64,156,5,3,2,0.6,1,1,0,1.0,0.7499999999999999,gemini,medalign,nursing_note,PROMPT1_entailment
65,157,5,5,0,1.0,3,2,1,0.6666666666666666,0.8,gemini,medalign,nursing_note,PROMPT1_entailment
66,158,6,6,0,1.0,1,0,1,0.0,0.0,gemini,medalign,nursing_note,PROMPT1_entailment
67,159,7,7,0,1.0,3,3,0,1.0,1.0,gemini,medalign,nursing_note,PROMPT1_entailment
68,16,6,5,1,0.8333333333333334,3,3,0,1.0,0.9090909090909092,gemini,medalign,nursing_note,PROMPT1_entailment
69,160,5,5,0,1.0,1,1,0,1.0,1.0,gemini,medalign,nursing_note,PROMPT1_entailment
70,161,6,4,2,0.6666666666666666,1,1,0,1.0,0.8,gemini,medalign,nursing_note,PROMPT1_entailment
71,162,13,12,1,0.9230769230769232,8,7,1,0.875,0.8983957219251337,gemini,medalign,nursing_note,PROMPT1_entailment
72,163,6,5,1,0.8333333333333334,3,3,0,1.0,0.9090909090909092,gemini,medalign,nursing_note,PROMPT1_entailment
73,164,7,7,0,1.0,2,2,0,1.0,1.0,gemini,medalign,nursing_note,PROMPT1_entailment
74,165,7,7,0,1.0,4,3,1,0.75,0.8571428571428571,gemini,medalign,nursing_note,PROMPT1_entailment
75,166,10,9,1,0.9,5,4,1,0.8,0.8470588235294118,gemini,medalign,nursing_note,PROMPT1_entailment
76,167,12,11,1,0.9166666666666666,2,1,1,0.5,0.6470588235294118,gemini,medalign,nursing_note,PROMPT1_entailment
77,168,5,5,0,1.0,3,3,0,1.0,1.0,gemini,medalign,nursing_note,PROMPT1_entailment
78,169,15,12,3,0.8,9,8,1,0.8888888888888888,0.8421052631578948,gemini,medalign,nursing_note,PROMPT1_entailment
79,17,9,4,5,0.4444444444444444,1,0,1,0.0,0.0,gemini,medalign,nursing_note,PROMPT1_entailment
80,170,6,5,1,0.8333333333333334,1,0,1,0.0,0.0,gemini,medalign,nursing_note,PROMPT1_entailment
81,171,9,8,1,0.8888888888888888,7,3,4,0.4285714285714285,0.5783132530120482,gemini,medalign,nursing_note,PROMPT1_entailment
82,172,15,14,1,0.9333333333333332,12,12,0,1.0,0.9655172413793104,gemini,medalign,nursing_note,PROMPT1_entailment
83,173,10,10,0,1.0,1,1,0,1.0,1.0,gemini,medalign,nursing_note,PROMPT1_entailment
84,174,5,5,0,1.0,1,1,0,1.0,1.0,gemini,medalign,nursing_note,PROMPT1_entailment
85,175,3,2,1,0.6666666666666666,2,2,0,1.0,0.8,gemini,medalign,nursing_note,PROMPT1_entailment
86,176,12,8,4,0.6666666666666666,3,3,0,1.0,0.8,gemini,medalign,nursing_note,PROMPT1_entailment
87,177,12,10,2,0.8333333333333334,8,8,0,1.0,0.9090909090909092,gemini,medalign,nursing_note,PROMPT1_entailment
88,178,11,7,4,0.6363636363636364,10,9,1,0.9,0.7455621301775148,gemini,medalign,nursing_note,PROMPT1_entailment
89,179,8,6,2,0.75,2,2,0,1.0,0.8571428571428571,gemini,medalign,nursing_note,PROMPT1_entailment
90,18,12,11,1,0.9166666666666666,3,2,1,0.6666666666666666,0.7719298245614035,gemini,medalign,nursing_note,PROMPT1_entailment
91,180,10,7,3,0.7,4,2,2,0.5,0.5833333333333334,gemini,medalign,nursing_note,PROMPT1_entailment
92,181,7,7,0,1.0,7,7,0,1.0,1.0,gemini,medalign,nursing_note,PROMPT1_entailment
93,182,4,3,1,0.75,2,1,1,0.5,0.6,gemini,medalign,nursing_note,PROMPT1_entailment
94,183,7,7,0,1.0,6,6,0,1.0,1.0,gemini,medalign,nursing_note,PROMPT1_entailment
95,184,15,13,2,0.8666666666666667,11,9,2,0.8181818181818182,0.8417266187050358,gemini,medalign,nursing_note,PROMPT1_entailment
96,185,7,7,0,1.0,3,3,0,1.0,1.0,gemini,medalign,nursing_note,PROMPT1_entailment
97,186,4,3,1,0.75,3,2,1,0.6666666666666666,0.7058823529411765,gemini,medalign,nursing_note,PROMPT1_entailment
98,187,6,0,6,0.0,1,1,0,1.0,0.0,gemini,medalign,nursing_note,PROMPT1_entailment
99,188,3,3,0,1.0,3,3,0,1.0,1.0,gemini,medalign,nursing_note,PROMPT1_entailment
100,189,21,16,5,0.7619047619047619,10,7,3,0.7,0.7296416938110748,gemini,medalign,nursing_note,PROMPT1_entailment
101,19,16,16,0,1.0,7,7,0,1.0,1.0,gemini,medalign,nursing_note,PROMPT1_entailment
102,190,5,5,0,1.0,2,2,0,1.0,1.0,gemini,medalign,nursing_note,PROMPT1_entailment
103,191,12,10,2,0.8333333333333334,5,5,0,1.0,0.9090909090909092,gemini,medalign,nursing_note,PROMPT1_entailment
104,192,4,4,0,1.0,1,1,0,1.0,1.0,gemini,medalign,nursing_note,PROMPT1_entailment
105,193,7,6,1,0.8571428571428571,3,3,0,1.0,0.923076923076923,gemini,medalign,nursing_note,PROMPT1_entailment
106,194,5,4,1,0.8,2,2,0,1.0,0.888888888888889,gemini,medalign,nursing_note,PROMPT1_entailment
107,195,19,13,6,0.6842105263157895,10,7,3,0.7,0.6920152091254752,gemini,medalign,nursing_note,PROMPT1_entailment
108,196,5,5,0,1.0,1,1,0,1.0,1.0,gemini,medalign,nursing_note,PROMPT1_entailment
109,197,4,2,2,0.5,1,1,0,1.0,0.6666666666666666,gemini,medalign,nursing_note,PROMPT1_entailment
110,198,14,12,2,0.8571428571428571,8,6,2,0.75,0.7999999999999999,gemini,medalign,nursing_note,PROMPT1_entailment
111,199,16,13,3,0.8125,7,6,1,0.8571428571428571,0.8342245989304812,gemini,medalign,nursing_note,PROMPT1_entailment
112,2,13,8,5,0.6153846153846154,5,4,1,0.8,0.6956521739130435,gemini,medalign,nursing_note,PROMPT1_entailment
113,20,6,3,3,0.5,2,1,1,0.5,0.5,gemini,medalign,nursing_note,PROMPT1_entailment
114,200,4,4,0,1.0,3,3,0,1.0,1.0,gemini,medalign,nursing_note,PROMPT1_entailment
115,201,5,5,0,1.0,1,1,0,1.0,1.0,gemini,medalign,nursing_note,PROMPT1_entailment
116,202,5,4,1,0.8,1,1,0,1.0,0.888888888888889,gemini,medalign,nursing_note,PROMPT1_entailment
117,203,7,7,0,1.0,1,1,0,1.0,1.0,gemini,medalign,nursing_note,PROMPT1_entailment
118,204,20,14,6,0.7,9,7,2,0.7777777777777778,0.7368421052631577,gemini,medalign,nursing_note,PROMPT1_entailment
119,205,18,7,11,0.3888888888888889,8,4,4,0.5,0.4375,gemini,medalign,nursing_note,PROMPT1_entailment
120,206,6,5,1,0.8333333333333334,4,4,0,1.0,0.9090909090909092,gemini,medalign,nursing_note,PROMPT1_entailment
121,207,8,7,1,0.875,6,5,1,0.8333333333333334,0.8536585365853658,gemini,medalign,nursing_note,PROMPT1_entailment
122,208,17,15,2,0.8823529411764706,10,10,0,1.0,0.9375,gemini,medalign,nursing_note,PROMPT1_entailment
123,209,4,4,0,1.0,1,0,1,0.0,0.0,gemini,medalign,nursing_note,PROMPT1_entailment
124,21,6,6,0,1.0,1,1,0,1.0,1.0,gemini,medalign,nursing_note,PROMPT1_entailment
125,210,5,4,1,0.8,2,1,1,0.5,0.6153846153846154,gemini,medalign,nursing_note,PROMPT1_entailment
126,211,5,4,1,0.8,2,2,0,1.0,0.888888888888889,gemini,medalign,nursing_note,PROMPT1_entailment
127,212,7,7,0,1.0,3,3,0,1.0,1.0,gemini,medalign,nursing_note,PROMPT1_entailment
128,213,12,12,0,1.0,8,8,0,1.0,1.0,gemini,medalign,nursing_note,PROMPT1_entailment
129,214,4,4,0,1.0,2,2,0,1.0,1.0,gemini,medalign,nursing_note,PROMPT1_entailment
130,215,4,3,1,0.75,1,1,0,1.0,0.8571428571428571,gemini,medalign,nursing_note,PROMPT1_entailment
131,216,5,4,1,0.8,3,3,0,1.0,0.888888888888889,gemini,medalign,nursing_note,PROMPT1_entailment
132,217,14,10,4,0.7142857142857143,11,7,4,0.6363636363636364,0.673076923076923,gemini,medalign,nursing_note,PROMPT1_entailment
133,218,15,14,1,0.9333333333333332,3,2,1,0.6666666666666666,0.7777777777777778,gemini,medalign,nursing_note,PROMPT1_entailment
134,219,5,4,1,0.8,2,2,0,1.0,0.888888888888889,gemini,medalign,nursing_note,PROMPT1_entailment
135,22,4,2,2,0.5,1,0,1,0.0,0.0,gemini,medalign,nursing_note,PROMPT1_entailment
136,220,10,8,2,0.8,7,5,2,0.7142857142857143,0.7547169811320756,gemini,medalign,nursing_note,PROMPT1_entailment
137,221,27,24,3,0.8888888888888888,23,15,8,0.6521739130434783,0.7523510971786834,gemini,medalign,nursing_note,PROMPT1_entailment
138,222,7,7,0,1.0,4,4,0,1.0,1.0,gemini,medalign,nursing_note,PROMPT1_entailment
139,223,3,3,0,1.0,2,1,1,0.5,0.6666666666666666,gemini,medalign,nursing_note,PROMPT1_entailment
140,224,11,11,0,1.0,4,2,2,0.5,0.6666666666666666,gemini,medalign,nursing_note,PROMPT1_entailment
141,225,7,7,0,1.0,2,2,0,1.0,1.0,gemini,medalign,nursing_note,PROMPT1_entailment
142,226,11,10,1,0.9090909090909092,5,4,1,0.8,0.8510638297872342,gemini,medalign,nursing_note,PROMPT1_entailment
143,227,6,2,4,0.3333333333333333,1,1,0,1.0,0.5,gemini,medalign,nursing_note,PROMPT1_entailment
144,228,34,32,2,0.9411764705882352,18,7,11,0.3888888888888889,0.5503685503685504,gemini,medalign,nursing_note,PROMPT1_entailment
145,229,11,9,2,0.8181818181818182,7,6,1,0.8571428571428571,0.8372093023255814,gemini,medalign,nursing_note,PROMPT1_entailment
146,23,16,14,2,0.875,21,8,13,0.3809523809523809,0.5308056872037914,gemini,medalign,nursing_note,PROMPT1_entailment
147,230,4,2,2,0.5,1,0,1,0.0,0.0,gemini,medalign,nursing_note,PROMPT1_entailment
148,231,14,11,3,0.7857142857142857,13,10,3,0.7692307692307693,0.7773851590106008,gemini,medalign,nursing_note,PROMPT1_entailment
149,232,9,8,1,0.8888888888888888,6,3,3,0.5,0.64,gemini,medalign,nursing_note,PROMPT1_entailment
150,233,5,3,2,0.6,4,3,1,0.75,0.6666666666666665,gemini,medalign,nursing_note,PROMPT1_entailment
151,234,5,5,0,1.0,2,2,0,1.0,1.0,gemini,medalign,nursing_note,PROMPT1_entailment
152,235,9,6,3,0.6666666666666666,1,0,1,0.0,0.0,gemini,medalign,nursing_note,PROMPT1_entailment
153,236,13,10,3,0.7692307692307693,14,13,1,0.9285714285714286,0.8414239482200646,gemini,medalign,nursing_note,PROMPT1_entailment
154,237,10,6,4,0.6,6,4,2,0.6666666666666666,0.631578947368421,gemini,medalign,nursing_note,PROMPT1_entailment
155,238,8,7,1,0.875,4,4,0,1.0,0.9333333333333332,gemini,medalign,nursing_note,PROMPT1_entailment
156,239,8,7,1,0.875,4,4,0,1.0,0.9333333333333332,gemini,medalign,nursing_note,PROMPT1_entailment
157,24,4,4,0,1.0,1,1,0,1.0,1.0,gemini,medalign,nursing_note,PROMPT1_entailment
158,240,11,3,8,0.2727272727272727,2,1,1,0.5,0.3529411764705882,gemini,medalign,nursing_note,PROMPT1_entailment
159,241,7,7,0,1.0,2,2,0,1.0,1.0,gemini,medalign,nursing_note,PROMPT1_entailment
160,242,12,11,1,0.9166666666666666,2,2,0,1.0,0.9565217391304348,gemini,medalign,nursing_note,PROMPT1_entailment
161,243,21,21,0,1.0,10,10,0,1.0,1.0,gemini,medalign,nursing_note,PROMPT1_entailment
162,244,4,4,0,1.0,1,1,0,1.0,1.0,gemini,medalign,nursing_note,PROMPT1_entailment
163,245,4,4,0,1.0,1,1,0,1.0,1.0,gemini,medalign,nursing_note,PROMPT1_entailment
164,246,4,4,0,1.0,1,1,0,1.0,1.0,gemini,medalign,nursing_note,PROMPT1_entailment
165,247,7,5,2,0.7142857142857143,5,5,0,1.0,0.8333333333333333,gemini,medalign,nursing_note,PROMPT1_entailment
166,248,4,4,0,1.0,1,1,0,1.0,1.0,gemini,medalign,nursing_note,PROMPT1_entailment
167,249,10,10,0,1.0,2,2,0,1.0,1.0,gemini,medalign,nursing_note,PROMPT1_entailment
168,25,38,29,9,0.7631578947368421,33,20,13,0.6060606060606061,0.6755969714618522,gemini,medalign,nursing_note,PROMPT1_entailment
169,26,6,6,0,1.0,1,1,0,1.0,1.0,gemini,medalign,nursing_note,PROMPT1_entailment
170,27,7,6,1,0.8571428571428571,2,2,0,1.0,0.923076923076923,gemini,medalign,nursing_note,PROMPT1_entailment
171,28,9,5,4,0.5555555555555556,4,3,1,0.75,0.6382978723404256,gemini,medalign,nursing_note,PROMPT1_entailment
172,29,8,6,2,0.75,3,3,0,1.0,0.8571428571428571,gemini,medalign,nursing_note,PROMPT1_entailment
173,3,7,7,0,1.0,2,2,0,1.0,1.0,gemini,medalign,nursing_note,PROMPT1_entailment
174,30,8,4,4,0.5,1,1,0,1.0,0.6666666666666666,gemini,medalign,nursing_note,PROMPT1_entailment
175,31,1,0,1,0.0,1,0,1,0.0,,gemini,medalign,nursing_note,PROMPT1_entailment
176,32,5,4,1,0.8,2,2,0,1.0,0.888888888888889,gemini,medalign,nursing_note,PROMPT1_entailment
177,33,11,8,3,0.7272727272727273,5,4,1,0.8,0.761904761904762,gemini,medalign,nursing_note,PROMPT1_entailment
178,34,11,9,2,0.8181818181818182,4,3,1,0.75,0.7826086956521738,gemini,medalign,nursing_note,PROMPT1_entailment
179,35,8,7,1,0.875,4,3,1,0.75,0.8076923076923077,gemini,medalign,nursing_note,PROMPT1_entailment
180,36,18,8,10,0.4444444444444444,5,3,2,0.6,0.5106382978723405,gemini,medalign,nursing_note,PROMPT1_entailment
181,37,7,6,1,0.8571428571428571,3,3,0,1.0,0.923076923076923,gemini,medalign,nursing_note,PROMPT1_entailment
182,38,13,7,6,0.5384615384615384,5,3,2,0.6,0.5675675675675675,gemini,medalign,nursing_note,PROMPT1_entailment
183,39,3,2,1,0.6666666666666666,1,1,0,1.0,0.8,gemini,medalign,nursing_note,PROMPT1_entailment
184,4,5,4,1,0.8,3,2,1,0.6666666666666666,0.7272727272727272,gemini,medalign,nursing_note,PROMPT1_entailment
185,40,16,11,5,0.6875,8,7,1,0.875,0.77,gemini,medalign,nursing_note,PROMPT1_entailment
186,41,6,6,0,1.0,1,1,0,1.0,1.0,gemini,medalign,nursing_note,PROMPT1_entailment
187,42,10,10,0,1.0,8,7,1,0.875,0.9333333333333332,gemini,medalign,nursing_note,PROMPT1_entailment
188,43,6,4,2,0.6666666666666666,2,2,0,1.0,0.8,gemini,medalign,nursing_note,PROMPT1_entailment
189,44,6,6,0,1.0,1,1,0,1.0,1.0,gemini,medalign,nursing_note,PROMPT1_entailment
190,45,4,2,2,0.5,1,0,1,0.0,0.0,gemini,medalign,nursing_note,PROMPT1_entailment
191,46,9,9,0,1.0,5,5,0,1.0,1.0,gemini,medalign,nursing_note,PROMPT1_entailment
192,47,28,22,6,0.7857142857142857,20,14,6,0.7,0.7403846153846153,gemini,medalign,nursing_note,PROMPT1_entailment
193,48,5,4,1,0.8,2,2,0,1.0,0.888888888888889,gemini,medalign,nursing_note,PROMPT1_entailment
194,49,3,2,1,0.6666666666666666,2,2,0,1.0,0.8,gemini,medalign,nursing_note,PROMPT1_entailment
195,5,9,8,1,0.8888888888888888,5,5,0,1.0,0.9411764705882352,gemini,medalign,nursing_note,PROMPT1_entailment
196,50,4,4,0,1.0,1,1,0,1.0,1.0,gemini,medalign,nursing_note,PROMPT1_entailment
197,51,5,5,0,1.0,2,2,0,1.0,1.0,gemini,medalign,nursing_note,PROMPT1_entailment
198,52,4,4,0,1.0,4,4,0,1.0,1.0,gemini,medalign,nursing_note,PROMPT1_entailment
199,53,2,1,1,0.5,1,1,0,1.0,0.6666666666666666,gemini,medalign,nursing_note,PROMPT1_entailment
200,54,12,10,2,0.8333333333333334,7,6,1,0.8571428571428571,0.8450704225352113,gemini,medalign,nursing_note,PROMPT1_entailment
201,55,4,4,0,1.0,2,1,1,0.5,0.6666666666666666,gemini,medalign,nursing_note,PROMPT1_entailment
202,56,7,7,0,1.0,3,2,1,0.6666666666666666,0.8,gemini,medalign,nursing_note,PROMPT1_entailment
203,57,8,4,4,0.5,4,1,3,0.25,0.3333333333333333,gemini,medalign,nursing_note,PROMPT1_entailment
204,58,5,5,0,1.0,1,1,0,1.0,1.0,gemini,medalign,nursing_note,PROMPT1_entailment
205,59,4,4,0,1.0,1,1,0,1.0,1.0,gemini,medalign,nursing_note,PROMPT1_entailment
206,6,6,6,0,1.0,3,3,0,1.0,1.0,gemini,medalign,nursing_note,PROMPT1_entailment
207,60,10,9,1,0.9,9,8,1,0.8888888888888888,0.8944099378881988,gemini,medalign,nursing_note,PROMPT1_entailment
208,61,4,4,0,1.0,1,1,0,1.0,1.0,gemini,medalign,nursing_note,PROMPT1_entailment
209,62,15,13,2,0.8666666666666667,5,3,2,0.6,0.7090909090909091,gemini,medalign,nursing_note,PROMPT1_entailment
210,63,8,6,2,0.75,7,5,2,0.7142857142857143,0.7317073170731706,gemini,medalign,nursing_note,PROMPT1_entailment
211,64,4,4,0,1.0,1,1,0,1.0,1.0,gemini,medalign,nursing_note,PROMPT1_entailment
212,65,6,5,1,0.8333333333333334,2,1,1,0.5,0.625,gemini,medalign,nursing_note,PROMPT1_entailment
213,66,7,6,1,0.8571428571428571,4,4,0,1.0,0.923076923076923,gemini,medalign,nursing_note,PROMPT1_entailment
214,67,7,6,1,0.8571428571428571,4,3,1,0.75,0.7999999999999999,gemini,medalign,nursing_note,PROMPT1_entailment
215,68,6,4,2,0.6666666666666666,1,1,0,1.0,0.8,gemini,medalign,nursing_note,PROMPT1_entailment
216,69,9,8,1,0.8888888888888888,2,1,1,0.5,0.64,gemini,medalign,nursing_note,PROMPT1_entailment
217,7,4,4,0,1.0,1,1,0,1.0,1.0,gemini,medalign,nursing_note,PROMPT1_entailment
218,70,7,7,0,1.0,1,1,0,1.0,1.0,gemini,medalign,nursing_note,PROMPT1_entailment
219,71,6,6,0,1.0,1,1,0,1.0,1.0,gemini,medalign,nursing_note,PROMPT1_entailment
220,72,2,2,0,1.0,1,1,0,1.0,1.0,gemini,medalign,nursing_note,PROMPT1_entailment
221,73,4,4,0,1.0,2,2,0,1.0,1.0,gemini,medalign,nursing_note,PROMPT1_entailment
222,74,12,8,4,0.6666666666666666,6,4,2,0.6666666666666666,0.6666666666666666,gemini,medalign,nursing_note,PROMPT1_entailment
223,75,5,2,3,0.4,1,0,1,0.0,0.0,gemini,medalign,nursing_note,PROMPT1_entailment
224,76,10,9,1,0.9,5,4,1,0.8,0.8470588235294118,gemini,medalign,nursing_note,PROMPT1_entailment
225,77,6,4,2,0.6666666666666666,3,3,0,1.0,0.8,gemini,medalign,nursing_note,PROMPT1_entailment
226,78,6,6,0,1.0,3,3,0,1.0,1.0,gemini,medalign,nursing_note,PROMPT1_entailment
227,79,8,6,2,0.75,8,5,3,0.625,0.6818181818181818,gemini,medalign,nursing_note,PROMPT1_entailment
228,8,11,8,3,0.7272727272727273,8,7,1,0.875,0.7943262411347517,gemini,medalign,nursing_note,PROMPT1_entailment
229,80,12,11,1,0.9166666666666666,10,9,1,0.9,0.908256880733945,gemini,medalign,nursing_note,PROMPT1_entailment
230,81,2,2,0,1.0,1,1,0,1.0,1.0,gemini,medalign,nursing_note,PROMPT1_entailment
231,82,4,4,0,1.0,3,3,0,1.0,1.0,gemini,medalign,nursing_note,PROMPT1_entailment
232,83,4,3,1,0.75,3,2,1,0.6666666666666666,0.7058823529411765,gemini,medalign,nursing_note,PROMPT1_entailment
233,84,11,8,3,0.7272727272727273,2,2,0,1.0,0.8421052631578948,gemini,medalign,nursing_note,PROMPT1_entailment
234,85,10,8,2,0.8,8,8,0,1.0,0.888888888888889,gemini,medalign,nursing_note,PROMPT1_entailment
235,86,4,3,1,0.75,3,3,0,1.0,0.8571428571428571,gemini,medalign,nursing_note,PROMPT1_entailment
236,87,4,4,0,1.0,2,2,0,1.0,1.0,gemini,medalign,nursing_note,PROMPT1_entailment
237,88,9,8,1,0.8888888888888888,7,7,0,1.0,0.9411764705882352,gemini,medalign,nursing_note,PROMPT1_entailment
238,89,9,9,0,1.0,6,6,0,1.0,1.0,gemini,medalign,nursing_note,PROMPT1_entailment
239,9,4,4,0,1.0,2,2,0,1.0,1.0,gemini,medalign,nursing_note,PROMPT1_entailment
240,90,7,6,1,0.8571428571428571,1,1,0,1.0,0.923076923076923,gemini,medalign,nursing_note,PROMPT1_entailment
241,91,4,4,0,1.0,1,1,0,1.0,1.0,gemini,medalign,nursing_note,PROMPT1_entailment
242,92,6,6,0,1.0,4,3,1,0.75,0.8571428571428571,gemini,medalign,nursing_note,PROMPT1_entailment
243,93,5,3,2,0.6,1,0,1,0.0,0.0,gemini,medalign,nursing_note,PROMPT1_entailment
244,94,14,10,4,0.7142857142857143,2,0,2,0.0,0.0,gemini,medalign,nursing_note,PROMPT1_entailment
245,95,7,6,1,0.8571428571428571,1,1,0,1.0,0.923076923076923,gemini,medalign,nursing_note,PROMPT1_entailment
246,96,3,2,1,0.6666666666666666,1,1,0,1.0,0.8,gemini,medalign,nursing_note,PROMPT1_entailment
247,97,6,5,1,0.8333333333333334,2,2,0,1.0,0.9090909090909092,gemini,medalign,nursing_note,PROMPT1_entailment
248,98,9,9,0,1.0,5,5,0,1.0,1.0,gemini,medalign,nursing_note,PROMPT1_entailment
249,99,12,12,0,1.0,7,5,2,0.7142857142857143,0.8333333333333333,gemini,medalign,nursing_note,PROMPT1_entailment
0,0,11,11,0,1.0,6,5,1,0.8333333333333334,0.9090909090909092,gemini,medalign,nursing_note,PROMPT1_ICL_entailment
1,1,10,10,0,1.0,1,1,0,1.0,1.0,gemini,medalign,nursing_note,PROMPT1_ICL_entailment
2,10,7,7,0,1.0,5,3,2,0.6,0.7499999999999999,gemini,medalign,nursing_note,PROMPT1_ICL_entailment
3,100,14,13,1,0.9285714285714286,10,8,2,0.8,0.859504132231405,gemini,medalign,nursing_note,PROMPT1_ICL_entailment
4,101,7,7,0,1.0,1,1,0,1.0,1.0,gemini,medalign,nursing_note,PROMPT1_ICL_entailment
5,102,8,8,0,1.0,4,4,0,1.0,1.0,gemini,medalign,nursing_note,PROMPT1_ICL_entailment
6,103,3,3,0,1.0,2,2,0,1.0,1.0,gemini,medalign,nursing_note,PROMPT1_ICL_entailment
7,104,22,19,3,0.8636363636363636,15,13,2,0.8666666666666667,0.8651488616462346,gemini,medalign,nursing_note,PROMPT1_ICL_entailment
8,105,4,4,0,1.0,1,1,0,1.0,1.0,gemini,medalign,nursing_note,PROMPT1_ICL_entailment
9,106,4,4,0,1.0,1,1,0,1.0,1.0,gemini,medalign,nursing_note,PROMPT1_ICL_entailment
10,107,9,9,0,1.0,4,3,1,0.75,0.8571428571428571,gemini,medalign,nursing_note,PROMPT1_ICL_entailment
11,108,2,2,0,1.0,2,2,0,1.0,1.0,gemini,medalign,nursing_note,PROMPT1_ICL_entailment
12,109,14,13,1,0.9285714285714286,5,5,0,1.0,0.962962962962963,gemini,medalign,nursing_note,PROMPT1_ICL_entailment
13,11,3,2,1,0.6666666666666666,1,1,0,1.0,0.8,gemini,medalign,nursing_note,PROMPT1_ICL_entailment
14,110,15,10,5,0.6666666666666666,6,5,1,0.8333333333333334,0.7407407407407408,gemini,medalign,nursing_note,PROMPT1_ICL_entailment
15,111,2,1,1,0.5,1,0,1,0.0,0.0,gemini,medalign,nursing_note,PROMPT1_ICL_entailment
16,112,5,5,0,1.0,2,2,0,1.0,1.0,gemini,medalign,nursing_note,PROMPT1_ICL_entailment
17,113,2,2,0,1.0,1,1,0,1.0,1.0,gemini,medalign,nursing_note,PROMPT1_ICL_entailment
18,114,3,3,0,1.0,1,1,0,1.0,1.0,gemini,medalign,nursing_note,PROMPT1_ICL_entailment
19,115,13,13,0,1.0,7,4,3,0.5714285714285714,0.7272727272727273,gemini,medalign,nursing_note,PROMPT1_ICL_entailment
20,116,9,7,2,0.7777777777777778,5,4,1,0.8,0.7887323943661971,gemini,medalign,nursing_note,PROMPT1_ICL_entailment
21,117,16,14,2,0.875,13,9,4,0.6923076923076923,0.7730061349693251,gemini,medalign,nursing_note,PROMPT1_ICL_entailment
22,118,3,3,0,1.0,2,2,0,1.0,1.0,gemini,medalign,nursing_note,PROMPT1_ICL_entailment
23,119,4,2,2,0.5,2,2,0,1.0,0.6666666666666666,gemini,medalign,nursing_note,PROMPT1_ICL_entailment
24,12,3,3,0,1.0,1,1,0,1.0,1.0,gemini,medalign,nursing_note,PROMPT1_ICL_entailment
25,120,11,11,0,1.0,7,6,1,0.8571428571428571,0.923076923076923,gemini,medalign,nursing_note,PROMPT1_ICL_entailment
26,121,4,4,0,1.0,1,1,0,1.0,1.0,gemini,medalign,nursing_note,PROMPT1_ICL_entailment
27,122,1,0,1,0.0,1,0,1,0.0,,gemini,medalign,nursing_note,PROMPT1_ICL_entailment
28,123,4,3,1,0.75,4,4,0,1.0,0.8571428571428571,gemini,medalign,nursing_note,PROMPT1_ICL_entailment
29,124,34,28,6,0.8235294117647058,14,14,0,1.0,0.9032258064516128,gemini,medalign,nursing_note,PROMPT1_ICL_entailment
30,125,13,12,1,0.9230769230769232,9,7,2,0.7777777777777778,0.8442211055276381,gemini,medalign,nursing_note,PROMPT1_ICL_entailment
31,126,3,3,0,1.0,2,2,0,1.0,1.0,gemini,medalign,nursing_note,PROMPT1_ICL_entailment
32,127,3,3,0,1.0,1,1,0,1.0,1.0,gemini,medalign,nursing_note,PROMPT1_ICL_entailment
33,128,4,4,0,1.0,2,2,0,1.0,1.0,gemini,medalign,nursing_note,PROMPT1_ICL_entailment
34,129,34,33,1,0.9705882352941176,20,20,0,1.0,0.9850746268656716,gemini,medalign,nursing_note,PROMPT1_ICL_entailment
35,13,5,5,0,1.0,5,5,0,1.0,1.0,gemini,medalign,nursing_note,PROMPT1_ICL_entailment
36,130,5,5,0,1.0,2,2,0,1.0,1.0,gemini,medalign,nursing_note,PROMPT1_ICL_entailment
37,131,4,3,1,0.75,1,1,0,1.0,0.8571428571428571,gemini,medalign,nursing_note,PROMPT1_ICL_entailment
38,132,6,5,1,0.8333333333333334,2,2,0,1.0,0.9090909090909092,gemini,medalign,nursing_note,PROMPT1_ICL_entailment
39,133,18,14,4,0.7777777777777778,14,8,6,0.5714285714285714,0.6588235294117646,gemini,medalign,nursing_note,PROMPT1_ICL_entailment
40,134,4,4,0,1.0,3,3,0,1.0,1.0,gemini,medalign,nursing_note,PROMPT1_ICL_entailment
41,135,5,5,0,1.0,2,2,0,1.0,1.0,gemini,medalign,nursing_note,PROMPT1_ICL_entailment
42,136,25,20,5,0.8,51,18,33,0.3529411764705882,0.489795918367347,gemini,medalign,nursing_note,PROMPT1_ICL_entailment
43,137,1,0,1,0.0,6,2,4,0.3333333333333333,0.0,gemini,medalign,nursing_note,PROMPT1_ICL_entailment
44,138,2,1,1,0.5,1,1,0,1.0,0.6666666666666666,gemini,medalign,nursing_note,PROMPT1_ICL_entailment
45,139,4,4,0,1.0,1,1,0,1.0,1.0,gemini,medalign,nursing_note,PROMPT1_ICL_entailment
46,14,2,1,1,0.5,1,1,0,1.0,0.6666666666666666,gemini,medalign,nursing_note,PROMPT1_ICL_entailment
47,140,4,4,0,1.0,3,3,0,1.0,1.0,gemini,medalign,nursing_note,PROMPT1_ICL_entailment
48,141,3,3,0,1.0,1,1,0,1.0,1.0,gemini,medalign,nursing_note,PROMPT1_ICL_entailment
49,142,2,2,0,1.0,1,1,0,1.0,1.0,gemini,medalign,nursing_note,PROMPT1_ICL_entailment
50,143,1,1,0,1.0,1,1,0,1.0,1.0,gemini,medalign,nursing_note,PROMPT1_ICL_entailment
51,144,1,0,1,0.0,1,0,1,0.0,,gemini,medalign,nursing_note,PROMPT1_ICL_entailment
52,145,4,4,0,1.0,4,4,0,1.0,1.0,gemini,medalign,nursing_note,PROMPT1_ICL_entailment
53,146,20,18,2,0.9,3,2,1,0.6666666666666666,0.7659574468085106,gemini,medalign,nursing_note,PROMPT1_ICL_entailment
54,147,11,10,1,0.9090909090909092,6,4,2,0.6666666666666666,0.7692307692307692,gemini,medalign,nursing_note,PROMPT1_ICL_entailment
55,148,25,24,1,0.96,7,7,0,1.0,0.979591836734694,gemini,medalign,nursing_note,PROMPT1_ICL_entailment
56,149,7,7,0,1.0,1,1,0,1.0,1.0,gemini,medalign,nursing_note,PROMPT1_ICL_entailment
57,15,6,5,1,0.8333333333333334,1,1,0,1.0,0.9090909090909092,gemini,medalign,nursing_note,PROMPT1_ICL_entailment
58,150,4,4,0,1.0,1,1,0,1.0,1.0,gemini,medalign,nursing_note,PROMPT1_ICL_entailment
59,151,15,15,0,1.0,8,8,0,1.0,1.0,gemini,medalign,nursing_note,PROMPT1_ICL_entailment
60,152,6,6,0,1.0,4,4,0,1.0,1.0,gemini,medalign,nursing_note,PROMPT1_ICL_entailment
61,153,14,12,2,0.8571428571428571,14,10,4,0.7142857142857143,0.7792207792207793,gemini,medalign,nursing_note,PROMPT1_ICL_entailment
62,154,4,4,0,1.0,1,1,0,1.0,1.0,gemini,medalign,nursing_note,PROMPT1_ICL_entailment
63,155,24,20,4,0.8333333333333334,14,10,4,0.7142857142857143,0.7692307692307692,gemini,medalign,nursing_note,PROMPT1_ICL_entailment
64,156,13,12,1,0.9230769230769232,1,0,1,0.0,0.0,gemini,medalign,nursing_note,PROMPT1_ICL_entailment
65,157,5,4,1,0.8,3,3,0,1.0,0.888888888888889,gemini,medalign,nursing_note,PROMPT1_ICL_entailment
66,158,10,10,0,1.0,1,1,0,1.0,1.0,gemini,medalign,nursing_note,PROMPT1_ICL_entailment
67,159,6,6,0,1.0,3,3,0,1.0,1.0,gemini,medalign,nursing_note,PROMPT1_ICL_entailment
68,16,20,18,2,0.9,3,2,1,0.6666666666666666,0.7659574468085106,gemini,medalign,nursing_note,PROMPT1_ICL_entailment
69,160,3,3,0,1.0,1,1,0,1.0,1.0,gemini,medalign,nursing_note,PROMPT1_ICL_entailment
70,161,5,5,0,1.0,1,1,0,1.0,1.0,gemini,medalign,nursing_note,PROMPT1_ICL_entailment
71,162,12,10,2,0.8333333333333334,8,6,2,0.75,0.7894736842105262,gemini,medalign,nursing_note,PROMPT1_ICL_entailment
72,163,7,7,0,1.0,3,3,0,1.0,1.0,gemini,medalign,nursing_note,PROMPT1_ICL_entailment
73,164,6,6,0,1.0,2,2,0,1.0,1.0,gemini,medalign,nursing_note,PROMPT1_ICL_entailment
74,165,10,10,0,1.0,4,3,1,0.75,0.8571428571428571,gemini,medalign,nursing_note,PROMPT1_ICL_entailment
75,166,15,13,2,0.8666666666666667,5,5,0,1.0,0.9285714285714286,gemini,medalign,nursing_note,PROMPT1_ICL_entailment
76,167,14,13,1,0.9285714285714286,2,1,1,0.5,0.65,gemini,medalign,nursing_note,PROMPT1_ICL_entailment
77,168,6,6,0,1.0,3,3,0,1.0,1.0,gemini,medalign,nursing_note,PROMPT1_ICL_entailment
78,169,13,11,2,0.8461538461538461,9,5,4,0.5555555555555556,0.6707317073170732,gemini,medalign,nursing_note,PROMPT1_ICL_entailment
79,17,3,2,1,0.6666666666666666,1,0,1,0.0,0.0,gemini,medalign,nursing_note,PROMPT1_ICL_entailment
80,170,5,5,0,1.0,1,1,0,1.0,1.0,gemini,medalign,nursing_note,PROMPT1_ICL_entailment
81,171,10,9,1,0.9,7,5,2,0.7142857142857143,0.7964601769911505,gemini,medalign,nursing_note,PROMPT1_ICL_entailment
82,172,17,13,4,0.7647058823529411,12,9,3,0.75,0.7572815533980582,gemini,medalign,nursing_note,PROMPT1_ICL_entailment
83,173,10,10,0,1.0,1,1,0,1.0,1.0,gemini,medalign,nursing_note,PROMPT1_ICL_entailment
84,174,4,4,0,1.0,1,1,0,1.0,1.0,gemini,medalign,nursing_note,PROMPT1_ICL_entailment
85,175,2,2,0,1.0,2,2,0,1.0,1.0,gemini,medalign,nursing_note,PROMPT1_ICL_entailment
86,176,10,8,2,0.8,3,3,0,1.0,0.888888888888889,gemini,medalign,nursing_note,PROMPT1_ICL_entailment
87,177,9,8,1,0.8888888888888888,8,6,2,0.75,0.8135593220338982,gemini,medalign,nursing_note,PROMPT1_ICL_entailment
88,178,10,9,1,0.9,10,7,3,0.7,0.7875,gemini,medalign,nursing_note,PROMPT1_ICL_entailment
89,179,9,7,2,0.7777777777777778,2,2,0,1.0,0.8750000000000001,gemini,medalign,nursing_note,PROMPT1_ICL_entailment
90,18,13,10,3,0.7692307692307693,3,1,2,0.3333333333333333,0.4651162790697674,gemini,medalign,nursing_note,PROMPT1_ICL_entailment
91,180,12,9,3,0.75,4,2,2,0.5,0.6,gemini,medalign,nursing_note,PROMPT1_ICL_entailment
92,181,7,7,0,1.0,7,7,0,1.0,1.0,gemini,medalign,nursing_note,PROMPT1_ICL_entailment
93,182,3,3,0,1.0,2,2,0,1.0,1.0,gemini,medalign,nursing_note,PROMPT1_ICL_entailment
94,183,7,7,0,1.0,6,6,0,1.0,1.0,gemini,medalign,nursing_note,PROMPT1_ICL_entailment
95,184,13,12,1,0.9230769230769232,11,9,2,0.8181818181818182,0.8674698795180724,gemini,medalign,nursing_note,PROMPT1_ICL_entailment
96,185,7,7,0,1.0,3,3,0,1.0,1.0,gemini,medalign,nursing_note,PROMPT1_ICL_entailment
97,186,5,4,1,0.8,3,2,1,0.6666666666666666,0.7272727272727272,gemini,medalign,nursing_note,PROMPT1_ICL_entailment
98,187,2,0,2,0.0,1,1,0,1.0,0.0,gemini,medalign,nursing_note,PROMPT1_ICL_entailment
99,188,3,3,0,1.0,3,3,0,1.0,1.0,gemini,medalign,nursing_note,PROMPT1_ICL_entailment
100,189,13,11,2,0.8461538461538461,10,7,3,0.7,0.7661691542288558,gemini,medalign,nursing_note,PROMPT1_ICL_entailment
101,19,15,15,0,1.0,7,7,0,1.0,1.0,gemini,medalign,nursing_note,PROMPT1_ICL_entailment
102,190,4,4,0,1.0,2,2,0,1.0,1.0,gemini,medalign,nursing_note,PROMPT1_ICL_entailment
103,191,17,16,1,0.9411764705882352,5,3,2,0.6,0.7328244274809161,gemini,medalign,nursing_note,PROMPT1_ICL_entailment
104,192,5,5,0,1.0,1,1,0,1.0,1.0,gemini,medalign,nursing_note,PROMPT1_ICL_entailment
105,193,6,6,0,1.0,3,3,0,1.0,1.0,gemini,medalign,nursing_note,PROMPT1_ICL_entailment
106,194,3,3,0,1.0,2,2,0,1.0,1.0,gemini,medalign,nursing_note,PROMPT1_ICL_entailment
107,195,13,11,2,0.8461538461538461,10,6,4,0.6,0.7021276595744681,gemini,medalign,nursing_note,PROMPT1_ICL_entailment
108,196,6,6,0,1.0,1,1,0,1.0,1.0,gemini,medalign,nursing_note,PROMPT1_ICL_entailment
109,197,4,4,0,1.0,1,1,0,1.0,1.0,gemini,medalign,nursing_note,PROMPT1_ICL_entailment
110,198,18,17,1,0.9444444444444444,8,8,0,1.0,0.9714285714285714,gemini,medalign,nursing_note,PROMPT1_ICL_entailment
111,199,19,14,5,0.7368421052631579,7,7,0,1.0,0.8484848484848484,gemini,medalign,nursing_note,PROMPT1_ICL_entailment
112,2,11,8,3,0.7272727272727273,5,3,2,0.6,0.6575342465753425,gemini,medalign,nursing_note,PROMPT1_ICL_entailment
113,20,6,5,1,0.8333333333333334,2,1,1,0.5,0.625,gemini,medalign,nursing_note,PROMPT1_ICL_entailment
114,200,4,4,0,1.0,3,3,0,1.0,1.0,gemini,medalign,nursing_note,PROMPT1_ICL_entailment
115,201,3,3,0,1.0,1,1,0,1.0,1.0,gemini,medalign,nursing_note,PROMPT1_ICL_entailment
116,202,6,6,0,1.0,1,1,0,1.0,1.0,gemini,medalign,nursing_note,PROMPT1_ICL_entailment
117,203,4,4,0,1.0,1,1,0,1.0,1.0,gemini,medalign,nursing_note,PROMPT1_ICL_entailment
118,204,20,16,4,0.8,9,7,2,0.7777777777777778,0.7887323943661971,gemini,medalign,nursing_note,PROMPT1_ICL_entailment
119,205,39,16,23,0.4102564102564102,8,3,5,0.375,0.3918367346938776,gemini,medalign,nursing_note,PROMPT1_ICL_entailment
120,206,5,5,0,1.0,4,4,0,1.0,1.0,gemini,medalign,nursing_note,PROMPT1_ICL_entailment
121,207,12,9,3,0.75,6,2,4,0.3333333333333333,0.4615384615384615,gemini,medalign,nursing_note,PROMPT1_ICL_entailment
122,208,14,13,1,0.9285714285714286,10,8,2,0.8,0.859504132231405,gemini,medalign,nursing_note,PROMPT1_ICL_entailment
123,209,5,5,0,1.0,1,1,0,1.0,1.0,gemini,medalign,nursing_note,PROMPT1_ICL_entailment
124,21,5,5,0,1.0,1,1,0,1.0,1.0,gemini,medalign,nursing_note,PROMPT1_ICL_entailment
125,210,4,4,0,1.0,2,1,1,0.5,0.6666666666666666,gemini,medalign,nursing_note,PROMPT1_ICL_entailment
126,211,4,4,0,1.0,2,2,0,1.0,1.0,gemini,medalign,nursing_note,PROMPT1_ICL_entailment
127,212,7,7,0,1.0,3,3,0,1.0,1.0,gemini,medalign,nursing_note,PROMPT1_ICL_entailment
128,213,15,14,1,0.9333333333333332,8,8,0,1.0,0.9655172413793104,gemini,medalign,nursing_note,PROMPT1_ICL_entailment
129,214,3,3,0,1.0,2,2,0,1.0,1.0,gemini,medalign,nursing_note,PROMPT1_ICL_entailment
130,215,3,3,0,1.0,1,1,0,1.0,1.0,gemini,medalign,nursing_note,PROMPT1_ICL_entailment
131,216,5,5,0,1.0,3,3,0,1.0,1.0,gemini,medalign,nursing_note,PROMPT1_ICL_entailment
132,217,15,11,4,0.7333333333333333,11,8,3,0.7272727272727273,0.7302904564315353,gemini,medalign,nursing_note,PROMPT1_ICL_entailment
133,218,19,18,1,0.9473684210526316,3,3,0,1.0,0.972972972972973,gemini,medalign,nursing_note,PROMPT1_ICL_entailment
134,219,8,6,2,0.75,2,2,0,1.0,0.8571428571428571,gemini,medalign,nursing_note,PROMPT1_ICL_entailment
135,22,1,0,1,0.0,1,0,1,0.0,,gemini,medalign,nursing_note,PROMPT1_ICL_entailment
136,220,11,10,1,0.9090909090909092,7,4,3,0.5714285714285714,0.7017543859649122,gemini,medalign,nursing_note,PROMPT1_ICL_entailment
137,221,27,22,5,0.8148148148148148,23,10,13,0.4347826086956521,0.5670103092783505,gemini,medalign,nursing_note,PROMPT1_ICL_entailment
138,222,8,8,0,1.0,4,4,0,1.0,1.0,gemini,medalign,nursing_note,PROMPT1_ICL_entailment
139,223,6,6,0,1.0,2,2,0,1.0,1.0,gemini,medalign,nursing_note,PROMPT1_ICL_entailment
140,224,11,11,0,1.0,4,3,1,0.75,0.8571428571428571,gemini,medalign,nursing_note,PROMPT1_ICL_entailment
141,225,8,5,3,0.625,2,2,0,1.0,0.7692307692307693,gemini,medalign,nursing_note,PROMPT1_ICL_entailment
142,226,10,9,1,0.9,5,4,1,0.8,0.8470588235294118,gemini,medalign,nursing_note,PROMPT1_ICL_entailment
143,227,1,1,0,1.0,1,1,0,1.0,1.0,gemini,medalign,nursing_note,PROMPT1_ICL_entailment
144,228,44,42,2,0.9545454545454546,18,16,2,0.8888888888888888,0.9205479452054794,gemini,medalign,nursing_note,PROMPT1_ICL_entailment
145,229,14,13,1,0.9285714285714286,7,5,2,0.7142857142857143,0.8074534161490684,gemini,medalign,nursing_note,PROMPT1_ICL_entailment
146,23,24,19,5,0.7916666666666666,21,12,9,0.5714285714285714,0.6637554585152837,gemini,medalign,nursing_note,PROMPT1_ICL_entailment
147,230,1,0,1,0.0,1,0,1,0.0,,gemini,medalign,nursing_note,PROMPT1_ICL_entailment
148,231,17,15,2,0.8823529411764706,13,11,2,0.8461538461538461,0.8638743455497382,gemini,medalign,nursing_note,PROMPT1_ICL_entailment
149,232,10,9,1,0.9,6,3,3,0.5,0.6428571428571429,gemini,medalign,nursing_note,PROMPT1_ICL_entailment
150,233,5,3,2,0.6,4,3,1,0.75,0.6666666666666665,gemini,medalign,nursing_note,PROMPT1_ICL_entailment
151,234,6,6,0,1.0,2,2,0,1.0,1.0,gemini,medalign,nursing_note,PROMPT1_ICL_entailment
152,235,1,0,1,0.0,1,1,0,1.0,0.0,gemini,medalign,nursing_note,PROMPT1_ICL_entailment
153,236,16,14,2,0.875,14,10,4,0.7142857142857143,0.7865168539325842,gemini,medalign,nursing_note,PROMPT1_ICL_entailment
154,237,11,8,3,0.7272727272727273,6,5,1,0.8333333333333334,0.7766990291262137,gemini,medalign,nursing_note,PROMPT1_ICL_entailment
155,238,5,5,0,1.0,4,3,1,0.75,0.8571428571428571,gemini,medalign,nursing_note,PROMPT1_ICL_entailment
156,239,16,16,0,1.0,4,4,0,1.0,1.0,gemini,medalign,nursing_note,PROMPT1_ICL_entailment
157,24,1,0,1,0.0,1,0,1,0.0,,gemini,medalign,nursing_note,PROMPT1_ICL_entailment
158,240,3,3,0,1.0,2,2,0,1.0,1.0,gemini,medalign,nursing_note,PROMPT1_ICL_entailment
159,241,5,5,0,1.0,2,2,0,1.0,1.0,gemini,medalign,nursing_note,PROMPT1_ICL_entailment
160,242,12,11,1,0.9166666666666666,2,1,1,0.5,0.6470588235294118,gemini,medalign,nursing_note,PROMPT1_ICL_entailment
161,243,23,22,1,0.9565217391304348,10,9,1,0.9,0.9274004683840747,gemini,medalign,nursing_note,PROMPT1_ICL_entailment
162,244,3,3,0,1.0,1,1,0,1.0,1.0,gemini,medalign,nursing_note,PROMPT1_ICL_entailment
163,245,3,3,0,1.0,1,1,0,1.0,1.0,gemini,medalign,nursing_note,PROMPT1_ICL_entailment
164,246,3,3,0,1.0,1,1,0,1.0,1.0,gemini,medalign,nursing_note,PROMPT1_ICL_entailment
165,247,8,8,0,1.0,5,5,0,1.0,1.0,gemini,medalign,nursing_note,PROMPT1_ICL_entailment
166,248,3,3,0,1.0,1,1,0,1.0,1.0,gemini,medalign,nursing_note,PROMPT1_ICL_entailment
167,249,9,9,0,1.0,2,2,0,1.0,1.0,gemini,medalign,nursing_note,PROMPT1_ICL_entailment
168,25,56,54,2,0.9642857142857144,33,26,7,0.7878787878787878,0.8672019765287214,gemini,medalign,nursing_note,PROMPT1_ICL_entailment
169,26,6,6,0,1.0,1,1,0,1.0,1.0,gemini,medalign,nursing_note,PROMPT1_ICL_entailment
170,27,9,6,3,0.6666666666666666,2,2,0,1.0,0.8,gemini,medalign,nursing_note,PROMPT1_ICL_entailment
171,28,9,8,1,0.8888888888888888,4,4,0,1.0,0.9411764705882352,gemini,medalign,nursing_note,PROMPT1_ICL_entailment
172,29,7,7,0,1.0,3,3,0,1.0,1.0,gemini,medalign,nursing_note,PROMPT1_ICL_entailment
173,3,3,2,1,0.6666666666666666,2,2,0,1.0,0.8,gemini,medalign,nursing_note,PROMPT1_ICL_entailment
174,30,5,5,0,1.0,1,1,0,1.0,1.0,gemini,medalign,nursing_note,PROMPT1_ICL_entailment
175,31,1,1,0,1.0,1,1,0,1.0,1.0,gemini,medalign,nursing_note,PROMPT1_ICL_entailment
176,32,5,5,0,1.0,2,2,0,1.0,1.0,gemini,medalign,nursing_note,PROMPT1_ICL_entailment
177,33,10,8,2,0.8,5,4,1,0.8,0.8000000000000002,gemini,medalign,nursing_note,PROMPT1_ICL_entailment
178,34,11,8,3,0.7272727272727273,4,1,3,0.25,0.3720930232558139,gemini,medalign,nursing_note,PROMPT1_ICL_entailment
179,35,9,8,1,0.8888888888888888,4,2,2,0.5,0.64,gemini,medalign,nursing_note,PROMPT1_ICL_entailment
180,36,16,10,6,0.625,5,3,2,0.6,0.6122448979591836,gemini,medalign,nursing_note,PROMPT1_ICL_entailment
181,37,8,8,0,1.0,3,3,0,1.0,1.0,gemini,medalign,nursing_note,PROMPT1_ICL_entailment
182,38,17,10,7,0.5882352941176471,5,4,1,0.8,0.6779661016949153,gemini,medalign,nursing_note,PROMPT1_ICL_entailment
183,39,3,3,0,1.0,1,1,0,1.0,1.0,gemini,medalign,nursing_note,PROMPT1_ICL_entailment
184,4,5,4,1,0.8,3,3,0,1.0,0.888888888888889,gemini,medalign,nursing_note,PROMPT1_ICL_entailment
185,40,17,17,0,1.0,8,5,3,0.625,0.7692307692307693,gemini,medalign,nursing_note,PROMPT1_ICL_entailment
186,41,4,4,0,1.0,1,1,0,1.0,1.0,gemini,medalign,nursing_note,PROMPT1_ICL_entailment
187,42,10,9,1,0.9,8,7,1,0.875,0.8873239436619719,gemini,medalign,nursing_note,PROMPT1_ICL_entailment
188,43,5,5,0,1.0,2,2,0,1.0,1.0,gemini,medalign,nursing_note,PROMPT1_ICL_entailment
189,44,4,4,0,1.0,1,1,0,1.0,1.0,gemini,medalign,nursing_note,PROMPT1_ICL_entailment
190,45,2,1,1,0.5,1,1,0,1.0,0.6666666666666666,gemini,medalign,nursing_note,PROMPT1_ICL_entailment
191,46,9,9,0,1.0,5,5,0,1.0,1.0,gemini,medalign,nursing_note,PROMPT1_ICL_entailment
192,47,27,27,0,1.0,20,19,1,0.95,0.9743589743589745,gemini,medalign,nursing_note,PROMPT1_ICL_entailment
193,48,5,5,0,1.0,2,2,0,1.0,1.0,gemini,medalign,nursing_note,PROMPT1_ICL_entailment
194,49,8,6,2,0.75,2,2,0,1.0,0.8571428571428571,gemini,medalign,nursing_note,PROMPT1_ICL_entailment
195,5,16,16,0,1.0,5,4,1,0.8,0.888888888888889,gemini,medalign,nursing_note,PROMPT1_ICL_entailment
196,50,3,3,0,1.0,1,1,0,1.0,1.0,gemini,medalign,nursing_note,PROMPT1_ICL_entailment
197,51,4,3,1,0.75,2,2,0,1.0,0.8571428571428571,gemini,medalign,nursing_note,PROMPT1_ICL_entailment
198,52,5,4,1,0.8,4,4,0,1.0,0.888888888888889,gemini,medalign,nursing_note,PROMPT1_ICL_entailment
199,53,3,3,0,1.0,1,1,0,1.0,1.0,gemini,medalign,nursing_note,PROMPT1_ICL_entailment
200,54,12,10,2,0.8333333333333334,7,4,3,0.5714285714285714,0.6779661016949152,gemini,medalign,nursing_note,PROMPT1_ICL_entailment
201,55,6,6,0,1.0,2,2,0,1.0,1.0,gemini,medalign,nursing_note,PROMPT1_ICL_entailment
202,56,8,7,1,0.875,3,2,1,0.6666666666666666,0.7567567567567567,gemini,medalign,nursing_note,PROMPT1_ICL_entailment
203,57,8,5,3,0.625,4,2,2,0.5,0.5555555555555556,gemini,medalign,nursing_note,PROMPT1_ICL_entailment
204,58,3,3,0,1.0,1,1,0,1.0,1.0,gemini,medalign,nursing_note,PROMPT1_ICL_entailment
205,59,2,2,0,1.0,1,1,0,1.0,1.0,gemini,medalign,nursing_note,PROMPT1_ICL_entailment
206,6,7,7,0,1.0,3,3,0,1.0,1.0,gemini,medalign,nursing_note,PROMPT1_ICL_entailment
207,60,12,10,2,0.8333333333333334,9,7,2,0.7777777777777778,0.8045977011494253,gemini,medalign,nursing_note,PROMPT1_ICL_entailment
208,61,3,3,0,1.0,1,1,0,1.0,1.0,gemini,medalign,nursing_note,PROMPT1_ICL_entailment
209,62,10,10,0,1.0,5,3,2,0.6,0.7499999999999999,gemini,medalign,nursing_note,PROMPT1_ICL_entailment
210,63,1,0,1,0.0,7,0,7,0.0,,gemini,medalign,nursing_note,PROMPT1_ICL_entailment
211,64,1,0,1,0.0,1,0,1,0.0,,gemini,medalign,nursing_note,PROMPT1_ICL_entailment
212,65,6,6,0,1.0,2,1,1,0.5,0.6666666666666666,gemini,medalign,nursing_note,PROMPT1_ICL_entailment
213,66,6,6,0,1.0,4,4,0,1.0,1.0,gemini,medalign,nursing_note,PROMPT1_ICL_entailment
214,67,6,6,0,1.0,4,3,1,0.75,0.8571428571428571,gemini,medalign,nursing_note,PROMPT1_ICL_entailment
215,68,1,0,1,0.0,1,0,1,0.0,,gemini,medalign,nursing_note,PROMPT1_ICL_entailment
216,69,5,4,1,0.8,2,1,1,0.5,0.6153846153846154,gemini,medalign,nursing_note,PROMPT1_ICL_entailment
217,7,7,7,0,1.0,1,1,0,1.0,1.0,gemini,medalign,nursing_note,PROMPT1_ICL_entailment
218,70,9,9,0,1.0,1,1,0,1.0,1.0,gemini,medalign,nursing_note,PROMPT1_ICL_entailment
219,71,6,5,1,0.8333333333333334,1,0,1,0.0,0.0,gemini,medalign,nursing_note,PROMPT1_ICL_entailment
220,72,3,2,1,0.6666666666666666,1,1,0,1.0,0.8,gemini,medalign,nursing_note,PROMPT1_ICL_entailment
221,73,3,3,0,1.0,2,2,0,1.0,1.0,gemini,medalign,nursing_note,PROMPT1_ICL_entailment
222,74,11,8,3,0.7272727272727273,6,5,1,0.8333333333333334,0.7766990291262137,gemini,medalign,nursing_note,PROMPT1_ICL_entailment
223,75,2,2,0,1.0,1,1,0,1.0,1.0,gemini,medalign,nursing_note,PROMPT1_ICL_entailment
224,76,20,18,2,0.9,5,5,0,1.0,0.9473684210526316,gemini,medalign,nursing_note,PROMPT1_ICL_entailment
225,77,1,0,1,0.0,3,0,3,0.0,,gemini,medalign,nursing_note,PROMPT1_ICL_entailment
226,78,9,9,0,1.0,3,2,1,0.6666666666666666,0.8,gemini,medalign,nursing_note,PROMPT1_ICL_entailment
227,79,9,8,1,0.8888888888888888,8,7,1,0.875,0.8818897637795274,gemini,medalign,nursing_note,PROMPT1_ICL_entailment
228,8,16,15,1,0.9375,8,6,2,0.75,0.8333333333333334,gemini,medalign,nursing_note,PROMPT1_ICL_entailment
229,80,15,14,1,0.9333333333333332,10,8,2,0.8,0.8615384615384616,gemini,medalign,nursing_note,PROMPT1_ICL_entailment
230,81,3,2,1,0.6666666666666666,1,1,0,1.0,0.8,gemini,medalign,nursing_note,PROMPT1_ICL_entailment
231,82,3,3,0,1.0,3,3,0,1.0,1.0,gemini,medalign,nursing_note,PROMPT1_ICL_entailment
232,83,9,7,2,0.7777777777777778,3,2,1,0.6666666666666666,0.717948717948718,gemini,medalign,nursing_note,PROMPT1_ICL_entailment
233,84,9,7,2,0.7777777777777778,2,1,1,0.5,0.6086956521739131,gemini,medalign,nursing_note,PROMPT1_ICL_entailment
234,85,15,14,1,0.9333333333333332,8,7,1,0.875,0.9032258064516128,gemini,medalign,nursing_note,PROMPT1_ICL_entailment
235,86,3,3,0,1.0,3,3,0,1.0,1.0,gemini,medalign,nursing_note,PROMPT1_ICL_entailment
236,87,4,4,0,1.0,2,2,0,1.0,1.0,gemini,medalign,nursing_note,PROMPT1_ICL_entailment
237,88,17,16,1,0.9411764705882352,7,7,0,1.0,0.9696969696969696,gemini,medalign,nursing_note,PROMPT1_ICL_entailment
238,89,12,12,0,1.0,6,6,0,1.0,1.0,gemini,medalign,nursing_note,PROMPT1_ICL_entailment
239,9,7,6,1,0.8571428571428571,2,2,0,1.0,0.923076923076923,gemini,medalign,nursing_note,PROMPT1_ICL_entailment
240,90,1,0,1,0.0,1,0,1,0.0,,gemini,medalign,nursing_note,PROMPT1_ICL_entailment
241,91,4,4,0,1.0,1,1,0,1.0,1.0,gemini,medalign,nursing_note,PROMPT1_ICL_entailment
242,92,7,7,0,1.0,4,3,1,0.75,0.8571428571428571,gemini,medalign,nursing_note,PROMPT1_ICL_entailment
243,93,4,3,1,0.75,1,1,0,1.0,0.8571428571428571,gemini,medalign,nursing_note,PROMPT1_ICL_entailment
244,94,5,5,0,1.0,2,2,0,1.0,1.0,gemini,medalign,nursing_note,PROMPT1_ICL_entailment
245,95,2,2,0,1.0,1,1,0,1.0,1.0,gemini,medalign,nursing_note,PROMPT1_ICL_entailment
246,96,2,2,0,1.0,1,1,0,1.0,1.0,gemini,medalign,nursing_note,PROMPT1_ICL_entailment
247,97,7,7,0,1.0,2,2,0,1.0,1.0,gemini,medalign,nursing_note,PROMPT1_ICL_entailment
248,98,9,9,0,1.0,5,5,0,1.0,1.0,gemini,medalign,nursing_note,PROMPT1_ICL_entailment
249,99,12,11,1,0.9166666666666666,7,5,2,0.7142857142857143,0.8029197080291971,gemini,medalign,nursing_note,PROMPT1_ICL_entailment
0,0,14,13,1,0.9285714285714286,6,5,1,0.8333333333333334,0.8783783783783784,gemini,medalign,nursing_note,PROMPT2_ICL_entailment
1,1,10,10,0,1.0,1,1,0,1.0,1.0,gemini,medalign,nursing_note,PROMPT2_ICL_entailment
2,10,9,9,0,1.0,5,3,2,0.6,0.7499999999999999,gemini,medalign,nursing_note,PROMPT2_ICL_entailment
3,100,12,12,0,1.0,10,8,2,0.8,0.888888888888889,gemini,medalign,nursing_note,PROMPT2_ICL_entailment
4,101,8,8,0,1.0,1,1,0,1.0,1.0,gemini,medalign,nursing_note,PROMPT2_ICL_entailment
5,102,13,13,0,1.0,4,4,0,1.0,1.0,gemini,medalign,nursing_note,PROMPT2_ICL_entailment
6,103,3,2,1,0.6666666666666666,2,1,1,0.5,0.5714285714285715,gemini,medalign,nursing_note,PROMPT2_ICL_entailment
7,104,20,17,3,0.85,15,14,1,0.9333333333333332,0.8897196261682243,gemini,medalign,nursing_note,PROMPT2_ICL_entailment
8,105,5,4,1,0.8,1,1,0,1.0,0.888888888888889,gemini,medalign,nursing_note,PROMPT2_ICL_entailment
9,106,1,0,1,0.0,1,1,0,1.0,0.0,gemini,medalign,nursing_note,PROMPT2_ICL_entailment
10,107,8,7,1,0.875,4,4,0,1.0,0.9333333333333332,gemini,medalign,nursing_note,PROMPT2_ICL_entailment
11,108,3,2,1,0.6666666666666666,2,2,0,1.0,0.8,gemini,medalign,nursing_note,PROMPT2_ICL_entailment
12,109,9,8,1,0.8888888888888888,5,5,0,1.0,0.9411764705882352,gemini,medalign,nursing_note,PROMPT2_ICL_entailment
13,11,1,1,0,1.0,1,1,0,1.0,1.0,gemini,medalign,nursing_note,PROMPT2_ICL_entailment
14,110,21,13,8,0.6190476190476191,6,3,3,0.5,0.5531914893617021,gemini,medalign,nursing_note,PROMPT2_ICL_entailment
15,111,1,1,0,1.0,1,1,0,1.0,1.0,gemini,medalign,nursing_note,PROMPT2_ICL_entailment
16,112,8,6,2,0.75,2,2,0,1.0,0.8571428571428571,gemini,medalign,nursing_note,PROMPT2_ICL_entailment
17,113,1,1,0,1.0,1,1,0,1.0,1.0,gemini,medalign,nursing_note,PROMPT2_ICL_entailment
18,114,4,3,1,0.75,1,1,0,1.0,0.8571428571428571,gemini,medalign,nursing_note,PROMPT2_ICL_entailment
19,115,14,14,0,1.0,7,4,3,0.5714285714285714,0.7272727272727273,gemini,medalign,nursing_note,PROMPT2_ICL_entailment
20,116,9,7,2,0.7777777777777778,5,4,1,0.8,0.7887323943661971,gemini,medalign,nursing_note,PROMPT2_ICL_entailment
21,117,14,12,2,0.8571428571428571,13,8,5,0.6153846153846154,0.7164179104477612,gemini,medalign,nursing_note,PROMPT2_ICL_entailment
22,118,3,3,0,1.0,2,2,0,1.0,1.0,gemini,medalign,nursing_note,PROMPT2_ICL_entailment
23,119,6,4,2,0.6666666666666666,2,2,0,1.0,0.8,gemini,medalign,nursing_note,PROMPT2_ICL_entailment
24,12,4,4,0,1.0,1,1,0,1.0,1.0,gemini,medalign,nursing_note,PROMPT2_ICL_entailment
25,120,11,11,0,1.0,7,5,2,0.7142857142857143,0.8333333333333333,gemini,medalign,nursing_note,PROMPT2_ICL_entailment
26,121,1,0,1,0.0,1,0,1,0.0,,gemini,medalign,nursing_note,PROMPT2_ICL_entailment
27,122,1,0,1,0.0,1,0,1,0.0,,gemini,medalign,nursing_note,PROMPT2_ICL_entailment
28,123,4,4,0,1.0,4,4,0,1.0,1.0,gemini,medalign,nursing_note,PROMPT2_ICL_entailment
29,124,32,24,8,0.75,14,14,0,1.0,0.8571428571428571,gemini,medalign,nursing_note,PROMPT2_ICL_entailment
30,125,19,19,0,1.0,9,8,1,0.8888888888888888,0.9411764705882352,gemini,medalign,nursing_note,PROMPT2_ICL_entailment
31,126,3,3,0,1.0,2,2,0,1.0,1.0,gemini,medalign,nursing_note,PROMPT2_ICL_entailment
32,127,3,2,1,0.6666666666666666,1,1,0,1.0,0.8,gemini,medalign,nursing_note,PROMPT2_ICL_entailment
33,128,5,5,0,1.0,2,2,0,1.0,1.0,gemini,medalign,nursing_note,PROMPT2_ICL_entailment
34,129,25,23,2,0.92,20,15,5,0.75,0.8263473053892216,gemini,medalign,nursing_note,PROMPT2_ICL_entailment
35,13,7,7,0,1.0,5,4,1,0.8,0.888888888888889,gemini,medalign,nursing_note,PROMPT2_ICL_entailment
36,130,6,5,1,0.8333333333333334,2,2,0,1.0,0.9090909090909092,gemini,medalign,nursing_note,PROMPT2_ICL_entailment
37,131,3,3,0,1.0,1,1,0,1.0,1.0,gemini,medalign,nursing_note,PROMPT2_ICL_entailment
38,132,6,3,3,0.5,2,1,1,0.5,0.5,gemini,medalign,nursing_note,PROMPT2_ICL_entailment
39,133,13,11,2,0.8461538461538461,14,6,8,0.4285714285714285,0.5689655172413793,gemini,medalign,nursing_note,PROMPT2_ICL_entailment
40,134,5,5,0,1.0,3,3,0,1.0,1.0,gemini,medalign,nursing_note,PROMPT2_ICL_entailment
41,135,6,5,1,0.8333333333333334,2,2,0,1.0,0.9090909090909092,gemini,medalign,nursing_note,PROMPT2_ICL_entailment
42,136,26,21,5,0.8076923076923077,51,13,38,0.2549019607843137,0.3875088715400993,gemini,medalign,nursing_note,PROMPT2_ICL_entailment
43,137,16,16,0,1.0,6,6,0,1.0,1.0,gemini,medalign,nursing_note,PROMPT2_ICL_entailment
44,138,1,1,0,1.0,1,1,0,1.0,1.0,gemini,medalign,nursing_note,PROMPT2_ICL_entailment
45,139,5,4,1,0.8,1,1,0,1.0,0.888888888888889,gemini,medalign,nursing_note,PROMPT2_ICL_entailment
46,14,1,1,0,1.0,1,1,0,1.0,1.0,gemini,medalign,nursing_note,PROMPT2_ICL_entailment
47,140,4,4,0,1.0,3,3,0,1.0,1.0,gemini,medalign,nursing_note,PROMPT2_ICL_entailment
48,141,2,2,0,1.0,1,1,0,1.0,1.0,gemini,medalign,nursing_note,PROMPT2_ICL_entailment
49,142,3,2,1,0.6666666666666666,1,1,0,1.0,0.8,gemini,medalign,nursing_note,PROMPT2_ICL_entailment
50,143,1,1,0,1.0,1,1,0,1.0,1.0,gemini,medalign,nursing_note,PROMPT2_ICL_entailment
51,144,1,0,1,0.0,1,0,1,0.0,,gemini,medalign,nursing_note,PROMPT2_ICL_entailment
52,145,5,5,0,1.0,4,4,0,1.0,1.0,gemini,medalign,nursing_note,PROMPT2_ICL_entailment
53,146,18,17,1,0.9444444444444444,3,2,1,0.6666666666666666,0.7816091954022987,gemini,medalign,nursing_note,PROMPT2_ICL_entailment
54,147,12,10,2,0.8333333333333334,6,4,2,0.6666666666666666,0.7407407407407408,gemini,medalign,nursing_note,PROMPT2_ICL_entailment
55,148,26,25,1,0.9615384615384616,7,7,0,1.0,0.9803921568627452,gemini,medalign,nursing_note,PROMPT2_ICL_entailment
56,149,12,11,1,0.9166666666666666,1,1,0,1.0,0.9565217391304348,gemini,medalign,nursing_note,PROMPT2_ICL_entailment
57,15,8,7,1,0.875,1,1,0,1.0,0.9333333333333332,gemini,medalign,nursing_note,PROMPT2_ICL_entailment
58,150,5,4,1,0.8,1,1,0,1.0,0.888888888888889,gemini,medalign,nursing_note,PROMPT2_ICL_entailment
59,151,18,17,1,0.9444444444444444,8,7,1,0.875,0.9083969465648856,gemini,medalign,nursing_note,PROMPT2_ICL_entailment
60,152,8,7,1,0.875,4,4,0,1.0,0.9333333333333332,gemini,medalign,nursing_note,PROMPT2_ICL_entailment
61,153,15,14,1,0.9333333333333332,14,11,3,0.7857142857142857,0.8531855955678669,gemini,medalign,nursing_note,PROMPT2_ICL_entailment
62,154,10,3,7,0.3,1,1,0,1.0,0.4615384615384615,gemini,medalign,nursing_note,PROMPT2_ICL_entailment
63,155,25,20,5,0.8,14,11,3,0.7857142857142857,0.7927927927927927,gemini,medalign,nursing_note,PROMPT2_ICL_entailment
64,156,12,11,1,0.9166666666666666,1,1,0,1.0,0.9565217391304348,gemini,medalign,nursing_note,PROMPT2_ICL_entailment
65,157,6,6,0,1.0,3,1,2,0.3333333333333333,0.5,gemini,medalign,nursing_note,PROMPT2_ICL_entailment
66,158,8,8,0,1.0,1,1,0,1.0,1.0,gemini,medalign,nursing_note,PROMPT2_ICL_entailment
67,159,6,6,0,1.0,3,3,0,1.0,1.0,gemini,medalign,nursing_note,PROMPT2_ICL_entailment
68,16,18,16,2,0.8888888888888888,3,2,1,0.6666666666666666,0.761904761904762,gemini,medalign,nursing_note,PROMPT2_ICL_entailment
69,160,5,5,0,1.0,1,1,0,1.0,1.0,gemini,medalign,nursing_note,PROMPT2_ICL_entailment
70,161,6,6,0,1.0,1,1,0,1.0,1.0,gemini,medalign,nursing_note,PROMPT2_ICL_entailment
71,162,14,13,1,0.9285714285714286,8,8,0,1.0,0.962962962962963,gemini,medalign,nursing_note,PROMPT2_ICL_entailment
72,163,8,7,1,0.875,3,3,0,1.0,0.9333333333333332,gemini,medalign,nursing_note,PROMPT2_ICL_entailment
73,164,7,7,0,1.0,2,2,0,1.0,1.0,gemini,medalign,nursing_note,PROMPT2_ICL_entailment
74,165,6,5,1,0.8333333333333334,4,4,0,1.0,0.9090909090909092,gemini,medalign,nursing_note,PROMPT2_ICL_entailment
75,166,18,15,3,0.8333333333333334,5,5,0,1.0,0.9090909090909092,gemini,medalign,nursing_note,PROMPT2_ICL_entailment
76,167,16,15,1,0.9375,2,1,1,0.5,0.6521739130434783,gemini,medalign,nursing_note,PROMPT2_ICL_entailment
77,168,8,8,0,1.0,3,3,0,1.0,1.0,gemini,medalign,nursing_note,PROMPT2_ICL_entailment
78,169,15,14,1,0.9333333333333332,9,4,5,0.4444444444444444,0.6021505376344086,gemini,medalign,nursing_note,PROMPT2_ICL_entailment
79,17,3,2,1,0.6666666666666666,1,0,1,0.0,0.0,gemini,medalign,nursing_note,PROMPT2_ICL_entailment
80,170,1,0,1,0.0,1,0,1,0.0,,gemini,medalign,nursing_note,PROMPT2_ICL_entailment
81,171,10,8,2,0.8,7,3,4,0.4285714285714285,0.5581395348837209,gemini,medalign,nursing_note,PROMPT2_ICL_entailment
82,172,16,14,2,0.875,12,8,4,0.6666666666666666,0.7567567567567567,gemini,medalign,nursing_note,PROMPT2_ICL_entailment
83,173,10,10,0,1.0,1,1,0,1.0,1.0,gemini,medalign,nursing_note,PROMPT2_ICL_entailment
84,174,4,0,4,0.0,1,1,0,1.0,0.0,gemini,medalign,nursing_note,PROMPT2_ICL_entailment
85,175,4,3,1,0.75,2,2,0,1.0,0.8571428571428571,gemini,medalign,nursing_note,PROMPT2_ICL_entailment
86,176,15,9,6,0.6,3,1,2,0.3333333333333333,0.4285714285714285,gemini,medalign,nursing_note,PROMPT2_ICL_entailment
87,177,12,10,2,0.8333333333333334,8,6,2,0.75,0.7894736842105262,gemini,medalign,nursing_note,PROMPT2_ICL_entailment
88,178,10,9,1,0.9,10,9,1,0.9,0.9,gemini,medalign,nursing_note,PROMPT2_ICL_entailment
89,179,12,11,1,0.9166666666666666,2,1,1,0.5,0.6470588235294118,gemini,medalign,nursing_note,PROMPT2_ICL_entailment
90,18,16,15,1,0.9375,3,3,0,1.0,0.967741935483871,gemini,medalign,nursing_note,PROMPT2_ICL_entailment
91,180,10,9,1,0.9,4,2,2,0.5,0.6428571428571429,gemini,medalign,nursing_note,PROMPT2_ICL_entailment
92,181,8,8,0,1.0,7,7,0,1.0,1.0,gemini,medalign,nursing_note,PROMPT2_ICL_entailment
93,182,4,4,0,1.0,2,2,0,1.0,1.0,gemini,medalign,nursing_note,PROMPT2_ICL_entailment
94,183,9,9,0,1.0,6,6,0,1.0,1.0,gemini,medalign,nursing_note,PROMPT2_ICL_entailment
95,184,11,10,1,0.9090909090909092,11,9,2,0.8181818181818182,0.861244019138756,gemini,medalign,nursing_note,PROMPT2_ICL_entailment
96,185,7,6,1,0.8571428571428571,3,3,0,1.0,0.923076923076923,gemini,medalign,nursing_note,PROMPT2_ICL_entailment
97,186,9,9,0,1.0,3,3,0,1.0,1.0,gemini,medalign,nursing_note,PROMPT2_ICL_entailment
98,187,1,1,0,1.0,1,1,0,1.0,1.0,gemini,medalign,nursing_note,PROMPT2_ICL_entailment
99,188,4,3,1,0.75,3,3,0,1.0,0.8571428571428571,gemini,medalign,nursing_note,PROMPT2_ICL_entailment
100,189,13,11,2,0.8461538461538461,10,8,2,0.8,0.8224299065420562,gemini,medalign,nursing_note,PROMPT2_ICL_entailment
101,19,18,18,0,1.0,7,7,0,1.0,1.0,gemini,medalign,nursing_note,PROMPT2_ICL_entailment
102,190,4,4,0,1.0,2,2,0,1.0,1.0,gemini,medalign,nursing_note,PROMPT2_ICL_entailment
103,191,18,16,2,0.8888888888888888,5,4,1,0.8,0.8421052631578948,gemini,medalign,nursing_note,PROMPT2_ICL_entailment
104,192,6,6,0,1.0,1,1,0,1.0,1.0,gemini,medalign,nursing_note,PROMPT2_ICL_entailment
105,193,7,6,1,0.8571428571428571,3,3,0,1.0,0.923076923076923,gemini,medalign,nursing_note,PROMPT2_ICL_entailment
106,194,5,4,1,0.8,2,2,0,1.0,0.888888888888889,gemini,medalign,nursing_note,PROMPT2_ICL_entailment
107,195,13,11,2,0.8461538461538461,10,7,3,0.7,0.7661691542288558,gemini,medalign,nursing_note,PROMPT2_ICL_entailment
108,196,8,8,0,1.0,1,1,0,1.0,1.0,gemini,medalign,nursing_note,PROMPT2_ICL_entailment
109,197,5,4,1,0.8,1,1,0,1.0,0.888888888888889,gemini,medalign,nursing_note,PROMPT2_ICL_entailment
110,198,15,15,0,1.0,8,7,1,0.875,0.9333333333333332,gemini,medalign,nursing_note,PROMPT2_ICL_entailment
111,199,22,17,5,0.7727272727272727,7,7,0,1.0,0.8717948717948718,gemini,medalign,nursing_note,PROMPT2_ICL_entailment
112,2,13,8,5,0.6153846153846154,5,3,2,0.6,0.6075949367088608,gemini,medalign,nursing_note,PROMPT2_ICL_entailment
113,20,6,4,2,0.6666666666666666,2,1,1,0.5,0.5714285714285715,gemini,medalign,nursing_note,PROMPT2_ICL_entailment
114,200,5,5,0,1.0,3,3,0,1.0,1.0,gemini,medalign,nursing_note,PROMPT2_ICL_entailment
115,201,2,2,0,1.0,1,0,1,0.0,0.0,gemini,medalign,nursing_note,PROMPT2_ICL_entailment
116,202,7,6,1,0.8571428571428571,1,1,0,1.0,0.923076923076923,gemini,medalign,nursing_note,PROMPT2_ICL_entailment
117,203,2,2,0,1.0,1,1,0,1.0,1.0,gemini,medalign,nursing_note,PROMPT2_ICL_entailment
118,204,26,18,8,0.6923076923076923,9,4,5,0.4444444444444444,0.5413533834586466,gemini,medalign,nursing_note,PROMPT2_ICL_entailment
119,205,31,17,14,0.5483870967741935,8,2,6,0.25,0.3434343434343434,gemini,medalign,nursing_note,PROMPT2_ICL_entailment
120,206,5,4,1,0.8,4,4,0,1.0,0.888888888888889,gemini,medalign,nursing_note,PROMPT2_ICL_entailment
121,207,13,10,3,0.7692307692307693,6,6,0,1.0,0.8695652173913044,gemini,medalign,nursing_note,PROMPT2_ICL_entailment
122,208,11,11,0,1.0,10,8,2,0.8,0.888888888888889,gemini,medalign,nursing_note,PROMPT2_ICL_entailment
123,209,6,6,0,1.0,1,0,1,0.0,0.0,gemini,medalign,nursing_note,PROMPT2_ICL_entailment
124,21,6,6,0,1.0,1,1,0,1.0,1.0,gemini,medalign,nursing_note,PROMPT2_ICL_entailment
125,210,4,3,1,0.75,2,1,1,0.5,0.6,gemini,medalign,nursing_note,PROMPT2_ICL_entailment
126,211,7,4,3,0.5714285714285714,2,0,2,0.0,0.0,gemini,medalign,nursing_note,PROMPT2_ICL_entailment
127,212,6,6,0,1.0,3,3,0,1.0,1.0,gemini,medalign,nursing_note,PROMPT2_ICL_entailment
128,213,14,14,0,1.0,8,8,0,1.0,1.0,gemini,medalign,nursing_note,PROMPT2_ICL_entailment
129,214,2,2,0,1.0,2,1,1,0.5,0.6666666666666666,gemini,medalign,nursing_note,PROMPT2_ICL_entailment
130,215,1,0,1,0.0,1,0,1,0.0,,gemini,medalign,nursing_note,PROMPT2_ICL_entailment
131,216,7,7,0,1.0,3,3,0,1.0,1.0,gemini,medalign,nursing_note,PROMPT2_ICL_entailment
132,217,17,13,4,0.7647058823529411,11,9,2,0.8181818181818182,0.7905405405405405,gemini,medalign,nursing_note,PROMPT2_ICL_entailment
133,218,18,17,1,0.9444444444444444,3,2,1,0.6666666666666666,0.7816091954022987,gemini,medalign,nursing_note,PROMPT2_ICL_entailment
134,219,6,5,1,0.8333333333333334,2,2,0,1.0,0.9090909090909092,gemini,medalign,nursing_note,PROMPT2_ICL_entailment
135,22,3,2,1,0.6666666666666666,1,0,1,0.0,0.0,gemini,medalign,nursing_note,PROMPT2_ICL_entailment
136,220,13,12,1,0.9230769230769232,7,5,2,0.7142857142857143,0.8053691275167787,gemini,medalign,nursing_note,PROMPT2_ICL_entailment
137,221,6,6,0,1.0,23,3,20,0.1304347826086956,0.2307692307692307,gemini,medalign,nursing_note,PROMPT2_ICL_entailment
138,222,9,9,0,1.0,4,4,0,1.0,1.0,gemini,medalign,nursing_note,PROMPT2_ICL_entailment
139,223,6,6,0,1.0,2,2,0,1.0,1.0,gemini,medalign,nursing_note,PROMPT2_ICL_entailment
140,224,12,9,3,0.75,4,3,1,0.75,0.75,gemini,medalign,nursing_note,PROMPT2_ICL_entailment
141,225,9,9,0,1.0,2,2,0,1.0,1.0,gemini,medalign,nursing_note,PROMPT2_ICL_entailment
142,226,17,8,9,0.4705882352941176,5,3,2,0.6,0.5274725274725275,gemini,medalign,nursing_note,PROMPT2_ICL_entailment
143,227,1,1,0,1.0,1,1,0,1.0,1.0,gemini,medalign,nursing_note,PROMPT2_ICL_entailment
144,228,49,48,1,0.979591836734694,18,12,6,0.6666666666666666,0.793388429752066,gemini,medalign,nursing_note,PROMPT2_ICL_entailment
145,229,14,12,2,0.8571428571428571,7,6,1,0.8571428571428571,0.8571428571428571,gemini,medalign,nursing_note,PROMPT2_ICL_entailment
146,23,30,25,5,0.8333333333333334,21,10,11,0.4761904761904761,0.6060606060606061,gemini,medalign,nursing_note,PROMPT2_ICL_entailment
147,230,3,2,1,0.6666666666666666,1,1,0,1.0,0.8,gemini,medalign,nursing_note,PROMPT2_ICL_entailment
148,231,15,12,3,0.8,13,9,4,0.6923076923076923,0.7422680412371134,gemini,medalign,nursing_note,PROMPT2_ICL_entailment
149,232,8,8,0,1.0,6,4,2,0.6666666666666666,0.8,gemini,medalign,nursing_note,PROMPT2_ICL_entailment
150,233,6,4,2,0.6666666666666666,4,4,0,1.0,0.8,gemini,medalign,nursing_note,PROMPT2_ICL_entailment
151,234,10,10,0,1.0,2,2,0,1.0,1.0,gemini,medalign,nursing_note,PROMPT2_ICL_entailment
152,235,1,0,1,0.0,1,0,1,0.0,,gemini,medalign,nursing_note,PROMPT2_ICL_entailment
153,236,13,11,2,0.8461538461538461,14,11,3,0.7857142857142857,0.8148148148148148,gemini,medalign,nursing_note,PROMPT2_ICL_entailment
154,237,13,11,2,0.8461538461538461,6,5,1,0.8333333333333334,0.8396946564885497,gemini,medalign,nursing_note,PROMPT2_ICL_entailment
155,238,13,13,0,1.0,4,4,0,1.0,1.0,gemini,medalign,nursing_note,PROMPT2_ICL_entailment
156,239,15,14,1,0.9333333333333332,4,4,0,1.0,0.9655172413793104,gemini,medalign,nursing_note,PROMPT2_ICL_entailment
157,24,1,0,1,0.0,1,1,0,1.0,0.0,gemini,medalign,nursing_note,PROMPT2_ICL_entailment
158,240,3,3,0,1.0,2,2,0,1.0,1.0,gemini,medalign,nursing_note,PROMPT2_ICL_entailment
159,241,6,5,1,0.8333333333333334,2,1,1,0.5,0.625,gemini,medalign,nursing_note,PROMPT2_ICL_entailment
160,242,13,12,1,0.9230769230769232,2,2,0,1.0,0.96,gemini,medalign,nursing_note,PROMPT2_ICL_entailment
161,243,28,28,0,1.0,10,9,1,0.9,0.9473684210526316,gemini,medalign,nursing_note,PROMPT2_ICL_entailment
162,244,4,3,1,0.75,1,1,0,1.0,0.8571428571428571,gemini,medalign,nursing_note,PROMPT2_ICL_entailment
163,245,4,3,1,0.75,1,1,0,1.0,0.8571428571428571,gemini,medalign,nursing_note,PROMPT2_ICL_entailment
164,246,4,4,0,1.0,1,1,0,1.0,1.0,gemini,medalign,nursing_note,PROMPT2_ICL_entailment
165,247,9,9,0,1.0,5,5,0,1.0,1.0,gemini,medalign,nursing_note,PROMPT2_ICL_entailment
166,248,8,4,4,0.5,1,1,0,1.0,0.6666666666666666,gemini,medalign,nursing_note,PROMPT2_ICL_entailment
167,249,10,10,0,1.0,2,2,0,1.0,1.0,gemini,medalign,nursing_note,PROMPT2_ICL_entailment
168,25,58,46,12,0.7931034482758621,33,22,11,0.6666666666666666,0.7244094488188977,gemini,medalign,nursing_note,PROMPT2_ICL_entailment
169,26,5,2,3,0.4,1,0,1,0.0,0.0,gemini,medalign,nursing_note,PROMPT2_ICL_entailment
170,27,10,9,1,0.9,2,1,1,0.5,0.6428571428571429,gemini,medalign,nursing_note,PROMPT2_ICL_entailment
171,28,17,12,5,0.7058823529411765,4,2,2,0.5,0.5853658536585366,gemini,medalign,nursing_note,PROMPT2_ICL_entailment
172,29,10,10,0,1.0,3,3,0,1.0,1.0,gemini,medalign,nursing_note,PROMPT2_ICL_entailment
173,3,6,5,1,0.8333333333333334,2,2,0,1.0,0.9090909090909092,gemini,medalign,nursing_note,PROMPT2_ICL_entailment
174,30,5,5,0,1.0,1,1,0,1.0,1.0,gemini,medalign,nursing_note,PROMPT2_ICL_entailment
175,31,1,1,0,1.0,1,1,0,1.0,1.0,gemini,medalign,nursing_note,PROMPT2_ICL_entailment
176,32,1,0,1,0.0,2,1,1,0.5,0.0,gemini,medalign,nursing_note,PROMPT2_ICL_entailment
177,33,18,18,0,1.0,5,5,0,1.0,1.0,gemini,medalign,nursing_note,PROMPT2_ICL_entailment
178,34,16,11,5,0.6875,4,2,2,0.5,0.5789473684210527,gemini,medalign,nursing_note,PROMPT2_ICL_entailment
179,35,8,7,1,0.875,4,2,2,0.5,0.6363636363636364,gemini,medalign,nursing_note,PROMPT2_ICL_entailment
180,36,22,11,11,0.5,5,4,1,0.8,0.6153846153846154,gemini,medalign,nursing_note,PROMPT2_ICL_entailment
181,37,9,9,0,1.0,3,3,0,1.0,1.0,gemini,medalign,nursing_note,PROMPT2_ICL_entailment
182,38,18,12,6,0.6666666666666666,5,4,1,0.8,0.7272727272727272,gemini,medalign,nursing_note,PROMPT2_ICL_entailment
183,39,4,4,0,1.0,1,1,0,1.0,1.0,gemini,medalign,nursing_note,PROMPT2_ICL_entailment
184,4,11,0,11,0.0,3,0,3,0.0,,gemini,medalign,nursing_note,PROMPT2_ICL_entailment
185,40,21,20,1,0.9523809523809524,8,6,2,0.75,0.8391608391608391,gemini,medalign,nursing_note,PROMPT2_ICL_entailment
186,41,3,3,0,1.0,1,1,0,1.0,1.0,gemini,medalign,nursing_note,PROMPT2_ICL_entailment
187,42,11,10,1,0.9090909090909092,8,7,1,0.875,0.8917197452229298,gemini,medalign,nursing_note,PROMPT2_ICL_entailment
188,43,9,7,2,0.7777777777777778,2,2,0,1.0,0.8750000000000001,gemini,medalign,nursing_note,PROMPT2_ICL_entailment
189,44,5,5,0,1.0,1,1,0,1.0,1.0,gemini,medalign,nursing_note,PROMPT2_ICL_entailment
190,45,3,2,1,0.6666666666666666,1,1,0,1.0,0.8,gemini,medalign,nursing_note,PROMPT2_ICL_entailment
191,46,15,15,0,1.0,5,5,0,1.0,1.0,gemini,medalign,nursing_note,PROMPT2_ICL_entailment
192,47,28,26,2,0.9285714285714286,20,18,2,0.9,0.9140625,gemini,medalign,nursing_note,PROMPT2_ICL_entailment
193,48,1,1,0,1.0,2,1,1,0.5,0.6666666666666666,gemini,medalign,nursing_note,PROMPT2_ICL_entailment
194,49,9,7,2,0.7777777777777778,2,2,0,1.0,0.8750000000000001,gemini,medalign,nursing_note,PROMPT2_ICL_entailment
195,5,15,15,0,1.0,5,5,0,1.0,1.0,gemini,medalign,nursing_note,PROMPT2_ICL_entailment
196,50,3,3,0,1.0,1,1,0,1.0,1.0,gemini,medalign,nursing_note,PROMPT2_ICL_entailment
197,51,5,5,0,1.0,2,2,0,1.0,1.0,gemini,medalign,nursing_note,PROMPT2_ICL_entailment
198,52,8,8,0,1.0,4,4,0,1.0,1.0,gemini,medalign,nursing_note,PROMPT2_ICL_entailment
199,53,4,3,1,0.75,1,1,0,1.0,0.8571428571428571,gemini,medalign,nursing_note,PROMPT2_ICL_entailment
200,54,11,9,2,0.8181818181818182,7,6,1,0.8571428571428571,0.8372093023255814,gemini,medalign,nursing_note,PROMPT2_ICL_entailment
201,55,9,8,1,0.8888888888888888,2,2,0,1.0,0.9411764705882352,gemini,medalign,nursing_note,PROMPT2_ICL_entailment
202,56,6,5,1,0.8333333333333334,3,2,1,0.6666666666666666,0.7407407407407408,gemini,medalign,nursing_note,PROMPT2_ICL_entailment
203,57,12,7,5,0.5833333333333334,4,3,1,0.75,0.6562499999999999,gemini,medalign,nursing_note,PROMPT2_ICL_entailment
204,58,5,4,1,0.8,1,1,0,1.0,0.888888888888889,gemini,medalign,nursing_note,PROMPT2_ICL_entailment
205,59,4,4,0,1.0,1,1,0,1.0,1.0,gemini,medalign,nursing_note,PROMPT2_ICL_entailment
206,6,3,3,0,1.0,3,3,0,1.0,1.0,gemini,medalign,nursing_note,PROMPT2_ICL_entailment
207,60,11,9,2,0.8181818181818182,9,9,0,1.0,0.9,gemini,medalign,nursing_note,PROMPT2_ICL_entailment
208,61,4,4,0,1.0,1,1,0,1.0,1.0,gemini,medalign,nursing_note,PROMPT2_ICL_entailment
209,62,11,11,0,1.0,5,3,2,0.6,0.7499999999999999,gemini,medalign,nursing_note,PROMPT2_ICL_entailment
210,63,1,0,1,0.0,7,0,7,0.0,,gemini,medalign,nursing_note,PROMPT2_ICL_entailment
211,64,1,0,1,0.0,1,1,0,1.0,0.0,gemini,medalign,nursing_note,PROMPT2_ICL_entailment
212,65,7,7,0,1.0,2,1,1,0.5,0.6666666666666666,gemini,medalign,nursing_note,PROMPT2_ICL_entailment
213,66,10,9,1,0.9,4,4,0,1.0,0.9473684210526316,gemini,medalign,nursing_note,PROMPT2_ICL_entailment
214,67,10,8,2,0.8,4,3,1,0.75,0.7741935483870969,gemini,medalign,nursing_note,PROMPT2_ICL_entailment
215,68,1,0,1,0.0,1,0,1,0.0,,gemini,medalign,nursing_note,PROMPT2_ICL_entailment
216,69,8,7,1,0.875,2,2,0,1.0,0.9333333333333332,gemini,medalign,nursing_note,PROMPT2_ICL_entailment
217,7,6,6,0,1.0,1,0,1,0.0,0.0,gemini,medalign,nursing_note,PROMPT2_ICL_entailment
218,70,9,9,0,1.0,1,0,1,0.0,0.0,gemini,medalign,nursing_note,PROMPT2_ICL_entailment
219,71,15,13,2,0.8666666666666667,1,1,0,1.0,0.9285714285714286,gemini,medalign,nursing_note,PROMPT2_ICL_entailment
220,72,1,1,0,1.0,1,1,0,1.0,1.0,gemini,medalign,nursing_note,PROMPT2_ICL_entailment
221,73,6,4,2,0.6666666666666666,2,2,0,1.0,0.8,gemini,medalign,nursing_note,PROMPT2_ICL_entailment
222,74,11,5,6,0.4545454545454545,6,4,2,0.6666666666666666,0.5405405405405405,gemini,medalign,nursing_note,PROMPT2_ICL_entailment
223,75,3,3,0,1.0,1,1,0,1.0,1.0,gemini,medalign,nursing_note,PROMPT2_ICL_entailment
224,76,21,20,1,0.9523809523809524,5,5,0,1.0,0.975609756097561,gemini,medalign,nursing_note,PROMPT2_ICL_entailment
225,77,7,7,0,1.0,3,3,0,1.0,1.0,gemini,medalign,nursing_note,PROMPT2_ICL_entailment
226,78,11,9,2,0.8181818181818182,3,3,0,1.0,0.9,gemini,medalign,nursing_note,PROMPT2_ICL_entailment
227,79,19,11,8,0.5789473684210527,8,2,6,0.25,0.3492063492063492,gemini,medalign,nursing_note,PROMPT2_ICL_entailment
228,8,23,19,4,0.8260869565217391,8,7,1,0.875,0.8498402555910542,gemini,medalign,nursing_note,PROMPT2_ICL_entailment
229,80,14,13,1,0.9285714285714286,10,8,2,0.8,0.859504132231405,gemini,medalign,nursing_note,PROMPT2_ICL_entailment
230,81,1,1,0,1.0,1,1,0,1.0,1.0,gemini,medalign,nursing_note,PROMPT2_ICL_entailment
231,82,4,4,0,1.0,3,3,0,1.0,1.0,gemini,medalign,nursing_note,PROMPT2_ICL_entailment
232,83,7,6,1,0.8571428571428571,3,2,1,0.6666666666666666,0.75,gemini,medalign,nursing_note,PROMPT2_ICL_entailment
233,84,10,8,2,0.8,2,2,0,1.0,0.888888888888889,gemini,medalign,nursing_note,PROMPT2_ICL_entailment
234,85,13,12,1,0.9230769230769232,8,6,2,0.75,0.8275862068965517,gemini,medalign,nursing_note,PROMPT2_ICL_entailment
235,86,4,4,0,1.0,3,3,0,1.0,1.0,gemini,medalign,nursing_note,PROMPT2_ICL_entailment
236,87,4,4,0,1.0,2,2,0,1.0,1.0,gemini,medalign,nursing_note,PROMPT2_ICL_entailment
237,88,18,16,2,0.8888888888888888,7,6,1,0.8571428571428571,0.8727272727272727,gemini,medalign,nursing_note,PROMPT2_ICL_entailment
238,89,12,11,1,0.9166666666666666,6,5,1,0.8333333333333334,0.8730158730158729,gemini,medalign,nursing_note,PROMPT2_ICL_entailment
239,9,7,6,1,0.8571428571428571,2,1,1,0.5,0.631578947368421,gemini,medalign,nursing_note,PROMPT2_ICL_entailment
240,90,6,6,0,1.0,1,1,0,1.0,1.0,gemini,medalign,nursing_note,PROMPT2_ICL_entailment
241,91,4,4,0,1.0,1,1,0,1.0,1.0,gemini,medalign,nursing_note,PROMPT2_ICL_entailment
242,92,1,0,1,0.0,4,0,4,0.0,,gemini,medalign,nursing_note,PROMPT2_ICL_entailment
243,93,4,1,3,0.25,1,0,1,0.0,0.0,gemini,medalign,nursing_note,PROMPT2_ICL_entailment
244,94,6,4,2,0.6666666666666666,2,1,1,0.5,0.5714285714285715,gemini,medalign,nursing_note,PROMPT2_ICL_entailment
245,95,2,2,0,1.0,1,1,0,1.0,1.0,gemini,medalign,nursing_note,PROMPT2_ICL_entailment
246,96,2,2,0,1.0,1,1,0,1.0,1.0,gemini,medalign,nursing_note,PROMPT2_ICL_entailment
247,97,8,8,0,1.0,2,2,0,1.0,1.0,gemini,medalign,nursing_note,PROMPT2_ICL_entailment
248,98,17,16,1,0.9411764705882352,5,5,0,1.0,0.9696969696969696,gemini,medalign,nursing_note,PROMPT2_ICL_entailment
249,99,16,15,1,0.9375,7,5,2,0.7142857142857143,0.8108108108108109,gemini,medalign,nursing_note,PROMPT2_ICL_entailment
0,0,11,11,0,1.0,6,6,0,1.0,1.0,gemini,medalign,nursing_note,PROMPT2_entailment
1,1,7,7,0,1.0,1,1,0,1.0,1.0,gemini,medalign,nursing_note,PROMPT2_entailment
2,10,7,7,0,1.0,5,3,2,0.6,0.7499999999999999,gemini,medalign,nursing_note,PROMPT2_entailment
3,100,13,13,0,1.0,10,9,1,0.9,0.9473684210526316,gemini,medalign,nursing_note,PROMPT2_entailment
4,101,6,6,0,1.0,1,1,0,1.0,1.0,gemini,medalign,nursing_note,PROMPT2_entailment
5,102,9,9,0,1.0,4,4,0,1.0,1.0,gemini,medalign,nursing_note,PROMPT2_entailment
6,103,1,0,1,0.0,2,0,2,0.0,,gemini,medalign,nursing_note,PROMPT2_entailment
7,104,19,18,1,0.9473684210526316,15,12,3,0.8,0.8674698795180723,gemini,medalign,nursing_note,PROMPT2_entailment
8,105,1,1,0,1.0,1,1,0,1.0,1.0,gemini,medalign,nursing_note,PROMPT2_entailment
9,106,1,0,1,0.0,1,1,0,1.0,0.0,gemini,medalign,nursing_note,PROMPT2_entailment
10,107,5,5,0,1.0,4,4,0,1.0,1.0,gemini,medalign,nursing_note,PROMPT2_entailment
11,108,2,2,0,1.0,2,2,0,1.0,1.0,gemini,medalign,nursing_note,PROMPT2_entailment
12,109,9,8,1,0.8888888888888888,5,5,0,1.0,0.9411764705882352,gemini,medalign,nursing_note,PROMPT2_entailment
13,11,1,1,0,1.0,1,0,1,0.0,0.0,gemini,medalign,nursing_note,PROMPT2_entailment
14,110,12,8,4,0.6666666666666666,6,4,2,0.6666666666666666,0.6666666666666666,gemini,medalign,nursing_note,PROMPT2_entailment
15,111,1,0,1,0.0,1,0,1,0.0,,gemini,medalign,nursing_note,PROMPT2_entailment
16,112,4,4,0,1.0,2,2,0,1.0,1.0,gemini,medalign,nursing_note,PROMPT2_entailment
17,113,1,0,1,0.0,1,0,1,0.0,,gemini,medalign,nursing_note,PROMPT2_entailment
18,114,3,2,1,0.6666666666666666,1,1,0,1.0,0.8,gemini,medalign,nursing_note,PROMPT2_entailment
19,115,10,9,1,0.9,7,6,1,0.8571428571428571,0.8780487804878048,gemini,medalign,nursing_note,PROMPT2_entailment
20,116,8,7,1,0.875,5,2,3,0.4,0.5490196078431373,gemini,medalign,nursing_note,PROMPT2_entailment
21,117,14,11,3,0.7857142857142857,13,8,5,0.6153846153846154,0.6901960784313727,gemini,medalign,nursing_note,PROMPT2_entailment
22,118,3,3,0,1.0,2,2,0,1.0,1.0,gemini,medalign,nursing_note,PROMPT2_entailment
23,119,4,3,1,0.75,2,2,0,1.0,0.8571428571428571,gemini,medalign,nursing_note,PROMPT2_entailment
24,12,3,3,0,1.0,1,1,0,1.0,1.0,gemini,medalign,nursing_note,PROMPT2_entailment
25,120,8,7,1,0.875,7,5,2,0.7142857142857143,0.7865168539325842,gemini,medalign,nursing_note,PROMPT2_entailment
26,121,2,2,0,1.0,1,1,0,1.0,1.0,gemini,medalign,nursing_note,PROMPT2_entailment
27,122,1,0,1,0.0,1,0,1,0.0,,gemini,medalign,nursing_note,PROMPT2_entailment
28,123,2,2,0,1.0,4,3,1,0.75,0.8571428571428571,gemini,medalign,nursing_note,PROMPT2_entailment
29,124,26,21,5,0.8076923076923077,14,12,2,0.8571428571428571,0.8316831683168318,gemini,medalign,nursing_note,PROMPT2_entailment
30,125,14,13,1,0.9285714285714286,9,7,2,0.7777777777777778,0.8465116279069766,gemini,medalign,nursing_note,PROMPT2_entailment
31,126,2,2,0,1.0,2,1,1,0.5,0.6666666666666666,gemini,medalign,nursing_note,PROMPT2_entailment
32,127,1,1,0,1.0,1,1,0,1.0,1.0,gemini,medalign,nursing_note,PROMPT2_entailment
33,128,4,4,0,1.0,2,2,0,1.0,1.0,gemini,medalign,nursing_note,PROMPT2_entailment
34,129,32,27,5,0.84375,20,15,5,0.75,0.7941176470588235,gemini,medalign,nursing_note,PROMPT2_entailment
35,13,8,8,0,1.0,5,5,0,1.0,1.0,gemini,medalign,nursing_note,PROMPT2_entailment
36,130,4,4,0,1.0,2,2,0,1.0,1.0,gemini,medalign,nursing_note,PROMPT2_entailment
37,131,3,3,0,1.0,1,1,0,1.0,1.0,gemini,medalign,nursing_note,PROMPT2_entailment
38,132,6,4,2,0.6666666666666666,2,2,0,1.0,0.8,gemini,medalign,nursing_note,PROMPT2_entailment
39,133,12,12,0,1.0,14,6,8,0.4285714285714285,0.6,gemini,medalign,nursing_note,PROMPT2_entailment
40,134,5,5,0,1.0,3,3,0,1.0,1.0,gemini,medalign,nursing_note,PROMPT2_entailment
41,135,5,5,0,1.0,2,1,1,0.5,0.6666666666666666,gemini,medalign,nursing_note,PROMPT2_entailment
42,136,37,23,14,0.6216216216216216,51,25,26,0.4901960784313725,0.5481410867492851,gemini,medalign,nursing_note,PROMPT2_entailment
43,137,15,15,0,1.0,6,6,0,1.0,1.0,gemini,medalign,nursing_note,PROMPT2_entailment
44,138,1,0,1,0.0,1,0,1,0.0,,gemini,medalign,nursing_note,PROMPT2_entailment
45,139,4,4,0,1.0,1,1,0,1.0,1.0,gemini,medalign,nursing_note,PROMPT2_entailment
46,14,1,1,0,1.0,1,0,1,0.0,0.0,gemini,medalign,nursing_note,PROMPT2_entailment
47,140,5,5,0,1.0,3,3,0,1.0,1.0,gemini,medalign,nursing_note,PROMPT2_entailment
48,141,2,2,0,1.0,1,1,0,1.0,1.0,gemini,medalign,nursing_note,PROMPT2_entailment
49,142,9,1,8,0.1111111111111111,1,0,1,0.0,0.0,gemini,medalign,nursing_note,PROMPT2_entailment
50,143,1,0,1,0.0,1,0,1,0.0,,gemini,medalign,nursing_note,PROMPT2_entailment
51,144,2,0,2,0.0,1,1,0,1.0,0.0,gemini,medalign,nursing_note,PROMPT2_entailment
52,145,4,3,1,0.75,4,2,2,0.5,0.6,gemini,medalign,nursing_note,PROMPT2_entailment
53,146,15,13,2,0.8666666666666667,3,2,1,0.6666666666666666,0.7536231884057971,gemini,medalign,nursing_note,PROMPT2_entailment
54,147,10,10,0,1.0,6,3,3,0.5,0.6666666666666666,gemini,medalign,nursing_note,PROMPT2_entailment
55,148,25,25,0,1.0,7,7,0,1.0,1.0,gemini,medalign,nursing_note,PROMPT2_entailment
56,149,7,7,0,1.0,1,1,0,1.0,1.0,gemini,medalign,nursing_note,PROMPT2_entailment
57,15,4,4,0,1.0,1,1,0,1.0,1.0,gemini,medalign,nursing_note,PROMPT2_entailment
58,150,3,2,1,0.6666666666666666,1,1,0,1.0,0.8,gemini,medalign,nursing_note,PROMPT2_entailment
59,151,13,13,0,1.0,8,7,1,0.875,0.9333333333333332,gemini,medalign,nursing_note,PROMPT2_entailment
60,152,5,4,1,0.8,4,4,0,1.0,0.888888888888889,gemini,medalign,nursing_note,PROMPT2_entailment
61,153,14,13,1,0.9285714285714286,14,10,4,0.7142857142857143,0.8074534161490684,gemini,medalign,nursing_note,PROMPT2_entailment
62,154,2,2,0,1.0,1,1,0,1.0,1.0,gemini,medalign,nursing_note,PROMPT2_entailment
63,155,25,25,0,1.0,14,8,6,0.5714285714285714,0.7272727272727273,gemini,medalign,nursing_note,PROMPT2_entailment
64,156,11,10,1,0.9090909090909092,1,0,1,0.0,0.0,gemini,medalign,nursing_note,PROMPT2_entailment
65,157,6,5,1,0.8333333333333334,3,3,0,1.0,0.9090909090909092,gemini,medalign,nursing_note,PROMPT2_entailment
66,158,4,3,1,0.75,1,1,0,1.0,0.8571428571428571,gemini,medalign,nursing_note,PROMPT2_entailment
67,159,5,5,0,1.0,3,3,0,1.0,1.0,gemini,medalign,nursing_note,PROMPT2_entailment
68,16,18,14,4,0.7777777777777778,3,2,1,0.6666666666666666,0.717948717948718,gemini,medalign,nursing_note,PROMPT2_entailment
69,160,3,3,0,1.0,1,1,0,1.0,1.0,gemini,medalign,nursing_note,PROMPT2_entailment
70,161,4,4,0,1.0,1,1,0,1.0,1.0,gemini,medalign,nursing_note,PROMPT2_entailment
71,162,13,12,1,0.9230769230769232,8,7,1,0.875,0.8983957219251337,gemini,medalign,nursing_note,PROMPT2_entailment
72,163,7,7,0,1.0,3,3,0,1.0,1.0,gemini,medalign,nursing_note,PROMPT2_entailment
73,164,6,6,0,1.0,2,2,0,1.0,1.0,gemini,medalign,nursing_note,PROMPT2_entailment
74,165,6,5,1,0.8333333333333334,4,3,1,0.75,0.7894736842105262,gemini,medalign,nursing_note,PROMPT2_entailment
75,166,10,9,1,0.9,5,4,1,0.8,0.8470588235294118,gemini,medalign,nursing_note,PROMPT2_entailment
76,167,13,12,1,0.9230769230769232,2,1,1,0.5,0.6486486486486487,gemini,medalign,nursing_note,PROMPT2_entailment
77,168,11,8,3,0.7272727272727273,3,3,0,1.0,0.8421052631578948,gemini,medalign,nursing_note,PROMPT2_entailment
78,169,10,9,1,0.9,9,5,4,0.5555555555555556,0.6870229007633587,gemini,medalign,nursing_note,PROMPT2_entailment
79,17,2,2,0,1.0,1,0,1,0.0,0.0,gemini,medalign,nursing_note,PROMPT2_entailment
80,170,5,4,1,0.8,1,1,0,1.0,0.888888888888889,gemini,medalign,nursing_note,PROMPT2_entailment
81,171,10,8,2,0.8,7,3,4,0.4285714285714285,0.5581395348837209,gemini,medalign,nursing_note,PROMPT2_entailment
82,172,15,11,4,0.7333333333333333,12,9,3,0.75,0.7415730337078651,gemini,medalign,nursing_note,PROMPT2_entailment
83,173,10,10,0,1.0,1,1,0,1.0,1.0,gemini,medalign,nursing_note,PROMPT2_entailment
84,174,4,4,0,1.0,1,1,0,1.0,1.0,gemini,medalign,nursing_note,PROMPT2_entailment
85,175,1,0,1,0.0,2,1,1,0.5,0.0,gemini,medalign,nursing_note,PROMPT2_entailment
86,176,11,7,4,0.6363636363636364,3,2,1,0.6666666666666666,0.6511627906976744,gemini,medalign,nursing_note,PROMPT2_entailment
87,177,9,9,0,1.0,8,8,0,1.0,1.0,gemini,medalign,nursing_note,PROMPT2_entailment
88,178,8,7,1,0.875,10,8,2,0.8,0.8358208955223881,gemini,medalign,nursing_note,PROMPT2_entailment
89,179,7,7,0,1.0,2,0,2,0.0,0.0,gemini,medalign,nursing_note,PROMPT2_entailment
90,18,12,12,0,1.0,3,2,1,0.6666666666666666,0.8,gemini,medalign,nursing_note,PROMPT2_entailment
91,180,9,8,1,0.8888888888888888,4,2,2,0.5,0.64,gemini,medalign,nursing_note,PROMPT2_entailment
92,181,7,7,0,1.0,7,7,0,1.0,1.0,gemini,medalign,nursing_note,PROMPT2_entailment
93,182,3,3,0,1.0,2,2,0,1.0,1.0,gemini,medalign,nursing_note,PROMPT2_entailment
94,183,6,5,1,0.8333333333333334,6,6,0,1.0,0.9090909090909092,gemini,medalign,nursing_note,PROMPT2_entailment
95,184,10,8,2,0.8,11,10,1,0.9090909090909092,0.8510638297872342,gemini,medalign,nursing_note,PROMPT2_entailment
96,185,4,3,1,0.75,3,2,1,0.6666666666666666,0.7058823529411765,gemini,medalign,nursing_note,PROMPT2_entailment
97,186,4,3,1,0.75,3,2,1,0.6666666666666666,0.7058823529411765,gemini,medalign,nursing_note,PROMPT2_entailment
98,187,1,0,1,0.0,1,0,1,0.0,,gemini,medalign,nursing_note,PROMPT2_entailment
99,188,2,2,0,1.0,3,2,1,0.6666666666666666,0.8,gemini,medalign,nursing_note,PROMPT2_entailment
100,189,12,11,1,0.9166666666666666,10,4,6,0.4,0.5569620253164558,gemini,medalign,nursing_note,PROMPT2_entailment
101,19,15,13,2,0.8666666666666667,7,6,1,0.8571428571428571,0.861878453038674,gemini,medalign,nursing_note,PROMPT2_entailment
102,190,5,3,2,0.6,2,2,0,1.0,0.7499999999999999,gemini,medalign,nursing_note,PROMPT2_entailment
103,191,15,13,2,0.8666666666666667,5,3,2,0.6,0.7090909090909091,gemini,medalign,nursing_note,PROMPT2_entailment
104,192,3,3,0,1.0,1,1,0,1.0,1.0,gemini,medalign,nursing_note,PROMPT2_entailment
105,193,6,6,0,1.0,3,3,0,1.0,1.0,gemini,medalign,nursing_note,PROMPT2_entailment
106,194,3,3,0,1.0,2,2,0,1.0,1.0,gemini,medalign,nursing_note,PROMPT2_entailment
107,195,11,10,1,0.9090909090909092,10,6,4,0.6,0.7228915662650602,gemini,medalign,nursing_note,PROMPT2_entailment
108,196,5,5,0,1.0,1,1,0,1.0,1.0,gemini,medalign,nursing_note,PROMPT2_entailment
109,197,3,3,0,1.0,1,1,0,1.0,1.0,gemini,medalign,nursing_note,PROMPT2_entailment
110,198,19,18,1,0.9473684210526316,8,7,1,0.875,0.9097472924187724,gemini,medalign,nursing_note,PROMPT2_entailment
111,199,18,13,5,0.7222222222222222,7,5,2,0.7142857142857143,0.7182320441988951,gemini,medalign,nursing_note,PROMPT2_entailment
112,2,10,7,3,0.7,5,2,3,0.4,0.509090909090909,gemini,medalign,nursing_note,PROMPT2_entailment
113,20,6,5,1,0.8333333333333334,2,2,0,1.0,0.9090909090909092,gemini,medalign,nursing_note,PROMPT2_entailment
114,200,3,3,0,1.0,3,3,0,1.0,1.0,gemini,medalign,nursing_note,PROMPT2_entailment
115,201,4,3,1,0.75,1,1,0,1.0,0.8571428571428571,gemini,medalign,nursing_note,PROMPT2_entailment
116,202,4,4,0,1.0,1,1,0,1.0,1.0,gemini,medalign,nursing_note,PROMPT2_entailment
117,203,6,2,4,0.3333333333333333,1,0,1,0.0,0.0,gemini,medalign,nursing_note,PROMPT2_entailment
118,204,12,10,2,0.8333333333333334,9,4,5,0.4444444444444444,0.5797101449275363,gemini,medalign,nursing_note,PROMPT2_entailment
119,205,16,9,7,0.5625,8,3,5,0.375,0.45,gemini,medalign,nursing_note,PROMPT2_entailment
120,206,2,2,0,1.0,4,4,0,1.0,1.0,gemini,medalign,nursing_note,PROMPT2_entailment
121,207,10,8,2,0.8,6,5,1,0.8333333333333334,0.816326530612245,gemini,medalign,nursing_note,PROMPT2_entailment
122,208,13,13,0,1.0,10,7,3,0.7,0.8235294117647058,gemini,medalign,nursing_note,PROMPT2_entailment
123,209,6,5,1,0.8333333333333334,1,0,1,0.0,0.0,gemini,medalign,nursing_note,PROMPT2_entailment
124,21,4,4,0,1.0,1,1,0,1.0,1.0,gemini,medalign,nursing_note,PROMPT2_entailment
125,210,4,4,0,1.0,2,1,1,0.5,0.6666666666666666,gemini,medalign,nursing_note,PROMPT2_entailment
126,211,4,2,2,0.5,2,1,1,0.5,0.5,gemini,medalign,nursing_note,PROMPT2_entailment
127,212,6,6,0,1.0,3,3,0,1.0,1.0,gemini,medalign,nursing_note,PROMPT2_entailment
128,213,11,11,0,1.0,8,8,0,1.0,1.0,gemini,medalign,nursing_note,PROMPT2_entailment
129,214,3,3,0,1.0,2,2,0,1.0,1.0,gemini,medalign,nursing_note,PROMPT2_entailment
130,215,2,2,0,1.0,1,1,0,1.0,1.0,gemini,medalign,nursing_note,PROMPT2_entailment
131,216,5,5,0,1.0,3,3,0,1.0,1.0,gemini,medalign,nursing_note,PROMPT2_entailment
132,217,9,7,2,0.7777777777777778,11,5,6,0.4545454545454545,0.5737704918032788,gemini,medalign,nursing_note,PROMPT2_entailment
133,218,21,21,0,1.0,3,3,0,1.0,1.0,gemini,medalign,nursing_note,PROMPT2_entailment
134,219,9,8,1,0.8888888888888888,2,2,0,1.0,0.9411764705882352,gemini,medalign,nursing_note,PROMPT2_entailment
135,22,8,3,5,0.375,1,0,1,0.0,0.0,gemini,medalign,nursing_note,PROMPT2_entailment
136,220,14,12,2,0.8571428571428571,7,5,2,0.7142857142857143,0.7792207792207793,gemini,medalign,nursing_note,PROMPT2_entailment
137,221,11,9,2,0.8181818181818182,23,8,15,0.3478260869565217,0.488135593220339,gemini,medalign,nursing_note,PROMPT2_entailment
138,222,8,8,0,1.0,4,4,0,1.0,1.0,gemini,medalign,nursing_note,PROMPT2_entailment
139,223,5,5,0,1.0,2,2,0,1.0,1.0,gemini,medalign,nursing_note,PROMPT2_entailment
140,224,9,8,1,0.8888888888888888,4,3,1,0.75,0.8135593220338982,gemini,medalign,nursing_note,PROMPT2_entailment
141,225,6,0,6,0.0,2,1,1,0.5,0.0,gemini,medalign,nursing_note,PROMPT2_entailment
142,226,11,7,4,0.6363636363636364,5,4,1,0.8,0.7088607594936709,gemini,medalign,nursing_note,PROMPT2_entailment
143,227,1,0,1,0.0,1,0,1,0.0,,gemini,medalign,nursing_note,PROMPT2_entailment
144,228,41,38,3,0.926829268292683,18,14,4,0.7777777777777778,0.8457869634340223,gemini,medalign,nursing_note,PROMPT2_entailment
145,229,13,12,1,0.9230769230769232,7,6,1,0.8571428571428571,0.888888888888889,gemini,medalign,nursing_note,PROMPT2_entailment
146,23,25,21,4,0.84,21,7,14,0.3333333333333333,0.4772727272727272,gemini,medalign,nursing_note,PROMPT2_entailment
147,230,1,1,0,1.0,1,1,0,1.0,1.0,gemini,medalign,nursing_note,PROMPT2_entailment
148,231,13,11,2,0.8461538461538461,13,10,3,0.7692307692307693,0.8058608058608059,gemini,medalign,nursing_note,PROMPT2_entailment
149,232,10,10,0,1.0,6,3,3,0.5,0.6666666666666666,gemini,medalign,nursing_note,PROMPT2_entailment
150,233,4,3,1,0.75,4,2,2,0.5,0.6,gemini,medalign,nursing_note,PROMPT2_entailment
151,234,9,9,0,1.0,2,2,0,1.0,1.0,gemini,medalign,nursing_note,PROMPT2_entailment
152,235,1,0,1,0.0,1,0,1,0.0,,gemini,medalign,nursing_note,PROMPT2_entailment
153,236,11,9,2,0.8181818181818182,14,9,5,0.6428571428571429,0.7200000000000001,gemini,medalign,nursing_note,PROMPT2_entailment
154,237,11,10,1,0.9090909090909092,6,4,2,0.6666666666666666,0.7692307692307692,gemini,medalign,nursing_note,PROMPT2_entailment
155,238,11,11,0,1.0,4,3,1,0.75,0.8571428571428571,gemini,medalign,nursing_note,PROMPT2_entailment
156,239,11,11,0,1.0,4,4,0,1.0,1.0,gemini,medalign,nursing_note,PROMPT2_entailment
157,24,1,1,0,1.0,1,0,1,0.0,0.0,gemini,medalign,nursing_note,PROMPT2_entailment
158,240,2,2,0,1.0,2,1,1,0.5,0.6666666666666666,gemini,medalign,nursing_note,PROMPT2_entailment
159,241,8,5,3,0.625,2,2,0,1.0,0.7692307692307693,gemini,medalign,nursing_note,PROMPT2_entailment
160,242,12,10,2,0.8333333333333334,2,1,1,0.5,0.625,gemini,medalign,nursing_note,PROMPT2_entailment
161,243,28,25,3,0.8928571428571429,10,9,1,0.9,0.896414342629482,gemini,medalign,nursing_note,PROMPT2_entailment
162,244,3,2,1,0.6666666666666666,1,1,0,1.0,0.8,gemini,medalign,nursing_note,PROMPT2_entailment
163,245,3,3,0,1.0,1,1,0,1.0,1.0,gemini,medalign,nursing_note,PROMPT2_entailment
164,246,4,3,1,0.75,1,1,0,1.0,0.8571428571428571,gemini,medalign,nursing_note,PROMPT2_entailment
165,247,7,7,0,1.0,5,5,0,1.0,1.0,gemini,medalign,nursing_note,PROMPT2_entailment
166,248,3,3,0,1.0,1,1,0,1.0,1.0,gemini,medalign,nursing_note,PROMPT2_entailment
167,249,5,5,0,1.0,2,1,1,0.5,0.6666666666666666,gemini,medalign,nursing_note,PROMPT2_entailment
168,25,48,43,5,0.8958333333333334,33,24,9,0.7272727272727273,0.8028004667444576,gemini,medalign,nursing_note,PROMPT2_entailment
169,26,5,5,0,1.0,1,1,0,1.0,1.0,gemini,medalign,nursing_note,PROMPT2_entailment
170,27,9,6,3,0.6666666666666666,2,1,1,0.5,0.5714285714285715,gemini,medalign,nursing_note,PROMPT2_entailment
171,28,10,6,4,0.6,4,3,1,0.75,0.6666666666666665,gemini,medalign,nursing_note,PROMPT2_entailment
172,29,4,4,0,1.0,3,1,2,0.3333333333333333,0.5,gemini,medalign,nursing_note,PROMPT2_entailment
173,3,3,3,0,1.0,2,1,1,0.5,0.6666666666666666,gemini,medalign,nursing_note,PROMPT2_entailment
174,30,2,2,0,1.0,1,1,0,1.0,1.0,gemini,medalign,nursing_note,PROMPT2_entailment
175,31,2,1,1,0.5,1,1,0,1.0,0.6666666666666666,gemini,medalign,nursing_note,PROMPT2_entailment
176,32,4,4,0,1.0,2,2,0,1.0,1.0,gemini,medalign,nursing_note,PROMPT2_entailment
177,33,9,7,2,0.7777777777777778,5,4,1,0.8,0.7887323943661971,gemini,medalign,nursing_note,PROMPT2_entailment
178,34,12,6,6,0.5,4,1,3,0.25,0.3333333333333333,gemini,medalign,nursing_note,PROMPT2_entailment
179,35,7,7,0,1.0,4,3,1,0.75,0.8571428571428571,gemini,medalign,nursing_note,PROMPT2_entailment
180,36,17,12,5,0.7058823529411765,5,3,2,0.6,0.6486486486486486,gemini,medalign,nursing_note,PROMPT2_entailment
181,37,8,8,0,1.0,3,3,0,1.0,1.0,gemini,medalign,nursing_note,PROMPT2_entailment
182,38,14,11,3,0.7857142857142857,5,5,0,1.0,0.88,gemini,medalign,nursing_note,PROMPT2_entailment
183,39,3,3,0,1.0,1,0,1,0.0,0.0,gemini,medalign,nursing_note,PROMPT2_entailment
184,4,3,2,1,0.6666666666666666,3,3,0,1.0,0.8,gemini,medalign,nursing_note,PROMPT2_entailment
185,40,15,14,1,0.9333333333333332,8,7,1,0.875,0.9032258064516128,gemini,medalign,nursing_note,PROMPT2_entailment
186,41,3,3,0,1.0,1,1,0,1.0,1.0,gemini,medalign,nursing_note,PROMPT2_entailment
187,42,11,11,0,1.0,8,7,1,0.875,0.9333333333333332,gemini,medalign,nursing_note,PROMPT2_entailment
188,43,4,4,0,1.0,2,2,0,1.0,1.0,gemini,medalign,nursing_note,PROMPT2_entailment
189,44,4,4,0,1.0,1,1,0,1.0,1.0,gemini,medalign,nursing_note,PROMPT2_entailment
190,45,1,0,1,0.0,1,0,1,0.0,,gemini,medalign,nursing_note,PROMPT2_entailment
191,46,8,8,0,1.0,5,5,0,1.0,1.0,gemini,medalign,nursing_note,PROMPT2_entailment
192,47,26,24,2,0.9230769230769232,20,17,3,0.85,0.8850325379609545,gemini,medalign,nursing_note,PROMPT2_entailment
193,48,9,3,6,0.3333333333333333,2,0,2,0.0,0.0,gemini,medalign,nursing_note,PROMPT2_entailment
194,49,6,4,2,0.6666666666666666,2,2,0,1.0,0.8,gemini,medalign,nursing_note,PROMPT2_entailment
195,5,11,11,0,1.0,5,3,2,0.6,0.7499999999999999,gemini,medalign,nursing_note,PROMPT2_entailment
196,50,2,2,0,1.0,1,1,0,1.0,1.0,gemini,medalign,nursing_note,PROMPT2_entailment
197,51,2,2,0,1.0,2,2,0,1.0,1.0,gemini,medalign,nursing_note,PROMPT2_entailment
198,52,5,5,0,1.0,4,4,0,1.0,1.0,gemini,medalign,nursing_note,PROMPT2_entailment
199,53,3,3,0,1.0,1,1,0,1.0,1.0,gemini,medalign,nursing_note,PROMPT2_entailment
200,54,11,11,0,1.0,7,6,1,0.8571428571428571,0.923076923076923,gemini,medalign,nursing_note,PROMPT2_entailment
201,55,4,3,1,0.75,2,2,0,1.0,0.8571428571428571,gemini,medalign,nursing_note,PROMPT2_entailment
202,56,6,4,2,0.6666666666666666,3,3,0,1.0,0.8,gemini,medalign,nursing_note,PROMPT2_entailment
203,57,7,5,2,0.7142857142857143,4,1,3,0.25,0.3703703703703703,gemini,medalign,nursing_note,PROMPT2_entailment
204,58,4,4,0,1.0,1,1,0,1.0,1.0,gemini,medalign,nursing_note,PROMPT2_entailment
205,59,4,4,0,1.0,1,1,0,1.0,1.0,gemini,medalign,nursing_note,PROMPT2_entailment
206,6,2,2,0,1.0,3,3,0,1.0,1.0,gemini,medalign,nursing_note,PROMPT2_entailment
207,60,10,10,0,1.0,9,8,1,0.8888888888888888,0.9411764705882352,gemini,medalign,nursing_note,PROMPT2_entailment
208,61,2,2,0,1.0,1,1,0,1.0,1.0,gemini,medalign,nursing_note,PROMPT2_entailment
209,62,20,18,2,0.9,5,5,0,1.0,0.9473684210526316,gemini,medalign,nursing_note,PROMPT2_entailment
210,63,12,11,1,0.9166666666666666,7,5,2,0.7142857142857143,0.8029197080291971,gemini,medalign,nursing_note,PROMPT2_entailment
211,64,9,2,7,0.2222222222222222,1,0,1,0.0,0.0,gemini,medalign,nursing_note,PROMPT2_entailment
212,65,6,6,0,1.0,2,1,1,0.5,0.6666666666666666,gemini,medalign,nursing_note,PROMPT2_entailment
213,66,5,4,1,0.8,4,4,0,1.0,0.888888888888889,gemini,medalign,nursing_note,PROMPT2_entailment
214,67,8,7,1,0.875,4,3,1,0.75,0.8076923076923077,gemini,medalign,nursing_note,PROMPT2_entailment
215,68,4,4,0,1.0,1,1,0,1.0,1.0,gemini,medalign,nursing_note,PROMPT2_entailment
216,69,5,4,1,0.8,2,2,0,1.0,0.888888888888889,gemini,medalign,nursing_note,PROMPT2_entailment
217,7,3,3,0,1.0,1,1,0,1.0,1.0,gemini,medalign,nursing_note,PROMPT2_entailment
218,70,4,4,0,1.0,1,0,1,0.0,0.0,gemini,medalign,nursing_note,PROMPT2_entailment
219,71,16,8,8,0.5,1,0,1,0.0,0.0,gemini,medalign,nursing_note,PROMPT2_entailment
220,72,1,0,1,0.0,1,0,1,0.0,,gemini,medalign,nursing_note,PROMPT2_entailment
221,73,4,4,0,1.0,2,2,0,1.0,1.0,gemini,medalign,nursing_note,PROMPT2_entailment
222,74,12,8,4,0.6666666666666666,6,3,3,0.5,0.5714285714285715,gemini,medalign,nursing_note,PROMPT2_entailment
223,75,1,1,0,1.0,1,1,0,1.0,1.0,gemini,medalign,nursing_note,PROMPT2_entailment
224,76,12,10,2,0.8333333333333334,5,4,1,0.8,0.816326530612245,gemini,medalign,nursing_note,PROMPT2_entailment
225,77,5,4,1,0.8,3,3,0,1.0,0.888888888888889,gemini,medalign,nursing_note,PROMPT2_entailment
226,78,4,4,0,1.0,3,1,2,0.3333333333333333,0.5,gemini,medalign,nursing_note,PROMPT2_entailment
227,79,10,9,1,0.9,8,7,1,0.875,0.8873239436619719,gemini,medalign,nursing_note,PROMPT2_entailment
228,8,7,4,3,0.5714285714285714,8,2,6,0.25,0.3478260869565217,gemini,medalign,nursing_note,PROMPT2_entailment
229,80,12,12,0,1.0,10,7,3,0.7,0.8235294117647058,gemini,medalign,nursing_note,PROMPT2_entailment
230,81,1,1,0,1.0,1,0,1,0.0,0.0,gemini,medalign,nursing_note,PROMPT2_entailment
231,82,3,3,0,1.0,3,3,0,1.0,1.0,gemini,medalign,nursing_note,PROMPT2_entailment
232,83,3,2,1,0.6666666666666666,3,2,1,0.6666666666666666,0.6666666666666666,gemini,medalign,nursing_note,PROMPT2_entailment
233,84,1,1,0,1.0,2,1,1,0.5,0.6666666666666666,gemini,medalign,nursing_note,PROMPT2_entailment
234,85,1,0,1,0.0,8,0,8,0.0,,gemini,medalign,nursing_note,PROMPT2_entailment
235,86,3,3,0,1.0,3,3,0,1.0,1.0,gemini,medalign,nursing_note,PROMPT2_entailment
236,87,4,4,0,1.0,2,2,0,1.0,1.0,gemini,medalign,nursing_note,PROMPT2_entailment
237,88,11,11,0,1.0,7,6,1,0.8571428571428571,0.923076923076923,gemini,medalign,nursing_note,PROMPT2_entailment
238,89,11,11,0,1.0,6,5,1,0.8333333333333334,0.9090909090909092,gemini,medalign,nursing_note,PROMPT2_entailment
239,9,6,6,0,1.0,2,2,0,1.0,1.0,gemini,medalign,nursing_note,PROMPT2_entailment
240,90,1,0,1,0.0,1,0,1,0.0,,gemini,medalign,nursing_note,PROMPT2_entailment
241,91,4,4,0,1.0,1,1,0,1.0,1.0,gemini,medalign,nursing_note,PROMPT2_entailment
242,92,8,8,0,1.0,4,4,0,1.0,1.0,gemini,medalign,nursing_note,PROMPT2_entailment
243,93,1,0,1,0.0,1,0,1,0.0,,gemini,medalign,nursing_note,PROMPT2_entailment
244,94,4,4,0,1.0,2,1,1,0.5,0.6666666666666666,gemini,medalign,nursing_note,PROMPT2_entailment
245,95,10,4,6,0.4,1,0,1,0.0,0.0,gemini,medalign,nursing_note,PROMPT2_entailment
246,96,1,1,0,1.0,1,1,0,1.0,1.0,gemini,medalign,nursing_note,PROMPT2_entailment
247,97,6,6,0,1.0,2,2,0,1.0,1.0,gemini,medalign,nursing_note,PROMPT2_entailment
248,98,8,7,1,0.875,5,4,1,0.8,0.8358208955223881,gemini,medalign,nursing_note,PROMPT2_entailment
249,99,9,6,3,0.6666666666666666,7,5,2,0.7142857142857143,0.689655172413793,gemini,medalign,nursing_note,PROMPT2_entailment
0,0,72,51,21,0.7083333333333334,71,58,13,0.8169014084507042,0.7587533666794922,gemini,medalign,progress_note,PROMPT1_entailment
1,1,27,27,0,1.0,47,25,22,0.5319148936170213,0.6944444444444444,gemini,medalign,progress_note,PROMPT1_entailment
2,10,111,78,33,0.7027027027027027,48,35,13,0.7291666666666666,0.7156901297679906,gemini,medalign,progress_note,PROMPT1_entailment
3,100,50,44,6,0.88,43,30,13,0.6976744186046512,0.7783018867924528,gemini,medalign,progress_note,PROMPT1_entailment
4,101,47,41,6,0.8723404255319149,73,47,26,0.6438356164383562,0.7408688965782392,gemini,medalign,progress_note,PROMPT1_entailment
5,102,15,15,0,1.0,13,10,3,0.7692307692307693,0.8695652173913044,gemini,medalign,progress_note,PROMPT1_entailment
6,11,35,33,2,0.9428571428571428,38,23,15,0.6052631578947368,0.7372510927634774,gemini,medalign,progress_note,PROMPT1_entailment
7,12,18,16,2,0.8888888888888888,46,27,19,0.5869565217391305,0.707037643207856,gemini,medalign,progress_note,PROMPT1_entailment
8,13,75,59,16,0.7866666666666666,68,48,20,0.7058823529411765,0.744088281660536,gemini,medalign,progress_note,PROMPT1_entailment
9,14,12,10,2,0.8333333333333334,13,10,3,0.7692307692307693,0.8,gemini,medalign,progress_note,PROMPT1_entailment
10,15,31,27,4,0.8709677419354839,19,10,9,0.5263157894736842,0.6561360874848117,gemini,medalign,progress_note,PROMPT1_entailment
11,16,66,43,23,0.6515151515151515,78,53,25,0.6794871794871795,0.6652072387624051,gemini,medalign,progress_note,PROMPT1_entailment
12,17,23,22,1,0.9565217391304348,33,28,5,0.8484848484848485,0.8992700729927008,gemini,medalign,progress_note,PROMPT1_entailment
13,18,50,49,1,0.98,59,40,19,0.6779661016949152,0.8014720915968104,gemini,medalign,progress_note,PROMPT1_entailment
14,19,32,28,4,0.875,57,40,17,0.7017543859649122,0.7788595271210013,gemini,medalign,progress_note,PROMPT1_entailment
15,2,43,28,15,0.6511627906976745,54,44,10,0.8148148148148148,0.7238542890716804,gemini,medalign,progress_note,PROMPT1_entailment
16,20,24,23,1,0.9583333333333334,31,22,9,0.7096774193548387,0.8154713940370669,gemini,medalign,progress_note,PROMPT1_entailment
17,21,51,36,15,0.7058823529411765,31,14,17,0.4516129032258064,0.5508196721311476,gemini,medalign,progress_note,PROMPT1_entailment
18,22,19,19,0,1.0,63,31,32,0.492063492063492,0.6595744680851063,gemini,medalign,progress_note,PROMPT1_entailment
19,23,18,16,2,0.8888888888888888,35,27,8,0.7714285714285715,0.8260038240917783,gemini,medalign,progress_note,PROMPT1_entailment
20,24,41,34,7,0.8292682926829268,42,30,12,0.7142857142857143,0.7674943566591422,gemini,medalign,progress_note,PROMPT1_entailment
21,25,28,27,1,0.9642857142857144,26,23,3,0.8846153846153846,0.9227340267459138,gemini,medalign,progress_note,PROMPT1_entailment
22,26,16,13,3,0.8125,24,21,3,0.875,0.8425925925925926,gemini,medalign,progress_note,PROMPT1_entailment
23,27,69,61,8,0.8840579710144928,81,51,30,0.6296296296296297,0.7354609929078014,gemini,medalign,progress_note,PROMPT1_entailment
24,28,17,17,0,1.0,38,23,15,0.6052631578947368,0.7540983606557378,gemini,medalign,progress_note,PROMPT1_entailment
25,29,125,115,10,0.92,99,81,18,0.8181818181818182,0.8661087866108786,gemini,medalign,progress_note,PROMPT1_entailment
26,3,52,50,2,0.9615384615384616,56,41,15,0.7321428571428571,0.8313057583130575,gemini,medalign,progress_note,PROMPT1_entailment
27,30,64,58,6,0.90625,54,41,13,0.7592592592592593,0.8262682418346073,gemini,medalign,progress_note,PROMPT1_entailment
28,31,54,42,12,0.7777777777777778,38,28,10,0.7368421052631579,0.7567567567567567,gemini,medalign,progress_note,PROMPT1_entailment
29,32,87,73,14,0.8390804597701149,45,36,9,0.8,0.8190743338008416,gemini,medalign,progress_note,PROMPT1_entailment
30,33,21,16,5,0.7619047619047619,33,25,8,0.7575757575757576,0.7597340930674263,gemini,medalign,progress_note,PROMPT1_entailment
31,34,11,11,0,1.0,30,24,6,0.8,0.888888888888889,gemini,medalign,progress_note,PROMPT1_entailment
32,35,55,51,4,0.9272727272727272,57,44,13,0.7719298245614035,0.8425004693073024,gemini,medalign,progress_note,PROMPT1_entailment
33,36,51,44,7,0.8627450980392157,29,17,12,0.5862068965517241,0.698086794213719,gemini,medalign,progress_note,PROMPT1_entailment
34,37,25,12,13,0.48,19,12,7,0.631578947368421,0.5454545454545454,gemini,medalign,progress_note,PROMPT1_entailment
35,38,70,49,21,0.7,63,46,17,0.7301587301587301,0.7147613762486127,gemini,medalign,progress_note,PROMPT1_entailment
36,39,57,13,44,0.2280701754385964,43,29,14,0.6744186046511628,0.3408679927667269,gemini,medalign,progress_note,PROMPT1_entailment
37,4,77,71,6,0.922077922077922,65,47,18,0.7230769230769231,0.8105416565460287,gemini,medalign,progress_note,PROMPT1_entailment
38,40,25,22,3,0.88,31,15,16,0.4838709677419355,0.6244087038789027,gemini,medalign,progress_note,PROMPT1_entailment
39,41,61,54,7,0.8852459016393442,69,48,21,0.6956521739130435,0.7790802524797114,gemini,medalign,progress_note,PROMPT1_entailment
40,42,23,13,10,0.5652173913043478,32,18,14,0.5625,0.563855421686747,gemini,medalign,progress_note,PROMPT1_entailment
41,43,22,21,1,0.9545454545454546,23,14,9,0.6086956521739131,0.7433628318584071,gemini,medalign,progress_note,PROMPT1_entailment
42,44,47,40,7,0.851063829787234,92,66,26,0.717391304347826,0.7785314066647007,gemini,medalign,progress_note,PROMPT1_entailment
43,45,14,14,0,1.0,15,11,4,0.7333333333333333,0.846153846153846,gemini,medalign,progress_note,PROMPT1_entailment
44,46,59,58,1,0.9830508474576272,50,35,15,0.7,0.8177240684793555,gemini,medalign,progress_note,PROMPT1_entailment
45,47,35,26,9,0.7428571428571429,42,29,13,0.6904761904761905,0.7157095396298053,gemini,medalign,progress_note,PROMPT1_entailment
46,48,60,47,13,0.7833333333333333,56,38,18,0.6785714285714286,0.7271986970684038,gemini,medalign,progress_note,PROMPT1_entailment
47,49,79,69,10,0.8734177215189873,58,31,27,0.5344827586206896,0.6631529995349558,gemini,medalign,progress_note,PROMPT1_entailment
48,5,55,46,9,0.8363636363636363,69,43,26,0.6231884057971014,0.71420834085575,gemini,medalign,progress_note,PROMPT1_entailment
49,50,71,66,5,0.9295774647887324,68,55,13,0.8088235294117647,0.8650065530799477,gemini,medalign,progress_note,PROMPT1_entailment
50,51,57,53,4,0.9298245614035088,47,26,21,0.5531914893617021,0.693682355902341,gemini,medalign,progress_note,PROMPT1_entailment
51,52,15,14,1,0.9333333333333332,19,11,8,0.5789473684210527,0.7146171693735499,gemini,medalign,progress_note,PROMPT1_entailment
52,53,44,42,2,0.9545454545454546,54,36,18,0.6666666666666666,0.7850467289719627,gemini,medalign,progress_note,PROMPT1_entailment
53,54,22,20,2,0.9090909090909092,24,16,8,0.6666666666666666,0.7692307692307692,gemini,medalign,progress_note,PROMPT1_entailment
54,55,21,18,3,0.8571428571428571,23,19,4,0.8260869565217391,0.8413284132841329,gemini,medalign,progress_note,PROMPT1_entailment
55,56,38,33,5,0.868421052631579,25,15,10,0.6,0.7096774193548387,gemini,medalign,progress_note,PROMPT1_entailment
56,57,11,8,3,0.7272727272727273,4,4,0,1.0,0.8421052631578948,gemini,medalign,progress_note,PROMPT1_entailment
57,58,23,20,3,0.8695652173913043,13,12,1,0.9230769230769232,0.8955223880597014,gemini,medalign,progress_note,PROMPT1_entailment
58,59,16,13,3,0.8125,35,13,22,0.3714285714285714,0.5098039215686275,gemini,medalign,progress_note,PROMPT1_entailment
59,6,80,76,4,0.95,59,47,12,0.7966101694915254,0.8665696263949539,gemini,medalign,progress_note,PROMPT1_entailment
60,60,34,29,5,0.8529411764705882,56,35,21,0.625,0.7213930348258706,gemini,medalign,progress_note,PROMPT1_entailment
61,61,11,10,1,0.9090909090909092,25,18,7,0.72,0.8035714285714286,gemini,medalign,progress_note,PROMPT1_entailment
62,62,44,36,8,0.8181818181818182,32,20,12,0.625,0.7086614173228345,gemini,medalign,progress_note,PROMPT1_entailment
63,63,12,12,0,1.0,10,7,3,0.7,0.8235294117647058,gemini,medalign,progress_note,PROMPT1_entailment
64,64,102,71,31,0.696078431372549,69,56,13,0.8115942028985508,0.7494109885967393,gemini,medalign,progress_note,PROMPT1_entailment
65,65,61,32,29,0.5245901639344263,104,58,46,0.5576923076923077,0.5406350131080688,gemini,medalign,progress_note,PROMPT1_entailment
66,66,61,55,6,0.9016393442622952,87,66,21,0.7586206896551724,0.8239700374531834,gemini,medalign,progress_note,PROMPT1_entailment
67,67,21,18,3,0.8571428571428571,18,13,5,0.7222222222222222,0.7839195979899497,gemini,medalign,progress_note,PROMPT1_entailment
68,68,17,16,1,0.9411764705882352,11,8,3,0.7272727272727273,0.8205128205128205,gemini,medalign,progress_note,PROMPT1_entailment
69,69,65,55,10,0.8461538461538461,68,48,20,0.7058823529411765,0.7696793002915452,gemini,medalign,progress_note,PROMPT1_entailment
70,7,48,33,15,0.6875,37,33,4,0.8918918918918919,0.7764705882352941,gemini,medalign,progress_note,PROMPT1_entailment
71,70,13,13,0,1.0,69,32,37,0.463768115942029,0.6336633663366337,gemini,medalign,progress_note,PROMPT1_entailment
72,71,64,52,12,0.8125,48,41,7,0.8541666666666666,0.8328125000000001,gemini,medalign,progress_note,PROMPT1_entailment
73,72,78,63,15,0.8076923076923077,69,35,34,0.5072463768115942,0.6231454005934719,gemini,medalign,progress_note,PROMPT1_entailment
74,73,62,46,16,0.7419354838709677,90,50,40,0.5555555555555556,0.6353591160220995,gemini,medalign,progress_note,PROMPT1_entailment
75,74,21,20,1,0.9523809523809524,22,17,5,0.7727272727272727,0.8531994981179423,gemini,medalign,progress_note,PROMPT1_entailment
76,75,55,46,9,0.8363636363636363,49,34,15,0.6938775510204082,0.7584869059165857,gemini,medalign,progress_note,PROMPT1_entailment
77,76,55,42,13,0.7636363636363637,77,60,17,0.7792207792207793,0.7713498622589532,gemini,medalign,progress_note,PROMPT1_entailment
78,77,63,48,15,0.7619047619047619,38,22,16,0.5789473684210527,0.6579439252336449,gemini,medalign,progress_note,PROMPT1_entailment
79,78,67,65,2,0.9701492537313432,54,39,15,0.7222222222222222,0.8280254777070063,gemini,medalign,progress_note,PROMPT1_entailment
80,79,55,37,18,0.6727272727272727,64,58,6,0.90625,0.7722202231018351,gemini,medalign,progress_note,PROMPT1_entailment
81,8,51,44,7,0.8627450980392157,31,15,16,0.4838709677419355,0.6200093940817285,gemini,medalign,progress_note,PROMPT1_entailment
82,80,57,47,10,0.8245614035087719,66,29,37,0.4393939393939394,0.5732912723449002,gemini,medalign,progress_note,PROMPT1_entailment
83,81,30,24,6,0.8,12,9,3,0.75,0.7741935483870969,gemini,medalign,progress_note,PROMPT1_entailment
84,82,15,15,0,1.0,13,9,4,0.6923076923076923,0.8181818181818181,gemini,medalign,progress_note,PROMPT1_entailment
85,83,8,7,1,0.875,8,4,4,0.5,0.6363636363636364,gemini,medalign,progress_note,PROMPT1_entailment
86,84,19,13,6,0.6842105263157895,23,14,9,0.6086956521739131,0.6442477876106195,gemini,medalign,progress_note,PROMPT1_entailment
87,85,61,49,12,0.8032786885245902,63,39,24,0.6190476190476191,0.6992316136114161,gemini,medalign,progress_note,PROMPT1_entailment
88,86,57,44,13,0.7719298245614035,75,52,23,0.6933333333333334,0.7305236270753512,gemini,medalign,progress_note,PROMPT1_entailment
89,87,77,71,6,0.922077922077922,87,66,21,0.7586206896551724,0.8324007460698107,gemini,medalign,progress_note,PROMPT1_entailment
90,88,22,16,6,0.7272727272727273,84,71,13,0.8452380952380952,0.7818306951135583,gemini,medalign,progress_note,PROMPT1_entailment
91,89,42,36,6,0.8571428571428571,41,29,12,0.7073170731707317,0.7750556792873051,gemini,medalign,progress_note,PROMPT1_entailment
92,9,64,56,8,0.875,68,44,24,0.6470588235294118,0.7439613526570048,gemini,medalign,progress_note,PROMPT1_entailment
93,90,23,23,0,1.0,24,17,7,0.7083333333333334,0.8292682926829268,gemini,medalign,progress_note,PROMPT1_entailment
94,91,47,45,2,0.9574468085106383,45,32,13,0.7111111111111111,0.8160952111079627,gemini,medalign,progress_note,PROMPT1_entailment
95,92,13,11,2,0.8461538461538461,17,15,2,0.8823529411764706,0.8638743455497382,gemini,medalign,progress_note,PROMPT1_entailment
96,93,11,10,1,0.9090909090909092,25,18,7,0.72,0.8035714285714286,gemini,medalign,progress_note,PROMPT1_entailment
97,94,47,41,6,0.8723404255319149,33,11,22,0.3333333333333333,0.4823529411764705,gemini,medalign,progress_note,PROMPT1_entailment
98,95,57,47,10,0.8245614035087719,41,35,6,0.8536585365853658,0.8388577256501785,gemini,medalign,progress_note,PROMPT1_entailment
99,96,70,65,5,0.9285714285714286,48,35,13,0.7291666666666666,0.8168761220825853,gemini,medalign,progress_note,PROMPT1_entailment
100,97,70,59,11,0.8428571428571429,37,30,7,0.8108108108108109,0.8265234648610787,gemini,medalign,progress_note,PROMPT1_entailment
101,98,70,44,26,0.6285714285714286,55,45,10,0.8181818181818182,0.710951526032316,gemini,medalign,progress_note,PROMPT1_entailment
102,99,71,56,15,0.7887323943661971,73,49,24,0.6712328767123288,0.7252543940795559,gemini,medalign,progress_note,PROMPT1_entailment
0,0,82,67,15,0.8170731707317073,71,53,18,0.7464788732394366,0.780182357464572,gemini,medalign,progress_note,PROMPT1_ICL_entailment
1,1,76,68,8,0.8947368421052632,47,35,12,0.7446808510638298,0.8128415300546449,gemini,medalign,progress_note,PROMPT1_ICL_entailment
2,10,54,43,11,0.7962962962962963,48,28,20,0.5833333333333334,0.6733780760626398,gemini,medalign,progress_note,PROMPT1_ICL_entailment
3,100,35,34,1,0.9714285714285714,43,21,22,0.4883720930232558,0.6499772416932179,gemini,medalign,progress_note,PROMPT1_ICL_entailment
4,101,97,93,4,0.9587628865979382,73,50,23,0.684931506849315,0.7990377180170117,gemini,medalign,progress_note,PROMPT1_ICL_entailment
5,102,20,19,1,0.95,13,11,2,0.8461538461538461,0.8950749464668094,gemini,medalign,progress_note,PROMPT1_ICL_entailment
6,11,42,41,1,0.9761904761904762,38,27,11,0.7105263157894737,0.8224368499257058,gemini,medalign,progress_note,PROMPT1_ICL_entailment
7,12,74,68,6,0.918918918918919,46,38,8,0.8260869565217391,0.87003367003367,gemini,medalign,progress_note,PROMPT1_ICL_entailment
8,13,103,88,15,0.8543689320388349,68,46,22,0.6764705882352942,0.7550830069016975,gemini,medalign,progress_note,PROMPT1_ICL_entailment
9,14,13,12,1,0.9230769230769232,13,5,8,0.3846153846153846,0.5429864253393666,gemini,medalign,progress_note,PROMPT1_ICL_entailment
10,15,28,26,2,0.9285714285714286,19,13,6,0.6842105263157895,0.7878787878787878,gemini,medalign,progress_note,PROMPT1_ICL_entailment
11,16,130,111,19,0.8538461538461538,78,71,7,0.9102564102564102,0.881149373881932,gemini,medalign,progress_note,PROMPT1_ICL_entailment
12,17,63,59,4,0.9365079365079364,33,29,4,0.8787878787878788,0.9067302596714362,gemini,medalign,progress_note,PROMPT1_ICL_entailment
13,18,46,45,1,0.9782608695652174,59,43,16,0.7288135593220338,0.8353118929419382,gemini,medalign,progress_note,PROMPT1_ICL_entailment
14,19,74,64,10,0.8648648648648649,57,36,21,0.631578947368421,0.7300380228136882,gemini,medalign,progress_note,PROMPT1_ICL_entailment
15,2,79,67,12,0.8481012658227848,54,44,10,0.8148148148148148,0.8311248942768537,gemini,medalign,progress_note,PROMPT1_ICL_entailment
16,20,31,31,0,1.0,31,30,1,0.967741935483871,0.9836065573770492,gemini,medalign,progress_note,PROMPT1_ICL_entailment
17,21,56,45,11,0.8035714285714286,31,22,9,0.7096774193548387,0.75371145793681,gemini,medalign,progress_note,PROMPT1_ICL_entailment
18,22,89,68,21,0.7640449438202247,63,32,31,0.5079365079365079,0.6102075154234435,gemini,medalign,progress_note,PROMPT1_ICL_entailment
19,23,82,75,7,0.9146341463414634,35,32,3,0.9142857142857144,0.9144598971232616,gemini,medalign,progress_note,PROMPT1_ICL_entailment
20,24,53,49,4,0.9245283018867924,42,34,8,0.8095238095238095,0.8632124352331607,gemini,medalign,progress_note,PROMPT1_ICL_entailment
21,25,38,37,1,0.9736842105263158,26,22,4,0.8461538461538461,0.9054505005561736,gemini,medalign,progress_note,PROMPT1_ICL_entailment
22,26,38,36,2,0.9473684210526316,24,22,2,0.9166666666666666,0.9317647058823528,gemini,medalign,progress_note,PROMPT1_ICL_entailment
23,27,126,95,31,0.753968253968254,81,48,33,0.5925925925925926,0.6636105653787382,gemini,medalign,progress_note,PROMPT1_ICL_entailment
24,28,46,39,7,0.8478260869565217,38,26,12,0.6842105263157895,0.7572815533980581,gemini,medalign,progress_note,PROMPT1_ICL_entailment
25,29,154,139,15,0.9025974025974026,99,84,15,0.8484848484848485,0.8747050230362963,gemini,medalign,progress_note,PROMPT1_ICL_entailment
26,3,65,65,0,1.0,56,45,11,0.8035714285714286,0.8910891089108911,gemini,medalign,progress_note,PROMPT1_ICL_entailment
27,30,62,57,5,0.9193548387096774,54,43,11,0.7962962962962963,0.8534122562674094,gemini,medalign,progress_note,PROMPT1_ICL_entailment
28,31,91,71,20,0.7802197802197802,38,30,8,0.7894736842105263,0.7848194546794399,gemini,medalign,progress_note,PROMPT1_ICL_entailment
29,32,93,91,2,0.978494623655914,45,42,3,0.9333333333333332,0.9553805774278216,gemini,medalign,progress_note,PROMPT1_ICL_entailment
30,33,43,41,2,0.9534883720930232,33,26,7,0.7878787878787878,0.8628085795224605,gemini,medalign,progress_note,PROMPT1_ICL_entailment
31,34,33,33,0,1.0,30,23,7,0.7666666666666667,0.8679245283018869,gemini,medalign,progress_note,PROMPT1_ICL_entailment
32,35,37,37,0,1.0,57,36,21,0.631578947368421,0.7741935483870968,gemini,medalign,progress_note,PROMPT1_ICL_entailment
33,36,25,24,1,0.96,29,21,8,0.7241379310344828,0.8255528255528256,gemini,medalign,progress_note,PROMPT1_ICL_entailment
34,37,33,16,17,0.4848484848484848,19,11,8,0.5789473684210527,0.527736131934033,gemini,medalign,progress_note,PROMPT1_ICL_entailment
35,38,120,100,20,0.8333333333333334,63,56,7,0.8888888888888888,0.8602150537634408,gemini,medalign,progress_note,PROMPT1_ICL_entailment
36,39,70,34,36,0.4857142857142857,43,39,4,0.9069767441860463,0.6326335877862596,gemini,medalign,progress_note,PROMPT1_ICL_entailment
37,4,54,49,5,0.9074074074074074,65,32,33,0.4923076923076923,0.6383065336861389,gemini,medalign,progress_note,PROMPT1_ICL_entailment
38,40,36,35,1,0.9722222222222222,31,20,11,0.6451612903225806,0.7756232686980609,gemini,medalign,progress_note,PROMPT1_ICL_entailment
39,41,66,63,3,0.9545454545454546,69,50,19,0.7246376811594203,0.823852491173009,gemini,medalign,progress_note,PROMPT1_ICL_entailment
40,42,26,20,6,0.7692307692307693,32,24,8,0.75,0.7594936708860761,gemini,medalign,progress_note,PROMPT1_ICL_entailment
41,43,36,32,4,0.8888888888888888,23,16,7,0.6956521739130435,0.7804878048780488,gemini,medalign,progress_note,PROMPT1_ICL_entailment
42,44,97,85,12,0.8762886597938144,92,59,33,0.6413043478260869,0.7406040020674888,gemini,medalign,progress_note,PROMPT1_ICL_entailment
43,45,29,26,3,0.896551724137931,15,12,3,0.8,0.8455284552845529,gemini,medalign,progress_note,PROMPT1_ICL_entailment
44,46,49,49,0,1.0,50,41,9,0.82,0.9010989010989012,gemini,medalign,progress_note,PROMPT1_ICL_entailment
45,47,59,48,11,0.8135593220338984,42,31,11,0.7380952380952381,0.7739921976592978,gemini,medalign,progress_note,PROMPT1_ICL_entailment
46,48,31,26,5,0.8387096774193549,56,27,29,0.4821428571428571,0.6122982991713912,gemini,medalign,progress_note,PROMPT1_ICL_entailment
47,49,31,30,1,0.967741935483871,58,16,42,0.2758620689655172,0.4293381037567083,gemini,medalign,progress_note,PROMPT1_ICL_entailment
48,5,79,73,6,0.9240506329113924,69,48,21,0.6956521739130435,0.7937478763166836,gemini,medalign,progress_note,PROMPT1_ICL_entailment
49,50,48,45,3,0.9375,68,39,29,0.5735294117647058,0.7116788321167883,gemini,medalign,progress_note,PROMPT1_ICL_entailment
50,51,75,72,3,0.96,47,39,8,0.8297872340425532,0.8901569186875892,gemini,medalign,progress_note,PROMPT1_ICL_entailment
51,52,35,30,5,0.8571428571428571,19,15,4,0.7894736842105263,0.8219178082191781,gemini,medalign,progress_note,PROMPT1_ICL_entailment
52,53,56,54,2,0.9642857142857144,54,36,18,0.6666666666666666,0.7883211678832116,gemini,medalign,progress_note,PROMPT1_ICL_entailment
53,54,21,20,1,0.9523809523809524,24,15,9,0.625,0.7547169811320755,gemini,medalign,progress_note,PROMPT1_ICL_entailment
54,55,32,32,0,1.0,23,17,6,0.7391304347826086,0.85,gemini,medalign,progress_note,PROMPT1_ICL_entailment
55,56,30,27,3,0.9,25,17,8,0.68,0.7746835443037976,gemini,medalign,progress_note,PROMPT1_ICL_entailment
56,57,13,10,3,0.7692307692307693,4,3,1,0.75,0.7594936708860761,gemini,medalign,progress_note,PROMPT1_ICL_entailment
57,58,13,12,1,0.9230769230769232,13,9,4,0.6923076923076923,0.7912087912087913,gemini,medalign,progress_note,PROMPT1_ICL_entailment
58,59,21,21,0,1.0,35,20,15,0.5714285714285714,0.7272727272727273,gemini,medalign,progress_note,PROMPT1_ICL_entailment
59,6,75,74,1,0.9866666666666668,59,44,15,0.7457627118644068,0.8494651708844247,gemini,medalign,progress_note,PROMPT1_ICL_entailment
60,60,73,67,6,0.9178082191780822,56,39,17,0.6964285714285714,0.7919381724503712,gemini,medalign,progress_note,PROMPT1_ICL_entailment
61,61,33,31,2,0.9393939393939394,25,24,1,0.96,0.9495851946394384,gemini,medalign,progress_note,PROMPT1_ICL_entailment
62,62,25,18,7,0.72,32,21,11,0.65625,0.6866485013623977,gemini,medalign,progress_note,PROMPT1_ICL_entailment
63,63,20,20,0,1.0,10,9,1,0.9,0.9473684210526316,gemini,medalign,progress_note,PROMPT1_ICL_entailment
64,64,129,105,24,0.813953488372093,69,59,10,0.855072463768116,0.8340064620355413,gemini,medalign,progress_note,PROMPT1_ICL_entailment
65,65,112,85,27,0.7589285714285714,104,65,39,0.625,0.6854838709677419,gemini,medalign,progress_note,PROMPT1_ICL_entailment
66,66,91,86,5,0.945054945054945,87,73,14,0.8390804597701149,0.888920353982301,gemini,medalign,progress_note,PROMPT1_ICL_entailment
67,67,29,26,3,0.896551724137931,18,16,2,0.8888888888888888,0.8927038626609441,gemini,medalign,progress_note,PROMPT1_ICL_entailment
68,68,11,9,2,0.8181818181818182,11,5,6,0.4545454545454545,0.5844155844155845,gemini,medalign,progress_note,PROMPT1_ICL_entailment
69,69,88,78,10,0.8863636363636364,68,47,21,0.6911764705882353,0.7766949152542373,gemini,medalign,progress_note,PROMPT1_ICL_entailment
70,7,71,54,17,0.7605633802816901,37,31,6,0.8378378378378378,0.7973326982614908,gemini,medalign,progress_note,PROMPT1_ICL_entailment
71,70,45,42,3,0.9333333333333332,69,25,44,0.3623188405797101,0.5219985085756897,gemini,medalign,progress_note,PROMPT1_ICL_entailment
72,71,95,88,7,0.9263157894736842,48,41,7,0.8541666666666666,0.8887794063308287,gemini,medalign,progress_note,PROMPT1_ICL_entailment
73,72,73,68,5,0.9315068493150684,69,50,19,0.7246376811594203,0.8151522416686646,gemini,medalign,progress_note,PROMPT1_ICL_entailment
74,73,49,35,14,0.7142857142857143,90,38,52,0.4222222222222222,0.5307262569832402,gemini,medalign,progress_note,PROMPT1_ICL_entailment
75,74,30,30,0,1.0,22,21,1,0.9545454545454546,0.9767441860465116,gemini,medalign,progress_note,PROMPT1_ICL_entailment
76,75,42,38,4,0.9047619047619048,49,34,15,0.6938775510204082,0.7854103343465045,gemini,medalign,progress_note,PROMPT1_ICL_entailment
77,76,100,90,10,0.9,77,55,22,0.7142857142857143,0.7964601769911505,gemini,medalign,progress_note,PROMPT1_ICL_entailment
78,77,71,63,8,0.8873239436619719,38,31,7,0.8157894736842105,0.8500544069640914,gemini,medalign,progress_note,PROMPT1_ICL_entailment
79,78,61,61,0,1.0,54,42,12,0.7777777777777778,0.8750000000000001,gemini,medalign,progress_note,PROMPT1_ICL_entailment
80,79,82,55,27,0.6707317073170732,64,46,18,0.71875,0.693911135490949,gemini,medalign,progress_note,PROMPT1_ICL_entailment
81,8,40,32,8,0.8,31,19,12,0.6129032258064516,0.6940639269406392,gemini,medalign,progress_note,PROMPT1_ICL_entailment
82,80,56,47,9,0.8392857142857143,66,29,37,0.4393939393939394,0.5768091409225561,gemini,medalign,progress_note,PROMPT1_ICL_entailment
83,81,22,20,2,0.9090909090909092,12,9,3,0.75,0.821917808219178,gemini,medalign,progress_note,PROMPT1_ICL_entailment
84,82,17,16,1,0.9411764705882352,13,6,7,0.4615384615384615,0.6193548387096774,gemini,medalign,progress_note,PROMPT1_ICL_entailment
85,83,15,13,2,0.8666666666666667,8,5,3,0.625,0.7262569832402236,gemini,medalign,progress_note,PROMPT1_ICL_entailment
86,84,27,22,5,0.8148148148148148,23,16,7,0.6956521739130435,0.7505330490405117,gemini,medalign,progress_note,PROMPT1_ICL_entailment
87,85,80,79,1,0.9875,63,41,22,0.6507936507936508,0.7845464454402326,gemini,medalign,progress_note,PROMPT1_ICL_entailment
88,86,60,55,5,0.9166666666666666,75,39,36,0.52,0.6635730858468678,gemini,medalign,progress_note,PROMPT1_ICL_entailment
89,87,115,102,13,0.8869565217391304,87,70,17,0.8045977011494253,0.8437721578822974,gemini,medalign,progress_note,PROMPT1_ICL_entailment
90,88,128,115,13,0.8984375,84,64,20,0.7619047619047619,0.824557472552095,gemini,medalign,progress_note,PROMPT1_ICL_entailment
91,89,53,50,3,0.9433962264150944,41,28,13,0.6829268292682927,0.792303338992643,gemini,medalign,progress_note,PROMPT1_ICL_entailment
92,9,90,87,3,0.9666666666666668,68,44,24,0.6470588235294118,0.7752126366950182,gemini,medalign,progress_note,PROMPT1_ICL_entailment
93,90,18,16,2,0.8888888888888888,24,15,9,0.625,0.7339449541284404,gemini,medalign,progress_note,PROMPT1_ICL_entailment
94,91,46,43,3,0.9347826086956522,45,35,10,0.7777777777777778,0.849083215796897,gemini,medalign,progress_note,PROMPT1_ICL_entailment
95,92,24,23,1,0.9583333333333334,17,15,2,0.8823529411764706,0.918774966711052,gemini,medalign,progress_note,PROMPT1_ICL_entailment
96,93,41,31,10,0.7560975609756098,25,19,6,0.76,0.7580437580437581,gemini,medalign,progress_note,PROMPT1_ICL_entailment
97,94,32,30,2,0.9375,33,20,13,0.6060606060606061,0.736196319018405,gemini,medalign,progress_note,PROMPT1_ICL_entailment
98,95,55,44,11,0.8,41,37,4,0.902439024390244,0.8481375358166189,gemini,medalign,progress_note,PROMPT1_ICL_entailment
99,96,120,115,5,0.9583333333333334,48,42,6,0.875,0.9147727272727272,gemini,medalign,progress_note,PROMPT1_ICL_entailment
100,97,63,59,4,0.9365079365079364,37,35,2,0.945945945945946,0.9412032816773018,gemini,medalign,progress_note,PROMPT1_ICL_entailment
101,98,71,32,39,0.4507042253521127,55,41,14,0.7454545454545455,0.5617640762149433,gemini,medalign,progress_note,PROMPT1_ICL_entailment
102,99,93,81,12,0.8709677419354839,73,61,12,0.8356164383561644,0.8529259451061626,gemini,medalign,progress_note,PROMPT1_ICL_entailment
0,0,128,114,14,0.890625,71,54,17,0.7605633802816901,0.8204718112754898,gemini,medalign,progress_note,PROMPT2_ICL_entailment
1,1,40,32,8,0.8,47,19,28,0.4042553191489361,0.5371024734982333,gemini,medalign,progress_note,PROMPT2_ICL_entailment
2,10,89,79,10,0.8876404494382022,48,29,19,0.6041666666666666,0.7189706574611642,gemini,medalign,progress_note,PROMPT2_ICL_entailment
3,100,82,81,1,0.9878048780487804,43,36,7,0.8372093023255814,0.9062937062937062,gemini,medalign,progress_note,PROMPT2_ICL_entailment
4,101,95,89,6,0.936842105263158,73,49,24,0.6712328767123288,0.7821018651362985,gemini,medalign,progress_note,PROMPT2_ICL_entailment
5,102,18,17,1,0.9444444444444444,13,5,8,0.3846153846153846,0.5466237942122186,gemini,medalign,progress_note,PROMPT2_ICL_entailment
6,11,57,52,5,0.912280701754386,38,27,11,0.7105263157894737,0.7988620199146514,gemini,medalign,progress_note,PROMPT2_ICL_entailment
7,12,72,69,3,0.9583333333333334,46,35,11,0.7608695652173914,0.8482613277133826,gemini,medalign,progress_note,PROMPT2_ICL_entailment
8,13,88,72,16,0.8181818181818182,68,48,20,0.7058823529411765,0.7578947368421053,gemini,medalign,progress_note,PROMPT2_ICL_entailment
9,14,20,19,1,0.95,13,7,6,0.5384615384615384,0.6873385012919896,gemini,medalign,progress_note,PROMPT2_ICL_entailment
10,15,23,21,2,0.9130434782608696,19,14,5,0.7368421052631579,0.8155339805825242,gemini,medalign,progress_note,PROMPT2_ICL_entailment
11,16,144,123,21,0.8541666666666666,78,69,9,0.8846153846153846,0.8691244239631337,gemini,medalign,progress_note,PROMPT2_ICL_entailment
12,17,70,64,6,0.9142857142857144,33,29,4,0.8787878787878788,0.8961854176726219,gemini,medalign,progress_note,PROMPT2_ICL_entailment
13,18,88,82,6,0.9318181818181818,59,49,10,0.8305084745762712,0.8782513661202187,gemini,medalign,progress_note,PROMPT2_ICL_entailment
14,19,65,59,6,0.9076923076923076,57,26,31,0.4561403508771929,0.6071640609538888,gemini,medalign,progress_note,PROMPT2_ICL_entailment
15,2,83,70,13,0.8433734939759037,54,33,21,0.6111111111111112,0.708697653014266,gemini,medalign,progress_note,PROMPT2_ICL_entailment
16,20,47,47,0,1.0,31,27,4,0.8709677419354839,0.9310344827586208,gemini,medalign,progress_note,PROMPT2_ICL_entailment
17,21,56,45,11,0.8035714285714286,31,22,9,0.7096774193548387,0.75371145793681,gemini,medalign,progress_note,PROMPT2_ICL_entailment
18,22,78,76,2,0.9743589743589745,63,35,28,0.5555555555555556,0.7076350093109871,gemini,medalign,progress_note,PROMPT2_ICL_entailment
19,23,76,67,9,0.881578947368421,35,26,9,0.7428571428571429,0.8062948391576024,gemini,medalign,progress_note,PROMPT2_ICL_entailment
20,24,57,52,5,0.912280701754386,42,28,14,0.6666666666666666,0.7703703703703703,gemini,medalign,progress_note,PROMPT2_ICL_entailment
21,25,46,46,0,1.0,26,23,3,0.8846153846153846,0.9387755102040816,gemini,medalign,progress_note,PROMPT2_ICL_entailment
22,26,56,55,1,0.9821428571428572,24,21,3,0.875,0.9254807692307692,gemini,medalign,progress_note,PROMPT2_ICL_entailment
23,27,137,124,13,0.9051094890510948,81,47,34,0.5802469135802469,0.7071528241218225,gemini,medalign,progress_note,PROMPT2_ICL_entailment
24,28,72,64,8,0.8888888888888888,38,28,10,0.7368421052631579,0.8057553956834532,gemini,medalign,progress_note,PROMPT2_ICL_entailment
25,29,149,137,12,0.9194630872483222,99,54,45,0.5454545454545454,0.6847147022074135,gemini,medalign,progress_note,PROMPT2_ICL_entailment
26,3,70,67,3,0.9571428571428572,56,41,15,0.7321428571428571,0.8296587133796436,gemini,medalign,progress_note,PROMPT2_ICL_entailment
27,30,125,112,13,0.896,54,37,17,0.6851851851851852,0.7765389300103064,gemini,medalign,progress_note,PROMPT2_ICL_entailment
28,31,73,60,13,0.821917808219178,38,30,8,0.7894736842105263,0.8053691275167785,gemini,medalign,progress_note,PROMPT2_ICL_entailment
29,32,103,101,2,0.9805825242718448,45,39,6,0.8666666666666667,0.9201121233356692,gemini,medalign,progress_note,PROMPT2_ICL_entailment
30,33,34,33,1,0.9705882352941176,33,23,10,0.696969696969697,0.8113308391234635,gemini,medalign,progress_note,PROMPT2_ICL_entailment
31,34,44,43,1,0.9772727272727272,30,27,3,0.9,0.937046004842615,gemini,medalign,progress_note,PROMPT2_ICL_entailment
32,35,80,77,3,0.9625,57,49,8,0.8596491228070176,0.9081718618365628,gemini,medalign,progress_note,PROMPT2_ICL_entailment
33,36,29,27,2,0.9310344827586208,29,22,7,0.7586206896551724,0.8360309641097817,gemini,medalign,progress_note,PROMPT2_ICL_entailment
34,37,23,19,4,0.8260869565217391,19,8,11,0.4210526315789473,0.5577981651376146,gemini,medalign,progress_note,PROMPT2_ICL_entailment
35,38,132,102,30,0.7727272727272727,63,50,13,0.7936507936507936,0.7830492860432979,gemini,medalign,progress_note,PROMPT2_ICL_entailment
36,39,91,54,37,0.5934065934065934,43,37,6,0.8604651162790697,0.7024081560907014,gemini,medalign,progress_note,PROMPT2_ICL_entailment
37,4,94,86,8,0.9148936170212766,65,47,18,0.7230769230769231,0.80775379696243,gemini,medalign,progress_note,PROMPT2_ICL_entailment
38,40,40,35,5,0.875,31,12,19,0.3870967741935484,0.5367412140575079,gemini,medalign,progress_note,PROMPT2_ICL_entailment
39,41,128,118,10,0.921875,69,43,26,0.6231884057971014,0.7436611461234061,gemini,medalign,progress_note,PROMPT2_ICL_entailment
40,42,32,28,4,0.875,32,23,9,0.71875,0.7892156862745098,gemini,medalign,progress_note,PROMPT2_ICL_entailment
41,43,19,16,3,0.8421052631578947,23,12,11,0.5217391304347826,0.6442953020134228,gemini,medalign,progress_note,PROMPT2_ICL_entailment
42,44,144,129,15,0.8958333333333334,92,63,29,0.6847826086956522,0.77621776504298,gemini,medalign,progress_note,PROMPT2_ICL_entailment
43,45,24,23,1,0.9583333333333334,15,10,5,0.6666666666666666,0.7863247863247863,gemini,medalign,progress_note,PROMPT2_ICL_entailment
44,46,78,77,1,0.9871794871794872,50,37,13,0.74,0.8459026128266033,gemini,medalign,progress_note,PROMPT2_ICL_entailment
45,47,44,36,8,0.8181818181818182,42,36,6,0.8571428571428571,0.8372093023255814,gemini,medalign,progress_note,PROMPT2_ICL_entailment
46,48,71,67,4,0.943661971830986,56,41,15,0.7321428571428571,0.8245535044274351,gemini,medalign,progress_note,PROMPT2_ICL_entailment
47,49,109,100,9,0.9174311926605504,58,36,22,0.6206896551724138,0.7404360345536816,gemini,medalign,progress_note,PROMPT2_ICL_entailment
48,5,51,44,7,0.8627450980392157,69,30,39,0.4347826086956521,0.5781865965834428,gemini,medalign,progress_note,PROMPT2_ICL_entailment
49,50,124,118,6,0.9516129032258064,68,49,19,0.7205882352941176,0.8201418439716313,gemini,medalign,progress_note,PROMPT2_ICL_entailment
50,51,73,72,1,0.9863013698630136,47,35,12,0.7446808510638298,0.8486277151035526,gemini,medalign,progress_note,PROMPT2_ICL_entailment
51,52,26,25,1,0.9615384615384616,19,11,8,0.5789473684210527,0.7227332457293036,gemini,medalign,progress_note,PROMPT2_ICL_entailment
52,53,67,66,1,0.9850746268656716,54,42,12,0.7777777777777778,0.8692380056444026,gemini,medalign,progress_note,PROMPT2_ICL_entailment
53,54,26,25,1,0.9615384615384616,24,14,10,0.5833333333333334,0.7261410788381742,gemini,medalign,progress_note,PROMPT2_ICL_entailment
54,55,31,28,3,0.9032258064516128,23,15,8,0.6521739130434783,0.7574391343552751,gemini,medalign,progress_note,PROMPT2_ICL_entailment
55,56,33,32,1,0.9696969696969696,25,17,8,0.68,0.7994121969140338,gemini,medalign,progress_note,PROMPT2_ICL_entailment
56,57,1,1,0,1.0,4,0,4,0.0,0.0,gemini,medalign,progress_note,PROMPT2_ICL_entailment
57,58,12,11,1,0.9166666666666666,13,6,7,0.4615384615384615,0.6139534883720931,gemini,medalign,progress_note,PROMPT2_ICL_entailment
58,59,35,31,4,0.8857142857142857,35,24,11,0.6857142857142857,0.772987012987013,gemini,medalign,progress_note,PROMPT2_ICL_entailment
59,6,96,91,5,0.9479166666666666,59,47,12,0.7966101694915254,0.8657018520392672,gemini,medalign,progress_note,PROMPT2_ICL_entailment
60,60,64,58,6,0.90625,56,28,28,0.5,0.6444444444444445,gemini,medalign,progress_note,PROMPT2_ICL_entailment
61,61,19,18,1,0.9473684210526316,25,15,10,0.6,0.7346938775510204,gemini,medalign,progress_note,PROMPT2_ICL_entailment
62,62,35,33,2,0.9428571428571428,32,22,10,0.6875,0.7951807228915663,gemini,medalign,progress_note,PROMPT2_ICL_entailment
63,63,20,20,0,1.0,10,5,5,0.5,0.6666666666666666,gemini,medalign,progress_note,PROMPT2_ICL_entailment
64,64,151,119,32,0.7880794701986755,69,58,11,0.8405797101449275,0.8134834109258059,gemini,medalign,progress_note,PROMPT2_ICL_entailment
65,65,222,143,79,0.6441441441441441,104,59,45,0.5673076923076923,0.603289238469789,gemini,medalign,progress_note,PROMPT2_ICL_entailment
66,66,143,132,11,0.9230769230769232,87,58,29,0.6666666666666666,0.7741935483870968,gemini,medalign,progress_note,PROMPT2_ICL_entailment
67,67,35,33,2,0.9428571428571428,18,14,4,0.7777777777777778,0.8523985239852397,gemini,medalign,progress_note,PROMPT2_ICL_entailment
68,68,17,15,2,0.8823529411764706,11,7,4,0.6363636363636364,0.73943661971831,gemini,medalign,progress_note,PROMPT2_ICL_entailment
69,69,72,68,4,0.9444444444444444,68,45,23,0.6617647058823529,0.7782299084435401,gemini,medalign,progress_note,PROMPT2_ICL_entailment
70,7,69,57,12,0.8260869565217391,37,34,3,0.918918918918919,0.87003367003367,gemini,medalign,progress_note,PROMPT2_ICL_entailment
71,70,107,93,14,0.8691588785046729,69,36,33,0.5217391304347826,0.652059596844873,gemini,medalign,progress_note,PROMPT2_ICL_entailment
72,71,125,115,10,0.92,48,44,4,0.9166666666666666,0.9183303085299456,gemini,medalign,progress_note,PROMPT2_ICL_entailment
73,72,101,94,7,0.9306930693069309,69,45,24,0.6521739130434783,0.7669295621430513,gemini,medalign,progress_note,PROMPT2_ICL_entailment
74,73,156,120,36,0.7692307692307693,90,50,40,0.5555555555555556,0.6451612903225806,gemini,medalign,progress_note,PROMPT2_ICL_entailment
75,74,31,30,1,0.967741935483871,22,20,2,0.9090909090909092,0.9375,gemini,medalign,progress_note,PROMPT2_ICL_entailment
76,75,74,66,8,0.8918918918918919,49,41,8,0.8367346938775511,0.8634333120612636,gemini,medalign,progress_note,PROMPT2_ICL_entailment
77,76,130,112,18,0.8615384615384616,77,57,20,0.7402597402597403,0.7963078458276164,gemini,medalign,progress_note,PROMPT2_ICL_entailment
78,77,93,86,7,0.9247311827956988,38,33,5,0.868421052631579,0.8956919678081112,gemini,medalign,progress_note,PROMPT2_ICL_entailment
79,78,81,79,2,0.9753086419753086,54,38,16,0.7037037037037037,0.8175381263616559,gemini,medalign,progress_note,PROMPT2_ICL_entailment
80,79,130,89,41,0.6846153846153846,64,46,18,0.71875,0.7012675573826653,gemini,medalign,progress_note,PROMPT2_ICL_entailment
81,8,49,43,6,0.8775510204081632,31,18,13,0.5806451612903226,0.6988713318284424,gemini,medalign,progress_note,PROMPT2_ICL_entailment
82,80,95,93,2,0.9789473684210528,66,34,32,0.5151515151515151,0.6750640478223742,gemini,medalign,progress_note,PROMPT2_ICL_entailment
83,81,18,14,4,0.7777777777777778,12,5,7,0.4166666666666667,0.5426356589147286,gemini,medalign,progress_note,PROMPT2_ICL_entailment
84,82,16,15,1,0.9375,13,7,6,0.5384615384615384,0.6840390879478828,gemini,medalign,progress_note,PROMPT2_ICL_entailment
85,83,15,14,1,0.9333333333333332,8,4,4,0.5,0.6511627906976745,gemini,medalign,progress_note,PROMPT2_ICL_entailment
86,84,24,20,4,0.8333333333333334,23,14,9,0.6086956521739131,0.7035175879396984,gemini,medalign,progress_note,PROMPT2_ICL_entailment
87,85,102,96,6,0.9411764705882352,63,47,16,0.746031746031746,0.8323187603763144,gemini,medalign,progress_note,PROMPT2_ICL_entailment
88,86,101,97,4,0.9603960396039604,75,45,30,0.6,0.7385786802030456,gemini,medalign,progress_note,PROMPT2_ICL_entailment
89,87,136,128,8,0.9411764705882352,87,52,35,0.5977011494252874,0.7311072056239016,gemini,medalign,progress_note,PROMPT2_ICL_entailment
90,88,142,125,17,0.8802816901408451,84,70,14,0.8333333333333334,0.8561643835616439,gemini,medalign,progress_note,PROMPT2_ICL_entailment
91,89,91,86,5,0.945054945054945,41,35,6,0.8536585365853658,0.8970347191178661,gemini,medalign,progress_note,PROMPT2_ICL_entailment
92,9,103,98,5,0.9514563106796116,68,44,24,0.6470588235294118,0.7702750982493748,gemini,medalign,progress_note,PROMPT2_ICL_entailment
93,90,20,19,1,0.95,24,13,11,0.5416666666666666,0.6899441340782122,gemini,medalign,progress_note,PROMPT2_ICL_entailment
94,91,15,14,1,0.9333333333333332,45,30,15,0.6666666666666666,0.7777777777777778,gemini,medalign,progress_note,PROMPT2_ICL_entailment
95,92,24,24,0,1.0,17,13,4,0.7647058823529411,0.8666666666666666,gemini,medalign,progress_note,PROMPT2_ICL_entailment
96,93,27,24,3,0.8888888888888888,25,21,4,0.84,0.8637532133676092,gemini,medalign,progress_note,PROMPT2_ICL_entailment
97,94,40,35,5,0.875,33,20,13,0.6060606060606061,0.7161125319693095,gemini,medalign,progress_note,PROMPT2_ICL_entailment
98,95,79,64,15,0.810126582278481,41,34,7,0.8292682926829268,0.8195856873822974,gemini,medalign,progress_note,PROMPT2_ICL_entailment
99,96,120,111,9,0.925,48,42,6,0.875,0.8993055555555556,gemini,medalign,progress_note,PROMPT2_ICL_entailment
100,97,62,54,8,0.8709677419354839,37,32,5,0.8648648648648649,0.8679055750878956,gemini,medalign,progress_note,PROMPT2_ICL_entailment
101,98,119,70,49,0.5882352941176471,55,45,10,0.8181818181818182,0.6844106463878327,gemini,medalign,progress_note,PROMPT2_ICL_entailment
102,99,137,113,24,0.8248175182481752,73,58,15,0.7945205479452054,0.8093856128434702,gemini,medalign,progress_note,PROMPT2_ICL_entailment
0,0,102,82,20,0.803921568627451,71,52,19,0.7323943661971831,0.7664928995146503,gemini,medalign,progress_note,PROMPT2_entailment
1,1,61,54,7,0.8852459016393442,47,29,18,0.6170212765957447,0.7271882981193406,gemini,medalign,progress_note,PROMPT2_entailment
2,10,62,51,11,0.8225806451612904,48,24,24,0.5,0.6219512195121951,gemini,medalign,progress_note,PROMPT2_entailment
3,100,65,65,0,1.0,43,28,15,0.6511627906976745,0.7887323943661972,gemini,medalign,progress_note,PROMPT2_entailment
4,101,129,102,27,0.7906976744186046,73,49,24,0.6712328767123288,0.7260841141860971,gemini,medalign,progress_note,PROMPT2_entailment
5,102,11,11,0,1.0,13,5,8,0.3846153846153846,0.5555555555555556,gemini,medalign,progress_note,PROMPT2_entailment
6,11,44,43,1,0.9772727272727272,38,19,19,0.5,0.6615384615384615,gemini,medalign,progress_note,PROMPT2_entailment
7,12,67,66,1,0.9850746268656716,46,33,13,0.717391304347826,0.830188679245283,gemini,medalign,progress_note,PROMPT2_entailment
8,13,48,40,8,0.8333333333333334,68,41,27,0.6029411764705882,0.6996587030716723,gemini,medalign,progress_note,PROMPT2_entailment
9,14,17,17,0,1.0,13,5,8,0.3846153846153846,0.5555555555555556,gemini,medalign,progress_note,PROMPT2_entailment
10,15,15,13,2,0.8666666666666667,19,7,12,0.3684210526315789,0.5170454545454545,gemini,medalign,progress_note,PROMPT2_entailment
11,16,124,109,15,0.8790322580645161,78,60,18,0.7692307692307693,0.8204742190440346,gemini,medalign,progress_note,PROMPT2_entailment
12,17,49,45,4,0.9183673469387756,33,27,6,0.8181818181818182,0.8653846153846154,gemini,medalign,progress_note,PROMPT2_entailment
13,18,67,63,4,0.9402985074626866,59,46,13,0.7796610169491526,0.8524783056331814,gemini,medalign,progress_note,PROMPT2_entailment
14,19,74,63,11,0.8513513513513513,57,45,12,0.7894736842105263,0.8192457737321196,gemini,medalign,progress_note,PROMPT2_entailment
15,2,85,81,4,0.9529411764705882,54,26,28,0.4814814814814814,0.6397326852976913,gemini,medalign,progress_note,PROMPT2_entailment
16,20,36,36,0,1.0,31,28,3,0.9032258064516128,0.9491525423728812,gemini,medalign,progress_note,PROMPT2_entailment
17,21,41,34,7,0.8292682926829268,31,17,14,0.5483870967741935,0.6601941747572816,gemini,medalign,progress_note,PROMPT2_entailment
18,22,61,61,0,1.0,63,34,29,0.5396825396825397,0.7010309278350516,gemini,medalign,progress_note,PROMPT2_entailment
19,23,81,75,6,0.925925925925926,35,30,5,0.8571428571428571,0.8902077151335311,gemini,medalign,progress_note,PROMPT2_entailment
20,24,63,59,4,0.9365079365079364,42,33,9,0.7857142857142857,0.8545095457537853,gemini,medalign,progress_note,PROMPT2_entailment
21,25,34,33,1,0.9705882352941176,26,20,6,0.7692307692307693,0.8582574772431729,gemini,medalign,progress_note,PROMPT2_entailment
22,26,41,39,2,0.951219512195122,24,21,3,0.875,0.9115191986644408,gemini,medalign,progress_note,PROMPT2_entailment
23,27,145,133,12,0.9172413793103448,81,46,35,0.5679012345679012,0.7014848363240268,gemini,medalign,progress_note,PROMPT2_entailment
24,28,39,35,4,0.8974358974358975,38,24,14,0.631578947368421,0.7413945278022948,gemini,medalign,progress_note,PROMPT2_entailment
25,29,177,150,27,0.847457627118644,99,52,47,0.5252525252525253,0.6485407832377151,gemini,medalign,progress_note,PROMPT2_entailment
26,3,65,60,5,0.9230769230769232,56,40,16,0.7142857142857143,0.8053691275167787,gemini,medalign,progress_note,PROMPT2_entailment
27,30,78,75,3,0.9615384615384616,54,37,17,0.6851851851851852,0.8001730103806228,gemini,medalign,progress_note,PROMPT2_entailment
28,31,57,45,12,0.7894736842105263,38,27,11,0.7105263157894737,0.7479224376731302,gemini,medalign,progress_note,PROMPT2_entailment
29,32,63,61,2,0.9682539682539684,45,31,14,0.6888888888888889,0.8050234142188165,gemini,medalign,progress_note,PROMPT2_entailment
30,33,23,21,2,0.9130434782608696,33,19,14,0.5757575757575758,0.7061946902654866,gemini,medalign,progress_note,PROMPT2_entailment
31,34,31,31,0,1.0,30,25,5,0.8333333333333334,0.9090909090909092,gemini,medalign,progress_note,PROMPT2_entailment
32,35,60,59,1,0.9833333333333332,57,43,14,0.7543859649122807,0.8537775534241966,gemini,medalign,progress_note,PROMPT2_entailment
33,36,18,17,1,0.9444444444444444,29,17,12,0.5862068965517241,0.7234042553191489,gemini,medalign,progress_note,PROMPT2_entailment
34,37,19,11,8,0.5789473684210527,19,3,16,0.1578947368421052,0.2481203007518796,gemini,medalign,progress_note,PROMPT2_entailment
35,38,113,87,26,0.7699115044247787,63,41,22,0.6507936507936508,0.7053589084437414,gemini,medalign,progress_note,PROMPT2_entailment
36,39,45,29,16,0.6444444444444445,43,24,19,0.5581395348837209,0.598195100988397,gemini,medalign,progress_note,PROMPT2_entailment
37,4,68,63,5,0.9264705882352942,65,39,26,0.6,0.7283236994219654,gemini,medalign,progress_note,PROMPT2_entailment
38,40,41,37,4,0.902439024390244,31,20,11,0.6451612903225806,0.7524148449415354,gemini,medalign,progress_note,PROMPT2_entailment
39,41,109,101,8,0.926605504587156,69,46,23,0.6666666666666666,0.7754318618042227,gemini,medalign,progress_note,PROMPT2_entailment
40,42,34,27,7,0.7941176470588235,32,26,6,0.8125,0.8032036613272311,gemini,medalign,progress_note,PROMPT2_entailment
41,43,21,17,4,0.8095238095238095,23,11,12,0.4782608695652174,0.6012861736334404,gemini,medalign,progress_note,PROMPT2_entailment
42,44,53,52,1,0.981132075471698,92,42,50,0.4565217391304347,0.6231098430813123,gemini,medalign,progress_note,PROMPT2_entailment
43,45,16,15,1,0.9375,15,11,4,0.7333333333333333,0.8229426433915211,gemini,medalign,progress_note,PROMPT2_entailment
44,46,58,57,1,0.9827586206896552,50,29,21,0.58,0.7294792586054721,gemini,medalign,progress_note,PROMPT2_entailment
45,47,82,63,19,0.7682926829268293,42,29,13,0.6904761904761905,0.7273089171974523,gemini,medalign,progress_note,PROMPT2_entailment
46,48,67,65,2,0.9701492537313432,56,42,14,0.75,0.8459869848156183,gemini,medalign,progress_note,PROMPT2_entailment
47,49,88,81,7,0.9204545454545454,58,27,31,0.4655172413793103,0.6183206106870229,gemini,medalign,progress_note,PROMPT2_entailment
48,5,55,52,3,0.9454545454545454,69,28,41,0.4057971014492754,0.5678627145085805,gemini,medalign,progress_note,PROMPT2_entailment
49,50,129,120,9,0.9302325581395348,68,54,14,0.7941176470588235,0.85680285600952,gemini,medalign,progress_note,PROMPT2_entailment
50,51,83,81,2,0.9759036144578314,47,36,11,0.7659574468085106,0.8582781456953643,gemini,medalign,progress_note,PROMPT2_entailment
51,52,20,20,0,1.0,19,10,9,0.5263157894736842,0.6896551724137931,gemini,medalign,progress_note,PROMPT2_entailment
52,53,61,60,1,0.9836065573770492,54,42,12,0.7777777777777778,0.8686659772492243,gemini,medalign,progress_note,PROMPT2_entailment
53,54,28,27,1,0.9642857142857144,24,14,10,0.5833333333333334,0.7269230769230769,gemini,medalign,progress_note,PROMPT2_entailment
54,55,21,19,2,0.9047619047619048,23,14,9,0.6086956521739131,0.7277701778385773,gemini,medalign,progress_note,PROMPT2_entailment
55,56,32,31,1,0.96875,25,15,10,0.6,0.7410358565737051,gemini,medalign,progress_note,PROMPT2_entailment
56,57,7,6,1,0.8571428571428571,4,4,0,1.0,0.923076923076923,gemini,medalign,progress_note,PROMPT2_entailment
57,58,13,13,0,1.0,13,5,8,0.3846153846153846,0.5555555555555556,gemini,medalign,progress_note,PROMPT2_entailment
58,59,39,31,8,0.7948717948717948,35,18,17,0.5142857142857142,0.6245103525461667,gemini,medalign,progress_note,PROMPT2_entailment
59,6,65,61,4,0.9384615384615383,59,40,19,0.6779661016949152,0.7872237457654461,gemini,medalign,progress_note,PROMPT2_entailment
60,60,38,35,3,0.9210526315789472,56,17,39,0.3035714285714285,0.4566385264773598,gemini,medalign,progress_note,PROMPT2_entailment
61,61,15,14,1,0.9333333333333332,25,15,10,0.6,0.7304347826086957,gemini,medalign,progress_note,PROMPT2_entailment
62,62,32,30,2,0.9375,32,20,12,0.625,0.75,gemini,medalign,progress_note,PROMPT2_entailment
63,63,13,12,1,0.9230769230769232,10,6,4,0.6,0.7272727272727274,gemini,medalign,progress_note,PROMPT2_entailment
64,64,104,91,13,0.875,69,53,16,0.7681159420289855,0.8180815876515988,gemini,medalign,progress_note,PROMPT2_entailment
65,65,48,31,17,0.6458333333333334,104,43,61,0.4134615384615384,0.504160363086233,gemini,medalign,progress_note,PROMPT2_entailment
66,66,132,124,8,0.9393939393939394,87,65,22,0.7471264367816092,0.8323007021891781,gemini,medalign,progress_note,PROMPT2_entailment
67,67,28,26,2,0.9285714285714286,18,13,5,0.7222222222222222,0.8125000000000001,gemini,medalign,progress_note,PROMPT2_entailment
68,68,11,9,2,0.8181818181818182,11,6,5,0.5454545454545454,0.6545454545454545,gemini,medalign,progress_note,PROMPT2_entailment
69,69,61,59,2,0.9672131147540984,68,45,23,0.6617647058823529,0.7858517093384638,gemini,medalign,progress_note,PROMPT2_entailment
70,7,56,46,10,0.8214285714285714,37,32,5,0.8648648648648649,0.842587292501431,gemini,medalign,progress_note,PROMPT2_entailment
71,70,67,63,4,0.9402985074626866,69,33,36,0.4782608695652174,0.6340347666971637,gemini,medalign,progress_note,PROMPT2_entailment
72,71,89,76,13,0.8539325842696629,48,38,10,0.7916666666666666,0.8216216216216217,gemini,medalign,progress_note,PROMPT2_entailment
73,72,89,83,6,0.9325842696629212,69,43,26,0.6231884057971014,0.7471216244504919,gemini,medalign,progress_note,PROMPT2_entailment
74,73,114,83,31,0.7280701754385965,90,61,29,0.6777777777777778,0.702024403771492,gemini,medalign,progress_note,PROMPT2_entailment
75,74,24,24,0,1.0,22,17,5,0.7727272727272727,0.8717948717948718,gemini,medalign,progress_note,PROMPT2_entailment
76,75,37,33,4,0.8918918918918919,49,19,30,0.3877551020408163,0.5405172413793103,gemini,medalign,progress_note,PROMPT2_entailment
77,76,137,121,16,0.8832116788321168,77,51,26,0.6623376623376623,0.7569921491658489,gemini,medalign,progress_note,PROMPT2_entailment
78,77,68,59,9,0.8676470588235294,38,30,8,0.7894736842105263,0.8267164876226063,gemini,medalign,progress_note,PROMPT2_entailment
79,78,56,55,1,0.9821428571428572,54,35,19,0.6481481481481481,0.7809330628803246,gemini,medalign,progress_note,PROMPT2_entailment
80,79,78,53,25,0.6794871794871795,64,35,29,0.546875,0.6060111074812153,gemini,medalign,progress_note,PROMPT2_entailment
81,8,36,32,4,0.8888888888888888,31,20,11,0.6451612903225806,0.7476635514018692,gemini,medalign,progress_note,PROMPT2_entailment
82,80,94,75,19,0.7978723404255319,66,35,31,0.5303030303030303,0.6371359223300971,gemini,medalign,progress_note,PROMPT2_entailment
83,81,15,13,2,0.8666666666666667,12,4,8,0.3333333333333333,0.4814814814814814,gemini,medalign,progress_note,PROMPT2_entailment
84,82,14,13,1,0.9285714285714286,13,7,6,0.5384615384615384,0.6816479400749064,gemini,medalign,progress_note,PROMPT2_entailment
85,83,14,13,1,0.9285714285714286,8,6,2,0.75,0.8297872340425532,gemini,medalign,progress_note,PROMPT2_entailment
86,84,22,19,3,0.8636363636363636,23,15,8,0.6521739130434783,0.7431551499348109,gemini,medalign,progress_note,PROMPT2_entailment
87,85,74,72,2,0.972972972972973,63,37,26,0.5873015873015873,0.7324718174319496,gemini,medalign,progress_note,PROMPT2_entailment
88,86,60,54,6,0.9,75,41,34,0.5466666666666666,0.6801843317972349,gemini,medalign,progress_note,PROMPT2_entailment
89,87,90,86,4,0.9555555555555556,87,59,28,0.6781609195402298,0.7933083176985616,gemini,medalign,progress_note,PROMPT2_entailment
90,88,74,56,18,0.7567567567567568,84,68,16,0.8095238095238095,0.7822514379622022,gemini,medalign,progress_note,PROMPT2_entailment
91,89,61,57,4,0.9344262295081968,41,32,9,0.7804878048780488,0.8505479132664956,gemini,medalign,progress_note,PROMPT2_entailment
92,9,94,89,5,0.946808510638298,68,38,30,0.5588235294117647,0.7028262676641729,gemini,medalign,progress_note,PROMPT2_entailment
93,90,23,23,0,1.0,24,16,8,0.6666666666666666,0.8,gemini,medalign,progress_note,PROMPT2_entailment
94,91,44,41,3,0.9318181818181818,45,29,16,0.6444444444444445,0.7619352771547582,gemini,medalign,progress_note,PROMPT2_entailment
95,92,16,14,2,0.875,17,12,5,0.7058823529411765,0.7813953488372093,gemini,medalign,progress_note,PROMPT2_entailment
96,93,18,15,3,0.8333333333333334,25,15,10,0.6,0.6976744186046512,gemini,medalign,progress_note,PROMPT2_entailment
97,94,44,42,2,0.9545454545454546,33,22,11,0.6666666666666666,0.7850467289719627,gemini,medalign,progress_note,PROMPT2_entailment
98,95,67,60,7,0.8955223880597015,41,32,9,0.7804878048780488,0.8340573414422241,gemini,medalign,progress_note,PROMPT2_entailment
99,96,95,93,2,0.9789473684210528,48,33,15,0.6875,0.8077378602447691,gemini,medalign,progress_note,PROMPT2_entailment
100,97,53,47,6,0.8867924528301887,37,30,7,0.8108108108108109,0.8471012316010814,gemini,medalign,progress_note,PROMPT2_entailment
101,98,85,49,36,0.5764705882352941,55,31,24,0.5636363636363636,0.5699812382739211,gemini,medalign,progress_note,PROMPT2_entailment
102,99,122,100,22,0.819672131147541,73,50,23,0.684931506849315,0.7462686567164178,gemini,medalign,progress_note,PROMPT2_entailment
0,0,9,9,0,1.0,9,9,0,1.0,1.0,medlm,coral,pdac,PROMPT1_entailment
1,1,1,0,1,0.0,9,9,0,1.0,0.0,medlm,coral,pdac,PROMPT1_entailment
2,10,13,11,2,0.8461538461538461,11,8,3,0.7272727272727273,0.7822222222222223,medlm,coral,pdac,PROMPT1_entailment
3,100,11,10,1,0.9090909090909092,11,7,4,0.6363636363636364,0.7486631016042781,medlm,coral,pdac,PROMPT1_entailment
4,101,1,0,1,0.0,11,8,3,0.7272727272727273,0.0,medlm,coral,pdac,PROMPT1_entailment
5,102,5,5,0,1.0,27,17,10,0.6296296296296297,0.7727272727272727,medlm,coral,pdac,PROMPT1_entailment
6,103,10,9,1,0.9,15,9,6,0.6,0.7200000000000001,medlm,coral,pdac,PROMPT1_entailment
7,104,9,8,1,0.8888888888888888,12,11,1,0.9166666666666666,0.9025641025641026,medlm,coral,pdac,PROMPT1_entailment
8,105,6,2,4,0.3333333333333333,33,13,20,0.3939393939393939,0.361111111111111,medlm,coral,pdac,PROMPT1_entailment
9,106,1,1,0,1.0,10,10,0,1.0,1.0,medlm,coral,pdac,PROMPT1_entailment
10,107,4,4,0,1.0,10,10,0,1.0,1.0,medlm,coral,pdac,PROMPT1_entailment
11,108,1,1,0,1.0,10,10,0,1.0,1.0,medlm,coral,pdac,PROMPT1_entailment
12,109,28,27,1,0.9642857142857144,34,23,11,0.6764705882352942,0.7951344430217671,medlm,coral,pdac,PROMPT1_entailment
13,11,9,8,1,0.8888888888888888,10,10,0,1.0,0.9411764705882352,medlm,coral,pdac,PROMPT1_entailment
14,110,7,7,0,1.0,4,3,1,0.75,0.8571428571428571,medlm,coral,pdac,PROMPT1_entailment
15,111,10,7,3,0.7,3,3,0,1.0,0.8235294117647058,medlm,coral,pdac,PROMPT1_entailment
16,112,1,1,0,1.0,9,7,2,0.7777777777777778,0.8750000000000001,medlm,coral,pdac,PROMPT1_entailment
17,113,6,6,0,1.0,6,4,2,0.6666666666666666,0.8,medlm,coral,pdac,PROMPT1_entailment
18,114,1,1,0,1.0,9,8,1,0.8888888888888888,0.9411764705882352,medlm,coral,pdac,PROMPT1_entailment
19,115,6,6,0,1.0,7,7,0,1.0,1.0,medlm,coral,pdac,PROMPT1_entailment
20,116,5,5,0,1.0,2,2,0,1.0,1.0,medlm,coral,pdac,PROMPT1_entailment
21,117,1,1,0,1.0,8,4,4,0.5,0.6666666666666666,medlm,coral,pdac,PROMPT1_entailment
22,118,4,4,0,1.0,9,6,3,0.6666666666666666,0.8,medlm,coral,pdac,PROMPT1_entailment
23,119,9,8,1,0.8888888888888888,12,9,3,0.75,0.8135593220338982,medlm,coral,pdac,PROMPT1_entailment
24,12,7,6,1,0.8571428571428571,10,10,0,1.0,0.923076923076923,medlm,coral,pdac,PROMPT1_entailment
25,120,3,2,1,0.6666666666666666,13,10,3,0.7692307692307693,0.7142857142857142,medlm,coral,pdac,PROMPT1_entailment
26,122,1,1,0,1.0,45,25,20,0.5555555555555556,0.7142857142857143,medlm,coral,pdac,PROMPT1_entailment
27,123,10,10,0,1.0,10,8,2,0.8,0.888888888888889,medlm,coral,pdac,PROMPT1_entailment
28,124,4,4,0,1.0,3,3,0,1.0,1.0,medlm,coral,pdac,PROMPT1_entailment
29,125,1,1,0,1.0,8,7,1,0.875,0.9333333333333332,medlm,coral,pdac,PROMPT1_entailment
30,126,11,11,0,1.0,10,9,1,0.9,0.9473684210526316,medlm,coral,pdac,PROMPT1_entailment
31,127,1,1,0,1.0,30,18,12,0.6,0.7499999999999999,medlm,coral,pdac,PROMPT1_entailment
32,128,2,2,0,1.0,35,15,20,0.4285714285714285,0.6,medlm,coral,pdac,PROMPT1_entailment
33,129,1,1,0,1.0,11,10,1,0.9090909090909092,0.9523809523809524,medlm,coral,pdac,PROMPT1_entailment
34,13,9,9,0,1.0,13,11,2,0.8461538461538461,0.9166666666666666,medlm,coral,pdac,PROMPT1_entailment
35,130,15,12,3,0.8,12,7,5,0.5833333333333334,0.674698795180723,medlm,coral,pdac,PROMPT1_entailment
36,131,3,3,0,1.0,12,8,4,0.6666666666666666,0.8,medlm,coral,pdac,PROMPT1_entailment
37,132,1,0,1,0.0,10,9,1,0.9,0.0,medlm,coral,pdac,PROMPT1_entailment
38,133,9,8,1,0.8888888888888888,7,2,5,0.2857142857142857,0.4324324324324324,medlm,coral,pdac,PROMPT1_entailment
39,134,5,5,0,1.0,15,7,8,0.4666666666666667,0.6363636363636364,medlm,coral,pdac,PROMPT1_entailment
40,135,7,5,2,0.7142857142857143,9,9,0,1.0,0.8333333333333333,medlm,coral,pdac,PROMPT1_entailment
41,136,1,1,0,1.0,7,6,1,0.8571428571428571,0.923076923076923,medlm,coral,pdac,PROMPT1_entailment
42,137,1,1,0,1.0,10,6,4,0.6,0.7499999999999999,medlm,coral,pdac,PROMPT1_entailment
43,138,19,13,6,0.6842105263157895,25,13,12,0.52,0.5909090909090909,medlm,coral,pdac,PROMPT1_entailment
44,139,1,1,0,1.0,62,4,58,0.064516129032258,0.1212121212121212,medlm,coral,pdac,PROMPT1_entailment
45,14,9,8,1,0.8888888888888888,10,9,1,0.9,0.8944099378881988,medlm,coral,pdac,PROMPT1_entailment
46,140,11,10,1,0.9090909090909092,8,8,0,1.0,0.9523809523809524,medlm,coral,pdac,PROMPT1_entailment
47,141,12,10,2,0.8333333333333334,11,5,6,0.4545454545454545,0.5882352941176471,medlm,coral,pdac,PROMPT1_entailment
48,142,6,3,3,0.5,11,8,3,0.7272727272727273,0.5925925925925926,medlm,coral,pdac,PROMPT1_entailment
49,143,8,8,0,1.0,9,8,1,0.8888888888888888,0.9411764705882352,medlm,coral,pdac,PROMPT1_entailment
50,144,6,4,2,0.6666666666666666,12,6,6,0.5,0.5714285714285715,medlm,coral,pdac,PROMPT1_entailment
51,145,1,1,0,1.0,10,9,1,0.9,0.9473684210526316,medlm,coral,pdac,PROMPT1_entailment
52,146,1,1,0,1.0,7,5,2,0.7142857142857143,0.8333333333333333,medlm,coral,pdac,PROMPT1_entailment
53,147,5,3,2,0.6,12,9,3,0.75,0.6666666666666665,medlm,coral,pdac,PROMPT1_entailment
54,148,13,10,3,0.7692307692307693,25,16,9,0.64,0.6986899563318777,medlm,coral,pdac,PROMPT1_entailment
55,149,8,7,1,0.875,7,5,2,0.7142857142857143,0.7865168539325842,medlm,coral,pdac,PROMPT1_entailment
56,15,6,6,0,1.0,10,10,0,1.0,1.0,medlm,coral,pdac,PROMPT1_entailment
57,150,12,11,1,0.9166666666666666,8,8,0,1.0,0.9565217391304348,medlm,coral,pdac,PROMPT1_entailment
58,151,10,10,0,1.0,10,10,0,1.0,1.0,medlm,coral,pdac,PROMPT1_entailment
59,152,6,5,1,0.8333333333333334,11,9,2,0.8181818181818182,0.8256880733944955,medlm,coral,pdac,PROMPT1_entailment
60,153,4,3,1,0.75,30,20,10,0.6666666666666666,0.7058823529411765,medlm,coral,pdac,PROMPT1_entailment
61,154,1,1,0,1.0,15,11,4,0.7333333333333333,0.846153846153846,medlm,coral,pdac,PROMPT1_entailment
62,155,3,2,1,0.6666666666666666,47,20,27,0.425531914893617,0.5194805194805194,medlm,coral,pdac,PROMPT1_entailment
63,156,11,9,2,0.8181818181818182,10,8,2,0.8,0.8089887640449439,medlm,coral,pdac,PROMPT1_entailment
64,157,7,4,3,0.5714285714285714,14,8,6,0.5714285714285714,0.5714285714285714,medlm,coral,pdac,PROMPT1_entailment
65,158,6,6,0,1.0,10,5,5,0.5,0.6666666666666666,medlm,coral,pdac,PROMPT1_entailment
66,159,1,1,0,1.0,4,4,0,1.0,1.0,medlm,coral,pdac,PROMPT1_entailment
67,16,24,24,0,1.0,31,25,6,0.8064516129032258,0.8928571428571428,medlm,coral,pdac,PROMPT1_entailment
68,160,9,9,0,1.0,9,8,1,0.8888888888888888,0.9411764705882352,medlm,coral,pdac,PROMPT1_entailment
69,161,10,10,0,1.0,9,8,1,0.8888888888888888,0.9411764705882352,medlm,coral,pdac,PROMPT1_entailment
70,162,7,7,0,1.0,10,10,0,1.0,1.0,medlm,coral,pdac,PROMPT1_entailment
71,164,6,6,0,1.0,36,12,24,0.3333333333333333,0.5,medlm,coral,pdac,PROMPT1_entailment
72,165,8,7,1,0.875,10,5,5,0.5,0.6363636363636364,medlm,coral,pdac,PROMPT1_entailment
73,166,12,10,2,0.8333333333333334,11,8,3,0.7272727272727273,0.7766990291262137,medlm,coral,pdac,PROMPT1_entailment
74,167,1,1,0,1.0,8,6,2,0.75,0.8571428571428571,medlm,coral,pdac,PROMPT1_entailment
75,168,5,3,2,0.6,6,6,0,1.0,0.7499999999999999,medlm,coral,pdac,PROMPT1_entailment
76,169,6,6,0,1.0,7,5,2,0.7142857142857143,0.8333333333333333,medlm,coral,pdac,PROMPT1_entailment
77,17,8,8,0,1.0,5,5,0,1.0,1.0,medlm,coral,pdac,PROMPT1_entailment
78,170,10,9,1,0.9,16,7,9,0.4375,0.588785046728972,medlm,coral,pdac,PROMPT1_entailment
79,171,11,8,3,0.7272727272727273,13,8,5,0.6153846153846154,0.6666666666666667,medlm,coral,pdac,PROMPT1_entailment
80,172,1,1,0,1.0,10,8,2,0.8,0.888888888888889,medlm,coral,pdac,PROMPT1_entailment
81,173,1,1,0,1.0,22,10,12,0.4545454545454545,0.625,medlm,coral,pdac,PROMPT1_entailment
82,174,7,6,1,0.8571428571428571,11,7,4,0.6363636363636364,0.7304347826086957,medlm,coral,pdac,PROMPT1_entailment
83,175,7,2,5,0.2857142857142857,29,21,8,0.7241379310344828,0.4097560975609756,medlm,coral,pdac,PROMPT1_entailment
84,176,4,4,0,1.0,10,10,0,1.0,1.0,medlm,coral,pdac,PROMPT1_entailment
85,177,1,1,0,1.0,10,10,0,1.0,1.0,medlm,coral,pdac,PROMPT1_entailment
86,178,4,3,1,0.75,36,17,19,0.4722222222222222,0.5795454545454545,medlm,coral,pdac,PROMPT1_entailment
87,179,3,3,0,1.0,9,9,0,1.0,1.0,medlm,coral,pdac,PROMPT1_entailment
88,18,1,1,0,1.0,15,14,1,0.9333333333333332,0.9655172413793104,medlm,coral,pdac,PROMPT1_entailment
89,180,1,0,1,0.0,5,5,0,1.0,0.0,medlm,coral,pdac,PROMPT1_entailment
90,181,10,10,0,1.0,10,7,3,0.7,0.8235294117647058,medlm,coral,pdac,PROMPT1_entailment
91,182,10,9,1,0.9,8,4,4,0.5,0.6428571428571429,medlm,coral,pdac,PROMPT1_entailment
92,183,1,0,1,0.0,10,8,2,0.8,0.0,medlm,coral,pdac,PROMPT1_entailment
93,184,6,5,1,0.8333333333333334,9,6,3,0.6666666666666666,0.7407407407407408,medlm,coral,pdac,PROMPT1_entailment
94,185,1,1,0,1.0,22,14,8,0.6363636363636364,0.7777777777777778,medlm,coral,pdac,PROMPT1_entailment
95,187,7,5,2,0.7142857142857143,34,13,21,0.3823529411764705,0.4980842911877394,medlm,coral,pdac,PROMPT1_entailment
96,188,18,17,1,0.9444444444444444,8,7,1,0.875,0.9083969465648856,medlm,coral,pdac,PROMPT1_entailment
97,189,7,6,1,0.8571428571428571,5,5,0,1.0,0.923076923076923,medlm,coral,pdac,PROMPT1_entailment
98,19,11,10,1,0.9090909090909092,21,14,7,0.6666666666666666,0.7692307692307692,medlm,coral,pdac,PROMPT1_entailment
99,190,12,11,1,0.9166666666666666,17,6,11,0.3529411764705882,0.5096525096525097,medlm,coral,pdac,PROMPT1_entailment
100,191,1,0,1,0.0,15,11,4,0.7333333333333333,0.0,medlm,coral,pdac,PROMPT1_entailment
101,192,1,1,0,1.0,12,9,3,0.75,0.8571428571428571,medlm,coral,pdac,PROMPT1_entailment
102,193,8,5,3,0.625,10,10,0,1.0,0.7692307692307693,medlm,coral,pdac,PROMPT1_entailment
103,194,7,7,0,1.0,11,10,1,0.9090909090909092,0.9523809523809524,medlm,coral,pdac,PROMPT1_entailment
104,195,6,4,2,0.6666666666666666,7,7,0,1.0,0.8,medlm,coral,pdac,PROMPT1_entailment
105,196,8,7,1,0.875,8,7,1,0.875,0.875,medlm,coral,pdac,PROMPT1_entailment
106,197,6,6,0,1.0,9,3,6,0.3333333333333333,0.5,medlm,coral,pdac,PROMPT1_entailment
107,198,9,9,0,1.0,12,9,3,0.75,0.8571428571428571,medlm,coral,pdac,PROMPT1_entailment
108,199,1,1,0,1.0,9,5,4,0.5555555555555556,0.7142857142857143,medlm,coral,pdac,PROMPT1_entailment
109,2,7,5,2,0.7142857142857143,14,9,5,0.6428571428571429,0.6766917293233083,medlm,coral,pdac,PROMPT1_entailment
110,20,22,15,7,0.6818181818181818,18,10,8,0.5555555555555556,0.6122448979591836,medlm,coral,pdac,PROMPT1_entailment
111,200,1,1,0,1.0,16,11,5,0.6875,0.8148148148148148,medlm,coral,pdac,PROMPT1_entailment
112,201,1,1,0,1.0,10,10,0,1.0,1.0,medlm,coral,pdac,PROMPT1_entailment
113,202,1,1,0,1.0,10,10,0,1.0,1.0,medlm,coral,pdac,PROMPT1_entailment
114,203,18,11,7,0.6111111111111112,31,20,11,0.6451612903225806,0.6276747503566334,medlm,coral,pdac,PROMPT1_entailment
115,204,14,9,5,0.6428571428571429,14,9,5,0.6428571428571429,0.6428571428571429,medlm,coral,pdac,PROMPT1_entailment
116,205,4,2,2,0.5,7,6,1,0.8571428571428571,0.631578947368421,medlm,coral,pdac,PROMPT1_entailment
117,206,8,5,3,0.625,9,4,5,0.4444444444444444,0.5194805194805195,medlm,coral,pdac,PROMPT1_entailment
118,207,11,10,1,0.9090909090909092,8,4,4,0.5,0.6451612903225806,medlm,coral,pdac,PROMPT1_entailment
119,208,7,6,1,0.8571428571428571,8,7,1,0.875,0.8659793814432989,medlm,coral,pdac,PROMPT1_entailment
120,209,7,5,2,0.7142857142857143,9,9,0,1.0,0.8333333333333333,medlm,coral,pdac,PROMPT1_entailment
121,21,1,1,0,1.0,10,10,0,1.0,1.0,medlm,coral,pdac,PROMPT1_entailment
122,210,4,4,0,1.0,9,5,4,0.5555555555555556,0.7142857142857143,medlm,coral,pdac,PROMPT1_entailment
123,211,7,4,3,0.5714285714285714,8,6,2,0.75,0.6486486486486486,medlm,coral,pdac,PROMPT1_entailment
124,212,1,1,0,1.0,17,15,2,0.8823529411764706,0.9375,medlm,coral,pdac,PROMPT1_entailment
125,213,6,5,1,0.8333333333333334,11,9,2,0.8181818181818182,0.8256880733944955,medlm,coral,pdac,PROMPT1_entailment
126,214,3,3,0,1.0,18,8,10,0.4444444444444444,0.6153846153846153,medlm,coral,pdac,PROMPT1_entailment
127,215,1,0,1,0.0,12,5,7,0.4166666666666667,0.0,medlm,coral,pdac,PROMPT1_entailment
128,216,6,5,1,0.8333333333333334,33,8,25,0.2424242424242424,0.375586854460094,medlm,coral,pdac,PROMPT1_entailment
129,217,1,1,0,1.0,19,15,4,0.7894736842105263,0.8823529411764706,medlm,coral,pdac,PROMPT1_entailment
130,218,10,9,1,0.9,11,7,4,0.6363636363636364,0.7455621301775148,medlm,coral,pdac,PROMPT1_entailment
131,219,4,2,2,0.5,8,4,4,0.5,0.5,medlm,coral,pdac,PROMPT1_entailment
132,22,7,5,2,0.7142857142857143,17,12,5,0.7058823529411765,0.7100591715976332,medlm,coral,pdac,PROMPT1_entailment
133,220,9,7,2,0.7777777777777778,11,9,2,0.8181818181818182,0.7974683544303799,medlm,coral,pdac,PROMPT1_entailment
134,221,8,6,2,0.75,12,10,2,0.8333333333333334,0.7894736842105262,medlm,coral,pdac,PROMPT1_entailment
135,222,12,8,4,0.6666666666666666,11,11,0,1.0,0.8,medlm,coral,pdac,PROMPT1_entailment
136,223,1,0,1,0.0,37,8,29,0.2162162162162162,0.0,medlm,coral,pdac,PROMPT1_entailment
137,224,11,6,5,0.5454545454545454,8,7,1,0.875,0.6719999999999999,medlm,coral,pdac,PROMPT1_entailment
138,225,10,8,2,0.8,13,8,5,0.6153846153846154,0.6956521739130435,medlm,coral,pdac,PROMPT1_entailment
139,226,11,10,1,0.9090909090909092,11,9,2,0.8181818181818182,0.861244019138756,medlm,coral,pdac,PROMPT1_entailment
140,227,4,4,0,1.0,10,6,4,0.6,0.7499999999999999,medlm,coral,pdac,PROMPT1_entailment
141,228,10,9,1,0.9,9,7,2,0.7777777777777778,0.8344370860927153,medlm,coral,pdac,PROMPT1_entailment
142,229,7,7,0,1.0,9,8,1,0.8888888888888888,0.9411764705882352,medlm,coral,pdac,PROMPT1_entailment
143,23,7,4,3,0.5714285714285714,12,8,4,0.6666666666666666,0.6153846153846153,medlm,coral,pdac,PROMPT1_entailment
144,230,1,1,0,1.0,8,8,0,1.0,1.0,medlm,coral,pdac,PROMPT1_entailment
145,24,8,8,0,1.0,9,6,3,0.6666666666666666,0.8,medlm,coral,pdac,PROMPT1_entailment
146,25,6,4,2,0.6666666666666666,11,8,3,0.7272727272727273,0.6956521739130435,medlm,coral,pdac,PROMPT1_entailment
147,26,1,0,1,0.0,11,11,0,1.0,0.0,medlm,coral,pdac,PROMPT1_entailment
148,27,1,0,1,0.0,12,9,3,0.75,0.0,medlm,coral,pdac,PROMPT1_entailment
149,28,1,1,0,1.0,13,10,3,0.7692307692307693,0.8695652173913044,medlm,coral,pdac,PROMPT1_entailment
150,29,1,0,1,0.0,9,8,1,0.8888888888888888,0.0,medlm,coral,pdac,PROMPT1_entailment
151,3,7,7,0,1.0,8,7,1,0.875,0.9333333333333332,medlm,coral,pdac,PROMPT1_entailment
152,30,1,1,0,1.0,11,10,1,0.9090909090909092,0.9523809523809524,medlm,coral,pdac,PROMPT1_entailment
153,31,17,17,0,1.0,11,11,0,1.0,1.0,medlm,coral,pdac,PROMPT1_entailment
154,32,1,1,0,1.0,11,9,2,0.8181818181818182,0.9,medlm,coral,pdac,PROMPT1_entailment
155,33,1,1,0,1.0,24,9,15,0.375,0.5454545454545454,medlm,coral,pdac,PROMPT1_entailment
156,34,5,5,0,1.0,10,10,0,1.0,1.0,medlm,coral,pdac,PROMPT1_entailment
157,35,1,1,0,1.0,10,10,0,1.0,1.0,medlm,coral,pdac,PROMPT1_entailment
158,36,16,15,1,0.9375,44,19,25,0.4318181818181818,0.5912863070539419,medlm,coral,pdac,PROMPT1_entailment
159,37,13,12,1,0.9230769230769232,9,8,1,0.8888888888888888,0.9056603773584906,medlm,coral,pdac,PROMPT1_entailment
160,38,9,7,2,0.7777777777777778,13,7,6,0.5384615384615384,0.6363636363636364,medlm,coral,pdac,PROMPT1_entailment
161,39,1,1,0,1.0,10,9,1,0.9,0.9473684210526316,medlm,coral,pdac,PROMPT1_entailment
162,4,20,13,7,0.65,15,9,6,0.6,0.624,medlm,coral,pdac,PROMPT1_entailment
163,40,3,2,1,0.6666666666666666,10,5,5,0.5,0.5714285714285715,medlm,coral,pdac,PROMPT1_entailment
164,41,6,5,1,0.8333333333333334,8,3,5,0.375,0.5172413793103448,medlm,coral,pdac,PROMPT1_entailment
165,42,16,15,1,0.9375,11,9,2,0.8181818181818182,0.8737864077669902,medlm,coral,pdac,PROMPT1_entailment
166,43,2,2,0,1.0,13,4,9,0.3076923076923077,0.4705882352941176,medlm,coral,pdac,PROMPT1_entailment
167,44,1,1,0,1.0,11,8,3,0.7272727272727273,0.8421052631578948,medlm,coral,pdac,PROMPT1_entailment
168,45,5,4,1,0.8,10,8,2,0.8,0.8000000000000002,medlm,coral,pdac,PROMPT1_entailment
169,46,1,1,0,1.0,11,8,3,0.7272727272727273,0.8421052631578948,medlm,coral,pdac,PROMPT1_entailment
170,47,19,19,0,1.0,39,16,23,0.4102564102564102,0.5818181818181819,medlm,coral,pdac,PROMPT1_entailment
171,48,1,0,1,0.0,10,6,4,0.6,0.0,medlm,coral,pdac,PROMPT1_entailment
172,49,10,9,1,0.9,10,7,3,0.7,0.7875,medlm,coral,pdac,PROMPT1_entailment
173,5,9,9,0,1.0,10,7,3,0.7,0.8235294117647058,medlm,coral,pdac,PROMPT1_entailment
174,50,1,1,0,1.0,10,3,7,0.3,0.4615384615384615,medlm,coral,pdac,PROMPT1_entailment
175,51,9,8,1,0.8888888888888888,12,7,5,0.5833333333333334,0.7044025157232704,medlm,coral,pdac,PROMPT1_entailment
176,52,10,8,2,0.8,10,10,0,1.0,0.888888888888889,medlm,coral,pdac,PROMPT1_entailment
177,53,5,5,0,1.0,8,3,5,0.375,0.5454545454545454,medlm,coral,pdac,PROMPT1_entailment
178,54,2,2,0,1.0,2,2,0,1.0,1.0,medlm,coral,pdac,PROMPT1_entailment
179,55,13,11,2,0.8461538461538461,10,6,4,0.6,0.7021276595744681,medlm,coral,pdac,PROMPT1_entailment
180,56,11,10,1,0.9090909090909092,8,4,4,0.5,0.6451612903225806,medlm,coral,pdac,PROMPT1_entailment
181,57,1,1,0,1.0,13,6,7,0.4615384615384615,0.631578947368421,medlm,coral,pdac,PROMPT1_entailment
182,58,1,1,0,1.0,10,7,3,0.7,0.8235294117647058,medlm,coral,pdac,PROMPT1_entailment
183,59,6,5,1,0.8333333333333334,21,12,9,0.5714285714285714,0.6779661016949152,medlm,coral,pdac,PROMPT1_entailment
184,6,7,5,2,0.7142857142857143,12,8,4,0.6666666666666666,0.689655172413793,medlm,coral,pdac,PROMPT1_entailment
185,60,13,12,1,0.9230769230769232,13,6,7,0.4615384615384615,0.6153846153846155,medlm,coral,pdac,PROMPT1_entailment
186,61,1,1,0,1.0,7,7,0,1.0,1.0,medlm,coral,pdac,PROMPT1_entailment
187,62,7,7,0,1.0,11,10,1,0.9090909090909092,0.9523809523809524,medlm,coral,pdac,PROMPT1_entailment
188,63,5,5,0,1.0,10,10,0,1.0,1.0,medlm,coral,pdac,PROMPT1_entailment
189,64,9,9,0,1.0,12,11,1,0.9166666666666666,0.9565217391304348,medlm,coral,pdac,PROMPT1_entailment
190,65,7,5,2,0.7142857142857143,9,6,3,0.6666666666666666,0.689655172413793,medlm,coral,pdac,PROMPT1_entailment
191,66,1,1,0,1.0,12,10,2,0.8333333333333334,0.9090909090909092,medlm,coral,pdac,PROMPT1_entailment
192,67,3,3,0,1.0,1,1,0,1.0,1.0,medlm,coral,pdac,PROMPT1_entailment
193,68,9,8,1,0.8888888888888888,11,10,1,0.9090909090909092,0.8988764044943819,medlm,coral,pdac,PROMPT1_entailment
194,69,10,9,1,0.9,10,10,0,1.0,0.9473684210526316,medlm,coral,pdac,PROMPT1_entailment
195,7,10,9,1,0.9,11,10,1,0.9090909090909092,0.9045226130653266,medlm,coral,pdac,PROMPT1_entailment
196,70,11,9,2,0.8181818181818182,15,13,2,0.8666666666666667,0.8417266187050358,medlm,coral,pdac,PROMPT1_entailment
197,71,22,15,7,0.6818181818181818,9,7,2,0.7777777777777778,0.726643598615917,medlm,coral,pdac,PROMPT1_entailment
198,72,11,10,1,0.9090909090909092,13,9,4,0.6923076923076923,0.7860262008733625,medlm,coral,pdac,PROMPT1_entailment
199,73,15,2,13,0.1333333333333333,154,2,152,0.0129870129870129,0.0236686390532544,medlm,coral,pdac,PROMPT1_entailment
200,74,6,5,1,0.8333333333333334,8,6,2,0.75,0.7894736842105262,medlm,coral,pdac,PROMPT1_entailment
201,75,8,5,3,0.625,7,6,1,0.8571428571428571,0.7228915662650602,medlm,coral,pdac,PROMPT1_entailment
202,76,5,3,2,0.6,7,6,1,0.8571428571428571,0.7058823529411764,medlm,coral,pdac,PROMPT1_entailment
203,77,15,11,4,0.7333333333333333,8,6,2,0.75,0.7415730337078651,medlm,coral,pdac,PROMPT1_entailment
204,78,9,6,3,0.6666666666666666,8,6,2,0.75,0.7058823529411765,medlm,coral,pdac,PROMPT1_entailment
205,79,5,3,2,0.6,11,5,6,0.4545454545454545,0.5172413793103449,medlm,coral,pdac,PROMPT1_entailment
206,8,9,9,0,1.0,2,2,0,1.0,1.0,medlm,coral,pdac,PROMPT1_entailment
207,80,10,8,2,0.8,9,8,1,0.8888888888888888,0.8421052631578948,medlm,coral,pdac,PROMPT1_entailment
208,81,1,1,0,1.0,6,4,2,0.6666666666666666,0.8,medlm,coral,pdac,PROMPT1_entailment
209,82,15,15,0,1.0,4,3,1,0.75,0.8571428571428571,medlm,coral,pdac,PROMPT1_entailment
210,83,6,3,3,0.5,11,6,5,0.5454545454545454,0.5217391304347826,medlm,coral,pdac,PROMPT1_entailment
211,84,8,4,4,0.5,11,7,4,0.6363636363636364,0.56,medlm,coral,pdac,PROMPT1_entailment
212,85,1,1,0,1.0,35,15,20,0.4285714285714285,0.6,medlm,coral,pdac,PROMPT1_entailment
213,86,1,1,0,1.0,10,8,2,0.8,0.888888888888889,medlm,coral,pdac,PROMPT1_entailment
214,87,1,1,0,1.0,7,4,3,0.5714285714285714,0.7272727272727273,medlm,coral,pdac,PROMPT1_entailment
215,88,8,6,2,0.75,8,6,2,0.75,0.75,medlm,coral,pdac,PROMPT1_entailment
216,89,9,7,2,0.7777777777777778,10,9,1,0.9,0.8344370860927153,medlm,coral,pdac,PROMPT1_entailment
217,9,1,1,0,1.0,12,9,3,0.75,0.8571428571428571,medlm,coral,pdac,PROMPT1_entailment
218,90,1,1,0,1.0,9,8,1,0.8888888888888888,0.9411764705882352,medlm,coral,pdac,PROMPT1_entailment
219,91,11,11,0,1.0,10,9,1,0.9,0.9473684210526316,medlm,coral,pdac,PROMPT1_entailment
220,92,1,1,0,1.0,10,9,1,0.9,0.9473684210526316,medlm,coral,pdac,PROMPT1_entailment
221,93,8,7,1,0.875,9,8,1,0.8888888888888888,0.8818897637795274,medlm,coral,pdac,PROMPT1_entailment
222,94,4,3,1,0.75,7,6,1,0.8571428571428571,0.7999999999999999,medlm,coral,pdac,PROMPT1_entailment
223,95,8,7,1,0.875,8,5,3,0.625,0.7291666666666666,medlm,coral,pdac,PROMPT1_entailment
224,96,5,5,0,1.0,4,4,0,1.0,1.0,medlm,coral,pdac,PROMPT1_entailment
225,97,7,5,2,0.7142857142857143,8,7,1,0.875,0.7865168539325842,medlm,coral,pdac,PROMPT1_entailment
226,98,11,8,3,0.7272727272727273,9,9,0,1.0,0.8421052631578948,medlm,coral,pdac,PROMPT1_entailment
227,99,1,1,0,1.0,9,8,1,0.8888888888888888,0.9411764705882352,medlm,coral,pdac,PROMPT1_entailment
0,0,13,12,1,0.9230769230769232,9,8,1,0.8888888888888888,0.9056603773584906,medlm,coral,pdac,PROMPT1_ICL_entailment
1,1,14,14,0,1.0,9,7,2,0.7777777777777778,0.8750000000000001,medlm,coral,pdac,PROMPT1_ICL_entailment
2,10,11,11,0,1.0,11,7,4,0.6363636363636364,0.7777777777777778,medlm,coral,pdac,PROMPT1_ICL_entailment
3,100,10,10,0,1.0,11,8,3,0.7272727272727273,0.8421052631578948,medlm,coral,pdac,PROMPT1_ICL_entailment
4,101,17,16,1,0.9411764705882352,11,9,2,0.8181818181818182,0.8753799392097266,medlm,coral,pdac,PROMPT1_ICL_entailment
5,102,5,5,0,1.0,27,20,7,0.7407407407407407,0.851063829787234,medlm,coral,pdac,PROMPT1_ICL_entailment
6,103,10,7,3,0.7,15,9,6,0.6,0.6461538461538462,medlm,coral,pdac,PROMPT1_ICL_entailment
7,104,9,8,1,0.8888888888888888,12,12,0,1.0,0.9411764705882352,medlm,coral,pdac,PROMPT1_ICL_entailment
8,105,26,18,8,0.6923076923076923,33,6,27,0.1818181818181818,0.288,medlm,coral,pdac,PROMPT1_ICL_entailment
9,106,12,12,0,1.0,10,10,0,1.0,1.0,medlm,coral,pdac,PROMPT1_ICL_entailment
10,107,4,4,0,1.0,10,10,0,1.0,1.0,medlm,coral,pdac,PROMPT1_ICL_entailment
11,108,13,13,0,1.0,10,10,0,1.0,1.0,medlm,coral,pdac,PROMPT1_ICL_entailment
12,109,19,18,1,0.9473684210526316,34,12,22,0.3529411764705882,0.5142857142857143,medlm,coral,pdac,PROMPT1_ICL_entailment
13,11,11,11,0,1.0,10,10,0,1.0,1.0,medlm,coral,pdac,PROMPT1_ICL_entailment
14,110,9,9,0,1.0,4,4,0,1.0,1.0,medlm,coral,pdac,PROMPT1_ICL_entailment
15,111,9,8,1,0.8888888888888888,3,3,0,1.0,0.9411764705882352,medlm,coral,pdac,PROMPT1_ICL_entailment
16,112,6,2,4,0.3333333333333333,9,6,3,0.6666666666666666,0.4444444444444444,medlm,coral,pdac,PROMPT1_ICL_entailment
17,113,9,8,1,0.8888888888888888,6,3,3,0.5,0.64,medlm,coral,pdac,PROMPT1_ICL_entailment
18,114,11,11,0,1.0,9,9,0,1.0,1.0,medlm,coral,pdac,PROMPT1_ICL_entailment
19,115,14,14,0,1.0,7,7,0,1.0,1.0,medlm,coral,pdac,PROMPT1_ICL_entailment
20,116,6,6,0,1.0,2,2,0,1.0,1.0,medlm,coral,pdac,PROMPT1_ICL_entailment
21,117,9,8,1,0.8888888888888888,8,7,1,0.875,0.8818897637795274,medlm,coral,pdac,PROMPT1_ICL_entailment
22,118,15,14,1,0.9333333333333332,9,9,0,1.0,0.9655172413793104,medlm,coral,pdac,PROMPT1_ICL_entailment
23,119,11,10,1,0.9090909090909092,12,9,3,0.75,0.821917808219178,medlm,coral,pdac,PROMPT1_ICL_entailment
24,12,19,12,7,0.631578947368421,10,9,1,0.9,0.7422680412371133,medlm,coral,pdac,PROMPT1_ICL_entailment
25,120,5,4,1,0.8,13,10,3,0.7692307692307693,0.7843137254901961,medlm,coral,pdac,PROMPT1_ICL_entailment
26,121,20,18,2,0.9,12,11,1,0.9166666666666666,0.908256880733945,medlm,coral,pdac,PROMPT1_ICL_entailment
27,122,11,9,2,0.8181818181818182,45,9,36,0.2,0.3214285714285714,medlm,coral,pdac,PROMPT1_ICL_entailment
28,123,11,11,0,1.0,10,7,3,0.7,0.8235294117647058,medlm,coral,pdac,PROMPT1_ICL_entailment
29,124,6,6,0,1.0,3,3,0,1.0,1.0,medlm,coral,pdac,PROMPT1_ICL_entailment
30,125,11,11,0,1.0,8,8,0,1.0,1.0,medlm,coral,pdac,PROMPT1_ICL_entailment
31,126,15,15,0,1.0,10,10,0,1.0,1.0,medlm,coral,pdac,PROMPT1_ICL_entailment
32,127,21,17,4,0.8095238095238095,30,15,15,0.5,0.6181818181818182,medlm,coral,pdac,PROMPT1_ICL_entailment
33,128,24,22,2,0.9166666666666666,35,23,12,0.6571428571428571,0.7655068078668683,medlm,coral,pdac,PROMPT1_ICL_entailment
34,129,13,13,0,1.0,11,11,0,1.0,1.0,medlm,coral,pdac,PROMPT1_ICL_entailment
35,13,31,11,20,0.3548387096774194,13,10,3,0.7692307692307693,0.4856512141280353,medlm,coral,pdac,PROMPT1_ICL_entailment
36,130,15,14,1,0.9333333333333332,12,8,4,0.6666666666666666,0.7777777777777778,medlm,coral,pdac,PROMPT1_ICL_entailment
37,131,8,5,3,0.625,12,4,8,0.3333333333333333,0.4347826086956521,medlm,coral,pdac,PROMPT1_ICL_entailment
38,132,8,8,0,1.0,10,8,2,0.8,0.888888888888889,medlm,coral,pdac,PROMPT1_ICL_entailment
39,133,11,11,0,1.0,7,7,0,1.0,1.0,medlm,coral,pdac,PROMPT1_ICL_entailment
40,134,10,9,1,0.9,15,7,8,0.4666666666666667,0.6146341463414634,medlm,coral,pdac,PROMPT1_ICL_entailment
41,135,9,7,2,0.7777777777777778,9,9,0,1.0,0.8750000000000001,medlm,coral,pdac,PROMPT1_ICL_entailment
42,136,10,9,1,0.9,7,4,3,0.5714285714285714,0.6990291262135921,medlm,coral,pdac,PROMPT1_ICL_entailment
43,137,8,7,1,0.875,10,7,3,0.7,0.7777777777777777,medlm,coral,pdac,PROMPT1_ICL_entailment
44,138,21,16,5,0.7619047619047619,25,14,11,0.56,0.6455331412103746,medlm,coral,pdac,PROMPT1_ICL_entailment
45,139,11,10,1,0.9090909090909092,62,4,58,0.064516129032258,0.1204819277108433,medlm,coral,pdac,PROMPT1_ICL_entailment
46,14,10,10,0,1.0,10,10,0,1.0,1.0,medlm,coral,pdac,PROMPT1_ICL_entailment
47,140,15,14,1,0.9333333333333332,8,6,2,0.75,0.8316831683168316,medlm,coral,pdac,PROMPT1_ICL_entailment
48,141,13,11,2,0.8461538461538461,11,7,4,0.6363636363636364,0.7264150943396226,medlm,coral,pdac,PROMPT1_ICL_entailment
49,142,8,5,3,0.625,11,7,4,0.6363636363636364,0.6306306306306306,medlm,coral,pdac,PROMPT1_ICL_entailment
50,143,8,8,0,1.0,9,7,2,0.7777777777777778,0.8750000000000001,medlm,coral,pdac,PROMPT1_ICL_entailment
51,144,7,4,3,0.5714285714285714,12,8,4,0.6666666666666666,0.6153846153846153,medlm,coral,pdac,PROMPT1_ICL_entailment
52,145,10,8,2,0.8,10,9,1,0.9,0.8470588235294118,medlm,coral,pdac,PROMPT1_ICL_entailment
53,146,8,6,2,0.75,7,4,3,0.5714285714285714,0.6486486486486486,medlm,coral,pdac,PROMPT1_ICL_entailment
54,147,7,4,3,0.5714285714285714,12,8,4,0.6666666666666666,0.6153846153846153,medlm,coral,pdac,PROMPT1_ICL_entailment
55,148,21,17,4,0.8095238095238095,25,12,13,0.48,0.6026587887740029,medlm,coral,pdac,PROMPT1_ICL_entailment
56,149,7,7,0,1.0,7,6,1,0.8571428571428571,0.923076923076923,medlm,coral,pdac,PROMPT1_ICL_entailment
57,15,10,10,0,1.0,10,10,0,1.0,1.0,medlm,coral,pdac,PROMPT1_ICL_entailment
58,150,12,11,1,0.9166666666666666,8,8,0,1.0,0.9565217391304348,medlm,coral,pdac,PROMPT1_ICL_entailment
59,151,10,9,1,0.9,10,10,0,1.0,0.9473684210526316,medlm,coral,pdac,PROMPT1_ICL_entailment
60,152,16,15,1,0.9375,11,10,1,0.9090909090909092,0.923076923076923,medlm,coral,pdac,PROMPT1_ICL_entailment
61,153,6,6,0,1.0,30,13,17,0.4333333333333333,0.6046511627906976,medlm,coral,pdac,PROMPT1_ICL_entailment
62,154,17,12,5,0.7058823529411765,15,10,5,0.6666666666666666,0.6857142857142857,medlm,coral,pdac,PROMPT1_ICL_entailment
63,155,18,16,2,0.8888888888888888,47,14,33,0.2978723404255319,0.446215139442231,medlm,coral,pdac,PROMPT1_ICL_entailment
64,156,12,11,1,0.9166666666666666,10,8,2,0.8,0.854368932038835,medlm,coral,pdac,PROMPT1_ICL_entailment
65,157,7,4,3,0.5714285714285714,14,8,6,0.5714285714285714,0.5714285714285714,medlm,coral,pdac,PROMPT1_ICL_entailment
66,158,9,7,2,0.7777777777777778,10,7,3,0.7,0.7368421052631577,medlm,coral,pdac,PROMPT1_ICL_entailment
67,159,13,12,1,0.9230769230769232,4,3,1,0.75,0.8275862068965517,medlm,coral,pdac,PROMPT1_ICL_entailment
68,16,27,24,3,0.8888888888888888,31,18,13,0.5806451612903226,0.702439024390244,medlm,coral,pdac,PROMPT1_ICL_entailment
69,160,10,10,0,1.0,9,8,1,0.8888888888888888,0.9411764705882352,medlm,coral,pdac,PROMPT1_ICL_entailment
70,161,11,10,1,0.9090909090909092,9,8,1,0.8888888888888888,0.8988764044943819,medlm,coral,pdac,PROMPT1_ICL_entailment
71,162,15,15,0,1.0,10,9,1,0.9,0.9473684210526316,medlm,coral,pdac,PROMPT1_ICL_entailment
72,163,11,6,5,0.5454545454545454,13,10,3,0.7692307692307693,0.6382978723404256,medlm,coral,pdac,PROMPT1_ICL_entailment
73,164,7,7,0,1.0,36,15,21,0.4166666666666667,0.5882352941176471,medlm,coral,pdac,PROMPT1_ICL_entailment
74,165,7,7,0,1.0,10,4,6,0.4,0.5714285714285715,medlm,coral,pdac,PROMPT1_ICL_entailment
75,166,13,10,3,0.7692307692307693,11,7,4,0.6363636363636364,0.6965174129353234,medlm,coral,pdac,PROMPT1_ICL_entailment
76,167,14,12,2,0.8571428571428571,8,7,1,0.875,0.8659793814432989,medlm,coral,pdac,PROMPT1_ICL_entailment
77,168,9,8,1,0.8888888888888888,6,4,2,0.6666666666666666,0.761904761904762,medlm,coral,pdac,PROMPT1_ICL_entailment
78,169,9,9,0,1.0,7,6,1,0.8571428571428571,0.923076923076923,medlm,coral,pdac,PROMPT1_ICL_entailment
79,17,10,10,0,1.0,5,5,0,1.0,1.0,medlm,coral,pdac,PROMPT1_ICL_entailment
80,170,19,14,5,0.7368421052631579,16,12,4,0.75,0.743362831858407,medlm,coral,pdac,PROMPT1_ICL_entailment
81,171,10,6,4,0.6,13,10,3,0.7692307692307693,0.6741573033707865,medlm,coral,pdac,PROMPT1_ICL_entailment
82,172,7,7,0,1.0,10,10,0,1.0,1.0,medlm,coral,pdac,PROMPT1_ICL_entailment
83,173,6,6,0,1.0,22,10,12,0.4545454545454545,0.625,medlm,coral,pdac,PROMPT1_ICL_entailment
84,174,7,6,1,0.8571428571428571,11,7,4,0.6363636363636364,0.7304347826086957,medlm,coral,pdac,PROMPT1_ICL_entailment
85,175,30,17,13,0.5666666666666667,29,14,15,0.4827586206896552,0.5213581599123768,medlm,coral,pdac,PROMPT1_ICL_entailment
86,176,10,10,0,1.0,10,10,0,1.0,1.0,medlm,coral,pdac,PROMPT1_ICL_entailment
87,177,3,3,0,1.0,10,10,0,1.0,1.0,medlm,coral,pdac,PROMPT1_ICL_entailment
88,178,19,13,6,0.6842105263157895,36,21,15,0.5833333333333334,0.629757785467128,medlm,coral,pdac,PROMPT1_ICL_entailment
89,179,7,7,0,1.0,9,6,3,0.6666666666666666,0.8,medlm,coral,pdac,PROMPT1_ICL_entailment
90,18,9,8,1,0.8888888888888888,15,7,8,0.4666666666666667,0.6120218579234972,medlm,coral,pdac,PROMPT1_ICL_entailment
91,180,6,6,0,1.0,5,4,1,0.8,0.888888888888889,medlm,coral,pdac,PROMPT1_ICL_entailment
92,181,14,13,1,0.9285714285714286,10,8,2,0.8,0.859504132231405,medlm,coral,pdac,PROMPT1_ICL_entailment
93,182,10,9,1,0.9,8,8,0,1.0,0.9473684210526316,medlm,coral,pdac,PROMPT1_ICL_entailment
94,183,10,7,3,0.7,10,6,4,0.6,0.6461538461538462,medlm,coral,pdac,PROMPT1_ICL_entailment
95,184,13,6,7,0.4615384615384615,9,8,1,0.8888888888888888,0.6075949367088607,medlm,coral,pdac,PROMPT1_ICL_entailment
96,185,4,3,1,0.75,22,16,6,0.7272727272727273,0.7384615384615384,medlm,coral,pdac,PROMPT1_ICL_entailment
97,186,15,11,4,0.7333333333333333,32,16,16,0.5,0.5945945945945945,medlm,coral,pdac,PROMPT1_ICL_entailment
98,187,10,9,1,0.9,34,14,20,0.4117647058823529,0.5650224215246638,medlm,coral,pdac,PROMPT1_ICL_entailment
99,188,21,20,1,0.9523809523809524,8,8,0,1.0,0.975609756097561,medlm,coral,pdac,PROMPT1_ICL_entailment
100,189,11,11,0,1.0,5,5,0,1.0,1.0,medlm,coral,pdac,PROMPT1_ICL_entailment
101,19,15,14,1,0.9333333333333332,21,15,6,0.7142857142857143,0.809248554913295,medlm,coral,pdac,PROMPT1_ICL_entailment
102,190,18,17,1,0.9444444444444444,17,6,11,0.3529411764705882,0.5138539042821159,medlm,coral,pdac,PROMPT1_ICL_entailment
103,191,17,12,5,0.7058823529411765,15,15,0,1.0,0.8275862068965517,medlm,coral,pdac,PROMPT1_ICL_entailment
104,192,6,4,2,0.6666666666666666,12,11,1,0.9166666666666666,0.7719298245614035,medlm,coral,pdac,PROMPT1_ICL_entailment
105,193,10,9,1,0.9,10,9,1,0.9,0.9,medlm,coral,pdac,PROMPT1_ICL_entailment
106,194,10,9,1,0.9,11,10,1,0.9090909090909092,0.9045226130653266,medlm,coral,pdac,PROMPT1_ICL_entailment
107,195,7,4,3,0.5714285714285714,7,6,1,0.8571428571428571,0.6857142857142857,medlm,coral,pdac,PROMPT1_ICL_entailment
108,196,9,7,2,0.7777777777777778,8,7,1,0.875,0.823529411764706,medlm,coral,pdac,PROMPT1_ICL_entailment
109,197,7,6,1,0.8571428571428571,9,8,1,0.8888888888888888,0.8727272727272727,medlm,coral,pdac,PROMPT1_ICL_entailment
110,198,9,9,0,1.0,12,7,5,0.5833333333333334,0.7368421052631579,medlm,coral,pdac,PROMPT1_ICL_entailment
111,199,9,8,1,0.8888888888888888,9,9,0,1.0,0.9411764705882352,medlm,coral,pdac,PROMPT1_ICL_entailment
112,2,9,6,3,0.6666666666666666,14,8,6,0.5714285714285714,0.6153846153846153,medlm,coral,pdac,PROMPT1_ICL_entailment
113,20,25,17,8,0.68,18,12,6,0.6666666666666666,0.6732673267326733,medlm,coral,pdac,PROMPT1_ICL_entailment
114,200,14,14,0,1.0,16,11,5,0.6875,0.8148148148148148,medlm,coral,pdac,PROMPT1_ICL_entailment
115,201,10,10,0,1.0,10,10,0,1.0,1.0,medlm,coral,pdac,PROMPT1_ICL_entailment
116,202,10,10,0,1.0,10,10,0,1.0,1.0,medlm,coral,pdac,PROMPT1_ICL_entailment
117,203,18,13,5,0.7222222222222222,31,22,9,0.7096774193548387,0.7158948685857323,medlm,coral,pdac,PROMPT1_ICL_entailment
118,204,15,13,2,0.8666666666666667,14,9,5,0.6428571428571429,0.7381703470031546,medlm,coral,pdac,PROMPT1_ICL_entailment
119,205,9,7,2,0.7777777777777778,7,7,0,1.0,0.8750000000000001,medlm,coral,pdac,PROMPT1_ICL_entailment
120,206,11,10,1,0.9090909090909092,9,4,5,0.4444444444444444,0.5970149253731343,medlm,coral,pdac,PROMPT1_ICL_entailment
121,207,12,10,2,0.8333333333333334,8,7,1,0.875,0.8536585365853658,medlm,coral,pdac,PROMPT1_ICL_entailment
122,208,7,6,1,0.8571428571428571,8,7,1,0.875,0.8659793814432989,medlm,coral,pdac,PROMPT1_ICL_entailment
123,209,6,5,1,0.8333333333333334,9,5,4,0.5555555555555556,0.6666666666666667,medlm,coral,pdac,PROMPT1_ICL_entailment
124,21,10,10,0,1.0,10,10,0,1.0,1.0,medlm,coral,pdac,PROMPT1_ICL_entailment
125,210,15,11,4,0.7333333333333333,9,8,1,0.8888888888888888,0.8036529680365296,medlm,coral,pdac,PROMPT1_ICL_entailment
126,211,9,7,2,0.7777777777777778,8,5,3,0.625,0.6930693069306931,medlm,coral,pdac,PROMPT1_ICL_entailment
127,212,12,12,0,1.0,17,16,1,0.9411764705882352,0.9696969696969696,medlm,coral,pdac,PROMPT1_ICL_entailment
128,213,13,12,1,0.9230769230769232,11,9,2,0.8181818181818182,0.8674698795180724,medlm,coral,pdac,PROMPT1_ICL_entailment
129,214,10,9,1,0.9,18,8,10,0.4444444444444444,0.5950413223140495,medlm,coral,pdac,PROMPT1_ICL_entailment
130,215,11,8,3,0.7272727272727273,12,6,6,0.5,0.5925925925925926,medlm,coral,pdac,PROMPT1_ICL_entailment
131,216,6,5,1,0.8333333333333334,33,11,22,0.3333333333333333,0.4761904761904761,medlm,coral,pdac,PROMPT1_ICL_entailment
132,217,24,24,0,1.0,19,15,4,0.7894736842105263,0.8823529411764706,medlm,coral,pdac,PROMPT1_ICL_entailment
133,218,10,10,0,1.0,11,9,2,0.8181818181818182,0.9,medlm,coral,pdac,PROMPT1_ICL_entailment
134,219,11,9,2,0.8181818181818182,8,8,0,1.0,0.9,medlm,coral,pdac,PROMPT1_ICL_entailment
135,22,7,4,3,0.5714285714285714,17,9,8,0.5294117647058824,0.5496183206106869,medlm,coral,pdac,PROMPT1_ICL_entailment
136,220,10,8,2,0.8,11,8,3,0.7272727272727273,0.761904761904762,medlm,coral,pdac,PROMPT1_ICL_entailment
137,221,10,8,2,0.8,12,8,4,0.6666666666666666,0.7272727272727272,medlm,coral,pdac,PROMPT1_ICL_entailment
138,222,11,8,3,0.7272727272727273,11,11,0,1.0,0.8421052631578948,medlm,coral,pdac,PROMPT1_ICL_entailment
139,223,20,15,5,0.75,37,11,26,0.2972972972972973,0.4258064516129032,medlm,coral,pdac,PROMPT1_ICL_entailment
140,224,12,7,5,0.5833333333333334,8,6,2,0.75,0.6562499999999999,medlm,coral,pdac,PROMPT1_ICL_entailment
141,225,16,15,1,0.9375,13,8,5,0.6153846153846154,0.7430340557275542,medlm,coral,pdac,PROMPT1_ICL_entailment
142,226,11,10,1,0.9090909090909092,11,8,3,0.7272727272727273,0.8080808080808082,medlm,coral,pdac,PROMPT1_ICL_entailment
143,227,6,5,1,0.8333333333333334,10,7,3,0.7,0.7608695652173915,medlm,coral,pdac,PROMPT1_ICL_entailment
144,228,10,9,1,0.9,9,8,1,0.8888888888888888,0.8944099378881988,medlm,coral,pdac,PROMPT1_ICL_entailment
145,229,15,15,0,1.0,9,8,1,0.8888888888888888,0.9411764705882352,medlm,coral,pdac,PROMPT1_ICL_entailment
146,23,13,12,1,0.9230769230769232,12,8,4,0.6666666666666666,0.7741935483870968,medlm,coral,pdac,PROMPT1_ICL_entailment
147,230,12,12,0,1.0,8,8,0,1.0,1.0,medlm,coral,pdac,PROMPT1_ICL_entailment
148,24,10,10,0,1.0,9,7,2,0.7777777777777778,0.8750000000000001,medlm,coral,pdac,PROMPT1_ICL_entailment
149,25,10,8,2,0.8,11,6,5,0.5454545454545454,0.6486486486486486,medlm,coral,pdac,PROMPT1_ICL_entailment
150,26,14,14,0,1.0,11,11,0,1.0,1.0,medlm,coral,pdac,PROMPT1_ICL_entailment
151,27,16,14,2,0.875,12,11,1,0.9166666666666666,0.8953488372093024,medlm,coral,pdac,PROMPT1_ICL_entailment
152,28,12,10,2,0.8333333333333334,13,13,0,1.0,0.9090909090909092,medlm,coral,pdac,PROMPT1_ICL_entailment
153,29,7,5,2,0.7142857142857143,9,8,1,0.8888888888888888,0.792079207920792,medlm,coral,pdac,PROMPT1_ICL_entailment
154,3,9,8,1,0.8888888888888888,8,7,1,0.875,0.8818897637795274,medlm,coral,pdac,PROMPT1_ICL_entailment
155,30,18,17,1,0.9444444444444444,11,11,0,1.0,0.9714285714285714,medlm,coral,pdac,PROMPT1_ICL_entailment
156,31,20,19,1,0.95,11,11,0,1.0,0.9743589743589745,medlm,coral,pdac,PROMPT1_ICL_entailment
157,32,11,10,1,0.9090909090909092,11,6,5,0.5454545454545454,0.6818181818181818,medlm,coral,pdac,PROMPT1_ICL_entailment
158,33,15,7,8,0.4666666666666667,24,8,16,0.3333333333333333,0.3888888888888889,medlm,coral,pdac,PROMPT1_ICL_entailment
159,34,11,11,0,1.0,10,10,0,1.0,1.0,medlm,coral,pdac,PROMPT1_ICL_entailment
160,35,4,4,0,1.0,10,10,0,1.0,1.0,medlm,coral,pdac,PROMPT1_ICL_entailment
161,36,20,19,1,0.95,44,17,27,0.3863636363636363,0.5493197278911564,medlm,coral,pdac,PROMPT1_ICL_entailment
162,37,6,6,0,1.0,9,6,3,0.6666666666666666,0.8,medlm,coral,pdac,PROMPT1_ICL_entailment
163,38,9,7,2,0.7777777777777778,13,7,6,0.5384615384615384,0.6363636363636364,medlm,coral,pdac,PROMPT1_ICL_entailment
164,39,10,9,1,0.9,10,7,3,0.7,0.7875,medlm,coral,pdac,PROMPT1_ICL_entailment
165,4,14,12,2,0.8571428571428571,15,7,8,0.4666666666666667,0.60431654676259,medlm,coral,pdac,PROMPT1_ICL_entailment
166,40,2,1,1,0.5,10,5,5,0.5,0.5,medlm,coral,pdac,PROMPT1_ICL_entailment
167,41,6,6,0,1.0,8,4,4,0.5,0.6666666666666666,medlm,coral,pdac,PROMPT1_ICL_entailment
168,42,21,19,2,0.9047619047619048,11,10,1,0.9090909090909092,0.9069212410501194,medlm,coral,pdac,PROMPT1_ICL_entailment
169,43,18,16,2,0.8888888888888888,13,9,4,0.6923076923076923,0.7783783783783783,medlm,coral,pdac,PROMPT1_ICL_entailment
170,44,12,12,0,1.0,11,9,2,0.8181818181818182,0.9,medlm,coral,pdac,PROMPT1_ICL_entailment
171,45,14,10,4,0.7142857142857143,10,7,3,0.7,0.7070707070707072,medlm,coral,pdac,PROMPT1_ICL_entailment
172,46,16,11,5,0.6875,11,8,3,0.7272727272727273,0.7068273092369478,medlm,coral,pdac,PROMPT1_ICL_entailment
173,47,30,24,6,0.8,39,27,12,0.6923076923076923,0.7422680412371134,medlm,coral,pdac,PROMPT1_ICL_entailment
174,48,6,4,2,0.6666666666666666,10,7,3,0.7,0.6829268292682926,medlm,coral,pdac,PROMPT1_ICL_entailment
175,49,14,14,0,1.0,10,9,1,0.9,0.9473684210526316,medlm,coral,pdac,PROMPT1_ICL_entailment
176,5,8,8,0,1.0,10,7,3,0.7,0.8235294117647058,medlm,coral,pdac,PROMPT1_ICL_entailment
177,50,9,8,1,0.8888888888888888,10,7,3,0.7,0.7832167832167831,medlm,coral,pdac,PROMPT1_ICL_entailment
178,51,13,10,3,0.7692307692307693,12,12,0,1.0,0.8695652173913044,medlm,coral,pdac,PROMPT1_ICL_entailment
179,52,10,9,1,0.9,10,10,0,1.0,0.9473684210526316,medlm,coral,pdac,PROMPT1_ICL_entailment
180,53,5,4,1,0.8,8,6,2,0.75,0.7741935483870969,medlm,coral,pdac,PROMPT1_ICL_entailment
181,54,6,6,0,1.0,2,2,0,1.0,1.0,medlm,coral,pdac,PROMPT1_ICL_entailment
182,55,13,11,2,0.8461538461538461,10,8,2,0.8,0.8224299065420562,medlm,coral,pdac,PROMPT1_ICL_entailment
183,56,13,11,2,0.8461538461538461,8,5,3,0.625,0.7189542483660131,medlm,coral,pdac,PROMPT1_ICL_entailment
184,57,25,20,5,0.8,13,9,4,0.6923076923076923,0.7422680412371134,medlm,coral,pdac,PROMPT1_ICL_entailment
185,58,12,11,1,0.9166666666666666,10,10,0,1.0,0.9565217391304348,medlm,coral,pdac,PROMPT1_ICL_entailment
186,59,9,7,2,0.7777777777777778,21,16,5,0.7619047619047619,0.7697594501718213,medlm,coral,pdac,PROMPT1_ICL_entailment
187,6,7,6,1,0.8571428571428571,12,8,4,0.6666666666666666,0.75,medlm,coral,pdac,PROMPT1_ICL_entailment
188,60,13,11,2,0.8461538461538461,13,3,10,0.2307692307692307,0.3626373626373626,medlm,coral,pdac,PROMPT1_ICL_entailment
189,61,10,10,0,1.0,7,5,2,0.7142857142857143,0.8333333333333333,medlm,coral,pdac,PROMPT1_ICL_entailment
190,62,11,10,1,0.9090909090909092,11,11,0,1.0,0.9523809523809524,medlm,coral,pdac,PROMPT1_ICL_entailment
191,63,10,10,0,1.0,10,10,0,1.0,1.0,medlm,coral,pdac,PROMPT1_ICL_entailment
192,64,13,13,0,1.0,12,11,1,0.9166666666666666,0.9565217391304348,medlm,coral,pdac,PROMPT1_ICL_entailment
193,65,7,6,1,0.8571428571428571,9,7,2,0.7777777777777778,0.8155339805825242,medlm,coral,pdac,PROMPT1_ICL_entailment
194,66,13,13,0,1.0,12,10,2,0.8333333333333334,0.9090909090909092,medlm,coral,pdac,PROMPT1_ICL_entailment
195,67,5,5,0,1.0,1,1,0,1.0,1.0,medlm,coral,pdac,PROMPT1_ICL_entailment
196,68,15,13,2,0.8666666666666667,11,9,2,0.8181818181818182,0.8417266187050358,medlm,coral,pdac,PROMPT1_ICL_entailment
197,69,8,7,1,0.875,10,9,1,0.9,0.8873239436619719,medlm,coral,pdac,PROMPT1_ICL_entailment
198,7,10,9,1,0.9,11,8,3,0.7272727272727273,0.8044692737430167,medlm,coral,pdac,PROMPT1_ICL_entailment
199,70,8,6,2,0.75,15,13,2,0.8666666666666667,0.8041237113402062,medlm,coral,pdac,PROMPT1_ICL_entailment
200,71,21,14,7,0.6666666666666666,9,6,3,0.6666666666666666,0.6666666666666666,medlm,coral,pdac,PROMPT1_ICL_entailment
201,72,9,7,2,0.7777777777777778,13,6,7,0.4615384615384615,0.5793103448275861,medlm,coral,pdac,PROMPT1_ICL_entailment
202,73,13,0,13,0.0,154,38,116,0.2467532467532467,0.0,medlm,coral,pdac,PROMPT1_ICL_entailment
203,74,19,12,7,0.631578947368421,8,8,0,1.0,0.7741935483870968,medlm,coral,pdac,PROMPT1_ICL_entailment
204,75,10,10,0,1.0,7,7,0,1.0,1.0,medlm,coral,pdac,PROMPT1_ICL_entailment
205,76,8,8,0,1.0,7,7,0,1.0,1.0,medlm,coral,pdac,PROMPT1_ICL_entailment
206,77,16,12,4,0.75,8,7,1,0.875,0.8076923076923077,medlm,coral,pdac,PROMPT1_ICL_entailment
207,78,7,4,3,0.5714285714285714,8,6,2,0.75,0.6486486486486486,medlm,coral,pdac,PROMPT1_ICL_entailment
208,79,9,8,1,0.8888888888888888,11,8,3,0.7272727272727273,0.7999999999999999,medlm,coral,pdac,PROMPT1_ICL_entailment
209,8,9,9,0,1.0,2,2,0,1.0,1.0,medlm,coral,pdac,PROMPT1_ICL_entailment
210,80,11,10,1,0.9090909090909092,9,9,0,1.0,0.9523809523809524,medlm,coral,pdac,PROMPT1_ICL_entailment
211,81,11,10,1,0.9090909090909092,6,5,1,0.8333333333333334,0.8695652173913043,medlm,coral,pdac,PROMPT1_ICL_entailment
212,82,18,18,0,1.0,4,3,1,0.75,0.8571428571428571,medlm,coral,pdac,PROMPT1_ICL_entailment
213,83,12,11,1,0.9166666666666666,11,7,4,0.6363636363636364,0.7512195121951218,medlm,coral,pdac,PROMPT1_ICL_entailment
214,84,8,4,4,0.5,11,7,4,0.6363636363636364,0.56,medlm,coral,pdac,PROMPT1_ICL_entailment
215,85,21,18,3,0.8571428571428571,35,24,11,0.6857142857142857,0.7619047619047619,medlm,coral,pdac,PROMPT1_ICL_entailment
216,86,10,10,0,1.0,10,6,4,0.6,0.7499999999999999,medlm,coral,pdac,PROMPT1_ICL_entailment
217,87,17,15,2,0.8823529411764706,7,6,1,0.8571428571428571,0.8695652173913043,medlm,coral,pdac,PROMPT1_ICL_entailment
218,88,9,8,1,0.8888888888888888,8,5,3,0.625,0.7339449541284404,medlm,coral,pdac,PROMPT1_ICL_entailment
219,89,9,8,1,0.8888888888888888,10,9,1,0.9,0.8944099378881988,medlm,coral,pdac,PROMPT1_ICL_entailment
220,9,10,10,0,1.0,12,10,2,0.8333333333333334,0.9090909090909092,medlm,coral,pdac,PROMPT1_ICL_entailment
221,90,9,4,5,0.4444444444444444,9,7,2,0.7777777777777778,0.5656565656565655,medlm,coral,pdac,PROMPT1_ICL_entailment
222,91,15,14,1,0.9333333333333332,10,8,2,0.8,0.8615384615384616,medlm,coral,pdac,PROMPT1_ICL_entailment
223,92,10,7,3,0.7,10,8,2,0.8,0.7466666666666666,medlm,coral,pdac,PROMPT1_ICL_entailment
224,93,8,7,1,0.875,9,9,0,1.0,0.9333333333333332,medlm,coral,pdac,PROMPT1_ICL_entailment
225,94,11,9,2,0.8181818181818182,7,7,0,1.0,0.9,medlm,coral,pdac,PROMPT1_ICL_entailment
226,95,8,7,1,0.875,8,5,3,0.625,0.7291666666666666,medlm,coral,pdac,PROMPT1_ICL_entailment
227,96,8,8,0,1.0,4,4,0,1.0,1.0,medlm,coral,pdac,PROMPT1_ICL_entailment
228,97,10,8,2,0.8,8,8,0,1.0,0.888888888888889,medlm,coral,pdac,PROMPT1_ICL_entailment
229,98,16,14,2,0.875,9,9,0,1.0,0.9333333333333332,medlm,coral,pdac,PROMPT1_ICL_entailment
230,99,9,7,2,0.7777777777777778,9,8,1,0.8888888888888888,0.8296296296296296,medlm,coral,pdac,PROMPT1_ICL_entailment
0,0,11,11,0,1.0,9,9,0,1.0,1.0,medlm,coral,pdac,PROMPT2_ICL_entailment
1,1,14,14,0,1.0,9,7,2,0.7777777777777778,0.8750000000000001,medlm,coral,pdac,PROMPT2_ICL_entailment
2,10,15,14,1,0.9333333333333332,11,11,0,1.0,0.9655172413793104,medlm,coral,pdac,PROMPT2_ICL_entailment
3,100,12,12,0,1.0,11,11,0,1.0,1.0,medlm,coral,pdac,PROMPT2_ICL_entailment
4,101,17,16,1,0.9411764705882352,11,10,1,0.9090909090909092,0.92485549132948,medlm,coral,pdac,PROMPT2_ICL_entailment
5,102,23,23,0,1.0,27,14,13,0.5185185185185185,0.6829268292682926,medlm,coral,pdac,PROMPT2_ICL_entailment
6,103,10,7,3,0.7,15,8,7,0.5333333333333333,0.6054054054054053,medlm,coral,pdac,PROMPT2_ICL_entailment
7,104,9,8,1,0.8888888888888888,12,12,0,1.0,0.9411764705882352,medlm,coral,pdac,PROMPT2_ICL_entailment
8,105,30,19,11,0.6333333333333333,33,15,18,0.4545454545454545,0.5292479108635096,medlm,coral,pdac,PROMPT2_ICL_entailment
9,106,14,14,0,1.0,10,10,0,1.0,1.0,medlm,coral,pdac,PROMPT2_ICL_entailment
10,107,10,10,0,1.0,10,10,0,1.0,1.0,medlm,coral,pdac,PROMPT2_ICL_entailment
11,108,13,13,0,1.0,10,10,0,1.0,1.0,medlm,coral,pdac,PROMPT2_ICL_entailment
12,109,19,18,1,0.9473684210526316,34,13,21,0.3823529411764705,0.5448195576251456,medlm,coral,pdac,PROMPT2_ICL_entailment
13,11,18,16,2,0.8888888888888888,10,7,3,0.7,0.7832167832167831,medlm,coral,pdac,PROMPT2_ICL_entailment
14,110,9,9,0,1.0,4,4,0,1.0,1.0,medlm,coral,pdac,PROMPT2_ICL_entailment
15,111,9,8,1,0.8888888888888888,3,3,0,1.0,0.9411764705882352,medlm,coral,pdac,PROMPT2_ICL_entailment
16,112,6,2,4,0.3333333333333333,9,7,2,0.7777777777777778,0.4666666666666666,medlm,coral,pdac,PROMPT2_ICL_entailment
17,113,14,13,1,0.9285714285714286,6,6,0,1.0,0.962962962962963,medlm,coral,pdac,PROMPT2_ICL_entailment
18,114,12,11,1,0.9166666666666666,9,9,0,1.0,0.9565217391304348,medlm,coral,pdac,PROMPT2_ICL_entailment
19,115,15,15,0,1.0,7,7,0,1.0,1.0,medlm,coral,pdac,PROMPT2_ICL_entailment
20,116,5,5,0,1.0,2,2,0,1.0,1.0,medlm,coral,pdac,PROMPT2_ICL_entailment
21,117,9,8,1,0.8888888888888888,8,5,3,0.625,0.7339449541284404,medlm,coral,pdac,PROMPT2_ICL_entailment
22,118,18,18,0,1.0,9,9,0,1.0,1.0,medlm,coral,pdac,PROMPT2_ICL_entailment
23,119,13,11,2,0.8461538461538461,12,10,2,0.8333333333333334,0.8396946564885497,medlm,coral,pdac,PROMPT2_ICL_entailment
24,12,19,17,2,0.8947368421052632,10,10,0,1.0,0.9444444444444444,medlm,coral,pdac,PROMPT2_ICL_entailment
25,120,12,10,2,0.8333333333333334,13,9,4,0.6923076923076923,0.7563025210084034,medlm,coral,pdac,PROMPT2_ICL_entailment
26,121,27,24,3,0.8888888888888888,12,10,2,0.8333333333333334,0.8602150537634408,medlm,coral,pdac,PROMPT2_ICL_entailment
27,122,24,16,8,0.6666666666666666,45,23,22,0.5111111111111111,0.5786163522012578,medlm,coral,pdac,PROMPT2_ICL_entailment
28,123,11,10,1,0.9090909090909092,10,8,2,0.8,0.8510638297872342,medlm,coral,pdac,PROMPT2_ICL_entailment
29,124,6,6,0,1.0,3,3,0,1.0,1.0,medlm,coral,pdac,PROMPT2_ICL_entailment
30,125,11,11,0,1.0,8,7,1,0.875,0.9333333333333332,medlm,coral,pdac,PROMPT2_ICL_entailment
31,126,16,16,0,1.0,10,9,1,0.9,0.9473684210526316,medlm,coral,pdac,PROMPT2_ICL_entailment
32,127,27,26,1,0.9629629629629628,30,10,20,0.3333333333333333,0.4952380952380952,medlm,coral,pdac,PROMPT2_ICL_entailment
33,128,25,15,10,0.6,35,9,26,0.2571428571428571,0.36,medlm,coral,pdac,PROMPT2_ICL_entailment
34,129,13,13,0,1.0,11,10,1,0.9090909090909092,0.9523809523809524,medlm,coral,pdac,PROMPT2_ICL_entailment
35,13,18,17,1,0.9444444444444444,13,8,5,0.6153846153846154,0.7452054794520548,medlm,coral,pdac,PROMPT2_ICL_entailment
36,130,15,14,1,0.9333333333333332,12,8,4,0.6666666666666666,0.7777777777777778,medlm,coral,pdac,PROMPT2_ICL_entailment
37,131,7,6,1,0.8571428571428571,12,5,7,0.4166666666666667,0.5607476635514019,medlm,coral,pdac,PROMPT2_ICL_entailment
38,132,11,11,0,1.0,10,8,2,0.8,0.888888888888889,medlm,coral,pdac,PROMPT2_ICL_entailment
39,133,12,12,0,1.0,7,7,0,1.0,1.0,medlm,coral,pdac,PROMPT2_ICL_entailment
40,134,21,21,0,1.0,15,7,8,0.4666666666666667,0.6363636363636364,medlm,coral,pdac,PROMPT2_ICL_entailment
41,135,9,8,1,0.8888888888888888,9,7,2,0.7777777777777778,0.8296296296296296,medlm,coral,pdac,PROMPT2_ICL_entailment
42,136,17,12,5,0.7058823529411765,7,2,5,0.2857142857142857,0.4067796610169491,medlm,coral,pdac,PROMPT2_ICL_entailment
43,137,9,8,1,0.8888888888888888,10,6,4,0.6,0.7164179104477612,medlm,coral,pdac,PROMPT2_ICL_entailment
44,138,10,9,1,0.9,25,11,14,0.44,0.591044776119403,medlm,coral,pdac,PROMPT2_ICL_entailment
45,139,12,3,9,0.25,62,1,61,0.0161290322580645,0.0303030303030303,medlm,coral,pdac,PROMPT2_ICL_entailment
46,14,11,11,0,1.0,10,10,0,1.0,1.0,medlm,coral,pdac,PROMPT2_ICL_entailment
47,140,13,12,1,0.9230769230769232,8,7,1,0.875,0.8983957219251337,medlm,coral,pdac,PROMPT2_ICL_entailment
48,141,13,11,2,0.8461538461538461,11,7,4,0.6363636363636364,0.7264150943396226,medlm,coral,pdac,PROMPT2_ICL_entailment
49,142,11,7,4,0.6363636363636364,11,8,3,0.7272727272727273,0.6787878787878787,medlm,coral,pdac,PROMPT2_ICL_entailment
50,143,8,8,0,1.0,9,8,1,0.8888888888888888,0.9411764705882352,medlm,coral,pdac,PROMPT2_ICL_entailment
51,144,6,3,3,0.5,12,6,6,0.5,0.5,medlm,coral,pdac,PROMPT2_ICL_entailment
52,145,11,10,1,0.9090909090909092,10,8,2,0.8,0.8510638297872342,medlm,coral,pdac,PROMPT2_ICL_entailment
53,146,6,5,1,0.8333333333333334,7,3,4,0.4285714285714285,0.5660377358490566,medlm,coral,pdac,PROMPT2_ICL_entailment
54,147,7,4,3,0.5714285714285714,12,8,4,0.6666666666666666,0.6153846153846153,medlm,coral,pdac,PROMPT2_ICL_entailment
55,148,26,22,4,0.8461538461538461,25,14,11,0.56,0.673960612691466,medlm,coral,pdac,PROMPT2_ICL_entailment
56,149,6,6,0,1.0,7,4,3,0.5714285714285714,0.7272727272727273,medlm,coral,pdac,PROMPT2_ICL_entailment
57,15,10,10,0,1.0,10,10,0,1.0,1.0,medlm,coral,pdac,PROMPT2_ICL_entailment
58,150,13,12,1,0.9230769230769232,8,8,0,1.0,0.96,medlm,coral,pdac,PROMPT2_ICL_entailment
59,151,13,13,0,1.0,10,9,1,0.9,0.9473684210526316,medlm,coral,pdac,PROMPT2_ICL_entailment
60,152,19,19,0,1.0,11,10,1,0.9090909090909092,0.9523809523809524,medlm,coral,pdac,PROMPT2_ICL_entailment
61,153,30,16,14,0.5333333333333333,30,12,18,0.4,0.4571428571428572,medlm,coral,pdac,PROMPT2_ICL_entailment
62,154,17,12,5,0.7058823529411765,15,10,5,0.6666666666666666,0.6857142857142857,medlm,coral,pdac,PROMPT2_ICL_entailment
63,155,18,18,0,1.0,47,17,30,0.3617021276595745,0.53125,medlm,coral,pdac,PROMPT2_ICL_entailment
64,156,13,12,1,0.9230769230769232,10,6,4,0.6,0.7272727272727274,medlm,coral,pdac,PROMPT2_ICL_entailment
65,157,10,8,2,0.8,14,8,6,0.5714285714285714,0.6666666666666666,medlm,coral,pdac,PROMPT2_ICL_entailment
66,158,7,7,0,1.0,10,8,2,0.8,0.888888888888889,medlm,coral,pdac,PROMPT2_ICL_entailment
67,159,12,12,0,1.0,4,4,0,1.0,1.0,medlm,coral,pdac,PROMPT2_ICL_entailment
68,16,9,2,7,0.2222222222222222,31,11,20,0.3548387096774194,0.2732919254658384,medlm,coral,pdac,PROMPT2_ICL_entailment
69,160,10,10,0,1.0,9,7,2,0.7777777777777778,0.8750000000000001,medlm,coral,pdac,PROMPT2_ICL_entailment
70,161,14,14,0,1.0,9,8,1,0.8888888888888888,0.9411764705882352,medlm,coral,pdac,PROMPT2_ICL_entailment
71,162,11,11,0,1.0,10,9,1,0.9,0.9473684210526316,medlm,coral,pdac,PROMPT2_ICL_entailment
72,163,15,15,0,1.0,13,10,3,0.7692307692307693,0.8695652173913044,medlm,coral,pdac,PROMPT2_ICL_entailment
73,164,21,20,1,0.9523809523809524,36,16,20,0.4444444444444444,0.6060606060606061,medlm,coral,pdac,PROMPT2_ICL_entailment
74,165,13,11,2,0.8461538461538461,10,7,3,0.7,0.7661691542288558,medlm,coral,pdac,PROMPT2_ICL_entailment
75,166,8,8,0,1.0,11,9,2,0.8181818181818182,0.9,medlm,coral,pdac,PROMPT2_ICL_entailment
76,167,11,10,1,0.9090909090909092,8,7,1,0.875,0.8917197452229298,medlm,coral,pdac,PROMPT2_ICL_entailment
77,168,9,8,1,0.8888888888888888,6,6,0,1.0,0.9411764705882352,medlm,coral,pdac,PROMPT2_ICL_entailment
78,169,9,9,0,1.0,7,7,0,1.0,1.0,medlm,coral,pdac,PROMPT2_ICL_entailment
79,17,9,9,0,1.0,5,5,0,1.0,1.0,medlm,coral,pdac,PROMPT2_ICL_entailment
80,170,23,17,6,0.7391304347826086,16,13,3,0.8125,0.7740805604203151,medlm,coral,pdac,PROMPT2_ICL_entailment
81,171,10,7,3,0.7,13,11,2,0.8461538461538461,0.7661691542288558,medlm,coral,pdac,PROMPT2_ICL_entailment
82,172,20,17,3,0.85,10,10,0,1.0,0.9189189189189187,medlm,coral,pdac,PROMPT2_ICL_entailment
83,173,17,17,0,1.0,22,14,8,0.6363636363636364,0.7777777777777778,medlm,coral,pdac,PROMPT2_ICL_entailment
84,174,7,7,0,1.0,11,8,3,0.7272727272727273,0.8421052631578948,medlm,coral,pdac,PROMPT2_ICL_entailment
85,175,14,5,9,0.3571428571428571,29,7,22,0.2413793103448276,0.2880658436213992,medlm,coral,pdac,PROMPT2_ICL_entailment
86,176,12,12,0,1.0,10,10,0,1.0,1.0,medlm,coral,pdac,PROMPT2_ICL_entailment
87,177,3,3,0,1.0,10,10,0,1.0,1.0,medlm,coral,pdac,PROMPT2_ICL_entailment
88,178,19,13,6,0.6842105263157895,36,20,16,0.5555555555555556,0.6132075471698113,medlm,coral,pdac,PROMPT2_ICL_entailment
89,179,10,9,1,0.9,9,7,2,0.7777777777777778,0.8344370860927153,medlm,coral,pdac,PROMPT2_ICL_entailment
90,18,8,7,1,0.875,15,9,6,0.6,0.711864406779661,medlm,coral,pdac,PROMPT2_ICL_entailment
91,180,5,5,0,1.0,5,5,0,1.0,1.0,medlm,coral,pdac,PROMPT2_ICL_entailment
92,181,11,10,1,0.9090909090909092,10,6,4,0.6,0.7228915662650602,medlm,coral,pdac,PROMPT2_ICL_entailment
93,182,10,10,0,1.0,8,7,1,0.875,0.9333333333333332,medlm,coral,pdac,PROMPT2_ICL_entailment
94,183,13,12,1,0.9230769230769232,10,6,4,0.6,0.7272727272727274,medlm,coral,pdac,PROMPT2_ICL_entailment
95,184,14,8,6,0.5714285714285714,9,8,1,0.8888888888888888,0.6956521739130435,medlm,coral,pdac,PROMPT2_ICL_entailment
96,185,7,7,0,1.0,22,15,7,0.6818181818181818,0.8108108108108109,medlm,coral,pdac,PROMPT2_ICL_entailment
97,186,16,11,5,0.6875,32,10,22,0.3125,0.4296875,medlm,coral,pdac,PROMPT2_ICL_entailment
98,187,30,24,6,0.8,34,25,9,0.7352941176470589,0.7662835249042146,medlm,coral,pdac,PROMPT2_ICL_entailment
99,188,18,16,2,0.8888888888888888,8,7,1,0.875,0.8818897637795274,medlm,coral,pdac,PROMPT2_ICL_entailment
100,189,16,14,2,0.875,5,5,0,1.0,0.9333333333333332,medlm,coral,pdac,PROMPT2_ICL_entailment
101,19,16,11,5,0.6875,21,14,7,0.6666666666666666,0.676923076923077,medlm,coral,pdac,PROMPT2_ICL_entailment
102,190,16,15,1,0.9375,17,9,8,0.5294117647058824,0.6766917293233083,medlm,coral,pdac,PROMPT2_ICL_entailment
103,191,18,15,3,0.8333333333333334,15,14,1,0.9333333333333332,0.8805031446540881,medlm,coral,pdac,PROMPT2_ICL_entailment
104,192,7,6,1,0.8571428571428571,12,7,5,0.5833333333333334,0.6942148760330579,medlm,coral,pdac,PROMPT2_ICL_entailment
105,193,10,9,1,0.9,10,10,0,1.0,0.9473684210526316,medlm,coral,pdac,PROMPT2_ICL_entailment
106,194,11,9,2,0.8181818181818182,11,10,1,0.9090909090909092,0.861244019138756,medlm,coral,pdac,PROMPT2_ICL_entailment
107,195,8,8,0,1.0,7,4,3,0.5714285714285714,0.7272727272727273,medlm,coral,pdac,PROMPT2_ICL_entailment
108,196,17,16,1,0.9411764705882352,8,7,1,0.875,0.9068825910931174,medlm,coral,pdac,PROMPT2_ICL_entailment
109,197,7,7,0,1.0,9,8,1,0.8888888888888888,0.9411764705882352,medlm,coral,pdac,PROMPT2_ICL_entailment
110,198,10,10,0,1.0,12,9,3,0.75,0.8571428571428571,medlm,coral,pdac,PROMPT2_ICL_entailment
111,199,7,6,1,0.8571428571428571,9,7,2,0.7777777777777778,0.8155339805825242,medlm,coral,pdac,PROMPT2_ICL_entailment
112,2,7,5,2,0.7142857142857143,14,12,2,0.8571428571428571,0.7792207792207793,medlm,coral,pdac,PROMPT2_ICL_entailment
113,20,20,13,7,0.65,18,10,8,0.5555555555555556,0.5990783410138248,medlm,coral,pdac,PROMPT2_ICL_entailment
114,200,14,11,3,0.7857142857142857,16,12,4,0.75,0.7674418604651163,medlm,coral,pdac,PROMPT2_ICL_entailment
115,201,11,11,0,1.0,10,10,0,1.0,1.0,medlm,coral,pdac,PROMPT2_ICL_entailment
116,202,10,10,0,1.0,10,10,0,1.0,1.0,medlm,coral,pdac,PROMPT2_ICL_entailment
117,203,18,12,6,0.6666666666666666,31,20,11,0.6451612903225806,0.6557377049180327,medlm,coral,pdac,PROMPT2_ICL_entailment
118,204,19,19,0,1.0,14,9,5,0.6428571428571429,0.782608695652174,medlm,coral,pdac,PROMPT2_ICL_entailment
119,205,9,8,1,0.8888888888888888,7,5,2,0.7142857142857143,0.792079207920792,medlm,coral,pdac,PROMPT2_ICL_entailment
120,206,8,7,1,0.875,9,5,4,0.5555555555555556,0.6796116504854369,medlm,coral,pdac,PROMPT2_ICL_entailment
121,207,15,14,1,0.9333333333333332,8,7,1,0.875,0.9032258064516128,medlm,coral,pdac,PROMPT2_ICL_entailment
122,208,8,8,0,1.0,8,6,2,0.75,0.8571428571428571,medlm,coral,pdac,PROMPT2_ICL_entailment
123,209,10,10,0,1.0,9,7,2,0.7777777777777778,0.8750000000000001,medlm,coral,pdac,PROMPT2_ICL_entailment
124,21,10,10,0,1.0,10,10,0,1.0,1.0,medlm,coral,pdac,PROMPT2_ICL_entailment
125,210,12,10,2,0.8333333333333334,9,9,0,1.0,0.9090909090909092,medlm,coral,pdac,PROMPT2_ICL_entailment
126,211,9,6,3,0.6666666666666666,8,5,3,0.625,0.6451612903225806,medlm,coral,pdac,PROMPT2_ICL_entailment
127,212,16,16,0,1.0,17,16,1,0.9411764705882352,0.9696969696969696,medlm,coral,pdac,PROMPT2_ICL_entailment
128,213,13,12,1,0.9230769230769232,11,10,1,0.9090909090909092,0.9160305343511452,medlm,coral,pdac,PROMPT2_ICL_entailment
129,214,3,3,0,1.0,18,12,6,0.6666666666666666,0.8,medlm,coral,pdac,PROMPT2_ICL_entailment
130,215,1,0,1,0.0,12,8,4,0.6666666666666666,0.0,medlm,coral,pdac,PROMPT2_ICL_entailment
131,216,7,6,1,0.8571428571428571,33,8,25,0.2424242424242424,0.3779527559055118,medlm,coral,pdac,PROMPT2_ICL_entailment
132,217,16,14,2,0.875,19,15,4,0.7894736842105263,0.8300395256916996,medlm,coral,pdac,PROMPT2_ICL_entailment
133,218,9,9,0,1.0,11,8,3,0.7272727272727273,0.8421052631578948,medlm,coral,pdac,PROMPT2_ICL_entailment
134,219,12,11,1,0.9166666666666666,8,7,1,0.875,0.8953488372093024,medlm,coral,pdac,PROMPT2_ICL_entailment
135,22,22,15,7,0.6818181818181818,17,13,4,0.7647058823529411,0.7208872458410351,medlm,coral,pdac,PROMPT2_ICL_entailment
136,220,13,12,1,0.9230769230769232,11,6,5,0.5454545454545454,0.6857142857142856,medlm,coral,pdac,PROMPT2_ICL_entailment
137,221,10,9,1,0.9,12,9,3,0.75,0.8181818181818182,medlm,coral,pdac,PROMPT2_ICL_entailment
138,222,12,11,1,0.9166666666666666,11,9,2,0.8181818181818182,0.8646288209606987,medlm,coral,pdac,PROMPT2_ICL_entailment
139,223,23,17,6,0.7391304347826086,37,12,25,0.3243243243243243,0.4508287292817679,medlm,coral,pdac,PROMPT2_ICL_entailment
140,224,12,8,4,0.6666666666666666,8,7,1,0.875,0.7567567567567567,medlm,coral,pdac,PROMPT2_ICL_entailment
141,225,13,13,0,1.0,13,6,7,0.4615384615384615,0.631578947368421,medlm,coral,pdac,PROMPT2_ICL_entailment
142,226,8,6,2,0.75,11,6,5,0.5454545454545454,0.631578947368421,medlm,coral,pdac,PROMPT2_ICL_entailment
143,227,6,5,1,0.8333333333333334,10,9,1,0.9,0.8653846153846153,medlm,coral,pdac,PROMPT2_ICL_entailment
144,228,8,7,1,0.875,9,9,0,1.0,0.9333333333333332,medlm,coral,pdac,PROMPT2_ICL_entailment
145,229,14,14,0,1.0,9,5,4,0.5555555555555556,0.7142857142857143,medlm,coral,pdac,PROMPT2_ICL_entailment
146,23,11,11,0,1.0,12,9,3,0.75,0.8571428571428571,medlm,coral,pdac,PROMPT2_ICL_entailment
147,230,11,10,1,0.9090909090909092,8,8,0,1.0,0.9523809523809524,medlm,coral,pdac,PROMPT2_ICL_entailment
148,24,16,16,0,1.0,9,7,2,0.7777777777777778,0.8750000000000001,medlm,coral,pdac,PROMPT2_ICL_entailment
149,25,40,40,0,1.0,11,8,3,0.7272727272727273,0.8421052631578948,medlm,coral,pdac,PROMPT2_ICL_entailment
150,26,11,11,0,1.0,11,10,1,0.9090909090909092,0.9523809523809524,medlm,coral,pdac,PROMPT2_ICL_entailment
151,27,17,15,2,0.8823529411764706,12,11,1,0.9166666666666666,0.8991825613079019,medlm,coral,pdac,PROMPT2_ICL_entailment
152,28,12,10,2,0.8333333333333334,13,13,0,1.0,0.9090909090909092,medlm,coral,pdac,PROMPT2_ICL_entailment
153,29,13,12,1,0.9230769230769232,9,5,4,0.5555555555555556,0.6936416184971099,medlm,coral,pdac,PROMPT2_ICL_entailment
154,3,9,8,1,0.8888888888888888,8,7,1,0.875,0.8818897637795274,medlm,coral,pdac,PROMPT2_ICL_entailment
155,30,16,15,1,0.9375,11,10,1,0.9090909090909092,0.923076923076923,medlm,coral,pdac,PROMPT2_ICL_entailment
156,31,20,20,0,1.0,11,11,0,1.0,1.0,medlm,coral,pdac,PROMPT2_ICL_entailment
157,32,12,11,1,0.9166666666666666,11,7,4,0.6363636363636364,0.7512195121951218,medlm,coral,pdac,PROMPT2_ICL_entailment
158,33,18,14,4,0.7777777777777778,24,10,14,0.4166666666666667,0.5426356589147286,medlm,coral,pdac,PROMPT2_ICL_entailment
159,34,11,11,0,1.0,10,10,0,1.0,1.0,medlm,coral,pdac,PROMPT2_ICL_entailment
160,35,10,10,0,1.0,10,10,0,1.0,1.0,medlm,coral,pdac,PROMPT2_ICL_entailment
161,36,15,15,0,1.0,44,16,28,0.3636363636363636,0.5333333333333333,medlm,coral,pdac,PROMPT2_ICL_entailment
162,37,21,18,3,0.8571428571428571,9,7,2,0.7777777777777778,0.8155339805825242,medlm,coral,pdac,PROMPT2_ICL_entailment
163,38,12,10,2,0.8333333333333334,13,10,3,0.7692307692307693,0.8,medlm,coral,pdac,PROMPT2_ICL_entailment
164,39,10,10,0,1.0,10,8,2,0.8,0.888888888888889,medlm,coral,pdac,PROMPT2_ICL_entailment
165,4,21,12,9,0.5714285714285714,15,8,7,0.5333333333333333,0.5517241379310344,medlm,coral,pdac,PROMPT2_ICL_entailment
166,40,10,9,1,0.9,10,5,5,0.5,0.6428571428571429,medlm,coral,pdac,PROMPT2_ICL_entailment
167,41,10,10,0,1.0,8,6,2,0.75,0.8571428571428571,medlm,coral,pdac,PROMPT2_ICL_entailment
168,42,15,15,0,1.0,11,8,3,0.7272727272727273,0.8421052631578948,medlm,coral,pdac,PROMPT2_ICL_entailment
169,43,21,19,2,0.9047619047619048,13,9,4,0.6923076923076923,0.7844036697247706,medlm,coral,pdac,PROMPT2_ICL_entailment
170,44,12,11,1,0.9166666666666666,11,7,4,0.6363636363636364,0.7512195121951218,medlm,coral,pdac,PROMPT2_ICL_entailment
171,45,22,22,0,1.0,10,10,0,1.0,1.0,medlm,coral,pdac,PROMPT2_ICL_entailment
172,46,16,11,5,0.6875,11,9,2,0.8181818181818182,0.7471698113207547,medlm,coral,pdac,PROMPT2_ICL_entailment
173,47,32,32,0,1.0,39,25,14,0.6410256410256411,0.7812500000000001,medlm,coral,pdac,PROMPT2_ICL_entailment
174,48,8,7,1,0.875,10,7,3,0.7,0.7777777777777777,medlm,coral,pdac,PROMPT2_ICL_entailment
175,49,14,14,0,1.0,10,7,3,0.7,0.8235294117647058,medlm,coral,pdac,PROMPT2_ICL_entailment
176,5,10,9,1,0.9,10,9,1,0.9,0.9,medlm,coral,pdac,PROMPT2_ICL_entailment
177,50,14,14,0,1.0,10,7,3,0.7,0.8235294117647058,medlm,coral,pdac,PROMPT2_ICL_entailment
178,51,10,9,1,0.9,12,8,4,0.6666666666666666,0.7659574468085106,medlm,coral,pdac,PROMPT2_ICL_entailment
179,52,12,9,3,0.75,10,8,2,0.8,0.7741935483870969,medlm,coral,pdac,PROMPT2_ICL_entailment
180,53,6,6,0,1.0,8,5,3,0.625,0.7692307692307693,medlm,coral,pdac,PROMPT2_ICL_entailment
181,54,6,6,0,1.0,2,2,0,1.0,1.0,medlm,coral,pdac,PROMPT2_ICL_entailment
182,55,21,20,1,0.9523809523809524,10,5,5,0.5,0.6557377049180327,medlm,coral,pdac,PROMPT2_ICL_entailment
183,56,12,11,1,0.9166666666666666,8,5,3,0.625,0.7432432432432433,medlm,coral,pdac,PROMPT2_ICL_entailment
184,57,22,20,2,0.9090909090909092,13,11,2,0.8461538461538461,0.8764940239043824,medlm,coral,pdac,PROMPT2_ICL_entailment
185,58,34,31,3,0.9117647058823528,10,10,0,1.0,0.953846153846154,medlm,coral,pdac,PROMPT2_ICL_entailment
186,59,15,9,6,0.6,21,8,13,0.3809523809523809,0.4660194174757281,medlm,coral,pdac,PROMPT2_ICL_entailment
187,6,7,6,1,0.8571428571428571,12,9,3,0.75,0.7999999999999999,medlm,coral,pdac,PROMPT2_ICL_entailment
188,60,14,13,1,0.9285714285714286,13,6,7,0.4615384615384615,0.6166007905138341,medlm,coral,pdac,PROMPT2_ICL_entailment
189,61,10,10,0,1.0,7,7,0,1.0,1.0,medlm,coral,pdac,PROMPT2_ICL_entailment
190,62,17,10,7,0.5882352941176471,11,9,2,0.8181818181818182,0.6844106463878327,medlm,coral,pdac,PROMPT2_ICL_entailment
191,63,11,11,0,1.0,10,10,0,1.0,1.0,medlm,coral,pdac,PROMPT2_ICL_entailment
192,64,16,16,0,1.0,12,11,1,0.9166666666666666,0.9565217391304348,medlm,coral,pdac,PROMPT2_ICL_entailment
193,65,20,19,1,0.95,9,7,2,0.7777777777777778,0.855305466237942,medlm,coral,pdac,PROMPT2_ICL_entailment
194,66,8,4,4,0.5,12,8,4,0.6666666666666666,0.5714285714285715,medlm,coral,pdac,PROMPT2_ICL_entailment
195,67,7,7,0,1.0,1,1,0,1.0,1.0,medlm,coral,pdac,PROMPT2_ICL_entailment
196,68,14,13,1,0.9285714285714286,11,8,3,0.7272727272727273,0.8156862745098039,medlm,coral,pdac,PROMPT2_ICL_entailment
197,69,12,10,2,0.8333333333333334,10,10,0,1.0,0.9090909090909092,medlm,coral,pdac,PROMPT2_ICL_entailment
198,7,10,10,0,1.0,11,9,2,0.8181818181818182,0.9,medlm,coral,pdac,PROMPT2_ICL_entailment
199,70,8,8,0,1.0,15,14,1,0.9333333333333332,0.9655172413793104,medlm,coral,pdac,PROMPT2_ICL_entailment
200,71,24,16,8,0.6666666666666666,9,8,1,0.8888888888888888,0.761904761904762,medlm,coral,pdac,PROMPT2_ICL_entailment
201,72,10,8,2,0.8,13,8,5,0.6153846153846154,0.6956521739130435,medlm,coral,pdac,PROMPT2_ICL_entailment
202,73,19,5,14,0.2631578947368421,154,36,118,0.2337662337662337,0.2475928473177441,medlm,coral,pdac,PROMPT2_ICL_entailment
203,74,16,11,5,0.6875,8,7,1,0.875,0.77,medlm,coral,pdac,PROMPT2_ICL_entailment
204,75,12,11,1,0.9166666666666666,7,6,1,0.8571428571428571,0.8859060402684563,medlm,coral,pdac,PROMPT2_ICL_entailment
205,76,7,6,1,0.8571428571428571,7,7,0,1.0,0.923076923076923,medlm,coral,pdac,PROMPT2_ICL_entailment
206,77,16,12,4,0.75,8,7,1,0.875,0.8076923076923077,medlm,coral,pdac,PROMPT2_ICL_entailment
207,78,8,6,2,0.75,8,6,2,0.75,0.75,medlm,coral,pdac,PROMPT2_ICL_entailment
208,79,12,9,3,0.75,11,10,1,0.9090909090909092,0.821917808219178,medlm,coral,pdac,PROMPT2_ICL_entailment
209,8,3,3,0,1.0,2,2,0,1.0,1.0,medlm,coral,pdac,PROMPT2_ICL_entailment
210,80,21,17,4,0.8095238095238095,9,8,1,0.8888888888888888,0.8473520249221184,medlm,coral,pdac,PROMPT2_ICL_entailment
211,81,8,8,0,1.0,6,5,1,0.8333333333333334,0.9090909090909092,medlm,coral,pdac,PROMPT2_ICL_entailment
212,82,13,12,1,0.9230769230769232,4,3,1,0.75,0.8275862068965517,medlm,coral,pdac,PROMPT2_ICL_entailment
213,83,12,12,0,1.0,11,5,6,0.4545454545454545,0.625,medlm,coral,pdac,PROMPT2_ICL_entailment
214,84,15,7,8,0.4666666666666667,11,8,3,0.7272727272727273,0.5685279187817259,medlm,coral,pdac,PROMPT2_ICL_entailment
215,85,23,15,8,0.6521739130434783,35,21,14,0.6,0.6250000000000001,medlm,coral,pdac,PROMPT2_ICL_entailment
216,86,11,11,0,1.0,10,6,4,0.6,0.7499999999999999,medlm,coral,pdac,PROMPT2_ICL_entailment
217,87,10,7,3,0.7,7,6,1,0.8571428571428571,0.7706422018348624,medlm,coral,pdac,PROMPT2_ICL_entailment
218,88,13,12,1,0.9230769230769232,8,3,5,0.375,0.5333333333333333,medlm,coral,pdac,PROMPT2_ICL_entailment
219,89,7,6,1,0.8571428571428571,10,7,3,0.7,0.7706422018348624,medlm,coral,pdac,PROMPT2_ICL_entailment
220,9,11,11,0,1.0,12,8,4,0.6666666666666666,0.8,medlm,coral,pdac,PROMPT2_ICL_entailment
221,90,9,5,4,0.5555555555555556,9,7,2,0.7777777777777778,0.6481481481481481,medlm,coral,pdac,PROMPT2_ICL_entailment
222,91,15,14,1,0.9333333333333332,10,7,3,0.7,0.8,medlm,coral,pdac,PROMPT2_ICL_entailment
223,92,10,9,1,0.9,10,7,3,0.7,0.7875,medlm,coral,pdac,PROMPT2_ICL_entailment
224,93,20,19,1,0.95,9,7,2,0.7777777777777778,0.855305466237942,medlm,coral,pdac,PROMPT2_ICL_entailment
225,94,14,12,2,0.8571428571428571,7,5,2,0.7142857142857143,0.7792207792207793,medlm,coral,pdac,PROMPT2_ICL_entailment
226,95,9,8,1,0.8888888888888888,8,8,0,1.0,0.9411764705882352,medlm,coral,pdac,PROMPT2_ICL_entailment
227,96,7,7,0,1.0,4,4,0,1.0,1.0,medlm,coral,pdac,PROMPT2_ICL_entailment
228,97,10,8,2,0.8,8,7,1,0.875,0.8358208955223881,medlm,coral,pdac,PROMPT2_ICL_entailment
229,98,16,15,1,0.9375,9,8,1,0.8888888888888888,0.9125475285171102,medlm,coral,pdac,PROMPT2_ICL_entailment
230,99,9,7,2,0.7777777777777778,9,8,1,0.8888888888888888,0.8296296296296296,medlm,coral,pdac,PROMPT2_ICL_entailment
0,0,15,14,1,0.9333333333333332,9,9,0,1.0,0.9655172413793104,medlm,coral,pdac,PROMPT2_entailment
1,1,14,13,1,0.9285714285714286,9,9,0,1.0,0.962962962962963,medlm,coral,pdac,PROMPT2_entailment
2,10,16,16,0,1.0,11,9,2,0.8181818181818182,0.9,medlm,coral,pdac,PROMPT2_entailment
3,100,11,10,1,0.9090909090909092,11,10,1,0.9090909090909092,0.9090909090909092,medlm,coral,pdac,PROMPT2_entailment
4,101,17,15,2,0.8823529411764706,11,9,2,0.8181818181818182,0.8490566037735848,medlm,coral,pdac,PROMPT2_entailment
5,102,5,5,0,1.0,27,19,8,0.7037037037037037,0.8260869565217391,medlm,coral,pdac,PROMPT2_entailment
6,103,10,7,3,0.7,15,9,6,0.6,0.6461538461538462,medlm,coral,pdac,PROMPT2_entailment
7,104,9,8,1,0.8888888888888888,12,11,1,0.9166666666666666,0.9025641025641026,medlm,coral,pdac,PROMPT2_entailment
8,105,30,16,14,0.5333333333333333,33,10,23,0.303030303030303,0.3864734299516908,medlm,coral,pdac,PROMPT2_entailment
9,106,12,12,0,1.0,10,10,0,1.0,1.0,medlm,coral,pdac,PROMPT2_entailment
10,107,4,4,0,1.0,10,10,0,1.0,1.0,medlm,coral,pdac,PROMPT2_entailment
11,108,13,13,0,1.0,10,10,0,1.0,1.0,medlm,coral,pdac,PROMPT2_entailment
12,109,19,18,1,0.9473684210526316,34,14,20,0.4117647058823529,0.5740318906605922,medlm,coral,pdac,PROMPT2_entailment
13,11,8,7,1,0.875,10,10,0,1.0,0.9333333333333332,medlm,coral,pdac,PROMPT2_entailment
14,110,6,6,0,1.0,4,4,0,1.0,1.0,medlm,coral,pdac,PROMPT2_entailment
15,111,9,8,1,0.8888888888888888,3,3,0,1.0,0.9411764705882352,medlm,coral,pdac,PROMPT2_entailment
16,112,6,2,4,0.3333333333333333,9,8,1,0.8888888888888888,0.4848484848484848,medlm,coral,pdac,PROMPT2_entailment
17,113,10,9,1,0.9,6,4,2,0.6666666666666666,0.7659574468085106,medlm,coral,pdac,PROMPT2_entailment
18,114,6,3,3,0.5,9,9,0,1.0,0.6666666666666666,medlm,coral,pdac,PROMPT2_entailment
19,115,15,14,1,0.9333333333333332,7,6,1,0.8571428571428571,0.8936170212765957,medlm,coral,pdac,PROMPT2_entailment
20,116,5,5,0,1.0,2,2,0,1.0,1.0,medlm,coral,pdac,PROMPT2_entailment
21,117,9,8,1,0.8888888888888888,8,7,1,0.875,0.8818897637795274,medlm,coral,pdac,PROMPT2_entailment
22,118,17,17,0,1.0,9,7,2,0.7777777777777778,0.8750000000000001,medlm,coral,pdac,PROMPT2_entailment
23,119,11,9,2,0.8181818181818182,12,8,4,0.6666666666666666,0.7346938775510203,medlm,coral,pdac,PROMPT2_entailment
24,12,19,17,2,0.8947368421052632,10,8,2,0.8,0.84472049689441,medlm,coral,pdac,PROMPT2_entailment
25,120,4,4,0,1.0,13,9,4,0.6923076923076923,0.8181818181818181,medlm,coral,pdac,PROMPT2_entailment
26,121,18,16,2,0.8888888888888888,12,11,1,0.9166666666666666,0.9025641025641026,medlm,coral,pdac,PROMPT2_entailment
27,122,23,7,16,0.3043478260869565,45,18,27,0.4,0.345679012345679,medlm,coral,pdac,PROMPT2_entailment
28,123,13,13,0,1.0,10,8,2,0.8,0.888888888888889,medlm,coral,pdac,PROMPT2_entailment
29,124,4,4,0,1.0,3,3,0,1.0,1.0,medlm,coral,pdac,PROMPT2_entailment
30,125,11,11,0,1.0,8,8,0,1.0,1.0,medlm,coral,pdac,PROMPT2_entailment
31,126,13,13,0,1.0,10,8,2,0.8,0.888888888888889,medlm,coral,pdac,PROMPT2_entailment
32,127,7,7,0,1.0,30,13,17,0.4333333333333333,0.6046511627906976,medlm,coral,pdac,PROMPT2_entailment
33,128,6,4,2,0.6666666666666666,35,6,29,0.1714285714285714,0.2727272727272727,medlm,coral,pdac,PROMPT2_entailment
34,129,13,13,0,1.0,11,10,1,0.9090909090909092,0.9523809523809524,medlm,coral,pdac,PROMPT2_entailment
35,13,12,8,4,0.6666666666666666,13,6,7,0.4615384615384615,0.5454545454545455,medlm,coral,pdac,PROMPT2_entailment
36,130,15,14,1,0.9333333333333332,12,8,4,0.6666666666666666,0.7777777777777778,medlm,coral,pdac,PROMPT2_entailment
37,131,6,5,1,0.8333333333333334,12,4,8,0.3333333333333333,0.4761904761904761,medlm,coral,pdac,PROMPT2_entailment
38,132,7,7,0,1.0,10,8,2,0.8,0.888888888888889,medlm,coral,pdac,PROMPT2_entailment
39,133,11,10,1,0.9090909090909092,7,6,1,0.8571428571428571,0.8823529411764706,medlm,coral,pdac,PROMPT2_entailment
40,134,11,10,1,0.9090909090909092,15,6,9,0.4,0.5555555555555556,medlm,coral,pdac,PROMPT2_entailment
41,135,10,10,0,1.0,9,9,0,1.0,1.0,medlm,coral,pdac,PROMPT2_entailment
42,136,16,15,1,0.9375,7,3,4,0.4285714285714285,0.588235294117647,medlm,coral,pdac,PROMPT2_entailment
43,137,8,7,1,0.875,10,7,3,0.7,0.7777777777777777,medlm,coral,pdac,PROMPT2_entailment
44,138,4,1,3,0.25,25,12,13,0.48,0.3287671232876712,medlm,coral,pdac,PROMPT2_entailment
45,139,1,1,0,1.0,62,4,58,0.064516129032258,0.1212121212121212,medlm,coral,pdac,PROMPT2_entailment
46,14,10,10,0,1.0,10,10,0,1.0,1.0,medlm,coral,pdac,PROMPT2_entailment
47,140,12,10,2,0.8333333333333334,8,6,2,0.75,0.7894736842105262,medlm,coral,pdac,PROMPT2_entailment
48,141,12,10,2,0.8333333333333334,11,7,4,0.6363636363636364,0.7216494845360825,medlm,coral,pdac,PROMPT2_entailment
49,142,10,8,2,0.8,11,9,2,0.8181818181818182,0.8089887640449439,medlm,coral,pdac,PROMPT2_entailment
50,143,8,8,0,1.0,9,8,1,0.8888888888888888,0.9411764705882352,medlm,coral,pdac,PROMPT2_entailment
51,144,7,4,3,0.5714285714285714,12,8,4,0.6666666666666666,0.6153846153846153,medlm,coral,pdac,PROMPT2_entailment
52,145,10,10,0,1.0,10,10,0,1.0,1.0,medlm,coral,pdac,PROMPT2_entailment
53,146,6,5,1,0.8333333333333334,7,5,2,0.7142857142857143,0.7692307692307692,medlm,coral,pdac,PROMPT2_entailment
54,147,7,4,3,0.5714285714285714,12,8,4,0.6666666666666666,0.6153846153846153,medlm,coral,pdac,PROMPT2_entailment
55,148,18,17,1,0.9444444444444444,25,10,15,0.4,0.5619834710743801,medlm,coral,pdac,PROMPT2_entailment
56,149,6,6,0,1.0,7,5,2,0.7142857142857143,0.8333333333333333,medlm,coral,pdac,PROMPT2_entailment
57,15,10,10,0,1.0,10,10,0,1.0,1.0,medlm,coral,pdac,PROMPT2_entailment
58,150,13,12,1,0.9230769230769232,8,8,0,1.0,0.96,medlm,coral,pdac,PROMPT2_entailment
59,151,11,11,0,1.0,10,10,0,1.0,1.0,medlm,coral,pdac,PROMPT2_entailment
60,152,17,17,0,1.0,11,8,3,0.7272727272727273,0.8421052631578948,medlm,coral,pdac,PROMPT2_entailment
61,153,4,4,0,1.0,30,13,17,0.4333333333333333,0.6046511627906976,medlm,coral,pdac,PROMPT2_entailment
62,154,17,12,5,0.7058823529411765,15,12,3,0.8,0.7500000000000001,medlm,coral,pdac,PROMPT2_entailment
63,155,22,20,2,0.9090909090909092,47,14,33,0.2978723404255319,0.4487179487179488,medlm,coral,pdac,PROMPT2_entailment
64,156,12,11,1,0.9166666666666666,10,8,2,0.8,0.854368932038835,medlm,coral,pdac,PROMPT2_entailment
65,157,5,3,2,0.6,14,7,7,0.5,0.5454545454545454,medlm,coral,pdac,PROMPT2_entailment
66,158,7,7,0,1.0,10,7,3,0.7,0.8235294117647058,medlm,coral,pdac,PROMPT2_entailment
67,159,10,7,3,0.7,4,3,1,0.75,0.7241379310344827,medlm,coral,pdac,PROMPT2_entailment
68,16,32,29,3,0.90625,31,19,12,0.6129032258064516,0.7312541473125415,medlm,coral,pdac,PROMPT2_entailment
69,160,10,10,0,1.0,9,8,1,0.8888888888888888,0.9411764705882352,medlm,coral,pdac,PROMPT2_entailment
70,161,9,9,0,1.0,9,7,2,0.7777777777777778,0.8750000000000001,medlm,coral,pdac,PROMPT2_entailment
71,162,10,10,0,1.0,10,10,0,1.0,1.0,medlm,coral,pdac,PROMPT2_entailment
72,163,9,9,0,1.0,13,9,4,0.6923076923076923,0.8181818181818181,medlm,coral,pdac,PROMPT2_entailment
73,164,7,5,2,0.7142857142857143,36,18,18,0.5,0.588235294117647,medlm,coral,pdac,PROMPT2_entailment
74,165,14,10,4,0.7142857142857143,10,5,5,0.5,0.588235294117647,medlm,coral,pdac,PROMPT2_entailment
75,166,1,1,0,1.0,11,5,6,0.4545454545454545,0.625,medlm,coral,pdac,PROMPT2_entailment
76,167,11,9,2,0.8181818181818182,8,7,1,0.875,0.8456375838926175,medlm,coral,pdac,PROMPT2_entailment
77,168,8,7,1,0.875,6,6,0,1.0,0.9333333333333332,medlm,coral,pdac,PROMPT2_entailment
78,169,7,7,0,1.0,7,6,1,0.8571428571428571,0.923076923076923,medlm,coral,pdac,PROMPT2_entailment
79,17,9,9,0,1.0,5,4,1,0.8,0.888888888888889,medlm,coral,pdac,PROMPT2_entailment
80,170,12,7,5,0.5833333333333334,16,10,6,0.625,0.603448275862069,medlm,coral,pdac,PROMPT2_entailment
81,171,10,7,3,0.7,13,8,5,0.6153846153846154,0.6549707602339182,medlm,coral,pdac,PROMPT2_entailment
82,172,9,8,1,0.8888888888888888,10,8,2,0.8,0.8421052631578948,medlm,coral,pdac,PROMPT2_entailment
83,173,5,4,1,0.8,22,14,8,0.6363636363636364,0.7088607594936709,medlm,coral,pdac,PROMPT2_entailment
84,174,7,5,2,0.7142857142857143,11,6,5,0.5454545454545454,0.6185567010309277,medlm,coral,pdac,PROMPT2_entailment
85,175,14,7,7,0.5,29,7,22,0.2413793103448276,0.3255813953488372,medlm,coral,pdac,PROMPT2_entailment
86,176,12,12,0,1.0,10,10,0,1.0,1.0,medlm,coral,pdac,PROMPT2_entailment
87,177,11,11,0,1.0,10,10,0,1.0,1.0,medlm,coral,pdac,PROMPT2_entailment
88,178,19,12,7,0.631578947368421,36,20,16,0.5555555555555556,0.5911330049261083,medlm,coral,pdac,PROMPT2_entailment
89,179,7,7,0,1.0,9,5,4,0.5555555555555556,0.7142857142857143,medlm,coral,pdac,PROMPT2_entailment
90,18,10,9,1,0.9,15,6,9,0.4,0.5538461538461539,medlm,coral,pdac,PROMPT2_entailment
91,180,6,6,0,1.0,5,5,0,1.0,1.0,medlm,coral,pdac,PROMPT2_entailment
92,181,9,8,1,0.8888888888888888,10,8,2,0.8,0.8421052631578948,medlm,coral,pdac,PROMPT2_entailment
93,182,15,12,3,0.8,8,5,3,0.625,0.7017543859649122,medlm,coral,pdac,PROMPT2_entailment
94,183,8,7,1,0.875,10,3,7,0.3,0.4468085106382978,medlm,coral,pdac,PROMPT2_entailment
95,184,13,6,7,0.4615384615384615,9,8,1,0.8888888888888888,0.6075949367088607,medlm,coral,pdac,PROMPT2_entailment
96,185,4,3,1,0.75,22,15,7,0.6818181818181818,0.7142857142857143,medlm,coral,pdac,PROMPT2_entailment
97,186,15,11,4,0.7333333333333333,32,12,20,0.375,0.4962406015037593,medlm,coral,pdac,PROMPT2_entailment
98,187,30,24,6,0.8,34,24,10,0.7058823529411765,0.7500000000000001,medlm,coral,pdac,PROMPT2_entailment
99,188,18,16,2,0.8888888888888888,8,5,3,0.625,0.7339449541284404,medlm,coral,pdac,PROMPT2_entailment
100,189,8,6,2,0.75,5,3,2,0.6,0.6666666666666665,medlm,coral,pdac,PROMPT2_entailment
101,19,14,13,1,0.9285714285714286,21,11,10,0.5238095238095238,0.6697892271662763,medlm,coral,pdac,PROMPT2_entailment
102,190,23,22,1,0.9565217391304348,17,13,4,0.7647058823529411,0.849925705794948,medlm,coral,pdac,PROMPT2_entailment
103,191,17,16,1,0.9411764705882352,15,13,2,0.8666666666666667,0.9023861171366594,medlm,coral,pdac,PROMPT2_entailment
104,192,6,2,4,0.3333333333333333,12,7,5,0.5833333333333334,0.4242424242424242,medlm,coral,pdac,PROMPT2_entailment
105,193,10,9,1,0.9,10,8,2,0.8,0.8470588235294118,medlm,coral,pdac,PROMPT2_entailment
106,194,11,11,0,1.0,11,10,1,0.9090909090909092,0.9523809523809524,medlm,coral,pdac,PROMPT2_entailment
107,195,5,3,2,0.6,7,6,1,0.8571428571428571,0.7058823529411764,medlm,coral,pdac,PROMPT2_entailment
108,196,10,9,1,0.9,8,7,1,0.875,0.8873239436619719,medlm,coral,pdac,PROMPT2_entailment
109,197,7,7,0,1.0,9,7,2,0.7777777777777778,0.8750000000000001,medlm,coral,pdac,PROMPT2_entailment
110,198,9,9,0,1.0,12,9,3,0.75,0.8571428571428571,medlm,coral,pdac,PROMPT2_entailment
111,199,12,10,2,0.8333333333333334,9,8,1,0.8888888888888888,0.8602150537634408,medlm,coral,pdac,PROMPT2_entailment
112,2,7,5,2,0.7142857142857143,14,11,3,0.7857142857142857,0.7482993197278911,medlm,coral,pdac,PROMPT2_entailment
113,20,20,13,7,0.65,18,11,7,0.6111111111111112,0.629955947136564,medlm,coral,pdac,PROMPT2_entailment
114,200,14,12,2,0.8571428571428571,16,13,3,0.8125,0.8342245989304812,medlm,coral,pdac,PROMPT2_entailment
115,201,11,11,0,1.0,10,10,0,1.0,1.0,medlm,coral,pdac,PROMPT2_entailment
116,202,10,10,0,1.0,10,10,0,1.0,1.0,medlm,coral,pdac,PROMPT2_entailment
117,203,18,13,5,0.7222222222222222,31,22,9,0.7096774193548387,0.7158948685857323,medlm,coral,pdac,PROMPT2_entailment
118,204,12,10,2,0.8333333333333334,14,8,6,0.5714285714285714,0.6779661016949152,medlm,coral,pdac,PROMPT2_entailment
119,205,8,7,1,0.875,7,5,2,0.7142857142857143,0.7865168539325842,medlm,coral,pdac,PROMPT2_entailment
120,206,10,9,1,0.9,9,5,4,0.5555555555555556,0.6870229007633587,medlm,coral,pdac,PROMPT2_entailment
121,207,12,10,2,0.8333333333333334,8,6,2,0.75,0.7894736842105262,medlm,coral,pdac,PROMPT2_entailment
122,208,8,7,1,0.875,8,8,0,1.0,0.9333333333333332,medlm,coral,pdac,PROMPT2_entailment
123,209,6,6,0,1.0,9,7,2,0.7777777777777778,0.8750000000000001,medlm,coral,pdac,PROMPT2_entailment
124,21,10,10,0,1.0,10,10,0,1.0,1.0,medlm,coral,pdac,PROMPT2_entailment
125,210,9,8,1,0.8888888888888888,9,2,7,0.2222222222222222,0.3555555555555555,medlm,coral,pdac,PROMPT2_entailment
126,211,9,6,3,0.6666666666666666,8,4,4,0.5,0.5714285714285715,medlm,coral,pdac,PROMPT2_entailment
127,212,16,16,0,1.0,17,13,4,0.7647058823529411,0.8666666666666666,medlm,coral,pdac,PROMPT2_entailment
128,213,13,12,1,0.9230769230769232,11,9,2,0.8181818181818182,0.8674698795180724,medlm,coral,pdac,PROMPT2_entailment
129,214,2,2,0,1.0,18,10,8,0.5555555555555556,0.7142857142857143,medlm,coral,pdac,PROMPT2_entailment
130,215,11,9,2,0.8181818181818182,12,7,5,0.5833333333333334,0.6810810810810811,medlm,coral,pdac,PROMPT2_entailment
131,216,6,5,1,0.8333333333333334,33,10,23,0.303030303030303,0.4444444444444444,medlm,coral,pdac,PROMPT2_entailment
132,217,7,6,1,0.8571428571428571,19,17,2,0.8947368421052632,0.8755364806866952,medlm,coral,pdac,PROMPT2_entailment
133,218,14,13,1,0.9285714285714286,11,9,2,0.8181818181818182,0.8698884758364314,medlm,coral,pdac,PROMPT2_entailment
134,219,9,7,2,0.7777777777777778,8,8,0,1.0,0.8750000000000001,medlm,coral,pdac,PROMPT2_entailment
135,22,7,5,2,0.7142857142857143,17,11,6,0.6470588235294118,0.6790123456790124,medlm,coral,pdac,PROMPT2_entailment
136,220,10,8,2,0.8,11,9,2,0.8181818181818182,0.8089887640449439,medlm,coral,pdac,PROMPT2_entailment
137,221,8,6,2,0.75,12,9,3,0.75,0.75,medlm,coral,pdac,PROMPT2_entailment
138,222,12,12,0,1.0,11,11,0,1.0,1.0,medlm,coral,pdac,PROMPT2_entailment
139,223,21,14,7,0.6666666666666666,37,11,26,0.2972972972972973,0.4112149532710281,medlm,coral,pdac,PROMPT2_entailment
140,224,12,9,3,0.75,8,7,1,0.875,0.8076923076923077,medlm,coral,pdac,PROMPT2_entailment
141,225,13,13,0,1.0,13,6,7,0.4615384615384615,0.631578947368421,medlm,coral,pdac,PROMPT2_entailment
142,226,8,6,2,0.75,11,6,5,0.5454545454545454,0.631578947368421,medlm,coral,pdac,PROMPT2_entailment
143,227,5,4,1,0.8,10,7,3,0.7,0.7466666666666666,medlm,coral,pdac,PROMPT2_entailment
144,228,8,7,1,0.875,9,9,0,1.0,0.9333333333333332,medlm,coral,pdac,PROMPT2_entailment
145,229,10,10,0,1.0,9,6,3,0.6666666666666666,0.8,medlm,coral,pdac,PROMPT2_entailment
146,23,11,11,0,1.0,12,10,2,0.8333333333333334,0.9090909090909092,medlm,coral,pdac,PROMPT2_entailment
147,230,11,11,0,1.0,8,8,0,1.0,1.0,medlm,coral,pdac,PROMPT2_entailment
148,24,12,12,0,1.0,9,8,1,0.8888888888888888,0.9411764705882352,medlm,coral,pdac,PROMPT2_entailment
149,25,8,7,1,0.875,11,9,2,0.8181818181818182,0.8456375838926175,medlm,coral,pdac,PROMPT2_entailment
150,26,10,9,1,0.9,11,10,1,0.9090909090909092,0.9045226130653266,medlm,coral,pdac,PROMPT2_entailment
151,27,9,9,0,1.0,12,10,2,0.8333333333333334,0.9090909090909092,medlm,coral,pdac,PROMPT2_entailment
152,28,12,10,2,0.8333333333333334,13,13,0,1.0,0.9090909090909092,medlm,coral,pdac,PROMPT2_entailment
153,29,17,15,2,0.8823529411764706,9,4,5,0.4444444444444444,0.5911330049261083,medlm,coral,pdac,PROMPT2_entailment
154,3,10,9,1,0.9,8,6,2,0.75,0.8181818181818182,medlm,coral,pdac,PROMPT2_entailment
155,30,27,20,7,0.7407407407407407,11,7,4,0.6363636363636364,0.6845965770171148,medlm,coral,pdac,PROMPT2_entailment
156,31,20,20,0,1.0,11,11,0,1.0,1.0,medlm,coral,pdac,PROMPT2_entailment
157,32,2,2,0,1.0,11,8,3,0.7272727272727273,0.8421052631578948,medlm,coral,pdac,PROMPT2_entailment
158,33,17,5,12,0.2941176470588235,24,9,15,0.375,0.3296703296703296,medlm,coral,pdac,PROMPT2_entailment
159,34,10,10,0,1.0,10,10,0,1.0,1.0,medlm,coral,pdac,PROMPT2_entailment
160,35,10,10,0,1.0,10,10,0,1.0,1.0,medlm,coral,pdac,PROMPT2_entailment
161,36,1,0,1,0.0,44,1,43,0.0227272727272727,0.0,medlm,coral,pdac,PROMPT2_entailment
162,37,14,14,0,1.0,9,6,3,0.6666666666666666,0.8,medlm,coral,pdac,PROMPT2_entailment
163,38,7,6,1,0.8571428571428571,13,7,6,0.5384615384615384,0.6614173228346457,medlm,coral,pdac,PROMPT2_entailment
164,39,11,10,1,0.9090909090909092,10,8,2,0.8,0.8510638297872342,medlm,coral,pdac,PROMPT2_entailment
165,4,16,10,6,0.625,15,7,8,0.4666666666666667,0.5343511450381679,medlm,coral,pdac,PROMPT2_entailment
166,40,2,1,1,0.5,10,4,6,0.4,0.4444444444444445,medlm,coral,pdac,PROMPT2_entailment
167,41,8,7,1,0.875,8,8,0,1.0,0.9333333333333332,medlm,coral,pdac,PROMPT2_entailment
168,42,9,7,2,0.7777777777777778,11,7,4,0.6363636363636364,0.7000000000000001,medlm,coral,pdac,PROMPT2_entailment
169,43,19,17,2,0.8947368421052632,13,8,5,0.6153846153846154,0.7292225201072386,medlm,coral,pdac,PROMPT2_entailment
170,44,10,9,1,0.9,11,8,3,0.7272727272727273,0.8044692737430167,medlm,coral,pdac,PROMPT2_entailment
171,45,15,13,2,0.8666666666666667,10,9,1,0.9,0.8830188679245283,medlm,coral,pdac,PROMPT2_entailment
172,46,16,11,5,0.6875,11,9,2,0.8181818181818182,0.7471698113207547,medlm,coral,pdac,PROMPT2_entailment
173,47,22,21,1,0.9545454545454546,39,19,20,0.4871794871794871,0.645109135004042,medlm,coral,pdac,PROMPT2_entailment
174,48,6,4,2,0.6666666666666666,10,6,4,0.6,0.631578947368421,medlm,coral,pdac,PROMPT2_entailment
175,49,11,11,0,1.0,10,6,4,0.6,0.7499999999999999,medlm,coral,pdac,PROMPT2_entailment
176,5,9,7,2,0.7777777777777778,10,8,2,0.8,0.7887323943661971,medlm,coral,pdac,PROMPT2_entailment
177,50,8,7,1,0.875,10,8,2,0.8,0.8358208955223881,medlm,coral,pdac,PROMPT2_entailment
178,51,10,9,1,0.9,12,7,5,0.5833333333333334,0.7078651685393258,medlm,coral,pdac,PROMPT2_entailment
179,52,11,10,1,0.9090909090909092,10,9,1,0.9,0.9045226130653266,medlm,coral,pdac,PROMPT2_entailment
180,53,7,6,1,0.8571428571428571,8,5,3,0.625,0.7228915662650602,medlm,coral,pdac,PROMPT2_entailment
181,54,2,2,0,1.0,2,2,0,1.0,1.0,medlm,coral,pdac,PROMPT2_entailment
182,55,13,12,1,0.9230769230769232,10,8,2,0.8,0.8571428571428571,medlm,coral,pdac,PROMPT2_entailment
183,56,12,11,1,0.9166666666666666,8,6,2,0.75,0.8250000000000001,medlm,coral,pdac,PROMPT2_entailment
184,57,10,9,1,0.9,13,9,4,0.6923076923076923,0.7826086956521738,medlm,coral,pdac,PROMPT2_entailment
185,58,19,16,3,0.8421052631578947,10,10,0,1.0,0.9142857142857144,medlm,coral,pdac,PROMPT2_entailment
186,59,15,10,5,0.6666666666666666,21,9,12,0.4285714285714285,0.5217391304347826,medlm,coral,pdac,PROMPT2_entailment
187,6,7,6,1,0.8571428571428571,12,8,4,0.6666666666666666,0.75,medlm,coral,pdac,PROMPT2_entailment
188,60,18,12,6,0.6666666666666666,13,10,3,0.7692307692307693,0.7142857142857142,medlm,coral,pdac,PROMPT2_entailment
189,61,10,10,0,1.0,7,7,0,1.0,1.0,medlm,coral,pdac,PROMPT2_entailment
190,62,12,9,3,0.75,11,10,1,0.9090909090909092,0.821917808219178,medlm,coral,pdac,PROMPT2_entailment
191,63,10,10,0,1.0,10,10,0,1.0,1.0,medlm,coral,pdac,PROMPT2_entailment
192,64,15,15,0,1.0,12,10,2,0.8333333333333334,0.9090909090909092,medlm,coral,pdac,PROMPT2_entailment
193,65,9,7,2,0.7777777777777778,9,9,0,1.0,0.8750000000000001,medlm,coral,pdac,PROMPT2_entailment
194,66,10,8,2,0.8,12,7,5,0.5833333333333334,0.674698795180723,medlm,coral,pdac,PROMPT2_entailment
195,67,3,3,0,1.0,1,0,1,0.0,0.0,medlm,coral,pdac,PROMPT2_entailment
196,68,10,9,1,0.9,11,7,4,0.6363636363636364,0.7455621301775148,medlm,coral,pdac,PROMPT2_entailment
197,69,8,6,2,0.75,10,8,2,0.8,0.7741935483870969,medlm,coral,pdac,PROMPT2_entailment
198,7,8,8,0,1.0,11,9,2,0.8181818181818182,0.9,medlm,coral,pdac,PROMPT2_entailment
199,70,11,9,2,0.8181818181818182,15,13,2,0.8666666666666667,0.8417266187050358,medlm,coral,pdac,PROMPT2_entailment
200,71,21,12,9,0.5714285714285714,9,7,2,0.7777777777777778,0.6588235294117646,medlm,coral,pdac,PROMPT2_entailment
201,72,10,9,1,0.9,13,9,4,0.6923076923076923,0.7826086956521738,medlm,coral,pdac,PROMPT2_entailment
202,73,22,7,15,0.3181818181818182,154,29,125,0.1883116883116883,0.2365967365967365,medlm,coral,pdac,PROMPT2_entailment
203,74,13,10,3,0.7692307692307693,8,7,1,0.875,0.8187134502923977,medlm,coral,pdac,PROMPT2_entailment
204,75,14,11,3,0.7857142857142857,7,6,1,0.8571428571428571,0.8198757763975155,medlm,coral,pdac,PROMPT2_entailment
205,76,6,4,2,0.6666666666666666,7,5,2,0.7142857142857143,0.689655172413793,medlm,coral,pdac,PROMPT2_entailment
206,77,15,12,3,0.8,8,7,1,0.875,0.8358208955223881,medlm,coral,pdac,PROMPT2_entailment
207,78,7,4,3,0.5714285714285714,8,6,2,0.75,0.6486486486486486,medlm,coral,pdac,PROMPT2_entailment
208,79,9,6,3,0.6666666666666666,11,8,3,0.7272727272727273,0.6956521739130435,medlm,coral,pdac,PROMPT2_entailment
209,8,3,3,0,1.0,2,1,1,0.5,0.6666666666666666,medlm,coral,pdac,PROMPT2_entailment
210,80,12,11,1,0.9166666666666666,9,8,1,0.8888888888888888,0.9025641025641026,medlm,coral,pdac,PROMPT2_entailment
211,81,8,6,2,0.75,6,5,1,0.8333333333333334,0.7894736842105262,medlm,coral,pdac,PROMPT2_entailment
212,82,11,11,0,1.0,4,3,1,0.75,0.8571428571428571,medlm,coral,pdac,PROMPT2_entailment
213,83,12,12,0,1.0,11,5,6,0.4545454545454545,0.625,medlm,coral,pdac,PROMPT2_entailment
214,84,15,7,8,0.4666666666666667,11,8,3,0.7272727272727273,0.5685279187817259,medlm,coral,pdac,PROMPT2_entailment
215,85,22,13,9,0.5909090909090909,35,16,19,0.4571428571428571,0.5154894671623296,medlm,coral,pdac,PROMPT2_entailment
216,86,11,9,2,0.8181818181818182,10,7,3,0.7,0.7544910179640719,medlm,coral,pdac,PROMPT2_entailment
217,87,1,0,1,0.0,7,3,4,0.4285714285714285,0.0,medlm,coral,pdac,PROMPT2_entailment
218,88,13,13,0,1.0,8,5,3,0.625,0.7692307692307693,medlm,coral,pdac,PROMPT2_entailment
219,89,9,8,1,0.8888888888888888,10,9,1,0.9,0.8944099378881988,medlm,coral,pdac,PROMPT2_entailment
220,9,8,8,0,1.0,12,7,5,0.5833333333333334,0.7368421052631579,medlm,coral,pdac,PROMPT2_entailment
221,90,9,6,3,0.6666666666666666,9,8,1,0.8888888888888888,0.761904761904762,medlm,coral,pdac,PROMPT2_entailment
222,91,10,10,0,1.0,10,9,1,0.9,0.9473684210526316,medlm,coral,pdac,PROMPT2_entailment
223,92,10,8,2,0.8,10,8,2,0.8,0.8000000000000002,medlm,coral,pdac,PROMPT2_entailment
224,93,8,7,1,0.875,9,9,0,1.0,0.9333333333333332,medlm,coral,pdac,PROMPT2_entailment
225,94,11,9,2,0.8181818181818182,7,5,2,0.7142857142857143,0.7627118644067797,medlm,coral,pdac,PROMPT2_entailment
226,95,7,6,1,0.8571428571428571,8,7,1,0.875,0.8659793814432989,medlm,coral,pdac,PROMPT2_entailment
227,96,7,6,1,0.8571428571428571,4,4,0,1.0,0.923076923076923,medlm,coral,pdac,PROMPT2_entailment
228,97,10,8,2,0.8,8,7,1,0.875,0.8358208955223881,medlm,coral,pdac,PROMPT2_entailment
229,98,12,11,1,0.9166666666666666,9,7,2,0.7777777777777778,0.8415300546448087,medlm,coral,pdac,PROMPT2_entailment
230,99,9,8,1,0.8888888888888888,9,8,1,0.8888888888888888,0.8888888888888888,medlm,coral,pdac,PROMPT2_entailment
0,0,5,5,0,1.0,10,10,0,1.0,1.0,medlm,coral,breastca,PROMPT1_entailment
1,1,11,9,2,0.8181818181818182,12,9,3,0.75,0.7826086956521738,medlm,coral,breastca,PROMPT1_entailment
2,10,12,9,3,0.75,10,8,2,0.8,0.7741935483870969,medlm,coral,breastca,PROMPT1_entailment
3,100,9,7,2,0.7777777777777778,26,13,13,0.5,0.6086956521739131,medlm,coral,breastca,PROMPT1_entailment
4,101,8,8,0,1.0,18,10,8,0.5555555555555556,0.7142857142857143,medlm,coral,breastca,PROMPT1_entailment
5,102,5,5,0,1.0,7,7,0,1.0,1.0,medlm,coral,breastca,PROMPT1_entailment
6,103,1,1,0,1.0,10,8,2,0.8,0.888888888888889,medlm,coral,breastca,PROMPT1_entailment
7,104,9,9,0,1.0,26,8,18,0.3076923076923077,0.4705882352941176,medlm,coral,breastca,PROMPT1_entailment
8,105,10,9,1,0.9,15,10,5,0.6666666666666666,0.7659574468085106,medlm,coral,breastca,PROMPT1_entailment
9,106,10,8,2,0.8,9,9,0,1.0,0.888888888888889,medlm,coral,breastca,PROMPT1_entailment
10,107,1,0,1,0.0,9,6,3,0.6666666666666666,0.0,medlm,coral,breastca,PROMPT1_entailment
11,108,4,3,1,0.75,11,9,2,0.8181818181818182,0.7826086956521738,medlm,coral,breastca,PROMPT1_entailment
12,109,8,7,1,0.875,11,10,1,0.9090909090909092,0.8917197452229298,medlm,coral,breastca,PROMPT1_entailment
13,11,4,4,0,1.0,3,3,0,1.0,1.0,medlm,coral,breastca,PROMPT1_entailment
14,110,6,6,0,1.0,11,7,4,0.6363636363636364,0.7777777777777778,medlm,coral,breastca,PROMPT1_entailment
15,111,8,6,2,0.75,10,9,1,0.9,0.8181818181818182,medlm,coral,breastca,PROMPT1_entailment
16,112,1,0,1,0.0,10,6,4,0.6,0.0,medlm,coral,breastca,PROMPT1_entailment
17,113,22,14,8,0.6363636363636364,49,23,26,0.4693877551020408,0.540268456375839,medlm,coral,breastca,PROMPT1_entailment
18,114,1,0,1,0.0,21,14,7,0.6666666666666666,0.0,medlm,coral,breastca,PROMPT1_entailment
19,115,6,6,0,1.0,9,6,3,0.6666666666666666,0.8,medlm,coral,breastca,PROMPT1_entailment
20,116,15,14,1,0.9333333333333332,14,12,2,0.8571428571428571,0.8936170212765957,medlm,coral,breastca,PROMPT1_entailment
21,117,1,1,0,1.0,2,2,0,1.0,1.0,medlm,coral,breastca,PROMPT1_entailment
22,118,1,1,0,1.0,19,7,12,0.3684210526315789,0.5384615384615384,medlm,coral,breastca,PROMPT1_entailment
23,12,8,8,0,1.0,10,10,0,1.0,1.0,medlm,coral,breastca,PROMPT1_entailment
24,120,1,0,1,0.0,9,8,1,0.8888888888888888,0.0,medlm,coral,breastca,PROMPT1_entailment
25,121,9,8,1,0.8888888888888888,10,5,5,0.5,0.64,medlm,coral,breastca,PROMPT1_entailment
26,122,7,7,0,1.0,9,7,2,0.7777777777777778,0.8750000000000001,medlm,coral,breastca,PROMPT1_entailment
27,123,1,0,1,0.0,8,7,1,0.875,0.0,medlm,coral,breastca,PROMPT1_entailment
28,125,1,0,1,0.0,11,8,3,0.7272727272727273,0.0,medlm,coral,breastca,PROMPT1_entailment
29,126,6,4,2,0.6666666666666666,10,10,0,1.0,0.8,medlm,coral,breastca,PROMPT1_entailment
30,127,1,0,1,0.0,10,4,6,0.4,0.0,medlm,coral,breastca,PROMPT1_entailment
31,128,9,9,0,1.0,11,8,3,0.7272727272727273,0.8421052631578948,medlm,coral,breastca,PROMPT1_entailment
32,129,9,8,1,0.8888888888888888,11,9,2,0.8181818181818182,0.8520710059171598,medlm,coral,breastca,PROMPT1_entailment
33,13,9,6,3,0.6666666666666666,10,9,1,0.9,0.7659574468085106,medlm,coral,breastca,PROMPT1_entailment
34,130,1,0,1,0.0,7,2,5,0.2857142857142857,0.0,medlm,coral,breastca,PROMPT1_entailment
35,131,13,11,2,0.8461538461538461,10,10,0,1.0,0.9166666666666666,medlm,coral,breastca,PROMPT1_entailment
36,132,1,0,1,0.0,8,7,1,0.875,0.0,medlm,coral,breastca,PROMPT1_entailment
37,133,1,1,0,1.0,29,14,15,0.4827586206896552,0.6511627906976745,medlm,coral,breastca,PROMPT1_entailment
38,134,3,1,2,0.3333333333333333,11,9,2,0.8181818181818182,0.4736842105263157,medlm,coral,breastca,PROMPT1_entailment
39,135,4,2,2,0.5,16,9,7,0.5625,0.5294117647058824,medlm,coral,breastca,PROMPT1_entailment
40,136,1,1,0,1.0,10,7,3,0.7,0.8235294117647058,medlm,coral,breastca,PROMPT1_entailment
41,137,1,1,0,1.0,10,10,0,1.0,1.0,medlm,coral,breastca,PROMPT1_entailment
42,138,3,3,0,1.0,10,10,0,1.0,1.0,medlm,coral,breastca,PROMPT1_entailment
43,139,5,3,2,0.6,11,11,0,1.0,0.7499999999999999,medlm,coral,breastca,PROMPT1_entailment
44,14,12,9,3,0.75,59,5,54,0.0847457627118644,0.1522842639593908,medlm,coral,breastca,PROMPT1_entailment
45,140,1,0,1,0.0,9,5,4,0.5555555555555556,0.0,medlm,coral,breastca,PROMPT1_entailment
46,141,7,5,2,0.7142857142857143,11,11,0,1.0,0.8333333333333333,medlm,coral,breastca,PROMPT1_entailment
47,142,1,1,0,1.0,10,9,1,0.9,0.9473684210526316,medlm,coral,breastca,PROMPT1_entailment
48,143,5,2,3,0.4,10,5,5,0.5,0.4444444444444445,medlm,coral,breastca,PROMPT1_entailment
49,144,6,6,0,1.0,5,5,0,1.0,1.0,medlm,coral,breastca,PROMPT1_entailment
50,145,11,10,1,0.9090909090909092,5,4,1,0.8,0.8510638297872342,medlm,coral,breastca,PROMPT1_entailment
51,146,10,10,0,1.0,9,8,1,0.8888888888888888,0.9411764705882352,medlm,coral,breastca,PROMPT1_entailment
52,147,1,0,1,0.0,5,5,0,1.0,0.0,medlm,coral,breastca,PROMPT1_entailment
53,148,1,0,1,0.0,4,0,4,0.0,,medlm,coral,breastca,PROMPT1_entailment
54,149,1,1,0,1.0,1,1,0,1.0,1.0,medlm,coral,breastca,PROMPT1_entailment
55,15,1,1,0,1.0,16,5,11,0.3125,0.4761904761904761,medlm,coral,breastca,PROMPT1_entailment
56,150,1,1,0,1.0,2,1,1,0.5,0.6666666666666666,medlm,coral,breastca,PROMPT1_entailment
57,151,5,3,2,0.6,9,7,2,0.7777777777777778,0.6774193548387097,medlm,coral,breastca,PROMPT1_entailment
58,152,1,1,0,1.0,16,5,11,0.3125,0.4761904761904761,medlm,coral,breastca,PROMPT1_entailment
59,153,1,1,0,1.0,1,1,0,1.0,1.0,medlm,coral,breastca,PROMPT1_entailment
60,154,7,7,0,1.0,10,10,0,1.0,1.0,medlm,coral,breastca,PROMPT1_entailment
61,155,6,3,3,0.5,9,9,0,1.0,0.6666666666666666,medlm,coral,breastca,PROMPT1_entailment
62,156,1,1,0,1.0,8,7,1,0.875,0.9333333333333332,medlm,coral,breastca,PROMPT1_entailment
63,157,1,1,0,1.0,9,9,0,1.0,1.0,medlm,coral,breastca,PROMPT1_entailment
64,158,1,0,1,0.0,16,15,1,0.9375,0.0,medlm,coral,breastca,PROMPT1_entailment
65,159,5,5,0,1.0,29,14,15,0.4827586206896552,0.6511627906976745,medlm,coral,breastca,PROMPT1_entailment
66,16,13,13,0,1.0,10,6,4,0.6,0.7499999999999999,medlm,coral,breastca,PROMPT1_entailment
67,160,1,1,0,1.0,18,10,8,0.5555555555555556,0.7142857142857143,medlm,coral,breastca,PROMPT1_entailment
68,161,1,1,0,1.0,11,7,4,0.6363636363636364,0.7777777777777778,medlm,coral,breastca,PROMPT1_entailment
69,162,4,4,0,1.0,16,11,5,0.6875,0.8148148148148148,medlm,coral,breastca,PROMPT1_entailment
70,163,9,9,0,1.0,11,8,3,0.7272727272727273,0.8421052631578948,medlm,coral,breastca,PROMPT1_entailment
71,164,8,7,1,0.875,8,4,4,0.5,0.6363636363636364,medlm,coral,breastca,PROMPT1_entailment
72,165,5,3,2,0.6,12,11,1,0.9166666666666666,0.7252747252747253,medlm,coral,breastca,PROMPT1_entailment
73,166,7,6,1,0.8571428571428571,10,4,6,0.4,0.5454545454545455,medlm,coral,breastca,PROMPT1_entailment
74,167,5,5,0,1.0,7,5,2,0.7142857142857143,0.8333333333333333,medlm,coral,breastca,PROMPT1_entailment
75,168,1,0,1,0.0,7,6,1,0.8571428571428571,0.0,medlm,coral,breastca,PROMPT1_entailment
76,169,7,6,1,0.8571428571428571,11,6,5,0.5454545454545454,0.6666666666666665,medlm,coral,breastca,PROMPT1_entailment
77,17,1,1,0,1.0,3,3,0,1.0,1.0,medlm,coral,breastca,PROMPT1_entailment
78,170,1,1,0,1.0,10,9,1,0.9,0.9473684210526316,medlm,coral,breastca,PROMPT1_entailment
79,171,1,1,0,1.0,9,9,0,1.0,1.0,medlm,coral,breastca,PROMPT1_entailment
80,172,18,16,2,0.8888888888888888,32,13,19,0.40625,0.5576407506702413,medlm,coral,breastca,PROMPT1_entailment
81,173,1,0,1,0.0,11,10,1,0.9090909090909092,0.0,medlm,coral,breastca,PROMPT1_entailment
82,174,1,1,0,1.0,7,5,2,0.7142857142857143,0.8333333333333333,medlm,coral,breastca,PROMPT1_entailment
83,175,7,7,0,1.0,10,8,2,0.8,0.888888888888889,medlm,coral,breastca,PROMPT1_entailment
84,176,5,5,0,1.0,10,4,6,0.4,0.5714285714285715,medlm,coral,breastca,PROMPT1_entailment
85,177,1,0,1,0.0,9,6,3,0.6666666666666666,0.0,medlm,coral,breastca,PROMPT1_entailment
86,178,5,3,2,0.6,10,5,5,0.5,0.5454545454545454,medlm,coral,breastca,PROMPT1_entailment
87,179,7,7,0,1.0,9,7,2,0.7777777777777778,0.8750000000000001,medlm,coral,breastca,PROMPT1_entailment
88,18,1,1,0,1.0,8,7,1,0.875,0.9333333333333332,medlm,coral,breastca,PROMPT1_entailment
89,180,7,6,1,0.8571428571428571,10,9,1,0.9,0.8780487804878048,medlm,coral,breastca,PROMPT1_entailment
90,181,5,4,1,0.8,9,8,1,0.8888888888888888,0.8421052631578948,medlm,coral,breastca,PROMPT1_entailment
91,182,1,1,0,1.0,9,4,5,0.4444444444444444,0.6153846153846153,medlm,coral,breastca,PROMPT1_entailment
92,183,1,1,0,1.0,10,9,1,0.9,0.9473684210526316,medlm,coral,breastca,PROMPT1_entailment
93,184,12,10,2,0.8333333333333334,9,5,4,0.5555555555555556,0.6666666666666667,medlm,coral,breastca,PROMPT1_entailment
94,185,1,1,0,1.0,10,8,2,0.8,0.888888888888889,medlm,coral,breastca,PROMPT1_entailment
95,186,6,6,0,1.0,5,5,0,1.0,1.0,medlm,coral,breastca,PROMPT1_entailment
96,187,5,4,1,0.8,26,14,12,0.5384615384615384,0.6436781609195402,medlm,coral,breastca,PROMPT1_entailment
97,188,1,1,0,1.0,9,8,1,0.8888888888888888,0.9411764705882352,medlm,coral,breastca,PROMPT1_entailment
98,189,1,0,1,0.0,9,9,0,1.0,0.0,medlm,coral,breastca,PROMPT1_entailment
99,19,10,9,1,0.9,8,5,3,0.625,0.7377049180327869,medlm,coral,breastca,PROMPT1_entailment
100,190,7,3,4,0.4285714285714285,34,12,22,0.3529411764705882,0.3870967741935484,medlm,coral,breastca,PROMPT1_entailment
101,191,22,16,6,0.7272727272727273,14,11,3,0.7857142857142857,0.7553648068669527,medlm,coral,breastca,PROMPT1_entailment
102,192,1,0,1,0.0,12,10,2,0.8333333333333334,0.0,medlm,coral,breastca,PROMPT1_entailment
103,193,1,1,0,1.0,2,2,0,1.0,1.0,medlm,coral,breastca,PROMPT1_entailment
104,194,9,9,0,1.0,15,14,1,0.9333333333333332,0.9655172413793104,medlm,coral,breastca,PROMPT1_entailment
105,195,10,7,3,0.7,13,11,2,0.8461538461538461,0.7661691542288558,medlm,coral,breastca,PROMPT1_entailment
106,196,6,5,1,0.8333333333333334,30,15,15,0.5,0.625,medlm,coral,breastca,PROMPT1_entailment
107,197,10,6,4,0.6,14,11,3,0.7857142857142857,0.6804123711340206,medlm,coral,breastca,PROMPT1_entailment
108,198,9,9,0,1.0,11,8,3,0.7272727272727273,0.8421052631578948,medlm,coral,breastca,PROMPT1_entailment
109,199,1,0,1,0.0,2,2,0,1.0,0.0,medlm,coral,breastca,PROMPT1_entailment
110,2,11,9,2,0.8181818181818182,10,8,2,0.8,0.8089887640449439,medlm,coral,breastca,PROMPT1_entailment
111,20,1,1,0,1.0,17,5,12,0.2941176470588235,0.4545454545454545,medlm,coral,breastca,PROMPT1_entailment
112,200,1,1,0,1.0,15,11,4,0.7333333333333333,0.846153846153846,medlm,coral,breastca,PROMPT1_entailment
113,201,1,1,0,1.0,26,12,14,0.4615384615384615,0.631578947368421,medlm,coral,breastca,PROMPT1_entailment
114,202,8,8,0,1.0,17,12,5,0.7058823529411765,0.8275862068965517,medlm,coral,breastca,PROMPT1_entailment
115,203,1,1,0,1.0,27,13,14,0.4814814814814814,0.65,medlm,coral,breastca,PROMPT1_entailment
116,204,1,0,1,0.0,11,9,2,0.8181818181818182,0.0,medlm,coral,breastca,PROMPT1_entailment
117,205,1,1,0,1.0,11,7,4,0.6363636363636364,0.7777777777777778,medlm,coral,breastca,PROMPT1_entailment
118,206,1,0,1,0.0,4,4,0,1.0,0.0,medlm,coral,breastca,PROMPT1_entailment
119,207,6,6,0,1.0,12,6,6,0.5,0.6666666666666666,medlm,coral,breastca,PROMPT1_entailment
120,208,8,8,0,1.0,9,9,0,1.0,1.0,medlm,coral,breastca,PROMPT1_entailment
121,209,1,1,0,1.0,11,9,2,0.8181818181818182,0.9,medlm,coral,breastca,PROMPT1_entailment
122,21,16,8,8,0.5,27,19,8,0.7037037037037037,0.5846153846153846,medlm,coral,breastca,PROMPT1_entailment
123,210,16,14,2,0.875,13,10,3,0.7692307692307693,0.8187134502923977,medlm,coral,breastca,PROMPT1_entailment
124,211,12,4,8,0.3333333333333333,11,7,4,0.6363636363636364,0.4374999999999999,medlm,coral,breastca,PROMPT1_entailment
125,212,10,10,0,1.0,9,6,3,0.6666666666666666,0.8,medlm,coral,breastca,PROMPT1_entailment
126,213,10,8,2,0.8,11,9,2,0.8181818181818182,0.8089887640449439,medlm,coral,breastca,PROMPT1_entailment
127,214,5,1,4,0.2,28,13,15,0.4642857142857143,0.2795698924731182,medlm,coral,breastca,PROMPT1_entailment
128,215,1,1,0,1.0,37,17,20,0.4594594594594595,0.6296296296296297,medlm,coral,breastca,PROMPT1_entailment
129,216,1,1,0,1.0,15,14,1,0.9333333333333332,0.9655172413793104,medlm,coral,breastca,PROMPT1_entailment
130,22,12,7,5,0.5833333333333334,7,3,4,0.4285714285714285,0.4941176470588235,medlm,coral,breastca,PROMPT1_entailment
131,23,8,7,1,0.875,9,8,1,0.8888888888888888,0.8818897637795274,medlm,coral,breastca,PROMPT1_entailment
132,24,8,5,3,0.625,10,7,3,0.7,0.6603773584905661,medlm,coral,breastca,PROMPT1_entailment
133,25,7,7,0,1.0,8,5,3,0.625,0.7692307692307693,medlm,coral,breastca,PROMPT1_entailment
134,26,1,0,1,0.0,11,7,4,0.6363636363636364,0.0,medlm,coral,breastca,PROMPT1_entailment
135,27,8,5,3,0.625,12,6,6,0.5,0.5555555555555556,medlm,coral,breastca,PROMPT1_entailment
136,28,8,7,1,0.875,18,14,4,0.7777777777777778,0.823529411764706,medlm,coral,breastca,PROMPT1_entailment
137,29,1,0,1,0.0,9,5,4,0.5555555555555556,0.0,medlm,coral,breastca,PROMPT1_entailment
138,3,13,7,6,0.5384615384615384,11,7,4,0.6363636363636364,0.5833333333333334,medlm,coral,breastca,PROMPT1_entailment
139,30,7,5,2,0.7142857142857143,18,9,9,0.5,0.588235294117647,medlm,coral,breastca,PROMPT1_entailment
140,31,12,9,3,0.75,13,9,4,0.6923076923076923,0.7199999999999999,medlm,coral,breastca,PROMPT1_entailment
141,32,1,0,1,0.0,9,8,1,0.8888888888888888,0.0,medlm,coral,breastca,PROMPT1_entailment
142,33,8,4,4,0.5,8,6,2,0.75,0.6,medlm,coral,breastca,PROMPT1_entailment
143,34,5,3,2,0.6,10,8,2,0.8,0.6857142857142857,medlm,coral,breastca,PROMPT1_entailment
144,35,2,2,0,1.0,12,6,6,0.5,0.6666666666666666,medlm,coral,breastca,PROMPT1_entailment
145,36,1,1,0,1.0,11,9,2,0.8181818181818182,0.9,medlm,coral,breastca,PROMPT1_entailment
146,37,9,5,4,0.5555555555555556,11,10,1,0.9090909090909092,0.6896551724137931,medlm,coral,breastca,PROMPT1_entailment
147,38,6,5,1,0.8333333333333334,11,8,3,0.7272727272727273,0.7766990291262137,medlm,coral,breastca,PROMPT1_entailment
148,39,10,9,1,0.9,11,10,1,0.9090909090909092,0.9045226130653266,medlm,coral,breastca,PROMPT1_entailment
149,4,14,8,6,0.5714285714285714,59,24,35,0.4067796610169492,0.4752475247524753,medlm,coral,breastca,PROMPT1_entailment
150,40,6,5,1,0.8333333333333334,9,7,2,0.7777777777777778,0.8045977011494253,medlm,coral,breastca,PROMPT1_entailment
151,41,5,5,0,1.0,14,9,5,0.6428571428571429,0.782608695652174,medlm,coral,breastca,PROMPT1_entailment
152,42,1,1,0,1.0,9,3,6,0.3333333333333333,0.5,medlm,coral,breastca,PROMPT1_entailment
153,43,10,7,3,0.7,9,7,2,0.7777777777777778,0.7368421052631577,medlm,coral,breastca,PROMPT1_entailment
154,44,1,0,1,0.0,9,7,2,0.7777777777777778,0.0,medlm,coral,breastca,PROMPT1_entailment
155,45,3,3,0,1.0,2,2,0,1.0,1.0,medlm,coral,breastca,PROMPT1_entailment
156,46,6,6,0,1.0,5,5,0,1.0,1.0,medlm,coral,breastca,PROMPT1_entailment
157,47,12,11,1,0.9166666666666666,2,2,0,1.0,0.9565217391304348,medlm,coral,breastca,PROMPT1_entailment
158,48,1,1,0,1.0,5,5,0,1.0,1.0,medlm,coral,breastca,PROMPT1_entailment
159,49,1,0,1,0.0,16,11,5,0.6875,0.0,medlm,coral,breastca,PROMPT1_entailment
160,5,10,8,2,0.8,12,10,2,0.8333333333333334,0.816326530612245,medlm,coral,breastca,PROMPT1_entailment
161,50,11,10,1,0.9090909090909092,16,12,4,0.75,0.821917808219178,medlm,coral,breastca,PROMPT1_entailment
162,51,6,3,3,0.5,11,10,1,0.9090909090909092,0.6451612903225806,medlm,coral,breastca,PROMPT1_entailment
163,52,5,4,1,0.8,10,6,4,0.6,0.6857142857142857,medlm,coral,breastca,PROMPT1_entailment
164,53,1,1,0,1.0,10,10,0,1.0,1.0,medlm,coral,breastca,PROMPT1_entailment
165,54,1,1,0,1.0,9,8,1,0.8888888888888888,0.9411764705882352,medlm,coral,breastca,PROMPT1_entailment
166,55,3,3,0,1.0,1,1,0,1.0,1.0,medlm,coral,breastca,PROMPT1_entailment
167,56,7,7,0,1.0,18,4,14,0.2222222222222222,0.3636363636363636,medlm,coral,breastca,PROMPT1_entailment
168,57,9,7,2,0.7777777777777778,10,10,0,1.0,0.8750000000000001,medlm,coral,breastca,PROMPT1_entailment
169,58,6,5,1,0.8333333333333334,10,8,2,0.8,0.816326530612245,medlm,coral,breastca,PROMPT1_entailment
170,59,1,1,0,1.0,9,8,1,0.8888888888888888,0.9411764705882352,medlm,coral,breastca,PROMPT1_entailment
171,6,5,5,0,1.0,8,6,2,0.75,0.8571428571428571,medlm,coral,breastca,PROMPT1_entailment
172,60,1,1,0,1.0,10,10,0,1.0,1.0,medlm,coral,breastca,PROMPT1_entailment
173,61,1,1,0,1.0,11,11,0,1.0,1.0,medlm,coral,breastca,PROMPT1_entailment
174,62,1,1,0,1.0,10,9,1,0.9,0.9473684210526316,medlm,coral,breastca,PROMPT1_entailment
175,63,7,7,0,1.0,11,8,3,0.7272727272727273,0.8421052631578948,medlm,coral,breastca,PROMPT1_entailment
176,64,1,1,0,1.0,18,7,11,0.3888888888888889,0.56,medlm,coral,breastca,PROMPT1_entailment
177,65,9,9,0,1.0,6,6,0,1.0,1.0,medlm,coral,breastca,PROMPT1_entailment
178,66,9,7,2,0.7777777777777778,10,9,1,0.9,0.8344370860927153,medlm,coral,breastca,PROMPT1_entailment
179,67,5,5,0,1.0,49,21,28,0.4285714285714285,0.6,medlm,coral,breastca,PROMPT1_entailment
180,68,1,1,0,1.0,8,8,0,1.0,1.0,medlm,coral,breastca,PROMPT1_entailment
181,69,15,15,0,1.0,12,2,10,0.1666666666666666,0.2857142857142857,medlm,coral,breastca,PROMPT1_entailment
182,7,9,8,1,0.8888888888888888,11,8,3,0.7272727272727273,0.7999999999999999,medlm,coral,breastca,PROMPT1_entailment
183,70,1,1,0,1.0,51,5,46,0.0980392156862745,0.1785714285714285,medlm,coral,breastca,PROMPT1_entailment
184,71,6,6,0,1.0,5,5,0,1.0,1.0,medlm,coral,breastca,PROMPT1_entailment
185,72,1,1,0,1.0,3,2,1,0.6666666666666666,0.8,medlm,coral,breastca,PROMPT1_entailment
186,73,1,1,0,1.0,1,1,0,1.0,1.0,medlm,coral,breastca,PROMPT1_entailment
187,74,1,0,1,0.0,2,1,1,0.5,0.0,medlm,coral,breastca,PROMPT1_entailment
188,75,1,1,0,1.0,6,6,0,1.0,1.0,medlm,coral,breastca,PROMPT1_entailment
189,76,1,1,0,1.0,7,7,0,1.0,1.0,medlm,coral,breastca,PROMPT1_entailment
190,77,6,5,1,0.8333333333333334,15,10,5,0.6666666666666666,0.7407407407407408,medlm,coral,breastca,PROMPT1_entailment
191,78,1,0,1,0.0,8,6,2,0.75,0.0,medlm,coral,breastca,PROMPT1_entailment
192,79,1,0,1,0.0,8,8,0,1.0,0.0,medlm,coral,breastca,PROMPT1_entailment
193,8,5,4,1,0.8,9,5,4,0.5555555555555556,0.6557377049180328,medlm,coral,breastca,PROMPT1_entailment
194,80,34,31,3,0.9117647058823528,24,16,8,0.6666666666666666,0.7701863354037267,medlm,coral,breastca,PROMPT1_entailment
195,81,1,1,0,1.0,11,10,1,0.9090909090909092,0.9523809523809524,medlm,coral,breastca,PROMPT1_entailment
196,82,1,1,0,1.0,6,6,0,1.0,1.0,medlm,coral,breastca,PROMPT1_entailment
197,83,7,7,0,1.0,6,5,1,0.8333333333333334,0.9090909090909092,medlm,coral,breastca,PROMPT1_entailment
198,84,1,1,0,1.0,11,9,2,0.8181818181818182,0.9,medlm,coral,breastca,PROMPT1_entailment
199,85,1,0,1,0.0,7,4,3,0.5714285714285714,0.0,medlm,coral,breastca,PROMPT1_entailment
200,86,15,10,5,0.6666666666666666,16,9,7,0.5625,0.6101694915254238,medlm,coral,breastca,PROMPT1_entailment
201,87,1,1,0,1.0,8,8,0,1.0,1.0,medlm,coral,breastca,PROMPT1_entailment
202,88,7,7,0,1.0,8,7,1,0.875,0.9333333333333332,medlm,coral,breastca,PROMPT1_entailment
203,89,9,9,0,1.0,11,11,0,1.0,1.0,medlm,coral,breastca,PROMPT1_entailment
204,9,10,6,4,0.6,6,3,3,0.5,0.5454545454545454,medlm,coral,breastca,PROMPT1_entailment
205,90,12,2,10,0.1666666666666666,18,8,10,0.4444444444444444,0.2424242424242424,medlm,coral,breastca,PROMPT1_entailment
206,91,2,2,0,1.0,7,5,2,0.7142857142857143,0.8333333333333333,medlm,coral,breastca,PROMPT1_entailment
207,92,3,3,0,1.0,2,2,0,1.0,1.0,medlm,coral,breastca,PROMPT1_entailment
208,93,4,4,0,1.0,13,8,5,0.6153846153846154,0.761904761904762,medlm,coral,breastca,PROMPT1_entailment
209,94,10,9,1,0.9,25,11,14,0.44,0.591044776119403,medlm,coral,breastca,PROMPT1_entailment
210,95,1,1,0,1.0,13,7,6,0.5384615384615384,0.7000000000000001,medlm,coral,breastca,PROMPT1_entailment
211,96,14,12,2,0.8571428571428571,10,9,1,0.9,0.8780487804878048,medlm,coral,breastca,PROMPT1_entailment
212,97,10,9,1,0.9,11,9,2,0.8181818181818182,0.8571428571428572,medlm,coral,breastca,PROMPT1_entailment
213,98,2,2,0,1.0,2,2,0,1.0,1.0,medlm,coral,breastca,PROMPT1_entailment
214,99,8,7,1,0.875,15,10,5,0.6666666666666666,0.7567567567567567,medlm,coral,breastca,PROMPT1_entailment
0,0,12,12,0,1.0,10,10,0,1.0,1.0,medlm,coral,breastca,PROMPT1_ICL_entailment
1,1,15,13,2,0.8666666666666667,12,10,2,0.8333333333333334,0.8496732026143791,medlm,coral,breastca,PROMPT1_ICL_entailment
2,10,8,6,2,0.75,10,10,0,1.0,0.8571428571428571,medlm,coral,breastca,PROMPT1_ICL_entailment
3,100,11,11,0,1.0,26,13,13,0.5,0.6666666666666666,medlm,coral,breastca,PROMPT1_ICL_entailment
4,101,21,20,1,0.9523809523809524,18,12,6,0.6666666666666666,0.7843137254901961,medlm,coral,breastca,PROMPT1_ICL_entailment
5,102,8,8,0,1.0,7,6,1,0.8571428571428571,0.923076923076923,medlm,coral,breastca,PROMPT1_ICL_entailment
6,103,32,32,0,1.0,10,9,1,0.9,0.9473684210526316,medlm,coral,breastca,PROMPT1_ICL_entailment
7,104,12,12,0,1.0,26,10,16,0.3846153846153846,0.5555555555555556,medlm,coral,breastca,PROMPT1_ICL_entailment
8,105,14,14,0,1.0,15,13,2,0.8666666666666667,0.9285714285714286,medlm,coral,breastca,PROMPT1_ICL_entailment
9,106,13,12,1,0.9230769230769232,9,8,1,0.8888888888888888,0.9056603773584906,medlm,coral,breastca,PROMPT1_ICL_entailment
10,107,10,9,1,0.9,9,7,2,0.7777777777777778,0.8344370860927153,medlm,coral,breastca,PROMPT1_ICL_entailment
11,108,4,4,0,1.0,11,11,0,1.0,1.0,medlm,coral,breastca,PROMPT1_ICL_entailment
12,109,8,7,1,0.875,11,10,1,0.9090909090909092,0.8917197452229298,medlm,coral,breastca,PROMPT1_ICL_entailment
13,11,11,8,3,0.7272727272727273,3,3,0,1.0,0.8421052631578948,medlm,coral,breastca,PROMPT1_ICL_entailment
14,110,9,9,0,1.0,11,9,2,0.8181818181818182,0.9,medlm,coral,breastca,PROMPT1_ICL_entailment
15,111,12,9,3,0.75,10,8,2,0.8,0.7741935483870969,medlm,coral,breastca,PROMPT1_ICL_entailment
16,112,16,15,1,0.9375,10,9,1,0.9,0.9183673469387756,medlm,coral,breastca,PROMPT1_ICL_entailment
17,113,17,14,3,0.8235294117647058,49,19,30,0.3877551020408163,0.5272547076313181,medlm,coral,breastca,PROMPT1_ICL_entailment
18,114,34,1,33,0.0294117647058823,21,2,19,0.0952380952380952,0.044943820224719,medlm,coral,breastca,PROMPT1_ICL_entailment
19,115,6,5,1,0.8333333333333334,9,6,3,0.6666666666666666,0.7407407407407408,medlm,coral,breastca,PROMPT1_ICL_entailment
20,116,16,14,2,0.875,14,10,4,0.7142857142857143,0.7865168539325842,medlm,coral,breastca,PROMPT1_ICL_entailment
21,117,4,4,0,1.0,2,2,0,1.0,1.0,medlm,coral,breastca,PROMPT1_ICL_entailment
22,118,8,8,0,1.0,19,4,15,0.2105263157894736,0.3478260869565217,medlm,coral,breastca,PROMPT1_ICL_entailment
23,119,15,14,1,0.9333333333333332,10,9,1,0.9,0.9163636363636364,medlm,coral,breastca,PROMPT1_ICL_entailment
24,12,7,7,0,1.0,10,5,5,0.5,0.6666666666666666,medlm,coral,breastca,PROMPT1_ICL_entailment
25,120,15,15,0,1.0,9,8,1,0.8888888888888888,0.9411764705882352,medlm,coral,breastca,PROMPT1_ICL_entailment
26,121,12,9,3,0.75,10,8,2,0.8,0.7741935483870969,medlm,coral,breastca,PROMPT1_ICL_entailment
27,122,17,17,0,1.0,9,9,0,1.0,1.0,medlm,coral,breastca,PROMPT1_ICL_entailment
28,123,12,12,0,1.0,8,7,1,0.875,0.9333333333333332,medlm,coral,breastca,PROMPT1_ICL_entailment
29,124,21,19,2,0.9047619047619048,10,9,1,0.9,0.9023746701846964,medlm,coral,breastca,PROMPT1_ICL_entailment
30,125,22,21,1,0.9545454545454546,11,8,3,0.7272727272727273,0.8255528255528255,medlm,coral,breastca,PROMPT1_ICL_entailment
31,126,10,10,0,1.0,10,10,0,1.0,1.0,medlm,coral,breastca,PROMPT1_ICL_entailment
32,127,10,9,1,0.9,10,6,4,0.6,0.7200000000000001,medlm,coral,breastca,PROMPT1_ICL_entailment
33,128,15,15,0,1.0,11,9,2,0.8181818181818182,0.9,medlm,coral,breastca,PROMPT1_ICL_entailment
34,129,10,8,2,0.8,11,8,3,0.7272727272727273,0.761904761904762,medlm,coral,breastca,PROMPT1_ICL_entailment
35,13,8,7,1,0.875,10,5,5,0.5,0.6363636363636364,medlm,coral,breastca,PROMPT1_ICL_entailment
36,130,9,7,2,0.7777777777777778,7,5,2,0.7142857142857143,0.7446808510638298,medlm,coral,breastca,PROMPT1_ICL_entailment
37,131,13,12,1,0.9230769230769232,10,10,0,1.0,0.96,medlm,coral,breastca,PROMPT1_ICL_entailment
38,132,18,18,0,1.0,8,6,2,0.75,0.8571428571428571,medlm,coral,breastca,PROMPT1_ICL_entailment
39,133,30,26,4,0.8666666666666667,29,21,8,0.7241379310344828,0.7890173410404625,medlm,coral,breastca,PROMPT1_ICL_entailment
40,134,3,2,1,0.6666666666666666,11,9,2,0.8181818181818182,0.7346938775510203,medlm,coral,breastca,PROMPT1_ICL_entailment
41,135,15,10,5,0.6666666666666666,16,13,3,0.8125,0.7323943661971831,medlm,coral,breastca,PROMPT1_ICL_entailment
42,136,10,9,1,0.9,10,9,1,0.9,0.9,medlm,coral,breastca,PROMPT1_ICL_entailment
43,137,14,14,0,1.0,10,10,0,1.0,1.0,medlm,coral,breastca,PROMPT1_ICL_entailment
44,138,10,10,0,1.0,10,10,0,1.0,1.0,medlm,coral,breastca,PROMPT1_ICL_entailment
45,139,5,3,2,0.6,11,11,0,1.0,0.7499999999999999,medlm,coral,breastca,PROMPT1_ICL_entailment
46,14,36,19,17,0.5277777777777778,59,12,47,0.2033898305084746,0.2936252414681262,medlm,coral,breastca,PROMPT1_ICL_entailment
47,140,10,9,1,0.9,9,7,2,0.7777777777777778,0.8344370860927153,medlm,coral,breastca,PROMPT1_ICL_entailment
48,141,9,6,3,0.6666666666666666,11,10,1,0.9090909090909092,0.7692307692307692,medlm,coral,breastca,PROMPT1_ICL_entailment
49,142,10,10,0,1.0,10,8,2,0.8,0.888888888888889,medlm,coral,breastca,PROMPT1_ICL_entailment
50,143,6,5,1,0.8333333333333334,10,7,3,0.7,0.7608695652173915,medlm,coral,breastca,PROMPT1_ICL_entailment
51,144,8,8,0,1.0,5,5,0,1.0,1.0,medlm,coral,breastca,PROMPT1_ICL_entailment
52,145,11,11,0,1.0,5,4,1,0.8,0.888888888888889,medlm,coral,breastca,PROMPT1_ICL_entailment
53,146,10,10,0,1.0,9,7,2,0.7777777777777778,0.8750000000000001,medlm,coral,breastca,PROMPT1_ICL_entailment
54,147,7,7,0,1.0,5,5,0,1.0,1.0,medlm,coral,breastca,PROMPT1_ICL_entailment
55,148,12,9,3,0.75,4,2,2,0.5,0.6,medlm,coral,breastca,PROMPT1_ICL_entailment
56,149,10,10,0,1.0,1,1,0,1.0,1.0,medlm,coral,breastca,PROMPT1_ICL_entailment
57,15,12,7,5,0.5833333333333334,16,7,9,0.4375,0.5,medlm,coral,breastca,PROMPT1_ICL_entailment
58,150,11,9,2,0.8181818181818182,2,2,0,1.0,0.9,medlm,coral,breastca,PROMPT1_ICL_entailment
59,151,12,12,0,1.0,9,9,0,1.0,1.0,medlm,coral,breastca,PROMPT1_ICL_entailment
60,152,4,4,0,1.0,16,8,8,0.5,0.6666666666666666,medlm,coral,breastca,PROMPT1_ICL_entailment
61,153,10,9,1,0.9,1,1,0,1.0,0.9473684210526316,medlm,coral,breastca,PROMPT1_ICL_entailment
62,154,15,15,0,1.0,10,10,0,1.0,1.0,medlm,coral,breastca,PROMPT1_ICL_entailment
63,155,6,3,3,0.5,9,8,1,0.8888888888888888,0.64,medlm,coral,breastca,PROMPT1_ICL_entailment
64,156,19,17,2,0.8947368421052632,8,8,0,1.0,0.9444444444444444,medlm,coral,breastca,PROMPT1_ICL_entailment
65,157,13,12,1,0.9230769230769232,9,9,0,1.0,0.96,medlm,coral,breastca,PROMPT1_ICL_entailment
66,158,14,12,2,0.8571428571428571,16,10,6,0.625,0.7228915662650602,medlm,coral,breastca,PROMPT1_ICL_entailment
67,159,5,5,0,1.0,29,13,16,0.4482758620689655,0.6190476190476191,medlm,coral,breastca,PROMPT1_ICL_entailment
68,16,13,11,2,0.8461538461538461,10,6,4,0.6,0.7021276595744681,medlm,coral,breastca,PROMPT1_ICL_entailment
69,160,6,5,1,0.8333333333333334,18,11,7,0.6111111111111112,0.7051282051282051,medlm,coral,breastca,PROMPT1_ICL_entailment
70,161,4,4,0,1.0,11,7,4,0.6363636363636364,0.7777777777777778,medlm,coral,breastca,PROMPT1_ICL_entailment
71,162,13,10,3,0.7692307692307693,16,9,7,0.5625,0.6498194945848376,medlm,coral,breastca,PROMPT1_ICL_entailment
72,163,9,9,0,1.0,11,8,3,0.7272727272727273,0.8421052631578948,medlm,coral,breastca,PROMPT1_ICL_entailment
73,164,7,7,0,1.0,8,6,2,0.75,0.8571428571428571,medlm,coral,breastca,PROMPT1_ICL_entailment
74,165,9,8,1,0.8888888888888888,12,9,3,0.75,0.8135593220338982,medlm,coral,breastca,PROMPT1_ICL_entailment
75,166,8,7,1,0.875,10,5,5,0.5,0.6363636363636364,medlm,coral,breastca,PROMPT1_ICL_entailment
76,167,10,6,4,0.6,7,6,1,0.8571428571428571,0.7058823529411764,medlm,coral,breastca,PROMPT1_ICL_entailment
77,168,6,5,1,0.8333333333333334,7,5,2,0.7142857142857143,0.7692307692307692,medlm,coral,breastca,PROMPT1_ICL_entailment
78,169,12,11,1,0.9166666666666666,11,7,4,0.6363636363636364,0.7512195121951218,medlm,coral,breastca,PROMPT1_ICL_entailment
79,17,4,4,0,1.0,3,3,0,1.0,1.0,medlm,coral,breastca,PROMPT1_ICL_entailment
80,170,9,9,0,1.0,10,10,0,1.0,1.0,medlm,coral,breastca,PROMPT1_ICL_entailment
81,171,12,11,1,0.9166666666666666,9,8,1,0.8888888888888888,0.9025641025641026,medlm,coral,breastca,PROMPT1_ICL_entailment
82,172,17,15,2,0.8823529411764706,32,18,14,0.5625,0.6870229007633588,medlm,coral,breastca,PROMPT1_ICL_entailment
83,173,11,10,1,0.9090909090909092,11,10,1,0.9090909090909092,0.9090909090909092,medlm,coral,breastca,PROMPT1_ICL_entailment
84,174,4,2,2,0.5,7,4,3,0.5714285714285714,0.5333333333333333,medlm,coral,breastca,PROMPT1_ICL_entailment
85,175,7,7,0,1.0,10,7,3,0.7,0.8235294117647058,medlm,coral,breastca,PROMPT1_ICL_entailment
86,176,9,9,0,1.0,10,7,3,0.7,0.8235294117647058,medlm,coral,breastca,PROMPT1_ICL_entailment
87,177,13,12,1,0.9230769230769232,9,9,0,1.0,0.96,medlm,coral,breastca,PROMPT1_ICL_entailment
88,178,5,3,2,0.6,10,4,6,0.4,0.48,medlm,coral,breastca,PROMPT1_ICL_entailment
89,179,14,13,1,0.9285714285714286,9,7,2,0.7777777777777778,0.8465116279069766,medlm,coral,breastca,PROMPT1_ICL_entailment
90,18,11,10,1,0.9090909090909092,8,8,0,1.0,0.9523809523809524,medlm,coral,breastca,PROMPT1_ICL_entailment
91,180,9,8,1,0.8888888888888888,10,6,4,0.6,0.7164179104477612,medlm,coral,breastca,PROMPT1_ICL_entailment
92,181,4,4,0,1.0,9,7,2,0.7777777777777778,0.8750000000000001,medlm,coral,breastca,PROMPT1_ICL_entailment
93,182,6,6,0,1.0,9,4,5,0.4444444444444444,0.6153846153846153,medlm,coral,breastca,PROMPT1_ICL_entailment
94,183,9,9,0,1.0,10,10,0,1.0,1.0,medlm,coral,breastca,PROMPT1_ICL_entailment
95,184,20,19,1,0.95,9,8,1,0.8888888888888888,0.918429003021148,medlm,coral,breastca,PROMPT1_ICL_entailment
96,185,11,10,1,0.9090909090909092,10,6,4,0.6,0.7228915662650602,medlm,coral,breastca,PROMPT1_ICL_entailment
97,186,7,6,1,0.8571428571428571,5,5,0,1.0,0.923076923076923,medlm,coral,breastca,PROMPT1_ICL_entailment
98,187,9,8,1,0.8888888888888888,26,11,15,0.4230769230769231,0.5732899022801303,medlm,coral,breastca,PROMPT1_ICL_entailment
99,188,16,16,0,1.0,9,9,0,1.0,1.0,medlm,coral,breastca,PROMPT1_ICL_entailment
100,189,14,14,0,1.0,9,8,1,0.8888888888888888,0.9411764705882352,medlm,coral,breastca,PROMPT1_ICL_entailment
101,19,10,8,2,0.8,8,4,4,0.5,0.6153846153846154,medlm,coral,breastca,PROMPT1_ICL_entailment
102,190,17,8,9,0.4705882352941176,34,14,20,0.4117647058823529,0.4392156862745098,medlm,coral,breastca,PROMPT1_ICL_entailment
103,191,6,5,1,0.8333333333333334,14,7,7,0.5,0.625,medlm,coral,breastca,PROMPT1_ICL_entailment
104,192,10,10,0,1.0,12,11,1,0.9166666666666666,0.9565217391304348,medlm,coral,breastca,PROMPT1_ICL_entailment
105,193,5,5,0,1.0,2,2,0,1.0,1.0,medlm,coral,breastca,PROMPT1_ICL_entailment
106,194,21,20,1,0.9523809523809524,15,13,2,0.8666666666666667,0.9075043630017452,medlm,coral,breastca,PROMPT1_ICL_entailment
107,195,12,11,1,0.9166666666666666,13,9,4,0.6923076923076923,0.7888446215139442,medlm,coral,breastca,PROMPT1_ICL_entailment
108,196,21,18,3,0.8571428571428571,30,15,15,0.5,0.631578947368421,medlm,coral,breastca,PROMPT1_ICL_entailment
109,197,10,9,1,0.9,14,7,7,0.5,0.6428571428571429,medlm,coral,breastca,PROMPT1_ICL_entailment
110,198,15,14,1,0.9333333333333332,11,8,3,0.7272727272727273,0.8175182481751825,medlm,coral,breastca,PROMPT1_ICL_entailment
111,199,4,4,0,1.0,2,2,0,1.0,1.0,medlm,coral,breastca,PROMPT1_ICL_entailment
112,2,7,6,1,0.8571428571428571,10,4,6,0.4,0.5454545454545455,medlm,coral,breastca,PROMPT1_ICL_entailment
113,20,12,8,4,0.6666666666666666,17,8,9,0.4705882352941176,0.5517241379310345,medlm,coral,breastca,PROMPT1_ICL_entailment
114,200,7,7,0,1.0,15,10,5,0.6666666666666666,0.8,medlm,coral,breastca,PROMPT1_ICL_entailment
115,201,13,10,3,0.7692307692307693,26,15,11,0.5769230769230769,0.6593406593406593,medlm,coral,breastca,PROMPT1_ICL_entailment
116,202,16,16,0,1.0,17,12,5,0.7058823529411765,0.8275862068965517,medlm,coral,breastca,PROMPT1_ICL_entailment
117,203,29,23,6,0.7931034482758621,27,15,12,0.5555555555555556,0.6534090909090909,medlm,coral,breastca,PROMPT1_ICL_entailment
118,204,7,6,1,0.8571428571428571,11,6,5,0.5454545454545454,0.6666666666666665,medlm,coral,breastca,PROMPT1_ICL_entailment
119,205,10,10,0,1.0,11,10,1,0.9090909090909092,0.9523809523809524,medlm,coral,breastca,PROMPT1_ICL_entailment
120,206,10,10,0,1.0,4,3,1,0.75,0.8571428571428571,medlm,coral,breastca,PROMPT1_ICL_entailment
121,207,14,11,3,0.7857142857142857,12,7,5,0.5833333333333334,0.6695652173913044,medlm,coral,breastca,PROMPT1_ICL_entailment
122,208,13,13,0,1.0,9,7,2,0.7777777777777778,0.8750000000000001,medlm,coral,breastca,PROMPT1_ICL_entailment
123,209,11,9,2,0.8181818181818182,11,9,2,0.8181818181818182,0.8181818181818182,medlm,coral,breastca,PROMPT1_ICL_entailment
124,21,9,5,4,0.5555555555555556,27,9,18,0.3333333333333333,0.4166666666666667,medlm,coral,breastca,PROMPT1_ICL_entailment
125,210,8,8,0,1.0,13,4,9,0.3076923076923077,0.4705882352941176,medlm,coral,breastca,PROMPT1_ICL_entailment
126,211,7,7,0,1.0,11,7,4,0.6363636363636364,0.7777777777777778,medlm,coral,breastca,PROMPT1_ICL_entailment
127,212,9,9,0,1.0,9,4,5,0.4444444444444444,0.6153846153846153,medlm,coral,breastca,PROMPT1_ICL_entailment
128,213,10,9,1,0.9,11,10,1,0.9090909090909092,0.9045226130653266,medlm,coral,breastca,PROMPT1_ICL_entailment
129,214,6,2,4,0.3333333333333333,28,12,16,0.4285714285714285,0.375,medlm,coral,breastca,PROMPT1_ICL_entailment
130,215,23,17,6,0.7391304347826086,37,17,20,0.4594594594594595,0.5666666666666667,medlm,coral,breastca,PROMPT1_ICL_entailment
131,216,27,24,3,0.8888888888888888,15,12,3,0.8,0.8421052631578948,medlm,coral,breastca,PROMPT1_ICL_entailment
132,22,3,2,1,0.6666666666666666,7,0,7,0.0,0.0,medlm,coral,breastca,PROMPT1_ICL_entailment
133,23,8,7,1,0.875,9,8,1,0.8888888888888888,0.8818897637795274,medlm,coral,breastca,PROMPT1_ICL_entailment
134,24,16,12,4,0.75,10,9,1,0.9,0.8181818181818182,medlm,coral,breastca,PROMPT1_ICL_entailment
135,25,12,12,0,1.0,8,6,2,0.75,0.8571428571428571,medlm,coral,breastca,PROMPT1_ICL_entailment
136,26,17,16,1,0.9411764705882352,11,8,3,0.7272727272727273,0.8205128205128205,medlm,coral,breastca,PROMPT1_ICL_entailment
137,27,8,5,3,0.625,12,6,6,0.5,0.5555555555555556,medlm,coral,breastca,PROMPT1_ICL_entailment
138,28,10,8,2,0.8,18,10,8,0.5555555555555556,0.6557377049180328,medlm,coral,breastca,PROMPT1_ICL_entailment
139,29,4,3,1,0.75,9,3,6,0.3333333333333333,0.4615384615384615,medlm,coral,breastca,PROMPT1_ICL_entailment
140,3,16,13,3,0.8125,11,7,4,0.6363636363636364,0.7137254901960786,medlm,coral,breastca,PROMPT1_ICL_entailment
141,30,8,6,2,0.75,18,9,9,0.5,0.6,medlm,coral,breastca,PROMPT1_ICL_entailment
142,31,12,10,2,0.8333333333333334,13,8,5,0.6153846153846154,0.7079646017699115,medlm,coral,breastca,PROMPT1_ICL_entailment
143,32,9,7,2,0.7777777777777778,9,8,1,0.8888888888888888,0.8296296296296296,medlm,coral,breastca,PROMPT1_ICL_entailment
144,33,11,9,2,0.8181818181818182,8,5,3,0.625,0.7086614173228345,medlm,coral,breastca,PROMPT1_ICL_entailment
145,34,8,7,1,0.875,10,10,0,1.0,0.9333333333333332,medlm,coral,breastca,PROMPT1_ICL_entailment
146,35,5,5,0,1.0,12,7,5,0.5833333333333334,0.7368421052631579,medlm,coral,breastca,PROMPT1_ICL_entailment
147,36,12,11,1,0.9166666666666666,11,10,1,0.9090909090909092,0.9128630705394192,medlm,coral,breastca,PROMPT1_ICL_entailment
148,37,7,6,1,0.8571428571428571,11,6,5,0.5454545454545454,0.6666666666666665,medlm,coral,breastca,PROMPT1_ICL_entailment
149,38,16,15,1,0.9375,11,10,1,0.9090909090909092,0.923076923076923,medlm,coral,breastca,PROMPT1_ICL_entailment
150,39,12,12,0,1.0,11,10,1,0.9090909090909092,0.9523809523809524,medlm,coral,breastca,PROMPT1_ICL_entailment
151,4,12,9,3,0.75,59,22,37,0.3728813559322034,0.4981132075471699,medlm,coral,breastca,PROMPT1_ICL_entailment
152,40,8,6,2,0.75,9,6,3,0.6666666666666666,0.7058823529411765,medlm,coral,breastca,PROMPT1_ICL_entailment
153,41,5,5,0,1.0,14,8,6,0.5714285714285714,0.7272727272727273,medlm,coral,breastca,PROMPT1_ICL_entailment
154,42,16,15,1,0.9375,9,6,3,0.6666666666666666,0.7792207792207793,medlm,coral,breastca,PROMPT1_ICL_entailment
155,43,11,8,3,0.7272727272727273,9,7,2,0.7777777777777778,0.7516778523489932,medlm,coral,breastca,PROMPT1_ICL_entailment
156,44,11,10,1,0.9090909090909092,9,9,0,1.0,0.9523809523809524,medlm,coral,breastca,PROMPT1_ICL_entailment
157,45,5,4,1,0.8,2,2,0,1.0,0.888888888888889,medlm,coral,breastca,PROMPT1_ICL_entailment
158,46,12,12,0,1.0,5,4,1,0.8,0.888888888888889,medlm,coral,breastca,PROMPT1_ICL_entailment
159,47,4,2,2,0.5,2,2,0,1.0,0.6666666666666666,medlm,coral,breastca,PROMPT1_ICL_entailment
160,48,5,5,0,1.0,5,4,1,0.8,0.888888888888889,medlm,coral,breastca,PROMPT1_ICL_entailment
161,49,21,15,6,0.7142857142857143,16,9,7,0.5625,0.6293706293706294,medlm,coral,breastca,PROMPT1_ICL_entailment
162,5,6,5,1,0.8333333333333334,12,11,1,0.9166666666666666,0.8730158730158729,medlm,coral,breastca,PROMPT1_ICL_entailment
163,50,23,17,6,0.7391304347826086,16,11,5,0.6875,0.7123809523809523,medlm,coral,breastca,PROMPT1_ICL_entailment
164,51,6,4,2,0.6666666666666666,11,10,1,0.9090909090909092,0.7692307692307692,medlm,coral,breastca,PROMPT1_ICL_entailment
165,52,15,11,4,0.7333333333333333,10,9,1,0.9,0.8081632653061224,medlm,coral,breastca,PROMPT1_ICL_entailment
166,53,18,17,1,0.9444444444444444,10,10,0,1.0,0.9714285714285714,medlm,coral,breastca,PROMPT1_ICL_entailment
167,54,7,6,1,0.8571428571428571,9,5,4,0.5555555555555556,0.6741573033707865,medlm,coral,breastca,PROMPT1_ICL_entailment
168,55,3,3,0,1.0,1,1,0,1.0,1.0,medlm,coral,breastca,PROMPT1_ICL_entailment
169,56,26,10,16,0.3846153846153846,18,4,14,0.2222222222222222,0.2816901408450704,medlm,coral,breastca,PROMPT1_ICL_entailment
170,57,24,23,1,0.9583333333333334,10,10,0,1.0,0.9787234042553192,medlm,coral,breastca,PROMPT1_ICL_entailment
171,58,23,23,0,1.0,10,10,0,1.0,1.0,medlm,coral,breastca,PROMPT1_ICL_entailment
172,59,10,10,0,1.0,9,9,0,1.0,1.0,medlm,coral,breastca,PROMPT1_ICL_entailment
173,6,10,8,2,0.8,8,7,1,0.875,0.8358208955223881,medlm,coral,breastca,PROMPT1_ICL_entailment
174,60,17,16,1,0.9411764705882352,10,8,2,0.8,0.8648648648648648,medlm,coral,breastca,PROMPT1_ICL_entailment
175,61,16,16,0,1.0,11,9,2,0.8181818181818182,0.9,medlm,coral,breastca,PROMPT1_ICL_entailment
176,62,12,12,0,1.0,10,9,1,0.9,0.9473684210526316,medlm,coral,breastca,PROMPT1_ICL_entailment
177,63,6,5,1,0.8333333333333334,11,4,7,0.3636363636363636,0.5063291139240507,medlm,coral,breastca,PROMPT1_ICL_entailment
178,64,10,8,2,0.8,18,5,13,0.2777777777777778,0.4123711340206185,medlm,coral,breastca,PROMPT1_ICL_entailment
179,65,9,8,1,0.8888888888888888,6,5,1,0.8333333333333334,0.8602150537634408,medlm,coral,breastca,PROMPT1_ICL_entailment
180,66,9,7,2,0.7777777777777778,10,9,1,0.9,0.8344370860927153,medlm,coral,breastca,PROMPT1_ICL_entailment
181,67,10,6,4,0.6,49,23,26,0.4693877551020408,0.5267175572519084,medlm,coral,breastca,PROMPT1_ICL_entailment
182,68,8,8,0,1.0,8,8,0,1.0,1.0,medlm,coral,breastca,PROMPT1_ICL_entailment
183,69,15,4,11,0.2666666666666666,12,3,9,0.25,0.2580645161290323,medlm,coral,breastca,PROMPT1_ICL_entailment
184,7,13,11,2,0.8461538461538461,11,9,2,0.8181818181818182,0.8319327731092436,medlm,coral,breastca,PROMPT1_ICL_entailment
185,70,1,0,1,0.0,51,8,43,0.1568627450980392,0.0,medlm,coral,breastca,PROMPT1_ICL_entailment
186,71,16,9,7,0.5625,5,5,0,1.0,0.72,medlm,coral,breastca,PROMPT1_ICL_entailment
187,72,9,8,1,0.8888888888888888,3,2,1,0.6666666666666666,0.761904761904762,medlm,coral,breastca,PROMPT1_ICL_entailment
188,73,14,12,2,0.8571428571428571,1,1,0,1.0,0.923076923076923,medlm,coral,breastca,PROMPT1_ICL_entailment
189,74,10,8,2,0.8,2,2,0,1.0,0.888888888888889,medlm,coral,breastca,PROMPT1_ICL_entailment
190,75,10,8,2,0.8,6,5,1,0.8333333333333334,0.816326530612245,medlm,coral,breastca,PROMPT1_ICL_entailment
191,76,11,11,0,1.0,7,7,0,1.0,1.0,medlm,coral,breastca,PROMPT1_ICL_entailment
192,77,6,5,1,0.8333333333333334,15,8,7,0.5333333333333333,0.6504065040650406,medlm,coral,breastca,PROMPT1_ICL_entailment
193,78,10,9,1,0.9,8,5,3,0.625,0.7377049180327869,medlm,coral,breastca,PROMPT1_ICL_entailment
194,79,11,11,0,1.0,8,7,1,0.875,0.9333333333333332,medlm,coral,breastca,PROMPT1_ICL_entailment
195,8,8,7,1,0.875,9,6,3,0.6666666666666666,0.7567567567567567,medlm,coral,breastca,PROMPT1_ICL_entailment
196,80,34,30,4,0.8823529411764706,24,15,9,0.625,0.7317073170731708,medlm,coral,breastca,PROMPT1_ICL_entailment
197,81,10,9,1,0.9,11,10,1,0.9090909090909092,0.9045226130653266,medlm,coral,breastca,PROMPT1_ICL_entailment
198,82,9,7,2,0.7777777777777778,6,3,3,0.5,0.6086956521739131,medlm,coral,breastca,PROMPT1_ICL_entailment
199,83,7,7,0,1.0,6,4,2,0.6666666666666666,0.8,medlm,coral,breastca,PROMPT1_ICL_entailment
200,84,12,9,3,0.75,11,8,3,0.7272727272727273,0.7384615384615384,medlm,coral,breastca,PROMPT1_ICL_entailment
201,85,18,16,2,0.8888888888888888,7,7,0,1.0,0.9411764705882352,medlm,coral,breastca,PROMPT1_ICL_entailment
202,86,16,9,7,0.5625,16,11,5,0.6875,0.61875,medlm,coral,breastca,PROMPT1_ICL_entailment
203,87,6,4,2,0.6666666666666666,8,8,0,1.0,0.8,medlm,coral,breastca,PROMPT1_ICL_entailment
204,88,7,7,0,1.0,8,7,1,0.875,0.9333333333333332,medlm,coral,breastca,PROMPT1_ICL_entailment
205,89,9,9,0,1.0,11,9,2,0.8181818181818182,0.9,medlm,coral,breastca,PROMPT1_ICL_entailment
206,9,8,6,2,0.75,6,5,1,0.8333333333333334,0.7894736842105262,medlm,coral,breastca,PROMPT1_ICL_entailment
207,90,6,4,2,0.6666666666666666,18,5,13,0.2777777777777778,0.392156862745098,medlm,coral,breastca,PROMPT1_ICL_entailment
208,91,10,8,2,0.8,7,4,3,0.5714285714285714,0.6666666666666666,medlm,coral,breastca,PROMPT1_ICL_entailment
209,92,4,4,0,1.0,2,2,0,1.0,1.0,medlm,coral,breastca,PROMPT1_ICL_entailment
210,93,5,5,0,1.0,13,8,5,0.6153846153846154,0.761904761904762,medlm,coral,breastca,PROMPT1_ICL_entailment
211,94,22,15,7,0.6818181818181818,25,17,8,0.68,0.6809078771695594,medlm,coral,breastca,PROMPT1_ICL_entailment
212,95,6,5,1,0.8333333333333334,13,8,5,0.6153846153846154,0.7079646017699115,medlm,coral,breastca,PROMPT1_ICL_entailment
213,96,15,12,3,0.8,10,9,1,0.9,0.8470588235294118,medlm,coral,breastca,PROMPT1_ICL_entailment
214,97,11,10,1,0.9090909090909092,11,9,2,0.8181818181818182,0.861244019138756,medlm,coral,breastca,PROMPT1_ICL_entailment
215,98,7,6,1,0.8571428571428571,2,1,1,0.5,0.631578947368421,medlm,coral,breastca,PROMPT1_ICL_entailment
216,99,8,8,0,1.0,15,12,3,0.8,0.888888888888889,medlm,coral,breastca,PROMPT1_ICL_entailment
0,0,12,12,0,1.0,10,10,0,1.0,1.0,medlm,coral,breastca,PROMPT2_ICL_entailment
1,1,16,14,2,0.875,12,10,2,0.8333333333333334,0.8536585365853658,medlm,coral,breastca,PROMPT2_ICL_entailment
2,10,14,12,2,0.8571428571428571,10,10,0,1.0,0.923076923076923,medlm,coral,breastca,PROMPT2_ICL_entailment
3,100,14,9,5,0.6428571428571429,26,13,13,0.5,0.5625000000000001,medlm,coral,breastca,PROMPT2_ICL_entailment
4,101,30,28,2,0.9333333333333332,18,13,5,0.7222222222222222,0.814317673378076,medlm,coral,breastca,PROMPT2_ICL_entailment
5,102,14,13,1,0.9285714285714286,7,6,1,0.8571428571428571,0.8914285714285715,medlm,coral,breastca,PROMPT2_ICL_entailment
6,103,25,24,1,0.96,10,7,3,0.7,0.8096385542168675,medlm,coral,breastca,PROMPT2_ICL_entailment
7,104,13,9,4,0.6923076923076923,26,9,17,0.3461538461538461,0.4615384615384615,medlm,coral,breastca,PROMPT2_ICL_entailment
8,105,17,16,1,0.9411764705882352,15,14,1,0.9333333333333332,0.9372384937238494,medlm,coral,breastca,PROMPT2_ICL_entailment
9,106,14,13,1,0.9285714285714286,9,7,2,0.7777777777777778,0.8465116279069766,medlm,coral,breastca,PROMPT2_ICL_entailment
10,107,9,8,1,0.8888888888888888,9,8,1,0.8888888888888888,0.8888888888888888,medlm,coral,breastca,PROMPT2_ICL_entailment
11,108,12,12,0,1.0,11,9,2,0.8181818181818182,0.9,medlm,coral,breastca,PROMPT2_ICL_entailment
12,109,10,9,1,0.9,11,10,1,0.9090909090909092,0.9045226130653266,medlm,coral,breastca,PROMPT2_ICL_entailment
13,11,4,4,0,1.0,3,3,0,1.0,1.0,medlm,coral,breastca,PROMPT2_ICL_entailment
14,110,10,10,0,1.0,11,8,3,0.7272727272727273,0.8421052631578948,medlm,coral,breastca,PROMPT2_ICL_entailment
15,111,10,7,3,0.7,10,5,5,0.5,0.5833333333333334,medlm,coral,breastca,PROMPT2_ICL_entailment
16,112,13,13,0,1.0,10,7,3,0.7,0.8235294117647058,medlm,coral,breastca,PROMPT2_ICL_entailment
17,113,9,8,1,0.8888888888888888,49,18,31,0.3673469387755102,0.51985559566787,medlm,coral,breastca,PROMPT2_ICL_entailment
18,114,11,7,4,0.6363636363636364,21,11,10,0.5238095238095238,0.5746268656716419,medlm,coral,breastca,PROMPT2_ICL_entailment
19,115,13,11,2,0.8461538461538461,9,6,3,0.6666666666666666,0.7457627118644068,medlm,coral,breastca,PROMPT2_ICL_entailment
20,116,17,14,3,0.8235294117647058,14,14,0,1.0,0.9032258064516128,medlm,coral,breastca,PROMPT2_ICL_entailment
21,117,7,7,0,1.0,2,2,0,1.0,1.0,medlm,coral,breastca,PROMPT2_ICL_entailment
22,118,13,13,0,1.0,19,5,14,0.2631578947368421,0.4166666666666667,medlm,coral,breastca,PROMPT2_ICL_entailment
23,119,16,15,1,0.9375,10,9,1,0.9,0.9183673469387756,medlm,coral,breastca,PROMPT2_ICL_entailment
24,12,9,8,1,0.8888888888888888,10,6,4,0.6,0.7164179104477612,medlm,coral,breastca,PROMPT2_ICL_entailment
25,120,16,16,0,1.0,9,6,3,0.6666666666666666,0.8,medlm,coral,breastca,PROMPT2_ICL_entailment
26,121,14,11,3,0.7857142857142857,10,7,3,0.7,0.7403846153846153,medlm,coral,breastca,PROMPT2_ICL_entailment
27,122,18,17,1,0.9444444444444444,9,8,1,0.8888888888888888,0.9158249158249158,medlm,coral,breastca,PROMPT2_ICL_entailment
28,123,12,12,0,1.0,8,6,2,0.75,0.8571428571428571,medlm,coral,breastca,PROMPT2_ICL_entailment
29,124,21,19,2,0.9047619047619048,10,10,0,1.0,0.95,medlm,coral,breastca,PROMPT2_ICL_entailment
30,125,22,21,1,0.9545454545454546,11,7,4,0.6363636363636364,0.7636363636363637,medlm,coral,breastca,PROMPT2_ICL_entailment
31,126,13,12,1,0.9230769230769232,10,10,0,1.0,0.96,medlm,coral,breastca,PROMPT2_ICL_entailment
32,127,12,12,0,1.0,10,6,4,0.6,0.7499999999999999,medlm,coral,breastca,PROMPT2_ICL_entailment
33,128,17,17,0,1.0,11,8,3,0.7272727272727273,0.8421052631578948,medlm,coral,breastca,PROMPT2_ICL_entailment
34,129,10,9,1,0.9,11,6,5,0.5454545454545454,0.679245283018868,medlm,coral,breastca,PROMPT2_ICL_entailment
35,13,9,6,3,0.6666666666666666,10,9,1,0.9,0.7659574468085106,medlm,coral,breastca,PROMPT2_ICL_entailment
36,130,33,7,26,0.2121212121212121,7,7,0,1.0,0.35,medlm,coral,breastca,PROMPT2_ICL_entailment
37,131,13,10,3,0.7692307692307693,10,10,0,1.0,0.8695652173913044,medlm,coral,breastca,PROMPT2_ICL_entailment
38,132,12,12,0,1.0,8,7,1,0.875,0.9333333333333332,medlm,coral,breastca,PROMPT2_ICL_entailment
39,133,30,28,2,0.9333333333333332,29,18,11,0.6206896551724138,0.7455621301775148,medlm,coral,breastca,PROMPT2_ICL_entailment
40,134,12,6,6,0.5,11,10,1,0.9090909090909092,0.6451612903225806,medlm,coral,breastca,PROMPT2_ICL_entailment
41,135,13,7,6,0.5384615384615384,16,11,5,0.6875,0.6039215686274509,medlm,coral,breastca,PROMPT2_ICL_entailment
42,136,10,9,1,0.9,10,9,1,0.9,0.9,medlm,coral,breastca,PROMPT2_ICL_entailment
43,137,11,11,0,1.0,10,10,0,1.0,1.0,medlm,coral,breastca,PROMPT2_ICL_entailment
44,138,11,11,0,1.0,10,10,0,1.0,1.0,medlm,coral,breastca,PROMPT2_ICL_entailment
45,139,5,4,1,0.8,11,10,1,0.9090909090909092,0.8510638297872342,medlm,coral,breastca,PROMPT2_ICL_entailment
46,14,31,25,6,0.8064516129032258,59,13,46,0.2203389830508474,0.3461128860489882,medlm,coral,breastca,PROMPT2_ICL_entailment
47,140,9,7,2,0.7777777777777778,9,6,3,0.6666666666666666,0.717948717948718,medlm,coral,breastca,PROMPT2_ICL_entailment
48,141,8,5,3,0.625,11,9,2,0.8181818181818182,0.7086614173228345,medlm,coral,breastca,PROMPT2_ICL_entailment
49,142,13,13,0,1.0,10,10,0,1.0,1.0,medlm,coral,breastca,PROMPT2_ICL_entailment
50,143,6,6,0,1.0,10,6,4,0.6,0.7499999999999999,medlm,coral,breastca,PROMPT2_ICL_entailment
51,144,16,16,0,1.0,5,5,0,1.0,1.0,medlm,coral,breastca,PROMPT2_ICL_entailment
52,145,11,11,0,1.0,5,4,1,0.8,0.888888888888889,medlm,coral,breastca,PROMPT2_ICL_entailment
53,146,10,10,0,1.0,9,7,2,0.7777777777777778,0.8750000000000001,medlm,coral,breastca,PROMPT2_ICL_entailment
54,147,34,29,5,0.8529411764705882,5,3,2,0.6,0.7044534412955465,medlm,coral,breastca,PROMPT2_ICL_entailment
55,148,12,11,1,0.9166666666666666,4,2,2,0.5,0.6470588235294118,medlm,coral,breastca,PROMPT2_ICL_entailment
56,149,13,13,0,1.0,1,1,0,1.0,1.0,medlm,coral,breastca,PROMPT2_ICL_entailment
57,15,10,6,4,0.6,16,8,8,0.5,0.5454545454545454,medlm,coral,breastca,PROMPT2_ICL_entailment
58,150,18,13,5,0.7222222222222222,2,2,0,1.0,0.8387096774193548,medlm,coral,breastca,PROMPT2_ICL_entailment
59,151,5,4,1,0.8,9,4,5,0.4444444444444444,0.5714285714285714,medlm,coral,breastca,PROMPT2_ICL_entailment
60,152,9,8,1,0.8888888888888888,16,7,9,0.4375,0.5863874345549738,medlm,coral,breastca,PROMPT2_ICL_entailment
61,153,10,9,1,0.9,1,1,0,1.0,0.9473684210526316,medlm,coral,breastca,PROMPT2_ICL_entailment
62,154,13,13,0,1.0,10,10,0,1.0,1.0,medlm,coral,breastca,PROMPT2_ICL_entailment
63,155,17,13,4,0.7647058823529411,9,8,1,0.8888888888888888,0.8221343873517786,medlm,coral,breastca,PROMPT2_ICL_entailment
64,156,14,12,2,0.8571428571428571,8,8,0,1.0,0.923076923076923,medlm,coral,breastca,PROMPT2_ICL_entailment
65,157,12,11,1,0.9166666666666666,9,7,2,0.7777777777777778,0.8415300546448087,medlm,coral,breastca,PROMPT2_ICL_entailment
66,158,12,10,2,0.8333333333333334,16,15,1,0.9375,0.8823529411764706,medlm,coral,breastca,PROMPT2_ICL_entailment
67,159,8,7,1,0.875,29,12,17,0.4137931034482758,0.5618729096989967,medlm,coral,breastca,PROMPT2_ICL_entailment
68,16,12,12,0,1.0,10,6,4,0.6,0.7499999999999999,medlm,coral,breastca,PROMPT2_ICL_entailment
69,160,10,8,2,0.8,18,12,6,0.6666666666666666,0.7272727272727272,medlm,coral,breastca,PROMPT2_ICL_entailment
70,161,11,10,1,0.9090909090909092,11,7,4,0.6363636363636364,0.7486631016042781,medlm,coral,breastca,PROMPT2_ICL_entailment
71,162,12,9,3,0.75,16,8,8,0.5,0.6,medlm,coral,breastca,PROMPT2_ICL_entailment
72,163,9,9,0,1.0,11,8,3,0.7272727272727273,0.8421052631578948,medlm,coral,breastca,PROMPT2_ICL_entailment
73,164,10,10,0,1.0,8,7,1,0.875,0.9333333333333332,medlm,coral,breastca,PROMPT2_ICL_entailment
74,165,8,5,3,0.625,12,10,2,0.8333333333333334,0.7142857142857143,medlm,coral,breastca,PROMPT2_ICL_entailment
75,166,11,11,0,1.0,10,5,5,0.5,0.6666666666666666,medlm,coral,breastca,PROMPT2_ICL_entailment
76,167,11,8,3,0.7272727272727273,7,5,2,0.7142857142857143,0.7207207207207208,medlm,coral,breastca,PROMPT2_ICL_entailment
77,168,8,6,2,0.75,7,5,2,0.7142857142857143,0.7317073170731706,medlm,coral,breastca,PROMPT2_ICL_entailment
78,169,8,6,2,0.75,11,7,4,0.6363636363636364,0.6885245901639345,medlm,coral,breastca,PROMPT2_ICL_entailment
79,17,4,4,0,1.0,3,3,0,1.0,1.0,medlm,coral,breastca,PROMPT2_ICL_entailment
80,170,6,5,1,0.8333333333333334,10,10,0,1.0,0.9090909090909092,medlm,coral,breastca,PROMPT2_ICL_entailment
81,171,12,12,0,1.0,9,9,0,1.0,1.0,medlm,coral,breastca,PROMPT2_ICL_entailment
82,172,10,8,2,0.8,32,8,24,0.25,0.3809523809523809,medlm,coral,breastca,PROMPT2_ICL_entailment
83,173,12,11,1,0.9166666666666666,11,9,2,0.8181818181818182,0.8646288209606987,medlm,coral,breastca,PROMPT2_ICL_entailment
84,174,7,5,2,0.7142857142857143,7,3,4,0.4285714285714285,0.5357142857142858,medlm,coral,breastca,PROMPT2_ICL_entailment
85,175,8,8,0,1.0,10,6,4,0.6,0.7499999999999999,medlm,coral,breastca,PROMPT2_ICL_entailment
86,176,10,10,0,1.0,10,6,4,0.6,0.7499999999999999,medlm,coral,breastca,PROMPT2_ICL_entailment
87,177,16,15,1,0.9375,9,5,4,0.5555555555555556,0.6976744186046512,medlm,coral,breastca,PROMPT2_ICL_entailment
88,178,6,2,4,0.3333333333333333,10,4,6,0.4,0.3636363636363636,medlm,coral,breastca,PROMPT2_ICL_entailment
89,179,7,7,0,1.0,9,6,3,0.6666666666666666,0.8,medlm,coral,breastca,PROMPT2_ICL_entailment
90,18,16,16,0,1.0,8,7,1,0.875,0.9333333333333332,medlm,coral,breastca,PROMPT2_ICL_entailment
91,180,9,9,0,1.0,10,6,4,0.6,0.7499999999999999,medlm,coral,breastca,PROMPT2_ICL_entailment
92,181,7,7,0,1.0,9,8,1,0.8888888888888888,0.9411764705882352,medlm,coral,breastca,PROMPT2_ICL_entailment
93,182,6,6,0,1.0,9,4,5,0.4444444444444444,0.6153846153846153,medlm,coral,breastca,PROMPT2_ICL_entailment
94,183,6,6,0,1.0,10,8,2,0.8,0.888888888888889,medlm,coral,breastca,PROMPT2_ICL_entailment
95,184,11,10,1,0.9090909090909092,9,4,5,0.4444444444444444,0.5970149253731343,medlm,coral,breastca,PROMPT2_ICL_entailment
96,185,13,12,1,0.9230769230769232,10,9,1,0.9,0.9113924050632912,medlm,coral,breastca,PROMPT2_ICL_entailment
97,186,8,8,0,1.0,5,4,1,0.8,0.888888888888889,medlm,coral,breastca,PROMPT2_ICL_entailment
98,187,14,13,1,0.9285714285714286,26,15,11,0.5769230769230769,0.7116788321167883,medlm,coral,breastca,PROMPT2_ICL_entailment
99,188,17,17,0,1.0,9,9,0,1.0,1.0,medlm,coral,breastca,PROMPT2_ICL_entailment
100,189,15,15,0,1.0,9,9,0,1.0,1.0,medlm,coral,breastca,PROMPT2_ICL_entailment
101,19,9,8,1,0.8888888888888888,8,6,2,0.75,0.8135593220338982,medlm,coral,breastca,PROMPT2_ICL_entailment
102,190,18,9,9,0.5,34,14,20,0.4117647058823529,0.4516129032258064,medlm,coral,breastca,PROMPT2_ICL_entailment
103,191,27,20,7,0.7407407407407407,14,8,6,0.5714285714285714,0.6451612903225806,medlm,coral,breastca,PROMPT2_ICL_entailment
104,192,7,7,0,1.0,12,9,3,0.75,0.8571428571428571,medlm,coral,breastca,PROMPT2_ICL_entailment
105,193,7,6,1,0.8571428571428571,2,2,0,1.0,0.923076923076923,medlm,coral,breastca,PROMPT2_ICL_entailment
106,194,19,19,0,1.0,15,12,3,0.8,0.888888888888889,medlm,coral,breastca,PROMPT2_ICL_entailment
107,195,11,10,1,0.9090909090909092,13,9,4,0.6923076923076923,0.7860262008733625,medlm,coral,breastca,PROMPT2_ICL_entailment
108,196,24,22,2,0.9166666666666666,30,17,13,0.5666666666666667,0.7003745318352059,medlm,coral,breastca,PROMPT2_ICL_entailment
109,197,8,8,0,1.0,14,9,5,0.6428571428571429,0.782608695652174,medlm,coral,breastca,PROMPT2_ICL_entailment
110,198,15,15,0,1.0,11,7,4,0.6363636363636364,0.7777777777777778,medlm,coral,breastca,PROMPT2_ICL_entailment
111,199,4,4,0,1.0,2,2,0,1.0,1.0,medlm,coral,breastca,PROMPT2_ICL_entailment
112,2,6,5,1,0.8333333333333334,10,9,1,0.9,0.8653846153846153,medlm,coral,breastca,PROMPT2_ICL_entailment
113,20,11,8,3,0.7272727272727273,17,5,12,0.2941176470588235,0.418848167539267,medlm,coral,breastca,PROMPT2_ICL_entailment
114,200,11,11,0,1.0,15,8,7,0.5333333333333333,0.6956521739130436,medlm,coral,breastca,PROMPT2_ICL_entailment
115,201,23,16,7,0.6956521739130435,26,19,7,0.7307692307692307,0.7127784290738569,medlm,coral,breastca,PROMPT2_ICL_entailment
116,202,11,11,0,1.0,17,12,5,0.7058823529411765,0.8275862068965517,medlm,coral,breastca,PROMPT2_ICL_entailment
117,203,21,17,4,0.8095238095238095,27,11,16,0.4074074074074074,0.5420289855072463,medlm,coral,breastca,PROMPT2_ICL_entailment
118,204,8,7,1,0.875,11,8,3,0.7272727272727273,0.7943262411347517,medlm,coral,breastca,PROMPT2_ICL_entailment
119,205,18,15,3,0.8333333333333334,11,6,5,0.5454545454545454,0.6593406593406592,medlm,coral,breastca,PROMPT2_ICL_entailment
120,206,10,10,0,1.0,4,4,0,1.0,1.0,medlm,coral,breastca,PROMPT2_ICL_entailment
121,207,14,11,3,0.7857142857142857,12,6,6,0.5,0.6111111111111112,medlm,coral,breastca,PROMPT2_ICL_entailment
122,208,20,20,0,1.0,9,9,0,1.0,1.0,medlm,coral,breastca,PROMPT2_ICL_entailment
123,209,11,9,2,0.8181818181818182,11,9,2,0.8181818181818182,0.8181818181818182,medlm,coral,breastca,PROMPT2_ICL_entailment
124,21,9,4,5,0.4444444444444444,27,12,15,0.4444444444444444,0.4444444444444444,medlm,coral,breastca,PROMPT2_ICL_entailment
125,210,16,15,1,0.9375,13,9,4,0.6923076923076923,0.7964601769911505,medlm,coral,breastca,PROMPT2_ICL_entailment
126,211,13,13,0,1.0,11,9,2,0.8181818181818182,0.9,medlm,coral,breastca,PROMPT2_ICL_entailment
127,212,9,9,0,1.0,9,4,5,0.4444444444444444,0.6153846153846153,medlm,coral,breastca,PROMPT2_ICL_entailment
128,213,10,9,1,0.9,11,10,1,0.9090909090909092,0.9045226130653266,medlm,coral,breastca,PROMPT2_ICL_entailment
129,214,16,6,10,0.375,28,15,13,0.5357142857142857,0.4411764705882353,medlm,coral,breastca,PROMPT2_ICL_entailment
130,215,17,13,4,0.7647058823529411,37,9,28,0.2432432432432432,0.3690851735015773,medlm,coral,breastca,PROMPT2_ICL_entailment
131,216,27,23,4,0.8518518518518519,15,12,3,0.8,0.8251121076233184,medlm,coral,breastca,PROMPT2_ICL_entailment
132,22,20,14,6,0.7,7,4,3,0.5714285714285714,0.6292134831460674,medlm,coral,breastca,PROMPT2_ICL_entailment
133,23,13,12,1,0.9230769230769232,9,8,1,0.8888888888888888,0.9056603773584906,medlm,coral,breastca,PROMPT2_ICL_entailment
134,24,16,9,7,0.5625,10,9,1,0.9,0.6923076923076923,medlm,coral,breastca,PROMPT2_ICL_entailment
135,25,15,15,0,1.0,8,7,1,0.875,0.9333333333333332,medlm,coral,breastca,PROMPT2_ICL_entailment
136,26,17,16,1,0.9411764705882352,11,8,3,0.7272727272727273,0.8205128205128205,medlm,coral,breastca,PROMPT2_ICL_entailment
137,27,7,4,3,0.5714285714285714,12,8,4,0.6666666666666666,0.6153846153846153,medlm,coral,breastca,PROMPT2_ICL_entailment
138,28,10,8,2,0.8,18,9,9,0.5,0.6153846153846154,medlm,coral,breastca,PROMPT2_ICL_entailment
139,29,10,9,1,0.9,9,6,3,0.6666666666666666,0.7659574468085106,medlm,coral,breastca,PROMPT2_ICL_entailment
140,3,16,12,4,0.75,11,9,2,0.8181818181818182,0.7826086956521738,medlm,coral,breastca,PROMPT2_ICL_entailment
141,30,21,14,7,0.6666666666666666,18,6,12,0.3333333333333333,0.4444444444444444,medlm,coral,breastca,PROMPT2_ICL_entailment
142,31,13,10,3,0.7692307692307693,13,11,2,0.8461538461538461,0.8058608058608059,medlm,coral,breastca,PROMPT2_ICL_entailment
143,32,10,8,2,0.8,9,8,1,0.8888888888888888,0.8421052631578948,medlm,coral,breastca,PROMPT2_ICL_entailment
144,33,13,11,2,0.8461538461538461,8,4,4,0.5,0.6285714285714286,medlm,coral,breastca,PROMPT2_ICL_entailment
145,34,14,13,1,0.9285714285714286,10,7,3,0.7,0.7982456140350878,medlm,coral,breastca,PROMPT2_ICL_entailment
146,35,14,11,3,0.7857142857142857,12,9,3,0.75,0.7674418604651163,medlm,coral,breastca,PROMPT2_ICL_entailment
147,36,11,9,2,0.8181818181818182,11,10,1,0.9090909090909092,0.861244019138756,medlm,coral,breastca,PROMPT2_ICL_entailment
148,37,9,6,3,0.6666666666666666,11,9,2,0.8181818181818182,0.7346938775510203,medlm,coral,breastca,PROMPT2_ICL_entailment
149,38,7,6,1,0.8571428571428571,11,8,3,0.7272727272727273,0.7868852459016394,medlm,coral,breastca,PROMPT2_ICL_entailment
150,39,12,12,0,1.0,11,9,2,0.8181818181818182,0.9,medlm,coral,breastca,PROMPT2_ICL_entailment
151,4,26,18,8,0.6923076923076923,59,24,35,0.4067796610169492,0.5124555160142349,medlm,coral,breastca,PROMPT2_ICL_entailment
152,40,6,6,0,1.0,9,6,3,0.6666666666666666,0.8,medlm,coral,breastca,PROMPT2_ICL_entailment
153,41,7,7,0,1.0,14,9,5,0.6428571428571429,0.782608695652174,medlm,coral,breastca,PROMPT2_ICL_entailment
154,42,15,9,6,0.6,9,3,6,0.3333333333333333,0.4285714285714285,medlm,coral,breastca,PROMPT2_ICL_entailment
155,43,10,8,2,0.8,9,7,2,0.7777777777777778,0.7887323943661971,medlm,coral,breastca,PROMPT2_ICL_entailment
156,44,8,8,0,1.0,9,7,2,0.7777777777777778,0.8750000000000001,medlm,coral,breastca,PROMPT2_ICL_entailment
157,45,3,3,0,1.0,2,2,0,1.0,1.0,medlm,coral,breastca,PROMPT2_ICL_entailment
158,46,11,11,0,1.0,5,5,0,1.0,1.0,medlm,coral,breastca,PROMPT2_ICL_entailment
159,47,12,11,1,0.9166666666666666,2,2,0,1.0,0.9565217391304348,medlm,coral,breastca,PROMPT2_ICL_entailment
160,48,2,2,0,1.0,5,4,1,0.8,0.888888888888889,medlm,coral,breastca,PROMPT2_ICL_entailment
161,49,24,18,6,0.75,16,10,6,0.625,0.6818181818181818,medlm,coral,breastca,PROMPT2_ICL_entailment
162,5,20,15,5,0.75,12,9,3,0.75,0.75,medlm,coral,breastca,PROMPT2_ICL_entailment
163,50,24,13,11,0.5416666666666666,16,5,11,0.3125,0.3963414634146341,medlm,coral,breastca,PROMPT2_ICL_entailment
164,51,39,35,4,0.8974358974358975,11,9,2,0.8181818181818182,0.8559782608695653,medlm,coral,breastca,PROMPT2_ICL_entailment
165,52,15,13,2,0.8666666666666667,10,9,1,0.9,0.8830188679245283,medlm,coral,breastca,PROMPT2_ICL_entailment
166,53,19,19,0,1.0,10,9,1,0.9,0.9473684210526316,medlm,coral,breastca,PROMPT2_ICL_entailment
167,54,7,6,1,0.8571428571428571,9,4,5,0.4444444444444444,0.5853658536585367,medlm,coral,breastca,PROMPT2_ICL_entailment
168,55,3,3,0,1.0,1,1,0,1.0,1.0,medlm,coral,breastca,PROMPT2_ICL_entailment
169,56,8,8,0,1.0,18,4,14,0.2222222222222222,0.3636363636363636,medlm,coral,breastca,PROMPT2_ICL_entailment
170,57,24,23,1,0.9583333333333334,10,10,0,1.0,0.9787234042553192,medlm,coral,breastca,PROMPT2_ICL_entailment
171,58,19,16,3,0.8421052631578947,10,5,5,0.5,0.6274509803921569,medlm,coral,breastca,PROMPT2_ICL_entailment
172,59,10,8,2,0.8,9,9,0,1.0,0.888888888888889,medlm,coral,breastca,PROMPT2_ICL_entailment
173,6,10,8,2,0.8,8,8,0,1.0,0.888888888888889,medlm,coral,breastca,PROMPT2_ICL_entailment
174,60,18,17,1,0.9444444444444444,10,8,2,0.8,0.8662420382165604,medlm,coral,breastca,PROMPT2_ICL_entailment
175,61,16,16,0,1.0,11,9,2,0.8181818181818182,0.9,medlm,coral,breastca,PROMPT2_ICL_entailment
176,62,20,19,1,0.95,10,10,0,1.0,0.9743589743589745,medlm,coral,breastca,PROMPT2_ICL_entailment
177,63,6,6,0,1.0,11,4,7,0.3636363636363636,0.5333333333333333,medlm,coral,breastca,PROMPT2_ICL_entailment
178,64,3,3,0,1.0,18,9,9,0.5,0.6666666666666666,medlm,coral,breastca,PROMPT2_ICL_entailment
179,65,11,11,0,1.0,6,5,1,0.8333333333333334,0.9090909090909092,medlm,coral,breastca,PROMPT2_ICL_entailment
180,66,9,6,3,0.6666666666666666,10,8,2,0.8,0.7272727272727272,medlm,coral,breastca,PROMPT2_ICL_entailment
181,67,25,21,4,0.84,49,17,32,0.3469387755102041,0.4910591471801925,medlm,coral,breastca,PROMPT2_ICL_entailment
182,68,8,8,0,1.0,8,8,0,1.0,1.0,medlm,coral,breastca,PROMPT2_ICL_entailment
183,69,14,11,3,0.7857142857142857,12,4,8,0.3333333333333333,0.4680851063829786,medlm,coral,breastca,PROMPT2_ICL_entailment
184,7,10,10,0,1.0,11,6,5,0.5454545454545454,0.7058823529411764,medlm,coral,breastca,PROMPT2_ICL_entailment
185,70,28,17,11,0.6071428571428571,51,29,22,0.5686274509803921,0.5872543180464562,medlm,coral,breastca,PROMPT2_ICL_entailment
186,71,9,8,1,0.8888888888888888,5,5,0,1.0,0.9411764705882352,medlm,coral,breastca,PROMPT2_ICL_entailment
187,72,6,5,1,0.8333333333333334,3,2,1,0.6666666666666666,0.7407407407407408,medlm,coral,breastca,PROMPT2_ICL_entailment
188,73,13,12,1,0.9230769230769232,1,1,0,1.0,0.96,medlm,coral,breastca,PROMPT2_ICL_entailment
189,74,14,11,3,0.7857142857142857,2,2,0,1.0,0.88,medlm,coral,breastca,PROMPT2_ICL_entailment
190,75,22,20,2,0.9090909090909092,6,5,1,0.8333333333333334,0.8695652173913043,medlm,coral,breastca,PROMPT2_ICL_entailment
191,76,17,17,0,1.0,7,6,1,0.8571428571428571,0.923076923076923,medlm,coral,breastca,PROMPT2_ICL_entailment
192,77,10,10,0,1.0,15,8,7,0.5333333333333333,0.6956521739130436,medlm,coral,breastca,PROMPT2_ICL_entailment
193,78,13,12,1,0.9230769230769232,8,5,3,0.625,0.7453416149068324,medlm,coral,breastca,PROMPT2_ICL_entailment
194,79,10,8,2,0.8,8,5,3,0.625,0.7017543859649122,medlm,coral,breastca,PROMPT2_ICL_entailment
195,8,6,4,2,0.6666666666666666,9,5,4,0.5555555555555556,0.606060606060606,medlm,coral,breastca,PROMPT2_ICL_entailment
196,80,21,21,0,1.0,24,14,10,0.5833333333333334,0.7368421052631579,medlm,coral,breastca,PROMPT2_ICL_entailment
197,81,10,9,1,0.9,11,10,1,0.9090909090909092,0.9045226130653266,medlm,coral,breastca,PROMPT2_ICL_entailment
198,82,9,9,0,1.0,6,4,2,0.6666666666666666,0.8,medlm,coral,breastca,PROMPT2_ICL_entailment
199,83,8,8,0,1.0,6,5,1,0.8333333333333334,0.9090909090909092,medlm,coral,breastca,PROMPT2_ICL_entailment
200,84,19,17,2,0.8947368421052632,11,8,3,0.7272727272727273,0.8023598820058998,medlm,coral,breastca,PROMPT2_ICL_entailment
201,85,14,12,2,0.8571428571428571,7,3,4,0.4285714285714285,0.5714285714285714,medlm,coral,breastca,PROMPT2_ICL_entailment
202,86,21,18,3,0.8571428571428571,16,12,4,0.75,0.7999999999999999,medlm,coral,breastca,PROMPT2_ICL_entailment
203,87,6,4,2,0.6666666666666666,8,8,0,1.0,0.8,medlm,coral,breastca,PROMPT2_ICL_entailment
204,88,7,7,0,1.0,8,7,1,0.875,0.9333333333333332,medlm,coral,breastca,PROMPT2_ICL_entailment
205,89,10,10,0,1.0,11,9,2,0.8181818181818182,0.9,medlm,coral,breastca,PROMPT2_ICL_entailment
206,9,8,5,3,0.625,6,6,0,1.0,0.7692307692307693,medlm,coral,breastca,PROMPT2_ICL_entailment
207,90,19,8,11,0.4210526315789473,18,11,7,0.6111111111111112,0.4985835694050991,medlm,coral,breastca,PROMPT2_ICL_entailment
208,91,11,9,2,0.8181818181818182,7,2,5,0.2857142857142857,0.4235294117647059,medlm,coral,breastca,PROMPT2_ICL_entailment
209,92,6,6,0,1.0,2,1,1,0.5,0.6666666666666666,medlm,coral,breastca,PROMPT2_ICL_entailment
210,93,9,9,0,1.0,13,8,5,0.6153846153846154,0.761904761904762,medlm,coral,breastca,PROMPT2_ICL_entailment
211,94,22,15,7,0.6818181818181818,25,16,9,0.64,0.6602475928473177,medlm,coral,breastca,PROMPT2_ICL_entailment
212,95,34,29,5,0.8529411764705882,13,6,7,0.4615384615384615,0.5989672977624785,medlm,coral,breastca,PROMPT2_ICL_entailment
213,96,14,10,4,0.7142857142857143,10,8,2,0.8,0.7547169811320756,medlm,coral,breastca,PROMPT2_ICL_entailment
214,97,15,13,2,0.8666666666666667,11,9,2,0.8181818181818182,0.8417266187050358,medlm,coral,breastca,PROMPT2_ICL_entailment
215,98,6,6,0,1.0,2,2,0,1.0,1.0,medlm,coral,breastca,PROMPT2_ICL_entailment
216,99,18,18,0,1.0,15,12,3,0.8,0.888888888888889,medlm,coral,breastca,PROMPT2_ICL_entailment
0,0,8,8,0,1.0,10,9,1,0.9,0.9473684210526316,medlm,coral,breastca,PROMPT2_entailment
1,1,16,14,2,0.875,12,10,2,0.8333333333333334,0.8536585365853658,medlm,coral,breastca,PROMPT2_entailment
2,10,14,11,3,0.7857142857142857,10,10,0,1.0,0.88,medlm,coral,breastca,PROMPT2_entailment
3,100,13,8,5,0.6153846153846154,26,10,16,0.3846153846153846,0.4733727810650888,medlm,coral,breastca,PROMPT2_entailment
4,101,27,23,4,0.8518518518518519,18,15,3,0.8333333333333334,0.8424908424908426,medlm,coral,breastca,PROMPT2_entailment
5,102,7,7,0,1.0,7,6,1,0.8571428571428571,0.923076923076923,medlm,coral,breastca,PROMPT2_entailment
6,103,17,17,0,1.0,10,9,1,0.9,0.9473684210526316,medlm,coral,breastca,PROMPT2_entailment
7,104,9,8,1,0.8888888888888888,26,6,20,0.2307692307692307,0.366412213740458,medlm,coral,breastca,PROMPT2_entailment
8,105,7,6,1,0.8571428571428571,15,13,2,0.8666666666666667,0.861878453038674,medlm,coral,breastca,PROMPT2_entailment
9,106,14,13,1,0.9285714285714286,9,8,1,0.8888888888888888,0.9082969432314412,medlm,coral,breastca,PROMPT2_entailment
10,107,10,9,1,0.9,9,9,0,1.0,0.9473684210526316,medlm,coral,breastca,PROMPT2_entailment
11,108,4,4,0,1.0,11,11,0,1.0,1.0,medlm,coral,breastca,PROMPT2_entailment
12,109,9,8,1,0.8888888888888888,11,10,1,0.9090909090909092,0.8988764044943819,medlm,coral,breastca,PROMPT2_entailment
13,11,4,4,0,1.0,3,3,0,1.0,1.0,medlm,coral,breastca,PROMPT2_entailment
14,110,9,9,0,1.0,11,7,4,0.6363636363636364,0.7777777777777778,medlm,coral,breastca,PROMPT2_entailment
15,111,12,9,3,0.75,10,8,2,0.8,0.7741935483870969,medlm,coral,breastca,PROMPT2_entailment
16,112,12,12,0,1.0,10,8,2,0.8,0.888888888888889,medlm,coral,breastca,PROMPT2_entailment
17,113,16,11,5,0.6875,49,18,31,0.3673469387755102,0.4788391777509069,medlm,coral,breastca,PROMPT2_entailment
18,114,28,15,13,0.5357142857142857,21,13,8,0.6190476190476191,0.5743740795287188,medlm,coral,breastca,PROMPT2_entailment
19,115,13,9,4,0.6923076923076923,9,8,1,0.8888888888888888,0.7783783783783783,medlm,coral,breastca,PROMPT2_entailment
20,116,13,12,1,0.9230769230769232,14,11,3,0.7857142857142857,0.8488745980707394,medlm,coral,breastca,PROMPT2_entailment
21,117,4,4,0,1.0,2,2,0,1.0,1.0,medlm,coral,breastca,PROMPT2_entailment
22,118,11,11,0,1.0,19,4,15,0.2105263157894736,0.3478260869565217,medlm,coral,breastca,PROMPT2_entailment
23,119,10,8,2,0.8,10,10,0,1.0,0.888888888888889,medlm,coral,breastca,PROMPT2_entailment
24,12,8,7,1,0.875,10,9,1,0.9,0.8873239436619719,medlm,coral,breastca,PROMPT2_entailment
25,120,9,8,1,0.8888888888888888,9,6,3,0.6666666666666666,0.761904761904762,medlm,coral,breastca,PROMPT2_entailment
26,121,14,11,3,0.7857142857142857,10,6,4,0.6,0.6804123711340206,medlm,coral,breastca,PROMPT2_entailment
27,122,16,16,0,1.0,9,8,1,0.8888888888888888,0.9411764705882352,medlm,coral,breastca,PROMPT2_entailment
28,123,11,11,0,1.0,8,8,0,1.0,1.0,medlm,coral,breastca,PROMPT2_entailment
29,124,12,11,1,0.9166666666666666,10,10,0,1.0,0.9565217391304348,medlm,coral,breastca,PROMPT2_entailment
30,125,20,20,0,1.0,11,9,2,0.8181818181818182,0.9,medlm,coral,breastca,PROMPT2_entailment
31,126,11,10,1,0.9090909090909092,10,10,0,1.0,0.9523809523809524,medlm,coral,breastca,PROMPT2_entailment
32,127,12,11,1,0.9166666666666666,10,7,3,0.7,0.7938144329896907,medlm,coral,breastca,PROMPT2_entailment
33,128,19,18,1,0.9473684210526316,11,9,2,0.8181818181818182,0.8780487804878049,medlm,coral,breastca,PROMPT2_entailment
34,129,6,6,0,1.0,11,8,3,0.7272727272727273,0.8421052631578948,medlm,coral,breastca,PROMPT2_entailment
35,13,9,5,4,0.5555555555555556,10,7,3,0.7,0.6194690265486726,medlm,coral,breastca,PROMPT2_entailment
36,130,39,5,34,0.1282051282051282,7,6,1,0.8571428571428571,0.2230483271375464,medlm,coral,breastca,PROMPT2_entailment
37,131,11,11,0,1.0,10,10,0,1.0,1.0,medlm,coral,breastca,PROMPT2_entailment
38,132,5,5,0,1.0,8,4,4,0.5,0.6666666666666666,medlm,coral,breastca,PROMPT2_entailment
39,133,33,30,3,0.9090909090909092,29,15,14,0.5172413793103449,0.6593406593406593,medlm,coral,breastca,PROMPT2_entailment
40,134,3,3,0,1.0,11,9,2,0.8181818181818182,0.9,medlm,coral,breastca,PROMPT2_entailment
41,135,13,8,5,0.6153846153846154,16,12,4,0.75,0.676056338028169,medlm,coral,breastca,PROMPT2_entailment
42,136,25,11,14,0.44,10,7,3,0.7,0.5403508771929825,medlm,coral,breastca,PROMPT2_entailment
43,137,14,14,0,1.0,10,9,1,0.9,0.9473684210526316,medlm,coral,breastca,PROMPT2_entailment
44,138,3,3,0,1.0,10,10,0,1.0,1.0,medlm,coral,breastca,PROMPT2_entailment
45,139,5,4,1,0.8,11,10,1,0.9090909090909092,0.8510638297872342,medlm,coral,breastca,PROMPT2_entailment
46,14,16,14,2,0.875,59,14,45,0.2372881355932203,0.3733333333333333,medlm,coral,breastca,PROMPT2_entailment
47,140,9,6,3,0.6666666666666666,9,6,3,0.6666666666666666,0.6666666666666666,medlm,coral,breastca,PROMPT2_entailment
48,141,9,6,3,0.6666666666666666,11,10,1,0.9090909090909092,0.7692307692307692,medlm,coral,breastca,PROMPT2_entailment
49,142,7,7,0,1.0,10,10,0,1.0,1.0,medlm,coral,breastca,PROMPT2_entailment
50,143,4,2,2,0.5,10,6,4,0.6,0.5454545454545454,medlm,coral,breastca,PROMPT2_entailment
51,144,6,6,0,1.0,5,5,0,1.0,1.0,medlm,coral,breastca,PROMPT2_entailment
52,145,12,12,0,1.0,5,5,0,1.0,1.0,medlm,coral,breastca,PROMPT2_entailment
53,146,8,8,0,1.0,9,8,1,0.8888888888888888,0.9411764705882352,medlm,coral,breastca,PROMPT2_entailment
54,147,5,5,0,1.0,5,5,0,1.0,1.0,medlm,coral,breastca,PROMPT2_entailment
55,148,12,10,2,0.8333333333333334,4,1,3,0.25,0.3846153846153846,medlm,coral,breastca,PROMPT2_entailment
56,149,10,10,0,1.0,1,1,0,1.0,1.0,medlm,coral,breastca,PROMPT2_entailment
57,15,9,7,2,0.7777777777777778,16,6,10,0.375,0.5060240963855422,medlm,coral,breastca,PROMPT2_entailment
58,150,11,9,2,0.8181818181818182,2,2,0,1.0,0.9,medlm,coral,breastca,PROMPT2_entailment
59,151,5,4,1,0.8,9,4,5,0.4444444444444444,0.5714285714285714,medlm,coral,breastca,PROMPT2_entailment
60,152,6,4,2,0.6666666666666666,16,6,10,0.375,0.4800000000000001,medlm,coral,breastca,PROMPT2_entailment
61,153,10,9,1,0.9,1,1,0,1.0,0.9473684210526316,medlm,coral,breastca,PROMPT2_entailment
62,154,6,6,0,1.0,10,10,0,1.0,1.0,medlm,coral,breastca,PROMPT2_entailment
63,155,16,11,5,0.6875,9,9,0,1.0,0.8148148148148148,medlm,coral,breastca,PROMPT2_entailment
64,156,10,8,2,0.8,8,8,0,1.0,0.888888888888889,medlm,coral,breastca,PROMPT2_entailment
65,157,10,10,0,1.0,9,9,0,1.0,1.0,medlm,coral,breastca,PROMPT2_entailment
66,158,19,12,7,0.631578947368421,16,13,3,0.8125,0.7107061503416856,medlm,coral,breastca,PROMPT2_entailment
67,159,5,5,0,1.0,29,13,16,0.4482758620689655,0.6190476190476191,medlm,coral,breastca,PROMPT2_entailment
68,16,13,11,2,0.8461538461538461,10,5,5,0.5,0.6285714285714286,medlm,coral,breastca,PROMPT2_entailment
69,160,14,14,0,1.0,18,14,4,0.7777777777777778,0.8750000000000001,medlm,coral,breastca,PROMPT2_entailment
70,161,4,4,0,1.0,11,8,3,0.7272727272727273,0.8421052631578948,medlm,coral,breastca,PROMPT2_entailment
71,162,7,6,1,0.8571428571428571,16,10,6,0.625,0.7228915662650602,medlm,coral,breastca,PROMPT2_entailment
72,163,9,9,0,1.0,11,8,3,0.7272727272727273,0.8421052631578948,medlm,coral,breastca,PROMPT2_entailment
73,164,11,11,0,1.0,8,5,3,0.625,0.7692307692307693,medlm,coral,breastca,PROMPT2_entailment
74,165,6,6,0,1.0,12,8,4,0.6666666666666666,0.8,medlm,coral,breastca,PROMPT2_entailment
75,166,12,5,7,0.4166666666666667,10,4,6,0.4,0.4081632653061225,medlm,coral,breastca,PROMPT2_entailment
76,167,10,6,4,0.6,7,6,1,0.8571428571428571,0.7058823529411764,medlm,coral,breastca,PROMPT2_entailment
77,168,7,5,2,0.7142857142857143,7,4,3,0.5714285714285714,0.634920634920635,medlm,coral,breastca,PROMPT2_entailment
78,169,7,5,2,0.7142857142857143,11,7,4,0.6363636363636364,0.673076923076923,medlm,coral,breastca,PROMPT2_entailment
79,17,4,4,0,1.0,3,3,0,1.0,1.0,medlm,coral,breastca,PROMPT2_entailment
80,170,8,7,1,0.875,10,4,6,0.4,0.5490196078431373,medlm,coral,breastca,PROMPT2_entailment
81,171,12,11,1,0.9166666666666666,9,9,0,1.0,0.9565217391304348,medlm,coral,breastca,PROMPT2_entailment
82,172,1,1,0,1.0,32,2,30,0.0625,0.1176470588235294,medlm,coral,breastca,PROMPT2_entailment
83,173,12,10,2,0.8333333333333334,11,10,1,0.9090909090909092,0.8695652173913043,medlm,coral,breastca,PROMPT2_entailment
84,174,7,5,2,0.7142857142857143,7,4,3,0.5714285714285714,0.634920634920635,medlm,coral,breastca,PROMPT2_entailment
85,175,9,9,0,1.0,10,8,2,0.8,0.888888888888889,medlm,coral,breastca,PROMPT2_entailment
86,176,5,5,0,1.0,10,4,6,0.4,0.5714285714285715,medlm,coral,breastca,PROMPT2_entailment
87,177,1,0,1,0.0,9,6,3,0.6666666666666666,0.0,medlm,coral,breastca,PROMPT2_entailment
88,178,4,3,1,0.75,10,5,5,0.5,0.6,medlm,coral,breastca,PROMPT2_entailment
89,179,7,7,0,1.0,9,7,2,0.7777777777777778,0.8750000000000001,medlm,coral,breastca,PROMPT2_entailment
90,18,7,4,3,0.5714285714285714,8,8,0,1.0,0.7272727272727273,medlm,coral,breastca,PROMPT2_entailment
91,180,8,7,1,0.875,10,5,5,0.5,0.6363636363636364,medlm,coral,breastca,PROMPT2_entailment
92,181,3,3,0,1.0,9,6,3,0.6666666666666666,0.8,medlm,coral,breastca,PROMPT2_entailment
93,182,7,7,0,1.0,9,7,2,0.7777777777777778,0.8750000000000001,medlm,coral,breastca,PROMPT2_entailment
94,183,1,1,0,1.0,10,9,1,0.9,0.9473684210526316,medlm,coral,breastca,PROMPT2_entailment
95,184,11,9,2,0.8181818181818182,9,6,3,0.6666666666666666,0.7346938775510203,medlm,coral,breastca,PROMPT2_entailment
96,185,8,7,1,0.875,10,7,3,0.7,0.7777777777777777,medlm,coral,breastca,PROMPT2_entailment
97,186,6,6,0,1.0,5,5,0,1.0,1.0,medlm,coral,breastca,PROMPT2_entailment
98,187,8,7,1,0.875,26,8,18,0.3076923076923077,0.4552845528455285,medlm,coral,breastca,PROMPT2_entailment
99,188,13,13,0,1.0,9,9,0,1.0,1.0,medlm,coral,breastca,PROMPT2_entailment
100,189,15,15,0,1.0,9,8,1,0.8888888888888888,0.9411764705882352,medlm,coral,breastca,PROMPT2_entailment
101,19,10,10,0,1.0,8,6,2,0.75,0.8571428571428571,medlm,coral,breastca,PROMPT2_entailment
102,190,26,10,16,0.3846153846153846,34,14,20,0.4117647058823529,0.3977272727272727,medlm,coral,breastca,PROMPT2_entailment
103,191,8,6,2,0.75,14,8,6,0.5714285714285714,0.6486486486486486,medlm,coral,breastca,PROMPT2_entailment
104,192,12,12,0,1.0,12,11,1,0.9166666666666666,0.9565217391304348,medlm,coral,breastca,PROMPT2_entailment
105,193,5,5,0,1.0,2,2,0,1.0,1.0,medlm,coral,breastca,PROMPT2_entailment
106,194,9,9,0,1.0,15,11,4,0.7333333333333333,0.846153846153846,medlm,coral,breastca,PROMPT2_entailment
107,195,11,10,1,0.9090909090909092,13,11,2,0.8461538461538461,0.8764940239043824,medlm,coral,breastca,PROMPT2_entailment
108,196,23,17,6,0.7391304347826086,30,20,10,0.6666666666666666,0.7010309278350515,medlm,coral,breastca,PROMPT2_entailment
109,197,9,8,1,0.8888888888888888,14,9,5,0.6428571428571429,0.7461139896373057,medlm,coral,breastca,PROMPT2_entailment
110,198,14,13,1,0.9285714285714286,11,9,2,0.8181818181818182,0.8698884758364314,medlm,coral,breastca,PROMPT2_entailment
111,199,4,4,0,1.0,2,2,0,1.0,1.0,medlm,coral,breastca,PROMPT2_entailment
112,2,8,7,1,0.875,10,7,3,0.7,0.7777777777777777,medlm,coral,breastca,PROMPT2_entailment
113,20,11,8,3,0.7272727272727273,17,7,10,0.4117647058823529,0.5258215962441314,medlm,coral,breastca,PROMPT2_entailment
114,200,8,8,0,1.0,15,10,5,0.6666666666666666,0.8,medlm,coral,breastca,PROMPT2_entailment
115,201,12,10,2,0.8333333333333334,26,17,9,0.6538461538461539,0.7327586206896552,medlm,coral,breastca,PROMPT2_entailment
116,202,11,10,1,0.9090909090909092,17,12,5,0.7058823529411765,0.794701986754967,medlm,coral,breastca,PROMPT2_entailment
117,203,29,27,2,0.9310344827586208,27,15,12,0.5555555555555556,0.6958762886597938,medlm,coral,breastca,PROMPT2_entailment
118,204,7,6,1,0.8571428571428571,11,6,5,0.5454545454545454,0.6666666666666665,medlm,coral,breastca,PROMPT2_entailment
119,205,6,4,2,0.6666666666666666,11,7,4,0.6363636363636364,0.6511627906976744,medlm,coral,breastca,PROMPT2_entailment
120,206,9,9,0,1.0,4,4,0,1.0,1.0,medlm,coral,breastca,PROMPT2_entailment
121,207,13,12,1,0.9230769230769232,12,7,5,0.5833333333333334,0.7148936170212767,medlm,coral,breastca,PROMPT2_entailment
122,208,19,19,0,1.0,9,9,0,1.0,1.0,medlm,coral,breastca,PROMPT2_entailment
123,209,11,9,2,0.8181818181818182,11,10,1,0.9090909090909092,0.861244019138756,medlm,coral,breastca,PROMPT2_entailment
124,21,9,5,4,0.5555555555555556,27,9,18,0.3333333333333333,0.4166666666666667,medlm,coral,breastca,PROMPT2_entailment
125,210,16,16,0,1.0,13,10,3,0.7692307692307693,0.8695652173913044,medlm,coral,breastca,PROMPT2_entailment
126,211,7,3,4,0.4285714285714285,11,10,1,0.9090909090909092,0.5825242718446602,medlm,coral,breastca,PROMPT2_entailment
127,212,9,8,1,0.8888888888888888,9,5,4,0.5555555555555556,0.6837606837606838,medlm,coral,breastca,PROMPT2_entailment
128,213,10,10,0,1.0,11,10,1,0.9090909090909092,0.9523809523809524,medlm,coral,breastca,PROMPT2_entailment
129,214,6,1,5,0.1666666666666666,28,8,20,0.2857142857142857,0.2105263157894737,medlm,coral,breastca,PROMPT2_entailment
130,215,18,11,7,0.6111111111111112,37,18,19,0.4864864864864865,0.5417236662106704,medlm,coral,breastca,PROMPT2_entailment
131,216,27,23,4,0.8518518518518519,15,12,3,0.8,0.8251121076233184,medlm,coral,breastca,PROMPT2_entailment
132,22,6,6,0,1.0,7,4,3,0.5714285714285714,0.7272727272727273,medlm,coral,breastca,PROMPT2_entailment
133,23,11,10,1,0.9090909090909092,9,8,1,0.8888888888888888,0.8988764044943819,medlm,coral,breastca,PROMPT2_entailment
134,24,15,9,6,0.6,10,7,3,0.7,0.6461538461538462,medlm,coral,breastca,PROMPT2_entailment
135,25,15,15,0,1.0,8,7,1,0.875,0.9333333333333332,medlm,coral,breastca,PROMPT2_entailment
136,26,7,7,0,1.0,11,7,4,0.6363636363636364,0.7777777777777778,medlm,coral,breastca,PROMPT2_entailment
137,27,10,7,3,0.7,12,8,4,0.6666666666666666,0.6829268292682926,medlm,coral,breastca,PROMPT2_entailment
138,28,7,6,1,0.8571428571428571,18,11,7,0.6111111111111112,0.7135135135135134,medlm,coral,breastca,PROMPT2_entailment
139,29,9,8,1,0.8888888888888888,9,4,5,0.4444444444444444,0.5925925925925926,medlm,coral,breastca,PROMPT2_entailment
140,3,13,8,5,0.6153846153846154,11,9,2,0.8181818181818182,0.7024390243902439,medlm,coral,breastca,PROMPT2_entailment
141,30,22,10,12,0.4545454545454545,18,10,8,0.5555555555555556,0.5,medlm,coral,breastca,PROMPT2_entailment
142,31,11,9,2,0.8181818181818182,13,8,5,0.6153846153846154,0.7024390243902439,medlm,coral,breastca,PROMPT2_entailment
143,32,10,9,1,0.9,9,9,0,1.0,0.9473684210526316,medlm,coral,breastca,PROMPT2_entailment
144,33,13,12,1,0.9230769230769232,8,6,2,0.75,0.8275862068965517,medlm,coral,breastca,PROMPT2_entailment
145,34,13,12,1,0.9230769230769232,10,10,0,1.0,0.96,medlm,coral,breastca,PROMPT2_entailment
146,35,5,5,0,1.0,12,7,5,0.5833333333333334,0.7368421052631579,medlm,coral,breastca,PROMPT2_entailment
147,36,7,7,0,1.0,11,9,2,0.8181818181818182,0.9,medlm,coral,breastca,PROMPT2_entailment
148,37,8,4,4,0.5,11,7,4,0.6363636363636364,0.56,medlm,coral,breastca,PROMPT2_entailment
149,38,7,6,1,0.8571428571428571,11,8,3,0.7272727272727273,0.7868852459016394,medlm,coral,breastca,PROMPT2_entailment
150,39,12,11,1,0.9166666666666666,11,9,2,0.8181818181818182,0.8646288209606987,medlm,coral,breastca,PROMPT2_entailment
151,4,7,5,2,0.7142857142857143,59,20,39,0.3389830508474576,0.4597701149425287,medlm,coral,breastca,PROMPT2_entailment
152,40,5,5,0,1.0,9,5,4,0.5555555555555556,0.7142857142857143,medlm,coral,breastca,PROMPT2_entailment
153,41,4,4,0,1.0,14,11,3,0.7857142857142857,0.88,medlm,coral,breastca,PROMPT2_entailment
154,42,16,11,5,0.6875,9,3,6,0.3333333333333333,0.4489795918367347,medlm,coral,breastca,PROMPT2_entailment
155,43,10,8,2,0.8,9,7,2,0.7777777777777778,0.7887323943661971,medlm,coral,breastca,PROMPT2_entailment
156,44,10,10,0,1.0,9,8,1,0.8888888888888888,0.9411764705882352,medlm,coral,breastca,PROMPT2_entailment
157,45,4,4,0,1.0,2,2,0,1.0,1.0,medlm,coral,breastca,PROMPT2_entailment
158,46,7,6,1,0.8571428571428571,5,4,1,0.8,0.8275862068965518,medlm,coral,breastca,PROMPT2_entailment
159,47,12,11,1,0.9166666666666666,2,2,0,1.0,0.9565217391304348,medlm,coral,breastca,PROMPT2_entailment
160,48,5,5,0,1.0,5,4,1,0.8,0.888888888888889,medlm,coral,breastca,PROMPT2_entailment
161,49,20,13,7,0.65,16,9,7,0.5625,0.6030927835051547,medlm,coral,breastca,PROMPT2_entailment
162,5,21,17,4,0.8095238095238095,12,8,4,0.6666666666666666,0.7311827956989246,medlm,coral,breastca,PROMPT2_entailment
163,50,26,19,7,0.7307692307692307,16,12,4,0.75,0.7402597402597402,medlm,coral,breastca,PROMPT2_entailment
164,51,9,8,1,0.8888888888888888,11,9,2,0.8181818181818182,0.8520710059171598,medlm,coral,breastca,PROMPT2_entailment
165,52,9,9,0,1.0,10,10,0,1.0,1.0,medlm,coral,breastca,PROMPT2_entailment
166,53,15,14,1,0.9333333333333332,10,9,1,0.9,0.9163636363636364,medlm,coral,breastca,PROMPT2_entailment
167,54,7,6,1,0.8571428571428571,9,5,4,0.5555555555555556,0.6741573033707865,medlm,coral,breastca,PROMPT2_entailment
168,55,1,1,0,1.0,1,1,0,1.0,1.0,medlm,coral,breastca,PROMPT2_entailment
169,56,8,8,0,1.0,18,4,14,0.2222222222222222,0.3636363636363636,medlm,coral,breastca,PROMPT2_entailment
170,57,16,14,2,0.875,10,9,1,0.9,0.8873239436619719,medlm,coral,breastca,PROMPT2_entailment
171,58,8,8,0,1.0,10,7,3,0.7,0.8235294117647058,medlm,coral,breastca,PROMPT2_entailment
172,59,4,4,0,1.0,9,8,1,0.8888888888888888,0.9411764705882352,medlm,coral,breastca,PROMPT2_entailment
173,6,10,8,2,0.8,8,5,3,0.625,0.7017543859649122,medlm,coral,breastca,PROMPT2_entailment
174,60,16,16,0,1.0,10,9,1,0.9,0.9473684210526316,medlm,coral,breastca,PROMPT2_entailment
175,61,15,15,0,1.0,11,10,1,0.9090909090909092,0.9523809523809524,medlm,coral,breastca,PROMPT2_entailment
176,62,12,11,1,0.9166666666666666,10,10,0,1.0,0.9565217391304348,medlm,coral,breastca,PROMPT2_entailment
177,63,6,6,0,1.0,11,4,7,0.3636363636363636,0.5333333333333333,medlm,coral,breastca,PROMPT2_entailment
178,64,3,3,0,1.0,18,9,9,0.5,0.6666666666666666,medlm,coral,breastca,PROMPT2_entailment
179,65,9,9,0,1.0,6,4,2,0.6666666666666666,0.8,medlm,coral,breastca,PROMPT2_entailment
180,66,12,11,1,0.9166666666666666,10,5,5,0.5,0.6470588235294118,medlm,coral,breastca,PROMPT2_entailment
181,67,30,23,7,0.7666666666666667,49,25,24,0.5102040816326531,0.6126798082045818,medlm,coral,breastca,PROMPT2_entailment
182,68,8,8,0,1.0,8,8,0,1.0,1.0,medlm,coral,breastca,PROMPT2_entailment
183,69,13,11,2,0.8461538461538461,12,4,8,0.3333333333333333,0.4782608695652173,medlm,coral,breastca,PROMPT2_entailment
184,7,8,7,1,0.875,11,7,4,0.6363636363636364,0.7368421052631579,medlm,coral,breastca,PROMPT2_entailment
185,70,30,24,6,0.8,51,23,28,0.4509803921568627,0.5768025078369907,medlm,coral,breastca,PROMPT2_entailment
186,71,4,3,1,0.75,5,2,3,0.4,0.5217391304347827,medlm,coral,breastca,PROMPT2_entailment
187,72,6,5,1,0.8333333333333334,3,1,2,0.3333333333333333,0.4761904761904761,medlm,coral,breastca,PROMPT2_entailment
188,73,10,10,0,1.0,1,1,0,1.0,1.0,medlm,coral,breastca,PROMPT2_entailment
189,74,15,12,3,0.8,2,1,1,0.5,0.6153846153846154,medlm,coral,breastca,PROMPT2_entailment
190,75,19,13,6,0.6842105263157895,6,5,1,0.8333333333333334,0.7514450867052023,medlm,coral,breastca,PROMPT2_entailment
191,76,11,11,0,1.0,7,7,0,1.0,1.0,medlm,coral,breastca,PROMPT2_entailment
192,77,7,7,0,1.0,15,7,8,0.4666666666666667,0.6363636363636364,medlm,coral,breastca,PROMPT2_entailment
193,78,13,12,1,0.9230769230769232,8,5,3,0.625,0.7453416149068324,medlm,coral,breastca,PROMPT2_entailment
194,79,7,7,0,1.0,8,7,1,0.875,0.9333333333333332,medlm,coral,breastca,PROMPT2_entailment
195,8,7,4,3,0.5714285714285714,9,4,5,0.4444444444444444,0.5,medlm,coral,breastca,PROMPT2_entailment
196,80,25,21,4,0.84,24,16,8,0.6666666666666666,0.743362831858407,medlm,coral,breastca,PROMPT2_entailment
197,81,8,6,2,0.75,11,8,3,0.7272727272727273,0.7384615384615384,medlm,coral,breastca,PROMPT2_entailment
198,82,6,5,1,0.8333333333333334,6,6,0,1.0,0.9090909090909092,medlm,coral,breastca,PROMPT2_entailment
199,83,7,7,0,1.0,6,5,1,0.8333333333333334,0.9090909090909092,medlm,coral,breastca,PROMPT2_entailment
200,84,9,7,2,0.7777777777777778,11,8,3,0.7272727272727273,0.7516778523489932,medlm,coral,breastca,PROMPT2_entailment
201,85,6,4,2,0.6666666666666666,7,3,4,0.4285714285714285,0.5217391304347826,medlm,coral,breastca,PROMPT2_entailment
202,86,18,14,4,0.7777777777777778,16,13,3,0.8125,0.7947598253275109,medlm,coral,breastca,PROMPT2_entailment
203,87,5,5,0,1.0,8,8,0,1.0,1.0,medlm,coral,breastca,PROMPT2_entailment
204,88,5,5,0,1.0,8,6,2,0.75,0.8571428571428571,medlm,coral,breastca,PROMPT2_entailment
205,89,9,9,0,1.0,11,9,2,0.8181818181818182,0.9,medlm,coral,breastca,PROMPT2_entailment
206,9,8,7,1,0.875,6,5,1,0.8333333333333334,0.8536585365853658,medlm,coral,breastca,PROMPT2_entailment
207,90,20,12,8,0.6,18,9,9,0.5,0.5454545454545454,medlm,coral,breastca,PROMPT2_entailment
208,91,11,8,3,0.7272727272727273,7,4,3,0.5714285714285714,0.64,medlm,coral,breastca,PROMPT2_entailment
209,92,3,3,0,1.0,2,2,0,1.0,1.0,medlm,coral,breastca,PROMPT2_entailment
210,93,12,12,0,1.0,13,7,6,0.5384615384615384,0.7000000000000001,medlm,coral,breastca,PROMPT2_entailment
211,94,22,16,6,0.7272727272727273,25,17,8,0.68,0.7028423772609821,medlm,coral,breastca,PROMPT2_entailment
212,95,4,2,2,0.5,13,7,6,0.5384615384615384,0.5185185185185186,medlm,coral,breastca,PROMPT2_entailment
213,96,23,18,5,0.782608695652174,10,10,0,1.0,0.878048780487805,medlm,coral,breastca,PROMPT2_entailment
214,97,15,11,4,0.7333333333333333,11,7,4,0.6363636363636364,0.6814159292035398,medlm,coral,breastca,PROMPT2_entailment
215,98,6,6,0,1.0,2,2,0,1.0,1.0,medlm,coral,breastca,PROMPT2_entailment
216,99,8,8,0,1.0,15,10,5,0.6666666666666666,0.8,medlm,coral,breastca,PROMPT2_entailment
0,0,7,3,4,0.4285714285714285,11,7,4,0.6363636363636364,0.5121951219512195,medlm,mimiciii,nursing_note,PROMPT1_entailment
1,1,27,18,9,0.6666666666666666,31,21,10,0.6774193548387096,0.6719999999999999,medlm,mimiciii,nursing_note,PROMPT1_entailment
2,10,19,14,5,0.7368421052631579,18,14,4,0.7777777777777778,0.7567567567567567,medlm,mimiciii,nursing_note,PROMPT1_entailment
3,100,9,7,2,0.7777777777777778,6,4,2,0.6666666666666666,0.717948717948718,medlm,mimiciii,nursing_note,PROMPT1_entailment
4,101,26,25,1,0.9615384615384616,27,25,2,0.925925925925926,0.9433962264150944,medlm,mimiciii,nursing_note,PROMPT1_entailment
5,102,13,13,0,1.0,26,19,7,0.7307692307692307,0.8444444444444443,medlm,mimiciii,nursing_note,PROMPT1_entailment
6,103,18,13,5,0.7222222222222222,22,21,1,0.9545454545454546,0.822289156626506,medlm,mimiciii,nursing_note,PROMPT1_entailment
7,104,20,14,6,0.7,20,19,1,0.95,0.806060606060606,medlm,mimiciii,nursing_note,PROMPT1_entailment
8,105,19,11,8,0.5789473684210527,20,19,1,0.95,0.7194492254733219,medlm,mimiciii,nursing_note,PROMPT1_entailment
9,106,6,6,0,1.0,4,4,0,1.0,1.0,medlm,mimiciii,nursing_note,PROMPT1_entailment
10,107,21,13,8,0.6190476190476191,63,40,23,0.6349206349206349,0.6268836648583483,medlm,mimiciii,nursing_note,PROMPT1_entailment
11,108,32,32,0,1.0,28,23,5,0.8214285714285714,0.9019607843137256,medlm,mimiciii,nursing_note,PROMPT1_entailment
12,109,4,4,0,1.0,4,4,0,1.0,1.0,medlm,mimiciii,nursing_note,PROMPT1_entailment
13,11,1,1,0,1.0,2,1,1,0.5,0.6666666666666666,medlm,mimiciii,nursing_note,PROMPT1_entailment
14,110,13,13,0,1.0,13,13,0,1.0,1.0,medlm,mimiciii,nursing_note,PROMPT1_entailment
15,111,24,20,4,0.8333333333333334,34,28,6,0.8235294117647058,0.8284023668639053,medlm,mimiciii,nursing_note,PROMPT1_entailment
16,112,43,32,11,0.7441860465116279,37,25,12,0.6756756756756757,0.7082779991146525,medlm,mimiciii,nursing_note,PROMPT1_entailment
17,113,3,3,0,1.0,5,4,1,0.8,0.888888888888889,medlm,mimiciii,nursing_note,PROMPT1_entailment
18,114,18,14,4,0.7777777777777778,19,15,4,0.7894736842105263,0.7835820895522387,medlm,mimiciii,nursing_note,PROMPT1_entailment
19,115,9,9,0,1.0,7,5,2,0.7142857142857143,0.8333333333333333,medlm,mimiciii,nursing_note,PROMPT1_entailment
20,116,26,26,0,1.0,31,25,6,0.8064516129032258,0.8928571428571428,medlm,mimiciii,nursing_note,PROMPT1_entailment
21,117,18,16,2,0.8888888888888888,18,13,5,0.7222222222222222,0.7969348659003831,medlm,mimiciii,nursing_note,PROMPT1_entailment
22,118,21,17,4,0.8095238095238095,25,18,7,0.72,0.7621419676214197,medlm,mimiciii,nursing_note,PROMPT1_entailment
23,119,24,21,3,0.875,26,21,5,0.8076923076923077,0.8400000000000001,medlm,mimiciii,nursing_note,PROMPT1_entailment
24,12,17,16,1,0.9411764705882352,18,14,4,0.7777777777777778,0.8517110266159694,medlm,mimiciii,nursing_note,PROMPT1_entailment
25,120,17,12,5,0.7058823529411765,18,18,0,1.0,0.8275862068965517,medlm,mimiciii,nursing_note,PROMPT1_entailment
26,121,28,21,7,0.75,37,31,6,0.8378378378378378,0.7914893617021277,medlm,mimiciii,nursing_note,PROMPT1_entailment
27,122,15,12,3,0.8,11,9,2,0.8181818181818182,0.8089887640449439,medlm,mimiciii,nursing_note,PROMPT1_entailment
28,123,5,5,0,1.0,6,6,0,1.0,1.0,medlm,mimiciii,nursing_note,PROMPT1_entailment
29,124,7,6,1,0.8571428571428571,5,3,2,0.6,0.7058823529411764,medlm,mimiciii,nursing_note,PROMPT1_entailment
30,125,39,37,2,0.9487179487179488,43,34,9,0.7906976744186046,0.8625299965718203,medlm,mimiciii,nursing_note,PROMPT1_entailment
31,126,24,18,6,0.75,28,24,4,0.8571428571428571,0.7999999999999999,medlm,mimiciii,nursing_note,PROMPT1_entailment
32,127,8,7,1,0.875,10,8,2,0.8,0.8358208955223881,medlm,mimiciii,nursing_note,PROMPT1_entailment
33,128,18,14,4,0.7777777777777778,17,12,5,0.7058823529411765,0.7400881057268723,medlm,mimiciii,nursing_note,PROMPT1_entailment
34,129,22,17,5,0.7727272727272727,29,21,8,0.7241379310344828,0.7476439790575915,medlm,mimiciii,nursing_note,PROMPT1_entailment
35,13,32,28,4,0.875,34,31,3,0.9117647058823528,0.8930041152263375,medlm,mimiciii,nursing_note,PROMPT1_entailment
36,130,35,25,10,0.7142857142857143,33,25,8,0.7575757575757576,0.7352941176470589,medlm,mimiciii,nursing_note,PROMPT1_entailment
37,131,24,20,4,0.8333333333333334,31,28,3,0.9032258064516128,0.8668730650154799,medlm,mimiciii,nursing_note,PROMPT1_entailment
38,132,11,7,4,0.6363636363636364,17,14,3,0.8235294117647058,0.717948717948718,medlm,mimiciii,nursing_note,PROMPT1_entailment
39,133,8,8,0,1.0,10,6,4,0.6,0.7499999999999999,medlm,mimiciii,nursing_note,PROMPT1_entailment
40,134,33,16,17,0.4848484848484848,30,19,11,0.6333333333333333,0.5492321589882565,medlm,mimiciii,nursing_note,PROMPT1_entailment
41,135,46,33,13,0.717391304347826,47,25,22,0.5319148936170213,0.6108848574601998,medlm,mimiciii,nursing_note,PROMPT1_entailment
42,136,35,35,0,1.0,41,31,10,0.7560975609756098,0.8611111111111112,medlm,mimiciii,nursing_note,PROMPT1_entailment
43,137,2,2,0,1.0,2,1,1,0.5,0.6666666666666666,medlm,mimiciii,nursing_note,PROMPT1_entailment
44,138,4,4,0,1.0,5,4,1,0.8,0.888888888888889,medlm,mimiciii,nursing_note,PROMPT1_entailment
45,139,6,5,1,0.8333333333333334,4,3,1,0.75,0.7894736842105262,medlm,mimiciii,nursing_note,PROMPT1_entailment
46,14,15,15,0,1.0,26,19,7,0.7307692307692307,0.8444444444444443,medlm,mimiciii,nursing_note,PROMPT1_entailment
47,140,9,2,7,0.2222222222222222,24,22,2,0.9166666666666666,0.3577235772357723,medlm,mimiciii,nursing_note,PROMPT1_entailment
48,141,13,12,1,0.9230769230769232,11,11,0,1.0,0.96,medlm,mimiciii,nursing_note,PROMPT1_entailment
49,142,29,24,5,0.8275862068965517,8,4,4,0.5,0.6233766233766235,medlm,mimiciii,nursing_note,PROMPT1_entailment
50,143,18,14,4,0.7777777777777778,2,2,0,1.0,0.8750000000000001,medlm,mimiciii,nursing_note,PROMPT1_entailment
51,144,7,6,1,0.8571428571428571,5,5,0,1.0,0.923076923076923,medlm,mimiciii,nursing_note,PROMPT1_entailment
52,145,8,6,2,0.75,19,18,1,0.9473684210526316,0.8372093023255814,medlm,mimiciii,nursing_note,PROMPT1_entailment
53,146,7,6,1,0.8571428571428571,6,6,0,1.0,0.923076923076923,medlm,mimiciii,nursing_note,PROMPT1_entailment
54,147,8,4,4,0.5,26,23,3,0.8846153846153846,0.6388888888888888,medlm,mimiciii,nursing_note,PROMPT1_entailment
55,148,6,6,0,1.0,7,6,1,0.8571428571428571,0.923076923076923,medlm,mimiciii,nursing_note,PROMPT1_entailment
56,149,14,12,2,0.8571428571428571,36,19,17,0.5277777777777778,0.6532951289398281,medlm,mimiciii,nursing_note,PROMPT1_entailment
57,15,19,15,4,0.7894736842105263,33,22,11,0.6666666666666666,0.7228915662650601,medlm,mimiciii,nursing_note,PROMPT1_entailment
58,150,8,7,1,0.875,8,7,1,0.875,0.875,medlm,mimiciii,nursing_note,PROMPT1_entailment
59,151,25,21,4,0.84,26,24,2,0.9230769230769232,0.8795811518324608,medlm,mimiciii,nursing_note,PROMPT1_entailment
60,152,40,38,2,0.95,44,35,9,0.7954545454545454,0.8658854166666666,medlm,mimiciii,nursing_note,PROMPT1_entailment
61,153,3,3,0,1.0,4,4,0,1.0,1.0,medlm,mimiciii,nursing_note,PROMPT1_entailment
62,154,30,28,2,0.9333333333333332,34,26,8,0.7647058823529411,0.8406466512702079,medlm,mimiciii,nursing_note,PROMPT1_entailment
63,155,12,6,6,0.5,51,49,2,0.9607843137254902,0.6577181208053691,medlm,mimiciii,nursing_note,PROMPT1_entailment
64,156,22,22,0,1.0,26,18,8,0.6923076923076923,0.8181818181818181,medlm,mimiciii,nursing_note,PROMPT1_entailment
65,157,4,4,0,1.0,5,4,1,0.8,0.888888888888889,medlm,mimiciii,nursing_note,PROMPT1_entailment
66,158,26,25,1,0.9615384615384616,22,21,1,0.9545454545454546,0.958029197080292,medlm,mimiciii,nursing_note,PROMPT1_entailment
67,159,6,5,1,0.8333333333333334,8,7,1,0.875,0.8536585365853658,medlm,mimiciii,nursing_note,PROMPT1_entailment
68,16,28,27,1,0.9642857142857144,30,26,4,0.8666666666666667,0.9128738621586476,medlm,mimiciii,nursing_note,PROMPT1_entailment
69,160,21,20,1,0.9523809523809524,21,19,2,0.9047619047619048,0.927960927960928,medlm,mimiciii,nursing_note,PROMPT1_entailment
70,161,5,5,0,1.0,6,5,1,0.8333333333333334,0.9090909090909092,medlm,mimiciii,nursing_note,PROMPT1_entailment
71,162,30,25,5,0.8333333333333334,31,25,6,0.8064516129032258,0.819672131147541,medlm,mimiciii,nursing_note,PROMPT1_entailment
72,163,5,5,0,1.0,4,4,0,1.0,1.0,medlm,mimiciii,nursing_note,PROMPT1_entailment
73,164,17,15,2,0.8823529411764706,13,12,1,0.9230769230769232,0.9022556390977444,medlm,mimiciii,nursing_note,PROMPT1_entailment
74,165,9,7,2,0.7777777777777778,24,22,2,0.9166666666666666,0.8415300546448087,medlm,mimiciii,nursing_note,PROMPT1_entailment
75,166,8,8,0,1.0,3,3,0,1.0,1.0,medlm,mimiciii,nursing_note,PROMPT1_entailment
76,167,22,17,5,0.7727272727272727,16,15,1,0.9375,0.8471760797342192,medlm,mimiciii,nursing_note,PROMPT1_entailment
77,168,6,4,2,0.6666666666666666,25,21,4,0.84,0.743362831858407,medlm,mimiciii,nursing_note,PROMPT1_entailment
78,169,16,14,2,0.875,12,12,0,1.0,0.9333333333333332,medlm,mimiciii,nursing_note,PROMPT1_entailment
79,17,29,22,7,0.7586206896551724,39,30,9,0.7692307692307693,0.7638888888888888,medlm,mimiciii,nursing_note,PROMPT1_entailment
80,170,24,20,4,0.8333333333333334,21,19,2,0.9047619047619048,0.867579908675799,medlm,mimiciii,nursing_note,PROMPT1_entailment
81,171,8,6,2,0.75,8,5,3,0.625,0.6818181818181818,medlm,mimiciii,nursing_note,PROMPT1_entailment
82,172,35,32,3,0.9142857142857144,38,31,7,0.8157894736842105,0.8622338113863538,medlm,mimiciii,nursing_note,PROMPT1_entailment
83,173,8,7,1,0.875,20,12,8,0.6,0.711864406779661,medlm,mimiciii,nursing_note,PROMPT1_entailment
84,174,4,4,0,1.0,8,8,0,1.0,1.0,medlm,mimiciii,nursing_note,PROMPT1_entailment
85,175,3,3,0,1.0,4,4,0,1.0,1.0,medlm,mimiciii,nursing_note,PROMPT1_entailment
86,176,11,7,4,0.6363636363636364,13,11,2,0.8461538461538461,0.7264150943396226,medlm,mimiciii,nursing_note,PROMPT1_entailment
87,177,37,28,9,0.7567567567567568,38,33,5,0.868421052631579,0.8087527352297593,medlm,mimiciii,nursing_note,PROMPT1_entailment
88,178,24,24,0,1.0,25,20,5,0.8,0.888888888888889,medlm,mimiciii,nursing_note,PROMPT1_entailment
89,179,23,18,5,0.782608695652174,22,14,8,0.6363636363636364,0.701949860724234,medlm,mimiciii,nursing_note,PROMPT1_entailment
90,18,20,15,5,0.75,25,22,3,0.88,0.8098159509202455,medlm,mimiciii,nursing_note,PROMPT1_entailment
91,180,12,2,10,0.1666666666666666,27,11,16,0.4074074074074074,0.2365591397849462,medlm,mimiciii,nursing_note,PROMPT1_entailment
92,181,8,5,3,0.625,25,11,14,0.44,0.5164319248826291,medlm,mimiciii,nursing_note,PROMPT1_entailment
93,182,17,12,5,0.7058823529411765,10,8,2,0.8,0.7500000000000001,medlm,mimiciii,nursing_note,PROMPT1_entailment
94,183,6,6,0,1.0,5,5,0,1.0,1.0,medlm,mimiciii,nursing_note,PROMPT1_entailment
95,184,9,9,0,1.0,1,1,0,1.0,1.0,medlm,mimiciii,nursing_note,PROMPT1_entailment
96,185,28,25,3,0.8928571428571429,30,27,3,0.9,0.896414342629482,medlm,mimiciii,nursing_note,PROMPT1_entailment
97,186,4,4,0,1.0,4,3,1,0.75,0.8571428571428571,medlm,mimiciii,nursing_note,PROMPT1_entailment
98,187,21,19,2,0.9047619047619048,37,28,9,0.7567567567567568,0.8241673121611154,medlm,mimiciii,nursing_note,PROMPT1_entailment
99,188,1,1,0,1.0,2,1,1,0.5,0.6666666666666666,medlm,mimiciii,nursing_note,PROMPT1_entailment
100,189,16,15,1,0.9375,21,19,2,0.9047619047619048,0.9208400646203556,medlm,mimiciii,nursing_note,PROMPT1_entailment
101,19,35,29,6,0.8285714285714286,45,26,19,0.5777777777777777,0.6808126410835215,medlm,mimiciii,nursing_note,PROMPT1_entailment
102,190,25,24,1,0.96,24,20,4,0.8333333333333334,0.8921933085501859,medlm,mimiciii,nursing_note,PROMPT1_entailment
103,191,29,25,4,0.8620689655172413,29,20,9,0.6896551724137931,0.7662835249042146,medlm,mimiciii,nursing_note,PROMPT1_entailment
104,192,8,8,0,1.0,15,13,2,0.8666666666666667,0.9285714285714286,medlm,mimiciii,nursing_note,PROMPT1_entailment
105,193,10,9,1,0.9,40,23,17,0.575,0.7016949152542372,medlm,mimiciii,nursing_note,PROMPT1_entailment
106,194,8,8,0,1.0,13,10,3,0.7692307692307693,0.8695652173913044,medlm,mimiciii,nursing_note,PROMPT1_entailment
107,195,6,6,0,1.0,7,7,0,1.0,1.0,medlm,mimiciii,nursing_note,PROMPT1_entailment
108,196,37,33,4,0.8918918918918919,34,30,4,0.8823529411764706,0.8870967741935484,medlm,mimiciii,nursing_note,PROMPT1_entailment
109,197,9,8,1,0.8888888888888888,27,19,8,0.7037037037037037,0.7855297157622738,medlm,mimiciii,nursing_note,PROMPT1_entailment
110,198,27,24,3,0.8888888888888888,38,29,9,0.7631578947368421,0.8212389380530973,medlm,mimiciii,nursing_note,PROMPT1_entailment
111,199,13,13,0,1.0,14,13,1,0.9285714285714286,0.962962962962963,medlm,mimiciii,nursing_note,PROMPT1_entailment
112,2,11,4,7,0.3636363636363636,43,36,7,0.8372093023255814,0.5070422535211268,medlm,mimiciii,nursing_note,PROMPT1_entailment
113,20,47,29,18,0.6170212765957447,46,29,17,0.6304347826086957,0.6236559139784946,medlm,mimiciii,nursing_note,PROMPT1_entailment
114,200,24,14,10,0.5833333333333334,44,32,12,0.7272727272727273,0.6473988439306358,medlm,mimiciii,nursing_note,PROMPT1_entailment
115,202,9,8,1,0.8888888888888888,9,8,1,0.8888888888888888,0.8888888888888888,medlm,mimiciii,nursing_note,PROMPT1_entailment
116,203,6,6,0,1.0,7,6,1,0.8571428571428571,0.923076923076923,medlm,mimiciii,nursing_note,PROMPT1_entailment
117,204,16,12,4,0.75,24,14,10,0.5833333333333334,0.6562499999999999,medlm,mimiciii,nursing_note,PROMPT1_entailment
118,205,38,34,4,0.8947368421052632,69,29,40,0.4202898550724637,0.5719257540603249,medlm,mimiciii,nursing_note,PROMPT1_entailment
119,206,3,3,0,1.0,6,5,1,0.8333333333333334,0.9090909090909092,medlm,mimiciii,nursing_note,PROMPT1_entailment
120,207,29,27,2,0.9310344827586208,29,26,3,0.896551724137931,0.9134677944046844,medlm,mimiciii,nursing_note,PROMPT1_entailment
121,208,8,8,0,1.0,7,7,0,1.0,1.0,medlm,mimiciii,nursing_note,PROMPT1_entailment
122,209,2,2,0,1.0,2,2,0,1.0,1.0,medlm,mimiciii,nursing_note,PROMPT1_entailment
123,21,5,5,0,1.0,6,5,1,0.8333333333333334,0.9090909090909092,medlm,mimiciii,nursing_note,PROMPT1_entailment
124,210,20,11,9,0.55,22,20,2,0.9090909090909092,0.6853582554517135,medlm,mimiciii,nursing_note,PROMPT1_entailment
125,211,3,3,0,1.0,4,4,0,1.0,1.0,medlm,mimiciii,nursing_note,PROMPT1_entailment
126,212,29,23,6,0.7931034482758621,37,32,5,0.8648648648648649,0.8274311410905003,medlm,mimiciii,nursing_note,PROMPT1_entailment
127,213,15,13,2,0.8666666666666667,18,16,2,0.8888888888888888,0.8776371308016878,medlm,mimiciii,nursing_note,PROMPT1_entailment
128,214,5,5,0,1.0,3,3,0,1.0,1.0,medlm,mimiciii,nursing_note,PROMPT1_entailment
129,215,7,7,0,1.0,7,6,1,0.8571428571428571,0.923076923076923,medlm,mimiciii,nursing_note,PROMPT1_entailment
130,216,12,8,4,0.6666666666666666,13,9,4,0.6923076923076923,0.6792452830188679,medlm,mimiciii,nursing_note,PROMPT1_entailment
131,217,28,22,6,0.7857142857142857,25,22,3,0.88,0.830188679245283,medlm,mimiciii,nursing_note,PROMPT1_entailment
132,218,18,16,2,0.8888888888888888,18,12,6,0.6666666666666666,0.761904761904762,medlm,mimiciii,nursing_note,PROMPT1_entailment
133,219,12,9,3,0.75,14,14,0,1.0,0.8571428571428571,medlm,mimiciii,nursing_note,PROMPT1_entailment
134,22,7,6,1,0.8571428571428571,26,22,4,0.8461538461538461,0.8516129032258064,medlm,mimiciii,nursing_note,PROMPT1_entailment
135,220,6,5,1,0.8333333333333334,5,4,1,0.8,0.816326530612245,medlm,mimiciii,nursing_note,PROMPT1_entailment
136,221,20,10,10,0.5,45,25,20,0.5555555555555556,0.5263157894736842,medlm,mimiciii,nursing_note,PROMPT1_entailment
137,222,3,3,0,1.0,3,3,0,1.0,1.0,medlm,mimiciii,nursing_note,PROMPT1_entailment
138,223,23,7,16,0.3043478260869565,30,25,5,0.8333333333333334,0.4458598726114649,medlm,mimiciii,nursing_note,PROMPT1_entailment
139,224,7,6,1,0.8571428571428571,6,5,1,0.8333333333333334,0.8450704225352113,medlm,mimiciii,nursing_note,PROMPT1_entailment
140,225,28,16,12,0.5714285714285714,45,28,17,0.6222222222222222,0.5957446808510639,medlm,mimiciii,nursing_note,PROMPT1_entailment
141,226,15,15,0,1.0,20,16,4,0.8,0.888888888888889,medlm,mimiciii,nursing_note,PROMPT1_entailment
142,227,15,13,2,0.8666666666666667,15,12,3,0.8,0.832,medlm,mimiciii,nursing_note,PROMPT1_entailment
143,228,28,14,14,0.5,38,26,12,0.6842105263157895,0.5777777777777778,medlm,mimiciii,nursing_note,PROMPT1_entailment
144,229,26,19,7,0.7307692307692307,22,21,1,0.9545454545454546,0.8278008298755185,medlm,mimiciii,nursing_note,PROMPT1_entailment
145,23,38,32,6,0.8421052631578947,44,22,22,0.5,0.6274509803921569,medlm,mimiciii,nursing_note,PROMPT1_entailment
146,230,11,11,0,1.0,7,6,1,0.8571428571428571,0.923076923076923,medlm,mimiciii,nursing_note,PROMPT1_entailment
147,231,15,14,1,0.9333333333333332,15,11,4,0.7333333333333333,0.8213333333333334,medlm,mimiciii,nursing_note,PROMPT1_entailment
148,232,8,8,0,1.0,2,2,0,1.0,1.0,medlm,mimiciii,nursing_note,PROMPT1_entailment
149,233,28,14,14,0.5,44,26,18,0.5909090909090909,0.5416666666666667,medlm,mimiciii,nursing_note,PROMPT1_entailment
150,234,15,14,1,0.9333333333333332,32,28,4,0.875,0.9032258064516128,medlm,mimiciii,nursing_note,PROMPT1_entailment
151,235,11,11,0,1.0,10,9,1,0.9,0.9473684210526316,medlm,mimiciii,nursing_note,PROMPT1_entailment
152,236,6,4,2,0.6666666666666666,7,5,2,0.7142857142857143,0.689655172413793,medlm,mimiciii,nursing_note,PROMPT1_entailment
153,237,33,24,9,0.7272727272727273,35,26,9,0.7428571428571429,0.7349823321554771,medlm,mimiciii,nursing_note,PROMPT1_entailment
154,238,41,26,15,0.6341463414634146,42,25,17,0.5952380952380952,0.6140765233821446,medlm,mimiciii,nursing_note,PROMPT1_entailment
155,239,7,4,3,0.5714285714285714,21,15,6,0.7142857142857143,0.634920634920635,medlm,mimiciii,nursing_note,PROMPT1_entailment
156,24,7,7,0,1.0,5,5,0,1.0,1.0,medlm,mimiciii,nursing_note,PROMPT1_entailment
157,240,29,24,5,0.8275862068965517,42,34,8,0.8095238095238095,0.8184553660982948,medlm,mimiciii,nursing_note,PROMPT1_entailment
158,241,20,18,2,0.9,21,18,3,0.8571428571428571,0.8780487804878048,medlm,mimiciii,nursing_note,PROMPT1_entailment
159,242,13,9,4,0.6923076923076923,16,12,4,0.75,0.7199999999999999,medlm,mimiciii,nursing_note,PROMPT1_entailment
160,243,5,5,0,1.0,5,5,0,1.0,1.0,medlm,mimiciii,nursing_note,PROMPT1_entailment
161,244,20,12,8,0.6,16,11,5,0.6875,0.6407766990291262,medlm,mimiciii,nursing_note,PROMPT1_entailment
162,245,34,28,6,0.8235294117647058,37,33,4,0.8918918918918919,0.8563484708063022,medlm,mimiciii,nursing_note,PROMPT1_entailment
163,246,21,19,2,0.9047619047619048,10,10,0,1.0,0.95,medlm,mimiciii,nursing_note,PROMPT1_entailment
164,247,4,4,0,1.0,6,5,1,0.8333333333333334,0.9090909090909092,medlm,mimiciii,nursing_note,PROMPT1_entailment
165,248,49,39,10,0.7959183673469388,42,31,11,0.7380952380952381,0.7659170098194489,medlm,mimiciii,nursing_note,PROMPT1_entailment
166,249,11,8,3,0.7272727272727273,39,38,1,0.9743589743589745,0.8328767123287671,medlm,mimiciii,nursing_note,PROMPT1_entailment
167,25,24,20,4,0.8333333333333334,23,17,6,0.7391304347826086,0.783410138248848,medlm,mimiciii,nursing_note,PROMPT1_entailment
168,26,12,9,3,0.75,35,33,2,0.9428571428571428,0.8354430379746834,medlm,mimiciii,nursing_note,PROMPT1_entailment
169,27,3,3,0,1.0,3,2,1,0.6666666666666666,0.8,medlm,mimiciii,nursing_note,PROMPT1_entailment
170,28,26,21,5,0.8076923076923077,16,14,2,0.875,0.8400000000000001,medlm,mimiciii,nursing_note,PROMPT1_entailment
171,29,27,21,6,0.7777777777777778,33,26,7,0.7878787878787878,0.7827956989247311,medlm,mimiciii,nursing_note,PROMPT1_entailment
172,3,6,5,1,0.8333333333333334,6,6,0,1.0,0.9090909090909092,medlm,mimiciii,nursing_note,PROMPT1_entailment
173,30,11,10,1,0.9090909090909092,17,9,8,0.5294117647058824,0.6691449814126393,medlm,mimiciii,nursing_note,PROMPT1_entailment
174,31,18,11,7,0.6111111111111112,19,15,4,0.7894736842105263,0.6889352818371608,medlm,mimiciii,nursing_note,PROMPT1_entailment
175,32,38,37,1,0.9736842105263158,44,37,7,0.8409090909090909,0.902439024390244,medlm,mimiciii,nursing_note,PROMPT1_entailment
176,33,5,5,0,1.0,5,5,0,1.0,1.0,medlm,mimiciii,nursing_note,PROMPT1_entailment
177,34,3,3,0,1.0,3,3,0,1.0,1.0,medlm,mimiciii,nursing_note,PROMPT1_entailment
178,35,5,5,0,1.0,7,6,1,0.8571428571428571,0.923076923076923,medlm,mimiciii,nursing_note,PROMPT1_entailment
179,36,32,26,6,0.8125,62,46,16,0.7419354838709677,0.775616083009079,medlm,mimiciii,nursing_note,PROMPT1_entailment
180,37,30,15,15,0.5,38,27,11,0.7105263157894737,0.5869565217391304,medlm,mimiciii,nursing_note,PROMPT1_entailment
181,38,26,16,10,0.6153846153846154,26,23,3,0.8846153846153846,0.7258382642998028,medlm,mimiciii,nursing_note,PROMPT1_entailment
182,39,8,5,3,0.625,3,2,1,0.6666666666666666,0.6451612903225806,medlm,mimiciii,nursing_note,PROMPT1_entailment
183,4,26,18,8,0.6923076923076923,26,22,4,0.8461538461538461,0.7615384615384616,medlm,mimiciii,nursing_note,PROMPT1_entailment
184,40,5,5,0,1.0,3,2,1,0.6666666666666666,0.8,medlm,mimiciii,nursing_note,PROMPT1_entailment
185,41,39,36,3,0.9230769230769232,50,43,7,0.86,0.8904227782571181,medlm,mimiciii,nursing_note,PROMPT1_entailment
186,42,14,9,5,0.6428571428571429,7,7,0,1.0,0.782608695652174,medlm,mimiciii,nursing_note,PROMPT1_entailment
187,43,24,21,3,0.875,14,11,3,0.7857142857142857,0.8279569892473119,medlm,mimiciii,nursing_note,PROMPT1_entailment
188,44,5,5,0,1.0,3,3,0,1.0,1.0,medlm,mimiciii,nursing_note,PROMPT1_entailment
189,45,29,28,1,0.9655172413793104,34,25,9,0.7352941176470589,0.8348240906380441,medlm,mimiciii,nursing_note,PROMPT1_entailment
190,46,28,24,4,0.8571428571428571,33,25,8,0.7575757575757576,0.804289544235925,medlm,mimiciii,nursing_note,PROMPT1_entailment
191,47,6,4,2,0.6666666666666666,14,9,5,0.6428571428571429,0.6545454545454545,medlm,mimiciii,nursing_note,PROMPT1_entailment
192,48,10,10,0,1.0,9,8,1,0.8888888888888888,0.9411764705882352,medlm,mimiciii,nursing_note,PROMPT1_entailment
193,49,4,4,0,1.0,3,2,1,0.6666666666666666,0.8,medlm,mimiciii,nursing_note,PROMPT1_entailment
194,5,20,15,5,0.75,15,10,5,0.6666666666666666,0.7058823529411765,medlm,mimiciii,nursing_note,PROMPT1_entailment
195,50,11,7,4,0.6363636363636364,16,9,7,0.5625,0.5971563981042655,medlm,mimiciii,nursing_note,PROMPT1_entailment
196,51,5,5,0,1.0,6,6,0,1.0,1.0,medlm,mimiciii,nursing_note,PROMPT1_entailment
197,52,42,28,14,0.6666666666666666,38,30,8,0.7894736842105263,0.7228915662650601,medlm,mimiciii,nursing_note,PROMPT1_entailment
198,53,7,7,0,1.0,6,5,1,0.8333333333333334,0.9090909090909092,medlm,mimiciii,nursing_note,PROMPT1_entailment
199,54,10,8,2,0.8,37,32,5,0.8648648648648649,0.8311688311688312,medlm,mimiciii,nursing_note,PROMPT1_entailment
200,55,7,5,2,0.7142857142857143,35,26,9,0.7428571428571429,0.7282913165266106,medlm,mimiciii,nursing_note,PROMPT1_entailment
201,56,6,6,0,1.0,2,2,0,1.0,1.0,medlm,mimiciii,nursing_note,PROMPT1_entailment
202,57,32,30,2,0.9375,18,12,6,0.6666666666666666,0.7792207792207793,medlm,mimiciii,nursing_note,PROMPT1_entailment
203,58,12,11,1,0.9166666666666666,28,22,6,0.7857142857142857,0.8461538461538461,medlm,mimiciii,nursing_note,PROMPT1_entailment
204,59,8,8,0,1.0,9,8,1,0.8888888888888888,0.9411764705882352,medlm,mimiciii,nursing_note,PROMPT1_entailment
205,6,8,6,2,0.75,8,8,0,1.0,0.8571428571428571,medlm,mimiciii,nursing_note,PROMPT1_entailment
206,60,25,22,3,0.88,27,20,7,0.7407407407407407,0.8043875685557585,medlm,mimiciii,nursing_note,PROMPT1_entailment
207,61,14,12,2,0.8571428571428571,20,11,9,0.55,0.6700507614213198,medlm,mimiciii,nursing_note,PROMPT1_entailment
208,62,34,25,9,0.7352941176470589,37,29,8,0.7837837837837838,0.7587650444793302,medlm,mimiciii,nursing_note,PROMPT1_entailment
209,63,4,4,0,1.0,5,5,0,1.0,1.0,medlm,mimiciii,nursing_note,PROMPT1_entailment
210,64,36,30,6,0.8333333333333334,27,19,8,0.7037037037037037,0.7630522088353413,medlm,mimiciii,nursing_note,PROMPT1_entailment
211,65,15,14,1,0.9333333333333332,19,16,3,0.8421052631578947,0.8853754940711462,medlm,mimiciii,nursing_note,PROMPT1_entailment
212,66,5,5,0,1.0,1,1,0,1.0,1.0,medlm,mimiciii,nursing_note,PROMPT1_entailment
213,67,8,8,0,1.0,7,6,1,0.8571428571428571,0.923076923076923,medlm,mimiciii,nursing_note,PROMPT1_entailment
214,68,22,15,7,0.6818181818181818,18,15,3,0.8333333333333334,0.7499999999999999,medlm,mimiciii,nursing_note,PROMPT1_entailment
215,69,26,17,9,0.6538461538461539,25,17,8,0.68,0.6666666666666666,medlm,mimiciii,nursing_note,PROMPT1_entailment
216,7,3,3,0,1.0,2,2,0,1.0,1.0,medlm,mimiciii,nursing_note,PROMPT1_entailment
217,70,47,40,7,0.851063829787234,45,31,14,0.6888888888888889,0.7614369051274178,medlm,mimiciii,nursing_note,PROMPT1_entailment
218,71,12,3,9,0.25,52,22,30,0.4230769230769231,0.3142857142857143,medlm,mimiciii,nursing_note,PROMPT1_entailment
219,72,10,8,2,0.8,12,9,3,0.75,0.7741935483870969,medlm,mimiciii,nursing_note,PROMPT1_entailment
220,73,30,23,7,0.7666666666666667,38,28,10,0.7368421052631579,0.7514585764294048,medlm,mimiciii,nursing_note,PROMPT1_entailment
221,74,6,6,0,1.0,8,7,1,0.875,0.9333333333333332,medlm,mimiciii,nursing_note,PROMPT1_entailment
222,75,19,16,3,0.8421052631578947,27,21,6,0.7777777777777778,0.8086642599277979,medlm,mimiciii,nursing_note,PROMPT1_entailment
223,76,2,2,0,1.0,1,1,0,1.0,1.0,medlm,mimiciii,nursing_note,PROMPT1_entailment
224,77,13,4,9,0.3076923076923077,59,20,39,0.3389830508474576,0.3225806451612903,medlm,mimiciii,nursing_note,PROMPT1_entailment
225,78,6,5,1,0.8333333333333334,20,7,13,0.35,0.4929577464788732,medlm,mimiciii,nursing_note,PROMPT1_entailment
226,79,9,8,1,0.8888888888888888,30,27,3,0.9,0.8944099378881988,medlm,mimiciii,nursing_note,PROMPT1_entailment
227,8,6,5,1,0.8333333333333334,14,7,7,0.5,0.625,medlm,mimiciii,nursing_note,PROMPT1_entailment
228,80,25,15,10,0.6,22,21,1,0.9545454545454546,0.7368421052631579,medlm,mimiciii,nursing_note,PROMPT1_entailment
229,81,16,9,7,0.5625,22,14,8,0.6363636363636364,0.5971563981042655,medlm,mimiciii,nursing_note,PROMPT1_entailment
230,82,19,17,2,0.8947368421052632,17,15,2,0.8823529411764706,0.8885017421602787,medlm,mimiciii,nursing_note,PROMPT1_entailment
231,83,15,9,6,0.6,34,21,13,0.6176470588235294,0.608695652173913,medlm,mimiciii,nursing_note,PROMPT1_entailment
232,84,6,6,0,1.0,6,6,0,1.0,1.0,medlm,mimiciii,nursing_note,PROMPT1_entailment
233,85,14,12,2,0.8571428571428571,27,11,16,0.4074074074074074,0.5523012552301255,medlm,mimiciii,nursing_note,PROMPT1_entailment
234,86,41,30,11,0.7317073170731707,40,33,7,0.825,0.7755581668625147,medlm,mimiciii,nursing_note,PROMPT1_entailment
235,87,17,15,2,0.8823529411764706,15,10,5,0.6666666666666666,0.7594936708860759,medlm,mimiciii,nursing_note,PROMPT1_entailment
236,88,18,10,8,0.5555555555555556,15,12,3,0.8,0.6557377049180328,medlm,mimiciii,nursing_note,PROMPT1_entailment
237,89,27,21,6,0.7777777777777778,29,25,4,0.8620689655172413,0.8177570093457943,medlm,mimiciii,nursing_note,PROMPT1_entailment
238,9,12,10,2,0.8333333333333334,17,15,2,0.8823529411764706,0.8571428571428571,medlm,mimiciii,nursing_note,PROMPT1_entailment
239,90,16,14,2,0.875,14,13,1,0.9285714285714286,0.900990099009901,medlm,mimiciii,nursing_note,PROMPT1_entailment
240,91,20,14,6,0.7,25,21,4,0.84,0.7636363636363636,medlm,mimiciii,nursing_note,PROMPT1_entailment
241,92,8,6,2,0.75,28,28,0,1.0,0.8571428571428571,medlm,mimiciii,nursing_note,PROMPT1_entailment
242,93,11,11,0,1.0,23,21,2,0.9130434782608696,0.9545454545454544,medlm,mimiciii,nursing_note,PROMPT1_entailment
243,94,5,5,0,1.0,5,5,0,1.0,1.0,medlm,mimiciii,nursing_note,PROMPT1_entailment
244,95,15,8,7,0.5333333333333333,14,10,4,0.7142857142857143,0.6106870229007633,medlm,mimiciii,nursing_note,PROMPT1_entailment
245,96,6,6,0,1.0,6,6,0,1.0,1.0,medlm,mimiciii,nursing_note,PROMPT1_entailment
246,97,9,9,0,1.0,10,10,0,1.0,1.0,medlm,mimiciii,nursing_note,PROMPT1_entailment
247,98,20,17,3,0.85,13,11,2,0.8461538461538461,0.8480725623582767,medlm,mimiciii,nursing_note,PROMPT1_entailment
248,99,42,37,5,0.8809523809523809,44,31,13,0.7045454545454546,0.7829351535836178,medlm,mimiciii,nursing_note,PROMPT1_entailment
0,0,9,4,5,0.4444444444444444,11,9,2,0.8181818181818182,0.5760000000000001,medlm,mimiciii,nursing_note,PROMPT1_ICL_entailment
1,1,35,18,17,0.5142857142857142,31,26,5,0.8387096774193549,0.6376021798365121,medlm,mimiciii,nursing_note,PROMPT1_ICL_entailment
2,10,14,9,5,0.6428571428571429,18,8,10,0.4444444444444444,0.5255474452554744,medlm,mimiciii,nursing_note,PROMPT1_ICL_entailment
3,100,8,8,0,1.0,6,5,1,0.8333333333333334,0.9090909090909092,medlm,mimiciii,nursing_note,PROMPT1_ICL_entailment
4,101,28,27,1,0.9642857142857144,27,26,1,0.9629629629629628,0.9636238846945778,medlm,mimiciii,nursing_note,PROMPT1_ICL_entailment
5,102,24,19,5,0.7916666666666666,26,21,5,0.8076923076923077,0.7995991983967935,medlm,mimiciii,nursing_note,PROMPT1_ICL_entailment
6,103,25,20,5,0.8,22,22,0,1.0,0.888888888888889,medlm,mimiciii,nursing_note,PROMPT1_ICL_entailment
7,104,26,24,2,0.9230769230769232,20,20,0,1.0,0.96,medlm,mimiciii,nursing_note,PROMPT1_ICL_entailment
8,105,20,14,6,0.7,20,19,1,0.95,0.806060606060606,medlm,mimiciii,nursing_note,PROMPT1_ICL_entailment
9,106,6,6,0,1.0,4,4,0,1.0,1.0,medlm,mimiciii,nursing_note,PROMPT1_ICL_entailment
10,107,29,21,8,0.7241379310344828,63,38,25,0.6031746031746031,0.6581443298969072,medlm,mimiciii,nursing_note,PROMPT1_ICL_entailment
11,108,41,39,2,0.951219512195122,28,20,8,0.7142857142857143,0.8158995815899581,medlm,mimiciii,nursing_note,PROMPT1_ICL_entailment
12,109,3,3,0,1.0,4,4,0,1.0,1.0,medlm,mimiciii,nursing_note,PROMPT1_ICL_entailment
13,11,2,2,0,1.0,2,1,1,0.5,0.6666666666666666,medlm,mimiciii,nursing_note,PROMPT1_ICL_entailment
14,110,12,12,0,1.0,13,12,1,0.9230769230769232,0.96,medlm,mimiciii,nursing_note,PROMPT1_ICL_entailment
15,111,33,30,3,0.9090909090909092,34,28,6,0.8235294117647058,0.8641975308641976,medlm,mimiciii,nursing_note,PROMPT1_ICL_entailment
16,112,44,40,4,0.9090909090909092,37,25,12,0.6756756756756757,0.7751937984496124,medlm,mimiciii,nursing_note,PROMPT1_ICL_entailment
17,113,4,4,0,1.0,5,5,0,1.0,1.0,medlm,mimiciii,nursing_note,PROMPT1_ICL_entailment
18,114,18,11,7,0.6111111111111112,19,13,6,0.6842105263157895,0.6455981941309257,medlm,mimiciii,nursing_note,PROMPT1_ICL_entailment
19,115,9,9,0,1.0,7,7,0,1.0,1.0,medlm,mimiciii,nursing_note,PROMPT1_ICL_entailment
20,116,25,24,1,0.96,31,26,5,0.8387096774193549,0.8952654232424677,medlm,mimiciii,nursing_note,PROMPT1_ICL_entailment
21,117,37,31,6,0.8378378378378378,18,13,5,0.7222222222222222,0.7757459095283926,medlm,mimiciii,nursing_note,PROMPT1_ICL_entailment
22,118,31,24,7,0.7741935483870968,25,22,3,0.88,0.8237129485179406,medlm,mimiciii,nursing_note,PROMPT1_ICL_entailment
23,119,26,22,4,0.8461538461538461,26,22,4,0.8461538461538461,0.8461538461538461,medlm,mimiciii,nursing_note,PROMPT1_ICL_entailment
24,12,18,15,3,0.8333333333333334,18,15,3,0.8333333333333334,0.8333333333333334,medlm,mimiciii,nursing_note,PROMPT1_ICL_entailment
25,120,16,11,5,0.6875,18,17,1,0.9444444444444444,0.7957446808510639,medlm,mimiciii,nursing_note,PROMPT1_ICL_entailment
26,121,51,41,10,0.803921568627451,37,30,7,0.8108108108108109,0.807351493272071,medlm,mimiciii,nursing_note,PROMPT1_ICL_entailment
27,122,29,25,4,0.8620689655172413,11,9,2,0.8181818181818182,0.8395522388059702,medlm,mimiciii,nursing_note,PROMPT1_ICL_entailment
28,123,5,5,0,1.0,6,6,0,1.0,1.0,medlm,mimiciii,nursing_note,PROMPT1_ICL_entailment
29,124,8,7,1,0.875,5,5,0,1.0,0.9333333333333332,medlm,mimiciii,nursing_note,PROMPT1_ICL_entailment
30,125,44,42,2,0.9545454545454546,43,36,7,0.8372093023255814,0.8920353982300885,medlm,mimiciii,nursing_note,PROMPT1_ICL_entailment
31,126,30,24,6,0.8,28,27,1,0.9642857142857144,0.8744939271255061,medlm,mimiciii,nursing_note,PROMPT1_ICL_entailment
32,127,13,10,3,0.7692307692307693,10,9,1,0.9,0.8294930875576038,medlm,mimiciii,nursing_note,PROMPT1_ICL_entailment
33,128,23,22,1,0.9565217391304348,17,14,3,0.8235294117647058,0.8850574712643678,medlm,mimiciii,nursing_note,PROMPT1_ICL_entailment
34,129,29,24,5,0.8275862068965517,29,21,8,0.7241379310344828,0.7724137931034483,medlm,mimiciii,nursing_note,PROMPT1_ICL_entailment
35,13,33,28,5,0.8484848484848485,34,26,8,0.7647058823529411,0.8044198895027623,medlm,mimiciii,nursing_note,PROMPT1_ICL_entailment
36,130,40,30,10,0.75,33,24,9,0.7272727272727273,0.7384615384615384,medlm,mimiciii,nursing_note,PROMPT1_ICL_entailment
37,131,26,24,2,0.9230769230769232,31,27,4,0.8709677419354839,0.8962655601659751,medlm,mimiciii,nursing_note,PROMPT1_ICL_entailment
38,132,34,24,10,0.7058823529411765,17,13,4,0.7647058823529411,0.7341176470588234,medlm,mimiciii,nursing_note,PROMPT1_ICL_entailment
39,133,11,11,0,1.0,10,8,2,0.8,0.888888888888889,medlm,mimiciii,nursing_note,PROMPT1_ICL_entailment
40,134,36,12,24,0.3333333333333333,30,16,14,0.5333333333333333,0.4102564102564102,medlm,mimiciii,nursing_note,PROMPT1_ICL_entailment
41,135,44,35,9,0.7954545454545454,47,26,21,0.5531914893617021,0.6525636428827536,medlm,mimiciii,nursing_note,PROMPT1_ICL_entailment
42,136,45,41,4,0.9111111111111112,41,34,7,0.8292682926829268,0.8682653379009654,medlm,mimiciii,nursing_note,PROMPT1_ICL_entailment
43,137,2,2,0,1.0,2,1,1,0.5,0.6666666666666666,medlm,mimiciii,nursing_note,PROMPT1_ICL_entailment
44,138,4,4,0,1.0,5,4,1,0.8,0.888888888888889,medlm,mimiciii,nursing_note,PROMPT1_ICL_entailment
45,139,6,6,0,1.0,4,3,1,0.75,0.8571428571428571,medlm,mimiciii,nursing_note,PROMPT1_ICL_entailment
46,14,30,28,2,0.9333333333333332,26,24,2,0.9230769230769232,0.9281767955801106,medlm,mimiciii,nursing_note,PROMPT1_ICL_entailment
47,140,34,15,19,0.4411764705882353,24,19,5,0.7916666666666666,0.566600397614314,medlm,mimiciii,nursing_note,PROMPT1_ICL_entailment
48,141,13,12,1,0.9230769230769232,11,10,1,0.9090909090909092,0.9160305343511452,medlm,mimiciii,nursing_note,PROMPT1_ICL_entailment
49,142,54,47,7,0.8703703703703703,8,7,1,0.875,0.8726790450928382,medlm,mimiciii,nursing_note,PROMPT1_ICL_entailment
50,143,17,15,2,0.8823529411764706,2,1,1,0.5,0.6382978723404256,medlm,mimiciii,nursing_note,PROMPT1_ICL_entailment
51,144,7,6,1,0.8571428571428571,5,4,1,0.8,0.8275862068965518,medlm,mimiciii,nursing_note,PROMPT1_ICL_entailment
52,145,30,25,5,0.8333333333333334,19,16,3,0.8421052631578947,0.8376963350785339,medlm,mimiciii,nursing_note,PROMPT1_ICL_entailment
53,146,7,7,0,1.0,6,6,0,1.0,1.0,medlm,mimiciii,nursing_note,PROMPT1_ICL_entailment
54,147,23,18,5,0.782608695652174,26,21,5,0.8076923076923077,0.7949526813880126,medlm,mimiciii,nursing_note,PROMPT1_ICL_entailment
55,148,7,7,0,1.0,7,6,1,0.8571428571428571,0.923076923076923,medlm,mimiciii,nursing_note,PROMPT1_ICL_entailment
56,149,34,26,8,0.7647058823529411,36,22,14,0.6111111111111112,0.6793349168646081,medlm,mimiciii,nursing_note,PROMPT1_ICL_entailment
57,15,15,11,4,0.7333333333333333,33,15,18,0.4545454545454545,0.5612244897959184,medlm,mimiciii,nursing_note,PROMPT1_ICL_entailment
58,150,10,9,1,0.9,8,7,1,0.875,0.8873239436619719,medlm,mimiciii,nursing_note,PROMPT1_ICL_entailment
59,151,25,21,4,0.84,26,20,6,0.7692307692307693,0.8030592734225622,medlm,mimiciii,nursing_note,PROMPT1_ICL_entailment
60,152,42,39,3,0.9285714285714286,44,35,9,0.7954545454545454,0.856873822975518,medlm,mimiciii,nursing_note,PROMPT1_ICL_entailment
61,153,3,3,0,1.0,4,3,1,0.75,0.8571428571428571,medlm,mimiciii,nursing_note,PROMPT1_ICL_entailment
62,154,38,32,6,0.8421052631578947,34,29,5,0.8529411764705882,0.8474885844748858,medlm,mimiciii,nursing_note,PROMPT1_ICL_entailment
63,155,50,43,7,0.86,51,42,9,0.8235294117647058,0.8413696715583506,medlm,mimiciii,nursing_note,PROMPT1_ICL_entailment
64,156,7,4,3,0.5714285714285714,26,20,6,0.7692307692307693,0.6557377049180327,medlm,mimiciii,nursing_note,PROMPT1_ICL_entailment
65,157,4,4,0,1.0,5,4,1,0.8,0.888888888888889,medlm,mimiciii,nursing_note,PROMPT1_ICL_entailment
66,158,34,32,2,0.9411764705882352,22,19,3,0.8636363636363636,0.9007407407407408,medlm,mimiciii,nursing_note,PROMPT1_ICL_entailment
67,159,6,3,3,0.5,8,4,4,0.5,0.5,medlm,mimiciii,nursing_note,PROMPT1_ICL_entailment
68,16,13,5,8,0.3846153846153846,30,5,25,0.1666666666666666,0.2325581395348837,medlm,mimiciii,nursing_note,PROMPT1_ICL_entailment
69,160,33,29,4,0.8787878787878788,21,19,2,0.9047619047619048,0.8915857605177994,medlm,mimiciii,nursing_note,PROMPT1_ICL_entailment
70,161,7,6,1,0.8571428571428571,6,5,1,0.8333333333333334,0.8450704225352113,medlm,mimiciii,nursing_note,PROMPT1_ICL_entailment
71,162,31,29,2,0.935483870967742,31,25,6,0.8064516129032258,0.8661887694145759,medlm,mimiciii,nursing_note,PROMPT1_ICL_entailment
72,163,6,6,0,1.0,4,4,0,1.0,1.0,medlm,mimiciii,nursing_note,PROMPT1_ICL_entailment
73,164,17,16,1,0.9411764705882352,13,11,2,0.8461538461538461,0.8911392405063291,medlm,mimiciii,nursing_note,PROMPT1_ICL_entailment
74,165,36,31,5,0.8611111111111112,24,23,1,0.9583333333333334,0.9071246819338422,medlm,mimiciii,nursing_note,PROMPT1_ICL_entailment
75,166,11,10,1,0.9090909090909092,3,2,1,0.6666666666666666,0.7692307692307692,medlm,mimiciii,nursing_note,PROMPT1_ICL_entailment
76,167,31,25,6,0.8064516129032258,16,16,0,1.0,0.8928571428571428,medlm,mimiciii,nursing_note,PROMPT1_ICL_entailment
77,168,29,18,11,0.6206896551724138,25,19,6,0.76,0.6833166833166833,medlm,mimiciii,nursing_note,PROMPT1_ICL_entailment
78,169,25,23,2,0.92,12,9,3,0.75,0.8263473053892216,medlm,mimiciii,nursing_note,PROMPT1_ICL_entailment
79,17,24,19,5,0.7916666666666666,39,27,12,0.6923076923076923,0.7386609071274297,medlm,mimiciii,nursing_note,PROMPT1_ICL_entailment
80,170,26,22,4,0.8461538461538461,21,20,1,0.9523809523809524,0.8961303462321792,medlm,mimiciii,nursing_note,PROMPT1_ICL_entailment
81,171,8,7,1,0.875,8,8,0,1.0,0.9333333333333332,medlm,mimiciii,nursing_note,PROMPT1_ICL_entailment
82,172,40,38,2,0.95,38,32,6,0.8421052631578947,0.8928046989720998,medlm,mimiciii,nursing_note,PROMPT1_ICL_entailment
83,173,20,17,3,0.85,20,15,5,0.75,0.7968749999999999,medlm,mimiciii,nursing_note,PROMPT1_ICL_entailment
84,174,9,9,0,1.0,8,7,1,0.875,0.9333333333333332,medlm,mimiciii,nursing_note,PROMPT1_ICL_entailment
85,175,4,4,0,1.0,4,4,0,1.0,1.0,medlm,mimiciii,nursing_note,PROMPT1_ICL_entailment
86,176,15,12,3,0.8,13,10,3,0.7692307692307693,0.7843137254901961,medlm,mimiciii,nursing_note,PROMPT1_ICL_entailment
87,177,39,30,9,0.7692307692307693,38,29,9,0.7631578947368421,0.7661822985468957,medlm,mimiciii,nursing_note,PROMPT1_ICL_entailment
88,178,45,42,3,0.9333333333333332,25,18,7,0.72,0.8129032258064516,medlm,mimiciii,nursing_note,PROMPT1_ICL_entailment
89,179,33,27,6,0.8181818181818182,22,16,6,0.7272727272727273,0.770053475935829,medlm,mimiciii,nursing_note,PROMPT1_ICL_entailment
90,18,24,18,6,0.75,25,17,8,0.68,0.7132867132867132,medlm,mimiciii,nursing_note,PROMPT1_ICL_entailment
91,180,23,17,6,0.7391304347826086,27,17,10,0.6296296296296297,0.68,medlm,mimiciii,nursing_note,PROMPT1_ICL_entailment
92,181,28,22,6,0.7857142857142857,25,22,3,0.88,0.830188679245283,medlm,mimiciii,nursing_note,PROMPT1_ICL_entailment
93,182,8,7,1,0.875,10,6,4,0.6,0.711864406779661,medlm,mimiciii,nursing_note,PROMPT1_ICL_entailment
94,183,7,7,0,1.0,5,5,0,1.0,1.0,medlm,mimiciii,nursing_note,PROMPT1_ICL_entailment
95,184,13,13,0,1.0,1,1,0,1.0,1.0,medlm,mimiciii,nursing_note,PROMPT1_ICL_entailment
96,185,29,24,5,0.8275862068965517,30,28,2,0.9333333333333332,0.877284595300261,medlm,mimiciii,nursing_note,PROMPT1_ICL_entailment
97,186,4,4,0,1.0,4,3,1,0.75,0.8571428571428571,medlm,mimiciii,nursing_note,PROMPT1_ICL_entailment
98,187,22,17,5,0.7727272727272727,37,26,11,0.7027027027027027,0.736053288925895,medlm,mimiciii,nursing_note,PROMPT1_ICL_entailment
99,188,2,2,0,1.0,2,0,2,0.0,0.0,medlm,mimiciii,nursing_note,PROMPT1_ICL_entailment
100,189,19,18,1,0.9473684210526316,21,19,2,0.9047619047619048,0.925575101488498,medlm,mimiciii,nursing_note,PROMPT1_ICL_entailment
101,19,41,32,9,0.7804878048780488,45,32,13,0.7111111111111111,0.7441860465116279,medlm,mimiciii,nursing_note,PROMPT1_ICL_entailment
102,190,29,26,3,0.896551724137931,24,21,3,0.875,0.8856447688564477,medlm,mimiciii,nursing_note,PROMPT1_ICL_entailment
103,191,28,26,2,0.9285714285714286,29,22,7,0.7586206896551724,0.835036496350365,medlm,mimiciii,nursing_note,PROMPT1_ICL_entailment
104,192,10,10,0,1.0,15,13,2,0.8666666666666667,0.9285714285714286,medlm,mimiciii,nursing_note,PROMPT1_ICL_entailment
105,193,31,23,8,0.7419354838709677,40,29,11,0.725,0.7333699835074217,medlm,mimiciii,nursing_note,PROMPT1_ICL_entailment
106,194,13,13,0,1.0,13,10,3,0.7692307692307693,0.8695652173913044,medlm,mimiciii,nursing_note,PROMPT1_ICL_entailment
107,195,6,6,0,1.0,7,7,0,1.0,1.0,medlm,mimiciii,nursing_note,PROMPT1_ICL_entailment
108,196,37,33,4,0.8918918918918919,34,31,3,0.9117647058823528,0.9017188188629351,medlm,mimiciii,nursing_note,PROMPT1_ICL_entailment
109,197,38,29,9,0.7631578947368421,27,24,3,0.8888888888888888,0.8212389380530973,medlm,mimiciii,nursing_note,PROMPT1_ICL_entailment
110,198,35,31,4,0.8857142857142857,38,30,8,0.7894736842105263,0.8348294434470377,medlm,mimiciii,nursing_note,PROMPT1_ICL_entailment
111,199,13,13,0,1.0,14,13,1,0.9285714285714286,0.962962962962963,medlm,mimiciii,nursing_note,PROMPT1_ICL_entailment
112,2,47,22,25,0.4680851063829787,43,26,17,0.6046511627906976,0.5276752767527675,medlm,mimiciii,nursing_note,PROMPT1_ICL_entailment
113,20,48,34,14,0.7083333333333334,46,34,12,0.7391304347826086,0.723404255319149,medlm,mimiciii,nursing_note,PROMPT1_ICL_entailment
114,200,45,32,13,0.7111111111111111,44,31,13,0.7045454545454546,0.7078130574384587,medlm,mimiciii,nursing_note,PROMPT1_ICL_entailment
115,201,22,21,1,0.9545454545454546,29,23,6,0.7931034482758621,0.8663677130044842,medlm,mimiciii,nursing_note,PROMPT1_ICL_entailment
116,202,10,9,1,0.9,9,8,1,0.8888888888888888,0.8944099378881988,medlm,mimiciii,nursing_note,PROMPT1_ICL_entailment
117,203,8,8,0,1.0,7,6,1,0.8571428571428571,0.923076923076923,medlm,mimiciii,nursing_note,PROMPT1_ICL_entailment
118,204,26,22,4,0.8461538461538461,24,17,7,0.7083333333333334,0.7711340206185566,medlm,mimiciii,nursing_note,PROMPT1_ICL_entailment
119,205,52,49,3,0.9423076923076924,69,57,12,0.8260869565217391,0.8803782505910166,medlm,mimiciii,nursing_note,PROMPT1_ICL_entailment
120,206,5,5,0,1.0,6,5,1,0.8333333333333334,0.9090909090909092,medlm,mimiciii,nursing_note,PROMPT1_ICL_entailment
121,207,34,34,0,1.0,29,24,5,0.8275862068965517,0.9056603773584906,medlm,mimiciii,nursing_note,PROMPT1_ICL_entailment
122,208,9,8,1,0.8888888888888888,7,7,0,1.0,0.9411764705882352,medlm,mimiciii,nursing_note,PROMPT1_ICL_entailment
123,209,5,4,1,0.8,2,2,0,1.0,0.888888888888889,medlm,mimiciii,nursing_note,PROMPT1_ICL_entailment
124,21,6,5,1,0.8333333333333334,6,5,1,0.8333333333333334,0.8333333333333334,medlm,mimiciii,nursing_note,PROMPT1_ICL_entailment
125,210,23,19,4,0.8260869565217391,22,20,2,0.9090909090909092,0.8656036446469249,medlm,mimiciii,nursing_note,PROMPT1_ICL_entailment
126,211,4,4,0,1.0,4,4,0,1.0,1.0,medlm,mimiciii,nursing_note,PROMPT1_ICL_entailment
127,212,32,26,6,0.8125,37,31,6,0.8378378378378378,0.8249744114636642,medlm,mimiciii,nursing_note,PROMPT1_ICL_entailment
128,213,17,15,2,0.8823529411764706,18,16,2,0.8888888888888888,0.8856088560885608,medlm,mimiciii,nursing_note,PROMPT1_ICL_entailment
129,214,4,4,0,1.0,3,3,0,1.0,1.0,medlm,mimiciii,nursing_note,PROMPT1_ICL_entailment
130,215,6,6,0,1.0,7,6,1,0.8571428571428571,0.923076923076923,medlm,mimiciii,nursing_note,PROMPT1_ICL_entailment
131,216,27,15,12,0.5555555555555556,13,9,4,0.6923076923076923,0.6164383561643836,medlm,mimiciii,nursing_note,PROMPT1_ICL_entailment
132,217,32,24,8,0.75,25,24,1,0.96,0.8421052631578947,medlm,mimiciii,nursing_note,PROMPT1_ICL_entailment
133,218,19,17,2,0.8947368421052632,18,14,4,0.7777777777777778,0.8321678321678322,medlm,mimiciii,nursing_note,PROMPT1_ICL_entailment
134,219,27,20,7,0.7407407407407407,14,11,3,0.7857142857142857,0.7625649913344886,medlm,mimiciii,nursing_note,PROMPT1_ICL_entailment
135,22,31,27,4,0.8709677419354839,26,25,1,0.9615384615384616,0.9140148950575492,medlm,mimiciii,nursing_note,PROMPT1_ICL_entailment
136,220,10,9,1,0.9,5,3,2,0.6,0.7200000000000001,medlm,mimiciii,nursing_note,PROMPT1_ICL_entailment
137,221,24,20,4,0.8333333333333334,45,24,21,0.5333333333333333,0.6504065040650406,medlm,mimiciii,nursing_note,PROMPT1_ICL_entailment
138,222,3,3,0,1.0,3,3,0,1.0,1.0,medlm,mimiciii,nursing_note,PROMPT1_ICL_entailment
139,223,28,15,13,0.5357142857142857,30,28,2,0.9333333333333332,0.6807131280388978,medlm,mimiciii,nursing_note,PROMPT1_ICL_entailment
140,224,9,9,0,1.0,6,5,1,0.8333333333333334,0.9090909090909092,medlm,mimiciii,nursing_note,PROMPT1_ICL_entailment
141,225,46,26,20,0.5652173913043478,45,39,6,0.8666666666666667,0.6842105263157895,medlm,mimiciii,nursing_note,PROMPT1_ICL_entailment
142,226,18,16,2,0.8888888888888888,20,16,4,0.8,0.8421052631578948,medlm,mimiciii,nursing_note,PROMPT1_ICL_entailment
143,227,18,14,4,0.7777777777777778,15,10,5,0.6666666666666666,0.717948717948718,medlm,mimiciii,nursing_note,PROMPT1_ICL_entailment
144,228,8,4,4,0.5,38,20,18,0.5263157894736842,0.5128205128205129,medlm,mimiciii,nursing_note,PROMPT1_ICL_entailment
145,229,27,24,3,0.8888888888888888,22,20,2,0.9090909090909092,0.8988764044943819,medlm,mimiciii,nursing_note,PROMPT1_ICL_entailment
146,23,40,34,6,0.85,44,23,21,0.5227272727272727,0.6473509933774835,medlm,mimiciii,nursing_note,PROMPT1_ICL_entailment
147,230,11,11,0,1.0,7,6,1,0.8571428571428571,0.923076923076923,medlm,mimiciii,nursing_note,PROMPT1_ICL_entailment
148,231,20,19,1,0.95,15,12,3,0.8,0.8685714285714285,medlm,mimiciii,nursing_note,PROMPT1_ICL_entailment
149,232,8,7,1,0.875,2,2,0,1.0,0.9333333333333332,medlm,mimiciii,nursing_note,PROMPT1_ICL_entailment
150,233,30,24,6,0.8,44,28,16,0.6363636363636364,0.7088607594936709,medlm,mimiciii,nursing_note,PROMPT1_ICL_entailment
151,234,22,21,1,0.9545454545454546,32,18,14,0.5625,0.7078651685393259,medlm,mimiciii,nursing_note,PROMPT1_ICL_entailment
152,235,11,11,0,1.0,10,9,1,0.9,0.9473684210526316,medlm,mimiciii,nursing_note,PROMPT1_ICL_entailment
153,236,10,8,2,0.8,7,5,2,0.7142857142857143,0.7547169811320756,medlm,mimiciii,nursing_note,PROMPT1_ICL_entailment
154,237,34,26,8,0.7647058823529411,35,27,8,0.7714285714285715,0.7680525164113786,medlm,mimiciii,nursing_note,PROMPT1_ICL_entailment
155,238,45,27,18,0.6,42,25,17,0.5952380952380952,0.5976095617529881,medlm,mimiciii,nursing_note,PROMPT1_ICL_entailment
156,239,22,18,4,0.8181818181818182,21,20,1,0.9523809523809524,0.880195599022005,medlm,mimiciii,nursing_note,PROMPT1_ICL_entailment
157,24,7,7,0,1.0,5,5,0,1.0,1.0,medlm,mimiciii,nursing_note,PROMPT1_ICL_entailment
158,240,31,28,3,0.9032258064516128,42,30,12,0.7142857142857143,0.7977207977207977,medlm,mimiciii,nursing_note,PROMPT1_ICL_entailment
159,241,26,24,2,0.9230769230769232,21,20,1,0.9523809523809524,0.9375,medlm,mimiciii,nursing_note,PROMPT1_ICL_entailment
160,242,31,17,14,0.5483870967741935,16,12,4,0.75,0.6335403726708074,medlm,mimiciii,nursing_note,PROMPT1_ICL_entailment
161,243,4,3,1,0.75,5,4,1,0.8,0.7741935483870969,medlm,mimiciii,nursing_note,PROMPT1_ICL_entailment
162,244,41,32,9,0.7804878048780488,16,11,5,0.6875,0.731048805815161,medlm,mimiciii,nursing_note,PROMPT1_ICL_entailment
163,245,37,31,6,0.8378378378378378,37,30,7,0.8108108108108109,0.8241027913159061,medlm,mimiciii,nursing_note,PROMPT1_ICL_entailment
164,246,31,29,2,0.935483870967742,10,10,0,1.0,0.9666666666666666,medlm,mimiciii,nursing_note,PROMPT1_ICL_entailment
165,247,8,8,0,1.0,6,5,1,0.8333333333333334,0.9090909090909092,medlm,mimiciii,nursing_note,PROMPT1_ICL_entailment
166,248,48,40,8,0.8333333333333334,42,34,8,0.8095238095238095,0.8212560386473431,medlm,mimiciii,nursing_note,PROMPT1_ICL_entailment
167,249,41,34,7,0.8292682926829268,39,32,7,0.8205128205128205,0.8248673237300985,medlm,mimiciii,nursing_note,PROMPT1_ICL_entailment
168,25,37,32,5,0.8648648648648649,23,22,1,0.9565217391304348,0.9083870967741936,medlm,mimiciii,nursing_note,PROMPT1_ICL_entailment
169,26,35,33,2,0.9428571428571428,35,32,3,0.9142857142857144,0.9283516483516484,medlm,mimiciii,nursing_note,PROMPT1_ICL_entailment
170,27,4,3,1,0.75,3,2,1,0.6666666666666666,0.7058823529411765,medlm,mimiciii,nursing_note,PROMPT1_ICL_entailment
171,28,37,31,6,0.8378378378378378,16,12,4,0.75,0.7914893617021277,medlm,mimiciii,nursing_note,PROMPT1_ICL_entailment
172,29,31,28,3,0.9032258064516128,33,28,5,0.8484848484848485,0.875,medlm,mimiciii,nursing_note,PROMPT1_ICL_entailment
173,3,10,9,1,0.9,6,5,1,0.8333333333333334,0.8653846153846153,medlm,mimiciii,nursing_note,PROMPT1_ICL_entailment
174,30,13,11,2,0.8461538461538461,17,9,8,0.5294117647058824,0.6513157894736843,medlm,mimiciii,nursing_note,PROMPT1_ICL_entailment
175,31,16,11,5,0.6875,19,15,4,0.7894736842105263,0.7349665924276169,medlm,mimiciii,nursing_note,PROMPT1_ICL_entailment
176,32,41,38,3,0.926829268292683,44,40,4,0.9090909090909092,0.9178743961352656,medlm,mimiciii,nursing_note,PROMPT1_ICL_entailment
177,33,4,4,0,1.0,5,5,0,1.0,1.0,medlm,mimiciii,nursing_note,PROMPT1_ICL_entailment
178,34,3,3,0,1.0,3,3,0,1.0,1.0,medlm,mimiciii,nursing_note,PROMPT1_ICL_entailment
179,35,6,6,0,1.0,7,4,3,0.5714285714285714,0.7272727272727273,medlm,mimiciii,nursing_note,PROMPT1_ICL_entailment
180,36,69,46,23,0.6666666666666666,62,59,3,0.9516129032258064,0.7840531561461794,medlm,mimiciii,nursing_note,PROMPT1_ICL_entailment
181,37,36,21,15,0.5833333333333334,38,26,12,0.6842105263157895,0.629757785467128,medlm,mimiciii,nursing_note,PROMPT1_ICL_entailment
182,38,26,15,11,0.5769230769230769,26,21,5,0.8076923076923077,0.6730769230769231,medlm,mimiciii,nursing_note,PROMPT1_ICL_entailment
183,39,12,9,3,0.75,3,1,2,0.3333333333333333,0.4615384615384615,medlm,mimiciii,nursing_note,PROMPT1_ICL_entailment
184,4,27,16,11,0.5925925925925926,26,19,7,0.7307692307692307,0.6544671689989234,medlm,mimiciii,nursing_note,PROMPT1_ICL_entailment
185,40,8,7,1,0.875,3,2,1,0.6666666666666666,0.7567567567567567,medlm,mimiciii,nursing_note,PROMPT1_ICL_entailment
186,41,45,45,0,1.0,50,41,9,0.82,0.9010989010989012,medlm,mimiciii,nursing_note,PROMPT1_ICL_entailment
187,42,29,25,4,0.8620689655172413,7,6,1,0.8571428571428571,0.8595988538681948,medlm,mimiciii,nursing_note,PROMPT1_ICL_entailment
188,43,29,23,6,0.7931034482758621,14,11,3,0.7857142857142857,0.7893915756630265,medlm,mimiciii,nursing_note,PROMPT1_ICL_entailment
189,44,5,5,0,1.0,3,3,0,1.0,1.0,medlm,mimiciii,nursing_note,PROMPT1_ICL_entailment
190,45,30,30,0,1.0,34,28,6,0.8235294117647058,0.9032258064516128,medlm,mimiciii,nursing_note,PROMPT1_ICL_entailment
191,46,52,50,2,0.9615384615384616,33,23,10,0.696969696969697,0.8081517919887562,medlm,mimiciii,nursing_note,PROMPT1_ICL_entailment
192,47,19,12,7,0.631578947368421,14,8,6,0.5714285714285714,0.6,medlm,mimiciii,nursing_note,PROMPT1_ICL_entailment
193,48,13,13,0,1.0,9,8,1,0.8888888888888888,0.9411764705882352,medlm,mimiciii,nursing_note,PROMPT1_ICL_entailment
194,49,5,5,0,1.0,3,2,1,0.6666666666666666,0.8,medlm,mimiciii,nursing_note,PROMPT1_ICL_entailment
195,5,26,21,5,0.8076923076923077,15,12,3,0.8,0.8038277511961722,medlm,mimiciii,nursing_note,PROMPT1_ICL_entailment
196,50,11,8,3,0.7272727272727273,16,11,5,0.6875,0.7068273092369478,medlm,mimiciii,nursing_note,PROMPT1_ICL_entailment
197,51,6,6,0,1.0,6,6,0,1.0,1.0,medlm,mimiciii,nursing_note,PROMPT1_ICL_entailment
198,52,39,28,11,0.717948717948718,38,26,12,0.6842105263157895,0.7006737247353224,medlm,mimiciii,nursing_note,PROMPT1_ICL_entailment
199,53,8,7,1,0.875,6,4,2,0.6666666666666666,0.7567567567567567,medlm,mimiciii,nursing_note,PROMPT1_ICL_entailment
200,54,36,25,11,0.6944444444444444,37,29,8,0.7837837837837838,0.7364144235652614,medlm,mimiciii,nursing_note,PROMPT1_ICL_entailment
201,55,44,39,5,0.8863636363636364,35,18,17,0.5142857142857142,0.650904033379694,medlm,mimiciii,nursing_note,PROMPT1_ICL_entailment
202,56,6,6,0,1.0,2,2,0,1.0,1.0,medlm,mimiciii,nursing_note,PROMPT1_ICL_entailment
203,57,37,34,3,0.918918918918919,18,10,8,0.5555555555555556,0.6924643584521385,medlm,mimiciii,nursing_note,PROMPT1_ICL_entailment
204,58,35,27,8,0.7714285714285715,28,23,5,0.8214285714285714,0.7956438180653427,medlm,mimiciii,nursing_note,PROMPT1_ICL_entailment
205,59,8,8,0,1.0,9,7,2,0.7777777777777778,0.8750000000000001,medlm,mimiciii,nursing_note,PROMPT1_ICL_entailment
206,6,9,7,2,0.7777777777777778,8,7,1,0.875,0.823529411764706,medlm,mimiciii,nursing_note,PROMPT1_ICL_entailment
207,60,44,32,12,0.7272727272727273,27,24,3,0.8888888888888888,0.7999999999999999,medlm,mimiciii,nursing_note,PROMPT1_ICL_entailment
208,61,10,8,2,0.8,20,9,11,0.45,0.5760000000000001,medlm,mimiciii,nursing_note,PROMPT1_ICL_entailment
209,62,34,25,9,0.7352941176470589,37,31,6,0.8378378378378378,0.7832238504295099,medlm,mimiciii,nursing_note,PROMPT1_ICL_entailment
210,63,5,5,0,1.0,5,5,0,1.0,1.0,medlm,mimiciii,nursing_note,PROMPT1_ICL_entailment
211,64,38,33,5,0.868421052631579,27,20,7,0.7407407407407407,0.7995154451847365,medlm,mimiciii,nursing_note,PROMPT1_ICL_entailment
212,65,20,20,0,1.0,19,15,4,0.7894736842105263,0.8823529411764706,medlm,mimiciii,nursing_note,PROMPT1_ICL_entailment
213,66,6,6,0,1.0,1,1,0,1.0,1.0,medlm,mimiciii,nursing_note,PROMPT1_ICL_entailment
214,67,10,9,1,0.9,7,6,1,0.8571428571428571,0.8780487804878048,medlm,mimiciii,nursing_note,PROMPT1_ICL_entailment
215,68,32,28,4,0.875,18,16,2,0.8888888888888888,0.8818897637795274,medlm,mimiciii,nursing_note,PROMPT1_ICL_entailment
216,69,10,4,6,0.4,25,13,12,0.52,0.4521739130434782,medlm,mimiciii,nursing_note,PROMPT1_ICL_entailment
217,7,5,5,0,1.0,2,2,0,1.0,1.0,medlm,mimiciii,nursing_note,PROMPT1_ICL_entailment
218,70,41,34,7,0.8292682926829268,45,34,11,0.7555555555555555,0.7906976744186047,medlm,mimiciii,nursing_note,PROMPT1_ICL_entailment
219,71,14,6,8,0.4285714285714285,52,17,35,0.3269230769230769,0.3709090909090909,medlm,mimiciii,nursing_note,PROMPT1_ICL_entailment
220,72,11,10,1,0.9090909090909092,12,10,2,0.8333333333333334,0.8695652173913043,medlm,mimiciii,nursing_note,PROMPT1_ICL_entailment
221,73,30,22,8,0.7333333333333333,38,28,10,0.7368421052631579,0.7350835322195703,medlm,mimiciii,nursing_note,PROMPT1_ICL_entailment
222,74,6,6,0,1.0,8,7,1,0.875,0.9333333333333332,medlm,mimiciii,nursing_note,PROMPT1_ICL_entailment
223,75,21,18,3,0.8571428571428571,27,19,8,0.7037037037037037,0.7728813559322033,medlm,mimiciii,nursing_note,PROMPT1_ICL_entailment
224,76,3,1,2,0.3333333333333333,1,1,0,1.0,0.5,medlm,mimiciii,nursing_note,PROMPT1_ICL_entailment
225,77,59,26,33,0.4406779661016949,59,43,16,0.7288135593220338,0.5492507983296486,medlm,mimiciii,nursing_note,PROMPT1_ICL_entailment
226,78,18,11,7,0.6111111111111112,20,7,13,0.35,0.4450867052023121,medlm,mimiciii,nursing_note,PROMPT1_ICL_entailment
227,79,32,32,0,1.0,30,30,0,1.0,1.0,medlm,mimiciii,nursing_note,PROMPT1_ICL_entailment
228,8,5,4,1,0.8,14,9,5,0.6428571428571429,0.7128712871287128,medlm,mimiciii,nursing_note,PROMPT1_ICL_entailment
229,80,26,19,7,0.7307692307692307,22,20,2,0.9090909090909092,0.8102345415778252,medlm,mimiciii,nursing_note,PROMPT1_ICL_entailment
230,81,32,18,14,0.5625,22,19,3,0.8636363636363636,0.6812749003984063,medlm,mimiciii,nursing_note,PROMPT1_ICL_entailment
231,82,20,16,4,0.8,17,12,5,0.7058823529411765,0.7500000000000001,medlm,mimiciii,nursing_note,PROMPT1_ICL_entailment
232,83,19,14,5,0.7368421052631579,34,25,9,0.7352941176470589,0.7360672975814931,medlm,mimiciii,nursing_note,PROMPT1_ICL_entailment
233,84,6,6,0,1.0,6,6,0,1.0,1.0,medlm,mimiciii,nursing_note,PROMPT1_ICL_entailment
234,85,23,22,1,0.9565217391304348,27,20,7,0.7407407407407407,0.8349146110056925,medlm,mimiciii,nursing_note,PROMPT1_ICL_entailment
235,86,40,28,12,0.7,40,34,6,0.85,0.767741935483871,medlm,mimiciii,nursing_note,PROMPT1_ICL_entailment
236,87,17,15,2,0.8823529411764706,15,11,4,0.7333333333333333,0.8009708737864076,medlm,mimiciii,nursing_note,PROMPT1_ICL_entailment
237,88,43,32,11,0.7441860465116279,15,10,5,0.6666666666666666,0.7032967032967034,medlm,mimiciii,nursing_note,PROMPT1_ICL_entailment
238,89,26,21,5,0.8076923076923077,29,24,5,0.8275862068965517,0.8175182481751824,medlm,mimiciii,nursing_note,PROMPT1_ICL_entailment
239,9,34,34,0,1.0,17,15,2,0.8823529411764706,0.9375,medlm,mimiciii,nursing_note,PROMPT1_ICL_entailment
240,90,25,22,3,0.88,14,13,1,0.9285714285714286,0.9036334913112164,medlm,mimiciii,nursing_note,PROMPT1_ICL_entailment
241,91,22,13,9,0.5909090909090909,25,22,3,0.88,0.7070457354758962,medlm,mimiciii,nursing_note,PROMPT1_ICL_entailment
242,92,29,28,1,0.9655172413793104,28,28,0,1.0,0.9824561403508772,medlm,mimiciii,nursing_note,PROMPT1_ICL_entailment
243,93,26,23,3,0.8846153846153846,23,22,1,0.9565217391304348,0.9191643960036332,medlm,mimiciii,nursing_note,PROMPT1_ICL_entailment
244,94,6,6,0,1.0,5,4,1,0.8,0.888888888888889,medlm,mimiciii,nursing_note,PROMPT1_ICL_entailment
245,95,16,11,5,0.6875,14,11,3,0.7857142857142857,0.7333333333333334,medlm,mimiciii,nursing_note,PROMPT1_ICL_entailment
246,96,6,6,0,1.0,6,6,0,1.0,1.0,medlm,mimiciii,nursing_note,PROMPT1_ICL_entailment
247,97,9,9,0,1.0,10,9,1,0.9,0.9473684210526316,medlm,mimiciii,nursing_note,PROMPT1_ICL_entailment
248,98,47,41,6,0.8723404255319149,13,6,7,0.4615384615384615,0.603680981595092,medlm,mimiciii,nursing_note,PROMPT1_ICL_entailment
249,99,52,48,4,0.9230769230769232,44,39,5,0.8863636363636364,0.9043478260869564,medlm,mimiciii,nursing_note,PROMPT1_ICL_entailment
0,0,8,4,4,0.5,11,9,2,0.8181818181818182,0.6206896551724137,medlm,mimiciii,nursing_note,PROMPT2_ICL_entailment
1,1,32,10,22,0.3125,31,20,11,0.6451612903225806,0.4210526315789473,medlm,mimiciii,nursing_note,PROMPT2_ICL_entailment
2,10,23,17,6,0.7391304347826086,18,12,6,0.6666666666666666,0.7010309278350515,medlm,mimiciii,nursing_note,PROMPT2_ICL_entailment
3,100,8,8,0,1.0,6,6,0,1.0,1.0,medlm,mimiciii,nursing_note,PROMPT2_ICL_entailment
4,101,26,25,1,0.9615384615384616,27,24,3,0.8888888888888888,0.9237875288683602,medlm,mimiciii,nursing_note,PROMPT2_ICL_entailment
5,102,23,20,3,0.8695652173913043,26,22,4,0.8461538461538461,0.8576998050682261,medlm,mimiciii,nursing_note,PROMPT2_ICL_entailment
6,103,27,22,5,0.8148148148148148,22,22,0,1.0,0.8979591836734693,medlm,mimiciii,nursing_note,PROMPT2_ICL_entailment
7,104,23,19,4,0.8260869565217391,20,18,2,0.9,0.8614609571788413,medlm,mimiciii,nursing_note,PROMPT2_ICL_entailment
8,105,21,15,6,0.7142857142857143,20,19,1,0.95,0.8154506437768242,medlm,mimiciii,nursing_note,PROMPT2_ICL_entailment
9,106,6,6,0,1.0,4,3,1,0.75,0.8571428571428571,medlm,mimiciii,nursing_note,PROMPT2_ICL_entailment
10,107,46,37,9,0.8043478260869565,63,40,23,0.6349206349206349,0.7096619515703667,medlm,mimiciii,nursing_note,PROMPT2_ICL_entailment
11,108,39,35,4,0.8974358974358975,28,24,4,0.8571428571428571,0.8768267223382046,medlm,mimiciii,nursing_note,PROMPT2_ICL_entailment
12,109,4,4,0,1.0,4,4,0,1.0,1.0,medlm,mimiciii,nursing_note,PROMPT2_ICL_entailment
13,11,1,1,0,1.0,2,1,1,0.5,0.6666666666666666,medlm,mimiciii,nursing_note,PROMPT2_ICL_entailment
14,110,18,16,2,0.8888888888888888,13,11,2,0.8461538461538461,0.8669950738916256,medlm,mimiciii,nursing_note,PROMPT2_ICL_entailment
15,111,34,32,2,0.9411764705882352,34,29,5,0.8529411764705882,0.8948891031822566,medlm,mimiciii,nursing_note,PROMPT2_ICL_entailment
16,112,45,36,9,0.8,37,31,6,0.8378378378378378,0.8184818481848185,medlm,mimiciii,nursing_note,PROMPT2_ICL_entailment
17,113,4,4,0,1.0,5,4,1,0.8,0.888888888888889,medlm,mimiciii,nursing_note,PROMPT2_ICL_entailment
18,114,21,13,8,0.6190476190476191,19,16,3,0.8421052631578947,0.7135506003430532,medlm,mimiciii,nursing_note,PROMPT2_ICL_entailment
19,115,14,14,0,1.0,7,7,0,1.0,1.0,medlm,mimiciii,nursing_note,PROMPT2_ICL_entailment
20,116,27,27,0,1.0,31,25,6,0.8064516129032258,0.8928571428571428,medlm,mimiciii,nursing_note,PROMPT2_ICL_entailment
21,117,36,30,6,0.8333333333333334,18,15,3,0.8333333333333334,0.8333333333333334,medlm,mimiciii,nursing_note,PROMPT2_ICL_entailment
22,118,15,9,6,0.6,25,12,13,0.48,0.5333333333333332,medlm,mimiciii,nursing_note,PROMPT2_ICL_entailment
23,119,25,21,4,0.84,26,21,5,0.8076923076923077,0.8235294117647058,medlm,mimiciii,nursing_note,PROMPT2_ICL_entailment
24,12,18,16,2,0.8888888888888888,18,15,3,0.8333333333333334,0.8602150537634408,medlm,mimiciii,nursing_note,PROMPT2_ICL_entailment
25,120,21,15,6,0.7142857142857143,18,15,3,0.8333333333333334,0.7692307692307692,medlm,mimiciii,nursing_note,PROMPT2_ICL_entailment
26,121,39,34,5,0.8717948717948718,37,31,6,0.8378378378378378,0.854479124442643,medlm,mimiciii,nursing_note,PROMPT2_ICL_entailment
27,122,36,32,4,0.8888888888888888,11,8,3,0.7272727272727273,0.7999999999999999,medlm,mimiciii,nursing_note,PROMPT2_ICL_entailment
28,123,5,5,0,1.0,6,6,0,1.0,1.0,medlm,mimiciii,nursing_note,PROMPT2_ICL_entailment
29,124,7,6,1,0.8571428571428571,5,5,0,1.0,0.923076923076923,medlm,mimiciii,nursing_note,PROMPT2_ICL_entailment
30,125,40,38,2,0.95,43,33,10,0.7674418604651163,0.8490182802979012,medlm,mimiciii,nursing_note,PROMPT2_ICL_entailment
31,126,30,23,7,0.7666666666666667,28,23,5,0.8214285714285714,0.793103448275862,medlm,mimiciii,nursing_note,PROMPT2_ICL_entailment
32,127,13,11,2,0.8461538461538461,10,8,2,0.8,0.8224299065420562,medlm,mimiciii,nursing_note,PROMPT2_ICL_entailment
33,128,15,13,2,0.8666666666666667,17,12,5,0.7058823529411765,0.7780548628428927,medlm,mimiciii,nursing_note,PROMPT2_ICL_entailment
34,129,25,19,6,0.76,29,23,6,0.7931034482758621,0.7761989342806395,medlm,mimiciii,nursing_note,PROMPT2_ICL_entailment
35,13,32,27,5,0.84375,34,32,2,0.9411764705882352,0.8898043254376931,medlm,mimiciii,nursing_note,PROMPT2_ICL_entailment
36,130,40,30,10,0.75,33,24,9,0.7272727272727273,0.7384615384615384,medlm,mimiciii,nursing_note,PROMPT2_ICL_entailment
37,131,25,23,2,0.92,31,28,3,0.9032258064516128,0.9115357395612173,medlm,mimiciii,nursing_note,PROMPT2_ICL_entailment
38,132,34,25,9,0.7352941176470589,17,13,4,0.7647058823529411,0.7497116493656285,medlm,mimiciii,nursing_note,PROMPT2_ICL_entailment
39,133,11,11,0,1.0,10,8,2,0.8,0.888888888888889,medlm,mimiciii,nursing_note,PROMPT2_ICL_entailment
40,134,47,23,24,0.4893617021276595,30,22,8,0.7333333333333333,0.5870069605568445,medlm,mimiciii,nursing_note,PROMPT2_ICL_entailment
41,135,43,35,8,0.813953488372093,47,27,20,0.574468085106383,0.6735566642908055,medlm,mimiciii,nursing_note,PROMPT2_ICL_entailment
42,136,37,36,1,0.972972972972973,41,28,13,0.6829268292682927,0.8025477707006371,medlm,mimiciii,nursing_note,PROMPT2_ICL_entailment
43,137,2,2,0,1.0,2,1,1,0.5,0.6666666666666666,medlm,mimiciii,nursing_note,PROMPT2_ICL_entailment
44,138,4,4,0,1.0,5,4,1,0.8,0.888888888888889,medlm,mimiciii,nursing_note,PROMPT2_ICL_entailment
45,139,6,6,0,1.0,4,3,1,0.75,0.8571428571428571,medlm,mimiciii,nursing_note,PROMPT2_ICL_entailment
46,14,19,17,2,0.8947368421052632,26,21,5,0.8076923076923077,0.8489892984542212,medlm,mimiciii,nursing_note,PROMPT2_ICL_entailment
47,140,30,17,13,0.5666666666666667,24,22,2,0.9166666666666666,0.7003745318352059,medlm,mimiciii,nursing_note,PROMPT2_ICL_entailment
48,141,13,12,1,0.9230769230769232,11,11,0,1.0,0.96,medlm,mimiciii,nursing_note,PROMPT2_ICL_entailment
49,142,49,39,10,0.7959183673469388,8,7,1,0.875,0.833587786259542,medlm,mimiciii,nursing_note,PROMPT2_ICL_entailment
50,143,18,15,3,0.8333333333333334,2,1,1,0.5,0.625,medlm,mimiciii,nursing_note,PROMPT2_ICL_entailment
51,144,8,7,1,0.875,5,4,1,0.8,0.8358208955223881,medlm,mimiciii,nursing_note,PROMPT2_ICL_entailment
52,145,25,21,4,0.84,19,16,3,0.8421052631578947,0.8410513141426784,medlm,mimiciii,nursing_note,PROMPT2_ICL_entailment
53,146,7,6,1,0.8571428571428571,6,6,0,1.0,0.923076923076923,medlm,mimiciii,nursing_note,PROMPT2_ICL_entailment
54,147,21,16,5,0.7619047619047619,26,21,5,0.8076923076923077,0.7841306884480748,medlm,mimiciii,nursing_note,PROMPT2_ICL_entailment
55,148,6,6,0,1.0,7,6,1,0.8571428571428571,0.923076923076923,medlm,mimiciii,nursing_note,PROMPT2_ICL_entailment
56,149,35,29,6,0.8285714285714286,36,25,11,0.6944444444444444,0.7556018759770715,medlm,mimiciii,nursing_note,PROMPT2_ICL_entailment
57,15,13,10,3,0.7692307692307693,33,16,17,0.4848484848484848,0.5947955390334573,medlm,mimiciii,nursing_note,PROMPT2_ICL_entailment
58,150,11,11,0,1.0,8,8,0,1.0,1.0,medlm,mimiciii,nursing_note,PROMPT2_ICL_entailment
59,151,26,22,4,0.8461538461538461,26,22,4,0.8461538461538461,0.8461538461538461,medlm,mimiciii,nursing_note,PROMPT2_ICL_entailment
60,152,40,38,2,0.95,44,37,7,0.8409090909090909,0.8921319796954313,medlm,mimiciii,nursing_note,PROMPT2_ICL_entailment
61,153,4,4,0,1.0,4,4,0,1.0,1.0,medlm,mimiciii,nursing_note,PROMPT2_ICL_entailment
62,154,21,20,1,0.9523809523809524,34,21,13,0.6176470588235294,0.7493309545049064,medlm,mimiciii,nursing_note,PROMPT2_ICL_entailment
63,155,46,40,6,0.8695652173913043,51,45,6,0.8823529411764706,0.8759124087591241,medlm,mimiciii,nursing_note,PROMPT2_ICL_entailment
64,156,24,19,5,0.7916666666666666,26,17,9,0.6538461538461539,0.7161862527716185,medlm,mimiciii,nursing_note,PROMPT2_ICL_entailment
65,157,5,5,0,1.0,5,4,1,0.8,0.888888888888889,medlm,mimiciii,nursing_note,PROMPT2_ICL_entailment
66,158,34,32,2,0.9411764705882352,22,21,1,0.9545454545454546,0.9478138222849084,medlm,mimiciii,nursing_note,PROMPT2_ICL_entailment
67,159,7,5,2,0.7142857142857143,8,4,4,0.5,0.588235294117647,medlm,mimiciii,nursing_note,PROMPT2_ICL_entailment
68,16,42,36,6,0.8571428571428571,30,21,9,0.7,0.7706422018348624,medlm,mimiciii,nursing_note,PROMPT2_ICL_entailment
69,160,34,33,1,0.9705882352941176,21,18,3,0.8571428571428571,0.9103448275862068,medlm,mimiciii,nursing_note,PROMPT2_ICL_entailment
70,161,5,5,0,1.0,6,5,1,0.8333333333333334,0.9090909090909092,medlm,mimiciii,nursing_note,PROMPT2_ICL_entailment
71,162,31,29,2,0.935483870967742,31,23,8,0.7419354838709677,0.827543424317618,medlm,mimiciii,nursing_note,PROMPT2_ICL_entailment
72,163,8,8,0,1.0,4,4,0,1.0,1.0,medlm,mimiciii,nursing_note,PROMPT2_ICL_entailment
73,164,17,16,1,0.9411764705882352,13,11,2,0.8461538461538461,0.8911392405063291,medlm,mimiciii,nursing_note,PROMPT2_ICL_entailment
74,165,36,30,6,0.8333333333333334,24,22,2,0.9166666666666666,0.8730158730158729,medlm,mimiciii,nursing_note,PROMPT2_ICL_entailment
75,166,11,10,1,0.9090909090909092,3,3,0,1.0,0.9523809523809524,medlm,mimiciii,nursing_note,PROMPT2_ICL_entailment
76,167,31,25,6,0.8064516129032258,16,15,1,0.9375,0.8670520231213872,medlm,mimiciii,nursing_note,PROMPT2_ICL_entailment
77,168,30,20,10,0.6666666666666666,25,21,4,0.84,0.743362831858407,medlm,mimiciii,nursing_note,PROMPT2_ICL_entailment
78,169,24,23,1,0.9583333333333334,12,11,1,0.9166666666666666,0.937037037037037,medlm,mimiciii,nursing_note,PROMPT2_ICL_entailment
79,17,19,14,5,0.7368421052631579,39,24,15,0.6153846153846154,0.6706586826347305,medlm,mimiciii,nursing_note,PROMPT2_ICL_entailment
80,170,33,28,5,0.8484848484848485,21,20,1,0.9523809523809524,0.8974358974358975,medlm,mimiciii,nursing_note,PROMPT2_ICL_entailment
81,171,6,6,0,1.0,8,8,0,1.0,1.0,medlm,mimiciii,nursing_note,PROMPT2_ICL_entailment
82,172,39,37,2,0.9487179487179488,38,29,9,0.7631578947368421,0.8458809617658651,medlm,mimiciii,nursing_note,PROMPT2_ICL_entailment
83,173,19,15,4,0.7894736842105263,20,13,7,0.65,0.7129798903107861,medlm,mimiciii,nursing_note,PROMPT2_ICL_entailment
84,174,4,4,0,1.0,8,8,0,1.0,1.0,medlm,mimiciii,nursing_note,PROMPT2_ICL_entailment
85,175,3,3,0,1.0,4,4,0,1.0,1.0,medlm,mimiciii,nursing_note,PROMPT2_ICL_entailment
86,176,16,13,3,0.8125,13,10,3,0.7692307692307693,0.790273556231003,medlm,mimiciii,nursing_note,PROMPT2_ICL_entailment
87,177,38,30,8,0.7894736842105263,38,31,7,0.8157894736842105,0.8024158757549612,medlm,mimiciii,nursing_note,PROMPT2_ICL_entailment
88,178,45,41,4,0.9111111111111112,25,18,7,0.72,0.804359673024523,medlm,mimiciii,nursing_note,PROMPT2_ICL_entailment
89,179,30,26,4,0.8666666666666667,22,15,7,0.6818181818181818,0.7632093933463797,medlm,mimiciii,nursing_note,PROMPT2_ICL_entailment
90,18,32,22,10,0.6875,25,17,8,0.68,0.6837294332723949,medlm,mimiciii,nursing_note,PROMPT2_ICL_entailment
91,180,20,14,6,0.7,27,19,8,0.7037037037037037,0.7018469656992085,medlm,mimiciii,nursing_note,PROMPT2_ICL_entailment
92,181,25,19,6,0.76,25,23,2,0.92,0.8323809523809523,medlm,mimiciii,nursing_note,PROMPT2_ICL_entailment
93,182,17,10,7,0.5882352941176471,10,7,3,0.7,0.6392694063926941,medlm,mimiciii,nursing_note,PROMPT2_ICL_entailment
94,183,7,7,0,1.0,5,4,1,0.8,0.888888888888889,medlm,mimiciii,nursing_note,PROMPT2_ICL_entailment
95,184,9,9,0,1.0,1,1,0,1.0,1.0,medlm,mimiciii,nursing_note,PROMPT2_ICL_entailment
96,185,27,23,4,0.8518518518518519,30,28,2,0.9333333333333332,0.8907330567081604,medlm,mimiciii,nursing_note,PROMPT2_ICL_entailment
97,186,5,5,0,1.0,4,3,1,0.75,0.8571428571428571,medlm,mimiciii,nursing_note,PROMPT2_ICL_entailment
98,187,32,28,4,0.875,37,31,6,0.8378378378378378,0.8560157790927022,medlm,mimiciii,nursing_note,PROMPT2_ICL_entailment
99,188,2,2,0,1.0,2,1,1,0.5,0.6666666666666666,medlm,mimiciii,nursing_note,PROMPT2_ICL_entailment
100,189,20,17,3,0.85,21,20,1,0.9523809523809524,0.8982826948480845,medlm,mimiciii,nursing_note,PROMPT2_ICL_entailment
101,19,24,16,8,0.6666666666666666,45,19,26,0.4222222222222222,0.5170068027210885,medlm,mimiciii,nursing_note,PROMPT2_ICL_entailment
102,190,29,29,0,1.0,24,20,4,0.8333333333333334,0.9090909090909092,medlm,mimiciii,nursing_note,PROMPT2_ICL_entailment
103,191,28,23,5,0.8214285714285714,29,23,6,0.7931034482758621,0.8070175438596492,medlm,mimiciii,nursing_note,PROMPT2_ICL_entailment
104,192,11,10,1,0.9090909090909092,15,12,3,0.8,0.8510638297872342,medlm,mimiciii,nursing_note,PROMPT2_ICL_entailment
105,193,38,33,5,0.868421052631579,40,27,13,0.675,0.7595907928388748,medlm,mimiciii,nursing_note,PROMPT2_ICL_entailment
106,194,13,13,0,1.0,13,11,2,0.8461538461538461,0.9166666666666666,medlm,mimiciii,nursing_note,PROMPT2_ICL_entailment
107,195,6,6,0,1.0,7,7,0,1.0,1.0,medlm,mimiciii,nursing_note,PROMPT2_ICL_entailment
108,196,37,33,4,0.8918918918918919,34,31,3,0.9117647058823528,0.9017188188629351,medlm,mimiciii,nursing_note,PROMPT2_ICL_entailment
109,197,34,30,4,0.8823529411764706,27,27,0,1.0,0.9375,medlm,mimiciii,nursing_note,PROMPT2_ICL_entailment
110,198,27,23,4,0.8518518518518519,38,26,12,0.6842105263157895,0.7588832487309645,medlm,mimiciii,nursing_note,PROMPT2_ICL_entailment
111,199,14,14,0,1.0,14,13,1,0.9285714285714286,0.962962962962963,medlm,mimiciii,nursing_note,PROMPT2_ICL_entailment
112,2,49,27,22,0.5510204081632653,43,35,8,0.813953488372093,0.6571627260083448,medlm,mimiciii,nursing_note,PROMPT2_ICL_entailment
113,20,49,28,21,0.5714285714285714,46,31,15,0.6739130434782609,0.6184538653366582,medlm,mimiciii,nursing_note,PROMPT2_ICL_entailment
114,200,35,23,12,0.6571428571428571,44,30,14,0.6818181818181818,0.6692531522793405,medlm,mimiciii,nursing_note,PROMPT2_ICL_entailment
115,201,22,22,0,1.0,29,26,3,0.896551724137931,0.9454545454545454,medlm,mimiciii,nursing_note,PROMPT2_ICL_entailment
116,202,10,9,1,0.9,9,8,1,0.8888888888888888,0.8944099378881988,medlm,mimiciii,nursing_note,PROMPT2_ICL_entailment
117,203,6,6,0,1.0,7,5,2,0.7142857142857143,0.8333333333333333,medlm,mimiciii,nursing_note,PROMPT2_ICL_entailment
118,204,16,13,3,0.8125,24,13,11,0.5416666666666666,0.65,medlm,mimiciii,nursing_note,PROMPT2_ICL_entailment
119,205,42,41,1,0.9761904761904762,69,42,27,0.6086956521739131,0.7498367080339646,medlm,mimiciii,nursing_note,PROMPT2_ICL_entailment
120,206,6,6,0,1.0,6,5,1,0.8333333333333334,0.9090909090909092,medlm,mimiciii,nursing_note,PROMPT2_ICL_entailment
121,207,36,35,1,0.9722222222222222,29,25,4,0.8620689655172413,0.9138381201044388,medlm,mimiciii,nursing_note,PROMPT2_ICL_entailment
122,208,11,11,0,1.0,7,7,0,1.0,1.0,medlm,mimiciii,nursing_note,PROMPT2_ICL_entailment
123,209,2,2,0,1.0,2,2,0,1.0,1.0,medlm,mimiciii,nursing_note,PROMPT2_ICL_entailment
124,21,5,5,0,1.0,6,5,1,0.8333333333333334,0.9090909090909092,medlm,mimiciii,nursing_note,PROMPT2_ICL_entailment
125,210,22,17,5,0.7727272727272727,22,20,2,0.9090909090909092,0.8353808353808354,medlm,mimiciii,nursing_note,PROMPT2_ICL_entailment
126,211,2,2,0,1.0,4,4,0,1.0,1.0,medlm,mimiciii,nursing_note,PROMPT2_ICL_entailment
127,212,32,26,6,0.8125,37,31,6,0.8378378378378378,0.8249744114636642,medlm,mimiciii,nursing_note,PROMPT2_ICL_entailment
128,213,17,17,0,1.0,18,15,3,0.8333333333333334,0.9090909090909092,medlm,mimiciii,nursing_note,PROMPT2_ICL_entailment
129,214,4,4,0,1.0,3,3,0,1.0,1.0,medlm,mimiciii,nursing_note,PROMPT2_ICL_entailment
130,215,8,7,1,0.875,7,6,1,0.8571428571428571,0.8659793814432989,medlm,mimiciii,nursing_note,PROMPT2_ICL_entailment
131,216,27,17,10,0.6296296296296297,13,9,4,0.6923076923076923,0.6594827586206897,medlm,mimiciii,nursing_note,PROMPT2_ICL_entailment
132,217,30,22,8,0.7333333333333333,25,22,3,0.88,0.8,medlm,mimiciii,nursing_note,PROMPT2_ICL_entailment
133,218,21,19,2,0.9047619047619048,18,14,4,0.7777777777777778,0.8364779874213837,medlm,mimiciii,nursing_note,PROMPT2_ICL_entailment
134,219,26,19,7,0.7307692307692307,14,12,2,0.8571428571428571,0.7889273356401383,medlm,mimiciii,nursing_note,PROMPT2_ICL_entailment
135,22,35,28,7,0.8,26,24,2,0.9230769230769232,0.8571428571428571,medlm,mimiciii,nursing_note,PROMPT2_ICL_entailment
136,220,11,10,1,0.9090909090909092,5,3,2,0.6,0.7228915662650602,medlm,mimiciii,nursing_note,PROMPT2_ICL_entailment
137,221,31,20,11,0.6451612903225806,45,27,18,0.6,0.6217616580310881,medlm,mimiciii,nursing_note,PROMPT2_ICL_entailment
138,222,3,3,0,1.0,3,3,0,1.0,1.0,medlm,mimiciii,nursing_note,PROMPT2_ICL_entailment
139,223,14,3,11,0.2142857142857142,30,14,16,0.4666666666666667,0.2937062937062937,medlm,mimiciii,nursing_note,PROMPT2_ICL_entailment
140,224,6,6,0,1.0,6,4,2,0.6666666666666666,0.8,medlm,mimiciii,nursing_note,PROMPT2_ICL_entailment
141,225,46,26,20,0.5652173913043478,45,35,10,0.7777777777777778,0.6546762589928057,medlm,mimiciii,nursing_note,PROMPT2_ICL_entailment
142,226,15,13,2,0.8666666666666667,20,14,6,0.7,0.774468085106383,medlm,mimiciii,nursing_note,PROMPT2_ICL_entailment
143,227,18,14,4,0.7777777777777778,15,11,4,0.7333333333333333,0.7549019607843137,medlm,mimiciii,nursing_note,PROMPT2_ICL_entailment
144,228,30,15,15,0.5,38,25,13,0.6578947368421053,0.5681818181818182,medlm,mimiciii,nursing_note,PROMPT2_ICL_entailment
145,229,20,17,3,0.85,22,20,2,0.9090909090909092,0.8785529715762274,medlm,mimiciii,nursing_note,PROMPT2_ICL_entailment
146,23,10,7,3,0.7,44,12,32,0.2727272727272727,0.3925233644859813,medlm,mimiciii,nursing_note,PROMPT2_ICL_entailment
147,230,11,11,0,1.0,7,6,1,0.8571428571428571,0.923076923076923,medlm,mimiciii,nursing_note,PROMPT2_ICL_entailment
148,231,42,36,6,0.8571428571428571,15,10,5,0.6666666666666666,0.75,medlm,mimiciii,nursing_note,PROMPT2_ICL_entailment
149,232,8,6,2,0.75,2,2,0,1.0,0.8571428571428571,medlm,mimiciii,nursing_note,PROMPT2_ICL_entailment
150,233,31,25,6,0.8064516129032258,44,28,16,0.6363636363636364,0.7113821138211381,medlm,mimiciii,nursing_note,PROMPT2_ICL_entailment
151,234,23,23,0,1.0,32,23,9,0.71875,0.8363636363636363,medlm,mimiciii,nursing_note,PROMPT2_ICL_entailment
152,235,12,11,1,0.9166666666666666,10,9,1,0.9,0.908256880733945,medlm,mimiciii,nursing_note,PROMPT2_ICL_entailment
153,236,9,7,2,0.7777777777777778,7,5,2,0.7142857142857143,0.7446808510638298,medlm,mimiciii,nursing_note,PROMPT2_ICL_entailment
154,237,27,25,2,0.925925925925926,35,28,7,0.8,0.8583690987124465,medlm,mimiciii,nursing_note,PROMPT2_ICL_entailment
155,238,26,15,11,0.5769230769230769,42,28,14,0.6666666666666666,0.6185567010309277,medlm,mimiciii,nursing_note,PROMPT2_ICL_entailment
156,239,22,18,4,0.8181818181818182,21,16,5,0.7619047619047619,0.7890410958904108,medlm,mimiciii,nursing_note,PROMPT2_ICL_entailment
157,24,6,6,0,1.0,5,5,0,1.0,1.0,medlm,mimiciii,nursing_note,PROMPT2_ICL_entailment
158,240,33,30,3,0.9090909090909092,42,32,10,0.7619047619047619,0.8290155440414507,medlm,mimiciii,nursing_note,PROMPT2_ICL_entailment
159,241,25,21,4,0.84,21,19,2,0.9047619047619048,0.87117903930131,medlm,mimiciii,nursing_note,PROMPT2_ICL_entailment
160,242,28,14,14,0.5,16,12,4,0.75,0.6,medlm,mimiciii,nursing_note,PROMPT2_ICL_entailment
161,243,6,6,0,1.0,5,5,0,1.0,1.0,medlm,mimiciii,nursing_note,PROMPT2_ICL_entailment
162,244,33,24,9,0.7272727272727273,16,10,6,0.625,0.6722689075630253,medlm,mimiciii,nursing_note,PROMPT2_ICL_entailment
163,245,31,24,7,0.7741935483870968,37,26,11,0.7027027027027027,0.7367178276269184,medlm,mimiciii,nursing_note,PROMPT2_ICL_entailment
164,246,23,19,4,0.8260869565217391,10,10,0,1.0,0.9047619047619048,medlm,mimiciii,nursing_note,PROMPT2_ICL_entailment
165,247,7,7,0,1.0,6,5,1,0.8333333333333334,0.9090909090909092,medlm,mimiciii,nursing_note,PROMPT2_ICL_entailment
166,248,44,36,8,0.8181818181818182,42,37,5,0.8809523809523809,0.8484076433121019,medlm,mimiciii,nursing_note,PROMPT2_ICL_entailment
167,249,42,35,7,0.8333333333333334,39,31,8,0.7948717948717948,0.8136482939632546,medlm,mimiciii,nursing_note,PROMPT2_ICL_entailment
168,25,42,32,10,0.7619047619047619,23,17,6,0.7391304347826086,0.7503448275862068,medlm,mimiciii,nursing_note,PROMPT2_ICL_entailment
169,26,12,11,1,0.9166666666666666,35,33,2,0.9428571428571428,0.9295774647887324,medlm,mimiciii,nursing_note,PROMPT2_ICL_entailment
170,27,4,4,0,1.0,3,2,1,0.6666666666666666,0.8,medlm,mimiciii,nursing_note,PROMPT2_ICL_entailment
171,28,39,33,6,0.8461538461538461,16,13,3,0.8125,0.8289855072463768,medlm,mimiciii,nursing_note,PROMPT2_ICL_entailment
172,29,38,30,8,0.7894736842105263,33,24,9,0.7272727272727273,0.7570977917981072,medlm,mimiciii,nursing_note,PROMPT2_ICL_entailment
173,3,9,9,0,1.0,6,6,0,1.0,1.0,medlm,mimiciii,nursing_note,PROMPT2_ICL_entailment
174,30,13,12,1,0.9230769230769232,17,11,6,0.6470588235294118,0.760806916426513,medlm,mimiciii,nursing_note,PROMPT2_ICL_entailment
175,31,18,11,7,0.6111111111111112,19,16,3,0.8421052631578947,0.7082494969818913,medlm,mimiciii,nursing_note,PROMPT2_ICL_entailment
176,32,38,35,3,0.9210526315789472,44,36,8,0.8181818181818182,0.8665749656121045,medlm,mimiciii,nursing_note,PROMPT2_ICL_entailment
177,33,4,4,0,1.0,5,5,0,1.0,1.0,medlm,mimiciii,nursing_note,PROMPT2_ICL_entailment
178,34,3,3,0,1.0,3,3,0,1.0,1.0,medlm,mimiciii,nursing_note,PROMPT2_ICL_entailment
179,35,9,9,0,1.0,7,7,0,1.0,1.0,medlm,mimiciii,nursing_note,PROMPT2_ICL_entailment
180,36,69,45,24,0.6521739130434783,62,56,6,0.9032258064516128,0.7574391343552751,medlm,mimiciii,nursing_note,PROMPT2_ICL_entailment
181,37,38,22,16,0.5789473684210527,38,27,11,0.7105263157894737,0.6380236305048336,medlm,mimiciii,nursing_note,PROMPT2_ICL_entailment
182,38,28,20,8,0.7142857142857143,26,25,1,0.9615384615384616,0.819672131147541,medlm,mimiciii,nursing_note,PROMPT2_ICL_entailment
183,39,14,11,3,0.7857142857142857,3,2,1,0.6666666666666666,0.721311475409836,medlm,mimiciii,nursing_note,PROMPT2_ICL_entailment
184,4,27,15,12,0.5555555555555556,26,22,4,0.8461538461538461,0.6707317073170732,medlm,mimiciii,nursing_note,PROMPT2_ICL_entailment
185,40,7,5,2,0.7142857142857143,3,2,1,0.6666666666666666,0.689655172413793,medlm,mimiciii,nursing_note,PROMPT2_ICL_entailment
186,41,42,37,5,0.8809523809523809,50,42,8,0.84,0.859988931931378,medlm,mimiciii,nursing_note,PROMPT2_ICL_entailment
187,42,30,23,7,0.7666666666666667,7,5,2,0.7142857142857143,0.7395498392282959,medlm,mimiciii,nursing_note,PROMPT2_ICL_entailment
188,43,29,21,8,0.7241379310344828,14,10,4,0.7142857142857143,0.7191780821917808,medlm,mimiciii,nursing_note,PROMPT2_ICL_entailment
189,44,5,5,0,1.0,3,3,0,1.0,1.0,medlm,mimiciii,nursing_note,PROMPT2_ICL_entailment
190,45,32,31,1,0.96875,34,30,4,0.8823529411764706,0.923535253227408,medlm,mimiciii,nursing_note,PROMPT2_ICL_entailment
191,46,31,29,2,0.935483870967742,33,21,12,0.6363636363636364,0.7574626865671641,medlm,mimiciii,nursing_note,PROMPT2_ICL_entailment
192,47,19,16,3,0.8421052631578947,14,11,3,0.7857142857142857,0.8129330254041571,medlm,mimiciii,nursing_note,PROMPT2_ICL_entailment
193,48,14,11,3,0.7857142857142857,9,9,0,1.0,0.88,medlm,mimiciii,nursing_note,PROMPT2_ICL_entailment
194,49,7,6,1,0.8571428571428571,3,2,1,0.6666666666666666,0.75,medlm,mimiciii,nursing_note,PROMPT2_ICL_entailment
195,5,24,20,4,0.8333333333333334,15,13,2,0.8666666666666667,0.8496732026143791,medlm,mimiciii,nursing_note,PROMPT2_ICL_entailment
196,50,10,8,2,0.8,16,9,7,0.5625,0.6605504587155964,medlm,mimiciii,nursing_note,PROMPT2_ICL_entailment
197,51,6,6,0,1.0,6,6,0,1.0,1.0,medlm,mimiciii,nursing_note,PROMPT2_ICL_entailment
198,52,38,27,11,0.7105263157894737,38,20,18,0.5263157894736842,0.604703247480403,medlm,mimiciii,nursing_note,PROMPT2_ICL_entailment
199,53,7,7,0,1.0,6,4,2,0.6666666666666666,0.8,medlm,mimiciii,nursing_note,PROMPT2_ICL_entailment
200,54,32,24,8,0.75,37,32,5,0.8648648648648649,0.803347280334728,medlm,mimiciii,nursing_note,PROMPT2_ICL_entailment
201,55,44,39,5,0.8863636363636364,35,30,5,0.8571428571428571,0.8715083798882681,medlm,mimiciii,nursing_note,PROMPT2_ICL_entailment
202,56,6,6,0,1.0,2,2,0,1.0,1.0,medlm,mimiciii,nursing_note,PROMPT2_ICL_entailment
203,57,31,29,2,0.935483870967742,18,11,7,0.6111111111111112,0.7392815758980301,medlm,mimiciii,nursing_note,PROMPT2_ICL_entailment
204,58,26,19,7,0.7307692307692307,28,21,7,0.75,0.7402597402597402,medlm,mimiciii,nursing_note,PROMPT2_ICL_entailment
205,59,8,8,0,1.0,9,8,1,0.8888888888888888,0.9411764705882352,medlm,mimiciii,nursing_note,PROMPT2_ICL_entailment
206,6,8,8,0,1.0,8,6,2,0.75,0.8571428571428571,medlm,mimiciii,nursing_note,PROMPT2_ICL_entailment
207,60,30,23,7,0.7666666666666667,27,19,8,0.7037037037037037,0.7338371116708649,medlm,mimiciii,nursing_note,PROMPT2_ICL_entailment
208,61,19,12,7,0.631578947368421,20,13,7,0.65,0.6406570841889117,medlm,mimiciii,nursing_note,PROMPT2_ICL_entailment
209,62,34,26,8,0.7647058823529411,37,27,10,0.7297297297297297,0.7468085106382978,medlm,mimiciii,nursing_note,PROMPT2_ICL_entailment
210,63,4,4,0,1.0,5,4,1,0.8,0.888888888888889,medlm,mimiciii,nursing_note,PROMPT2_ICL_entailment
211,64,37,33,4,0.8918918918918919,27,23,4,0.8518518518518519,0.8714121699196326,medlm,mimiciii,nursing_note,PROMPT2_ICL_entailment
212,65,21,21,0,1.0,19,15,4,0.7894736842105263,0.8823529411764706,medlm,mimiciii,nursing_note,PROMPT2_ICL_entailment
213,66,6,6,0,1.0,1,1,0,1.0,1.0,medlm,mimiciii,nursing_note,PROMPT2_ICL_entailment
214,67,9,8,1,0.8888888888888888,7,4,3,0.5714285714285714,0.6956521739130435,medlm,mimiciii,nursing_note,PROMPT2_ICL_entailment
215,68,32,27,5,0.84375,18,14,4,0.7777777777777778,0.8094218415417559,medlm,mimiciii,nursing_note,PROMPT2_ICL_entailment
216,69,28,18,10,0.6428571428571429,25,19,6,0.76,0.6965376782077393,medlm,mimiciii,nursing_note,PROMPT2_ICL_entailment
217,7,3,3,0,1.0,2,2,0,1.0,1.0,medlm,mimiciii,nursing_note,PROMPT2_ICL_entailment
218,70,39,33,6,0.8461538461538461,45,34,11,0.7555555555555555,0.7982924226254001,medlm,mimiciii,nursing_note,PROMPT2_ICL_entailment
219,71,22,9,13,0.4090909090909091,52,33,19,0.6346153846153846,0.4974874371859297,medlm,mimiciii,nursing_note,PROMPT2_ICL_entailment
220,72,10,8,2,0.8,12,10,2,0.8333333333333334,0.816326530612245,medlm,mimiciii,nursing_note,PROMPT2_ICL_entailment
221,73,30,20,10,0.6666666666666666,38,24,14,0.631578947368421,0.6486486486486486,medlm,mimiciii,nursing_note,PROMPT2_ICL_entailment
222,74,6,6,0,1.0,8,6,2,0.75,0.8571428571428571,medlm,mimiciii,nursing_note,PROMPT2_ICL_entailment
223,75,27,19,8,0.7037037037037037,27,21,6,0.7777777777777778,0.738888888888889,medlm,mimiciii,nursing_note,PROMPT2_ICL_entailment
224,76,2,2,0,1.0,1,1,0,1.0,1.0,medlm,mimiciii,nursing_note,PROMPT2_ICL_entailment
225,77,65,31,34,0.4769230769230769,59,51,8,0.864406779661017,0.6146967340590981,medlm,mimiciii,nursing_note,PROMPT2_ICL_entailment
226,78,12,11,1,0.9166666666666666,20,8,12,0.4,0.5569620253164558,medlm,mimiciii,nursing_note,PROMPT2_ICL_entailment
227,79,32,32,0,1.0,30,30,0,1.0,1.0,medlm,mimiciii,nursing_note,PROMPT2_ICL_entailment
228,8,7,6,1,0.8571428571428571,14,8,6,0.5714285714285714,0.6857142857142857,medlm,mimiciii,nursing_note,PROMPT2_ICL_entailment
229,80,29,22,7,0.7586206896551724,22,21,1,0.9545454545454546,0.8453796889295517,medlm,mimiciii,nursing_note,PROMPT2_ICL_entailment
230,81,29,22,7,0.7586206896551724,22,19,3,0.8636363636363636,0.8077294685990338,medlm,mimiciii,nursing_note,PROMPT2_ICL_entailment
231,82,35,31,4,0.8857142857142857,17,12,5,0.7058823529411765,0.7856388595564942,medlm,mimiciii,nursing_note,PROMPT2_ICL_entailment
232,83,18,13,5,0.7222222222222222,34,23,11,0.6764705882352942,0.6985981308411215,medlm,mimiciii,nursing_note,PROMPT2_ICL_entailment
233,84,8,8,0,1.0,6,6,0,1.0,1.0,medlm,mimiciii,nursing_note,PROMPT2_ICL_entailment
234,85,24,22,2,0.9166666666666666,27,20,7,0.7407407407407407,0.8193668528864059,medlm,mimiciii,nursing_note,PROMPT2_ICL_entailment
235,86,39,31,8,0.7948717948717948,40,30,10,0.75,0.7717842323651453,medlm,mimiciii,nursing_note,PROMPT2_ICL_entailment
236,87,17,16,1,0.9411764705882352,15,11,4,0.7333333333333333,0.8243559718969555,medlm,mimiciii,nursing_note,PROMPT2_ICL_entailment
237,88,32,26,6,0.8125,15,9,6,0.6,0.6902654867256637,medlm,mimiciii,nursing_note,PROMPT2_ICL_entailment
238,89,12,9,3,0.75,29,17,12,0.5862068965517241,0.6580645161290322,medlm,mimiciii,nursing_note,PROMPT2_ICL_entailment
239,9,35,34,1,0.9714285714285714,17,14,3,0.8235294117647058,0.8913857677902621,medlm,mimiciii,nursing_note,PROMPT2_ICL_entailment
240,90,27,23,4,0.8518518518518519,14,13,1,0.9285714285714286,0.8885586924219911,medlm,mimiciii,nursing_note,PROMPT2_ICL_entailment
241,91,22,16,6,0.7272727272727273,25,21,4,0.84,0.7795823665893271,medlm,mimiciii,nursing_note,PROMPT2_ICL_entailment
242,92,28,28,0,1.0,28,28,0,1.0,1.0,medlm,mimiciii,nursing_note,PROMPT2_ICL_entailment
243,93,31,26,5,0.8387096774193549,23,19,4,0.8260869565217391,0.8323504633529908,medlm,mimiciii,nursing_note,PROMPT2_ICL_entailment
244,94,5,5,0,1.0,5,5,0,1.0,1.0,medlm,mimiciii,nursing_note,PROMPT2_ICL_entailment
245,95,30,24,6,0.8,14,10,4,0.7142857142857143,0.7547169811320756,medlm,mimiciii,nursing_note,PROMPT2_ICL_entailment
246,96,10,9,1,0.9,6,6,0,1.0,0.9473684210526316,medlm,mimiciii,nursing_note,PROMPT2_ICL_entailment
247,97,9,9,0,1.0,10,9,1,0.9,0.9473684210526316,medlm,mimiciii,nursing_note,PROMPT2_ICL_entailment
248,98,11,9,2,0.8181818181818182,13,11,2,0.8461538461538461,0.8319327731092436,medlm,mimiciii,nursing_note,PROMPT2_ICL_entailment
249,99,41,36,5,0.8780487804878049,44,34,10,0.7727272727272727,0.822028206850235,medlm,mimiciii,nursing_note,PROMPT2_ICL_entailment
0,0,8,5,3,0.625,11,9,2,0.8181818181818182,0.7086614173228345,medlm,mimiciii,nursing_note,PROMPT2_entailment
1,1,29,10,19,0.3448275862068966,31,21,10,0.6774193548387096,0.457018498367791,medlm,mimiciii,nursing_note,PROMPT2_entailment
2,10,19,16,3,0.8421052631578947,18,14,4,0.7777777777777778,0.8086642599277979,medlm,mimiciii,nursing_note,PROMPT2_entailment
3,100,9,9,0,1.0,6,6,0,1.0,1.0,medlm,mimiciii,nursing_note,PROMPT2_entailment
4,101,19,18,1,0.9473684210526316,27,23,4,0.8518518518518519,0.8970747562296857,medlm,mimiciii,nursing_note,PROMPT2_entailment
5,102,10,9,1,0.9,26,11,15,0.4230769230769231,0.5755813953488372,medlm,mimiciii,nursing_note,PROMPT2_entailment
6,103,20,15,5,0.75,22,21,1,0.9545454545454546,0.84,medlm,mimiciii,nursing_note,PROMPT2_entailment
7,104,23,19,4,0.8260869565217391,20,16,4,0.8,0.8128342245989306,medlm,mimiciii,nursing_note,PROMPT2_entailment
8,105,17,10,7,0.5882352941176471,20,10,10,0.5,0.5405405405405405,medlm,mimiciii,nursing_note,PROMPT2_entailment
9,106,6,6,0,1.0,4,4,0,1.0,1.0,medlm,mimiciii,nursing_note,PROMPT2_entailment
10,107,42,27,15,0.6428571428571429,63,28,35,0.4444444444444444,0.5255474452554744,medlm,mimiciii,nursing_note,PROMPT2_entailment
11,108,38,36,2,0.9473684210526316,28,23,5,0.8214285714285714,0.8799149840595111,medlm,mimiciii,nursing_note,PROMPT2_entailment
12,109,4,4,0,1.0,4,4,0,1.0,1.0,medlm,mimiciii,nursing_note,PROMPT2_entailment
13,11,1,1,0,1.0,2,1,1,0.5,0.6666666666666666,medlm,mimiciii,nursing_note,PROMPT2_entailment
14,110,11,11,0,1.0,13,10,3,0.7692307692307693,0.8695652173913044,medlm,mimiciii,nursing_note,PROMPT2_entailment
15,111,14,8,6,0.5714285714285714,34,27,7,0.7941176470588235,0.6646153846153845,medlm,mimiciii,nursing_note,PROMPT2_entailment
16,112,44,36,8,0.8181818181818182,37,24,13,0.6486486486486487,0.7236180904522613,medlm,mimiciii,nursing_note,PROMPT2_entailment
17,113,4,4,0,1.0,5,5,0,1.0,1.0,medlm,mimiciii,nursing_note,PROMPT2_entailment
18,114,18,13,5,0.7222222222222222,19,13,6,0.6842105263157895,0.7027027027027027,medlm,mimiciii,nursing_note,PROMPT2_entailment
19,115,9,9,0,1.0,7,6,1,0.8571428571428571,0.923076923076923,medlm,mimiciii,nursing_note,PROMPT2_entailment
20,116,20,19,1,0.95,31,15,16,0.4838709677419355,0.641169853768279,medlm,mimiciii,nursing_note,PROMPT2_entailment
21,117,21,16,5,0.7619047619047619,18,15,3,0.8333333333333334,0.7960199004975124,medlm,mimiciii,nursing_note,PROMPT2_entailment
22,118,23,17,6,0.7391304347826086,25,22,3,0.88,0.8034371643394198,medlm,mimiciii,nursing_note,PROMPT2_entailment
23,119,24,20,4,0.8333333333333334,26,19,7,0.7307692307692307,0.7786885245901639,medlm,mimiciii,nursing_note,PROMPT2_entailment
24,12,16,16,0,1.0,18,15,3,0.8333333333333334,0.9090909090909092,medlm,mimiciii,nursing_note,PROMPT2_entailment
25,120,16,9,7,0.5625,18,16,2,0.8888888888888888,0.6889952153110048,medlm,mimiciii,nursing_note,PROMPT2_entailment
26,121,32,28,4,0.875,37,32,5,0.8648648648648649,0.8699029126213592,medlm,mimiciii,nursing_note,PROMPT2_entailment
27,122,16,12,4,0.75,11,9,2,0.8181818181818182,0.7826086956521738,medlm,mimiciii,nursing_note,PROMPT2_entailment
28,123,5,5,0,1.0,6,6,0,1.0,1.0,medlm,mimiciii,nursing_note,PROMPT2_entailment
29,124,7,6,1,0.8571428571428571,5,4,1,0.8,0.8275862068965518,medlm,mimiciii,nursing_note,PROMPT2_entailment
30,125,42,41,1,0.9761904761904762,43,28,15,0.6511627906976745,0.7812181013950323,medlm,mimiciii,nursing_note,PROMPT2_entailment
31,126,26,18,8,0.6923076923076923,28,22,6,0.7857142857142857,0.7360594795539033,medlm,mimiciii,nursing_note,PROMPT2_entailment
32,127,14,10,4,0.7142857142857143,10,10,0,1.0,0.8333333333333333,medlm,mimiciii,nursing_note,PROMPT2_entailment
33,128,21,18,3,0.8571428571428571,17,13,4,0.7647058823529411,0.8082901554404144,medlm,mimiciii,nursing_note,PROMPT2_entailment
34,129,21,17,4,0.8095238095238095,29,17,12,0.5862068965517241,0.68,medlm,mimiciii,nursing_note,PROMPT2_entailment
35,13,12,10,2,0.8333333333333334,34,20,14,0.5882352941176471,0.6896551724137931,medlm,mimiciii,nursing_note,PROMPT2_entailment
36,130,34,29,5,0.8529411764705882,33,29,4,0.8787878787878788,0.8656716417910447,medlm,mimiciii,nursing_note,PROMPT2_entailment
37,131,32,27,5,0.84375,31,28,3,0.9032258064516128,0.8724754760530871,medlm,mimiciii,nursing_note,PROMPT2_entailment
38,132,22,14,8,0.6363636363636364,17,13,4,0.7647058823529411,0.6946564885496184,medlm,mimiciii,nursing_note,PROMPT2_entailment
39,133,9,8,1,0.8888888888888888,10,7,3,0.7,0.7832167832167831,medlm,mimiciii,nursing_note,PROMPT2_entailment
40,134,26,12,14,0.4615384615384615,30,23,7,0.7666666666666667,0.5762004175365344,medlm,mimiciii,nursing_note,PROMPT2_entailment
41,135,39,30,9,0.7692307692307693,47,26,21,0.5531914893617021,0.6435643564356436,medlm,mimiciii,nursing_note,PROMPT2_entailment
42,136,34,31,3,0.9117647058823528,41,33,8,0.8048780487804879,0.8549937317175094,medlm,mimiciii,nursing_note,PROMPT2_entailment
43,137,2,2,0,1.0,2,1,1,0.5,0.6666666666666666,medlm,mimiciii,nursing_note,PROMPT2_entailment
44,138,4,4,0,1.0,5,4,1,0.8,0.888888888888889,medlm,mimiciii,nursing_note,PROMPT2_entailment
45,139,6,6,0,1.0,4,3,1,0.75,0.8571428571428571,medlm,mimiciii,nursing_note,PROMPT2_entailment
46,14,18,16,2,0.8888888888888888,26,21,5,0.8076923076923077,0.8463476070528968,medlm,mimiciii,nursing_note,PROMPT2_entailment
47,140,22,13,9,0.5909090909090909,24,21,3,0.875,0.7054263565891474,medlm,mimiciii,nursing_note,PROMPT2_entailment
48,141,14,13,1,0.9285714285714286,11,11,0,1.0,0.962962962962963,medlm,mimiciii,nursing_note,PROMPT2_entailment
49,142,29,23,6,0.7931034482758621,8,6,2,0.75,0.770949720670391,medlm,mimiciii,nursing_note,PROMPT2_entailment
50,143,19,16,3,0.8421052631578947,2,1,1,0.5,0.6274509803921569,medlm,mimiciii,nursing_note,PROMPT2_entailment
51,144,7,6,1,0.8571428571428571,5,5,0,1.0,0.923076923076923,medlm,mimiciii,nursing_note,PROMPT2_entailment
52,145,17,11,6,0.6470588235294118,19,19,0,1.0,0.7857142857142858,medlm,mimiciii,nursing_note,PROMPT2_entailment
53,146,8,7,1,0.875,6,6,0,1.0,0.9333333333333332,medlm,mimiciii,nursing_note,PROMPT2_entailment
54,147,8,4,4,0.5,26,23,3,0.8846153846153846,0.6388888888888888,medlm,mimiciii,nursing_note,PROMPT2_entailment
55,148,6,6,0,1.0,7,6,1,0.8571428571428571,0.923076923076923,medlm,mimiciii,nursing_note,PROMPT2_entailment
56,149,36,27,9,0.75,36,27,9,0.75,0.75,medlm,mimiciii,nursing_note,PROMPT2_entailment
57,15,19,15,4,0.7894736842105263,33,20,13,0.6060606060606061,0.6857142857142856,medlm,mimiciii,nursing_note,PROMPT2_entailment
58,150,8,8,0,1.0,8,7,1,0.875,0.9333333333333332,medlm,mimiciii,nursing_note,PROMPT2_entailment
59,151,28,23,5,0.8214285714285714,26,25,1,0.9615384615384616,0.8859784283513097,medlm,mimiciii,nursing_note,PROMPT2_entailment
60,152,40,38,2,0.95,44,34,10,0.7727272727272727,0.8522427440633245,medlm,mimiciii,nursing_note,PROMPT2_entailment
61,153,4,4,0,1.0,4,4,0,1.0,1.0,medlm,mimiciii,nursing_note,PROMPT2_entailment
62,154,26,23,3,0.8846153846153846,34,27,7,0.7941176470588235,0.8369272237196765,medlm,mimiciii,nursing_note,PROMPT2_entailment
63,155,10,5,5,0.5,51,45,6,0.8823529411764706,0.6382978723404256,medlm,mimiciii,nursing_note,PROMPT2_entailment
64,156,25,24,1,0.96,26,20,6,0.7692307692307693,0.8540925266903916,medlm,mimiciii,nursing_note,PROMPT2_entailment
65,157,3,3,0,1.0,5,4,1,0.8,0.888888888888889,medlm,mimiciii,nursing_note,PROMPT2_entailment
66,158,26,25,1,0.9615384615384616,22,21,1,0.9545454545454546,0.958029197080292,medlm,mimiciii,nursing_note,PROMPT2_entailment
67,159,7,5,2,0.7142857142857143,8,6,2,0.75,0.7317073170731706,medlm,mimiciii,nursing_note,PROMPT2_entailment
68,16,27,24,3,0.8888888888888888,30,24,6,0.8,0.8421052631578948,medlm,mimiciii,nursing_note,PROMPT2_entailment
69,160,19,16,3,0.8421052631578947,21,17,4,0.8095238095238095,0.8254931714719271,medlm,mimiciii,nursing_note,PROMPT2_entailment
70,161,5,5,0,1.0,6,5,1,0.8333333333333334,0.9090909090909092,medlm,mimiciii,nursing_note,PROMPT2_entailment
71,162,31,25,6,0.8064516129032258,31,26,5,0.8387096774193549,0.8222643896268186,medlm,mimiciii,nursing_note,PROMPT2_entailment
72,163,7,7,0,1.0,4,4,0,1.0,1.0,medlm,mimiciii,nursing_note,PROMPT2_entailment
73,164,17,15,2,0.8823529411764706,13,12,1,0.9230769230769232,0.9022556390977444,medlm,mimiciii,nursing_note,PROMPT2_entailment
74,165,33,29,4,0.8787878787878788,24,20,4,0.8333333333333334,0.8554572271386431,medlm,mimiciii,nursing_note,PROMPT2_entailment
75,166,8,7,1,0.875,3,3,0,1.0,0.9333333333333332,medlm,mimiciii,nursing_note,PROMPT2_entailment
76,167,20,17,3,0.85,16,16,0,1.0,0.9189189189189187,medlm,mimiciii,nursing_note,PROMPT2_entailment
77,168,26,17,9,0.6538461538461539,25,19,6,0.76,0.7029379760609357,medlm,mimiciii,nursing_note,PROMPT2_entailment
78,169,15,11,4,0.7333333333333333,12,11,1,0.9166666666666666,0.8148148148148148,medlm,mimiciii,nursing_note,PROMPT2_entailment
79,17,24,17,7,0.7083333333333334,39,28,11,0.717948717948718,0.7131086142322098,medlm,mimiciii,nursing_note,PROMPT2_entailment
80,170,27,23,4,0.8518518518518519,21,20,1,0.9523809523809524,0.8993157380254154,medlm,mimiciii,nursing_note,PROMPT2_entailment
81,171,8,6,2,0.75,8,6,2,0.75,0.75,medlm,mimiciii,nursing_note,PROMPT2_entailment
82,172,36,34,2,0.9444444444444444,38,32,6,0.8421052631578947,0.8903436988543372,medlm,mimiciii,nursing_note,PROMPT2_entailment
83,173,13,7,6,0.5384615384615384,20,12,8,0.6,0.5675675675675675,medlm,mimiciii,nursing_note,PROMPT2_entailment
84,174,4,4,0,1.0,8,7,1,0.875,0.9333333333333332,medlm,mimiciii,nursing_note,PROMPT2_entailment
85,175,3,3,0,1.0,4,4,0,1.0,1.0,medlm,mimiciii,nursing_note,PROMPT2_entailment
86,176,15,12,3,0.8,13,9,4,0.6923076923076923,0.7422680412371134,medlm,mimiciii,nursing_note,PROMPT2_entailment
87,177,41,31,10,0.7560975609756098,38,30,8,0.7894736842105263,0.7724252491694352,medlm,mimiciii,nursing_note,PROMPT2_entailment
88,178,23,23,0,1.0,25,21,4,0.84,0.9130434782608696,medlm,mimiciii,nursing_note,PROMPT2_entailment
89,179,17,15,2,0.8823529411764706,22,14,8,0.6363636363636364,0.73943661971831,medlm,mimiciii,nursing_note,PROMPT2_entailment
90,18,19,15,4,0.7894736842105263,25,20,5,0.8,0.794701986754967,medlm,mimiciii,nursing_note,PROMPT2_entailment
91,180,14,12,2,0.8571428571428571,27,16,11,0.5925925925925926,0.7007299270072992,medlm,mimiciii,nursing_note,PROMPT2_entailment
92,181,15,10,5,0.6666666666666666,25,12,13,0.48,0.5581395348837209,medlm,mimiciii,nursing_note,PROMPT2_entailment
93,182,15,12,3,0.8,10,9,1,0.9,0.8470588235294118,medlm,mimiciii,nursing_note,PROMPT2_entailment
94,183,7,7,0,1.0,5,4,1,0.8,0.888888888888889,medlm,mimiciii,nursing_note,PROMPT2_entailment
95,184,7,7,0,1.0,1,1,0,1.0,1.0,medlm,mimiciii,nursing_note,PROMPT2_entailment
96,185,24,21,3,0.875,30,25,5,0.8333333333333334,0.8536585365853658,medlm,mimiciii,nursing_note,PROMPT2_entailment
97,186,5,5,0,1.0,4,3,1,0.75,0.8571428571428571,medlm,mimiciii,nursing_note,PROMPT2_entailment
98,187,18,15,3,0.8333333333333334,37,23,14,0.6216216216216216,0.7120743034055728,medlm,mimiciii,nursing_note,PROMPT2_entailment
99,188,2,2,0,1.0,2,1,1,0.5,0.6666666666666666,medlm,mimiciii,nursing_note,PROMPT2_entailment
100,189,17,14,3,0.8235294117647058,21,16,5,0.7619047619047619,0.7915194346289751,medlm,mimiciii,nursing_note,PROMPT2_entailment
101,19,30,25,5,0.8333333333333334,45,32,13,0.7111111111111111,0.7673860911270984,medlm,mimiciii,nursing_note,PROMPT2_entailment
102,190,19,18,1,0.9473684210526316,24,16,8,0.6666666666666666,0.782608695652174,medlm,mimiciii,nursing_note,PROMPT2_entailment
103,191,28,24,4,0.8571428571428571,29,23,6,0.7931034482758621,0.8238805970149252,medlm,mimiciii,nursing_note,PROMPT2_entailment
104,192,3,3,0,1.0,15,6,9,0.4,0.5714285714285715,medlm,mimiciii,nursing_note,PROMPT2_entailment
105,193,8,8,0,1.0,40,26,14,0.65,0.787878787878788,medlm,mimiciii,nursing_note,PROMPT2_entailment
106,195,6,6,0,1.0,7,7,0,1.0,1.0,medlm,mimiciii,nursing_note,PROMPT2_entailment
107,196,37,33,4,0.8918918918918919,34,31,3,0.9117647058823528,0.9017188188629351,medlm,mimiciii,nursing_note,PROMPT2_entailment
108,197,32,26,6,0.8125,27,25,2,0.925925925925926,0.8655126498002662,medlm,mimiciii,nursing_note,PROMPT2_entailment
109,198,28,24,4,0.8571428571428571,38,28,10,0.7368421052631579,0.7924528301886793,medlm,mimiciii,nursing_note,PROMPT2_entailment
110,199,13,13,0,1.0,14,13,1,0.9285714285714286,0.962962962962963,medlm,mimiciii,nursing_note,PROMPT2_entailment
111,2,45,19,26,0.4222222222222222,43,23,20,0.5348837209302325,0.4719222462203024,medlm,mimiciii,nursing_note,PROMPT2_entailment
112,20,46,29,17,0.6304347826086957,46,34,12,0.7391304347826086,0.6804692891649414,medlm,mimiciii,nursing_note,PROMPT2_entailment
113,200,34,22,12,0.6470588235294118,44,27,17,0.6136363636363636,0.6299045599151644,medlm,mimiciii,nursing_note,PROMPT2_entailment
114,202,9,8,1,0.8888888888888888,9,8,1,0.8888888888888888,0.8888888888888888,medlm,mimiciii,nursing_note,PROMPT2_entailment
115,203,6,6,0,1.0,7,6,1,0.8571428571428571,0.923076923076923,medlm,mimiciii,nursing_note,PROMPT2_entailment
116,204,15,11,4,0.7333333333333333,24,11,13,0.4583333333333333,0.5641025641025641,medlm,mimiciii,nursing_note,PROMPT2_entailment
117,205,36,34,2,0.9444444444444444,69,36,33,0.5217391304347826,0.6721581548599671,medlm,mimiciii,nursing_note,PROMPT2_entailment
118,206,3,3,0,1.0,6,5,1,0.8333333333333334,0.9090909090909092,medlm,mimiciii,nursing_note,PROMPT2_entailment
119,207,22,22,0,1.0,29,22,7,0.7586206896551724,0.8627450980392156,medlm,mimiciii,nursing_note,PROMPT2_entailment
120,208,8,8,0,1.0,7,7,0,1.0,1.0,medlm,mimiciii,nursing_note,PROMPT2_entailment
121,209,3,3,0,1.0,2,2,0,1.0,1.0,medlm,mimiciii,nursing_note,PROMPT2_entailment
122,21,5,5,0,1.0,6,4,2,0.6666666666666666,0.8,medlm,mimiciii,nursing_note,PROMPT2_entailment
123,210,23,14,9,0.6086956521739131,22,18,4,0.8181818181818182,0.6980609418282548,medlm,mimiciii,nursing_note,PROMPT2_entailment
124,211,2,2,0,1.0,4,4,0,1.0,1.0,medlm,mimiciii,nursing_note,PROMPT2_entailment
125,212,29,22,7,0.7586206896551724,37,30,7,0.8108108108108109,0.7838479809976248,medlm,mimiciii,nursing_note,PROMPT2_entailment
126,213,18,15,3,0.8333333333333334,18,16,2,0.8888888888888888,0.8602150537634408,medlm,mimiciii,nursing_note,PROMPT2_entailment
127,214,4,4,0,1.0,3,2,1,0.6666666666666666,0.8,medlm,mimiciii,nursing_note,PROMPT2_entailment
128,215,7,7,0,1.0,7,6,1,0.8571428571428571,0.923076923076923,medlm,mimiciii,nursing_note,PROMPT2_entailment
129,216,10,7,3,0.7,13,8,5,0.6153846153846154,0.6549707602339182,medlm,mimiciii,nursing_note,PROMPT2_entailment
130,217,28,24,4,0.8571428571428571,25,20,5,0.8,0.8275862068965518,medlm,mimiciii,nursing_note,PROMPT2_entailment
131,218,21,16,5,0.7619047619047619,18,10,8,0.5555555555555556,0.642570281124498,medlm,mimiciii,nursing_note,PROMPT2_entailment
132,219,19,12,7,0.631578947368421,14,10,4,0.7142857142857143,0.670391061452514,medlm,mimiciii,nursing_note,PROMPT2_entailment
133,22,27,23,4,0.8518518518518519,26,19,7,0.7307692307692307,0.7866786678667868,medlm,mimiciii,nursing_note,PROMPT2_entailment
134,220,6,5,1,0.8333333333333334,5,4,1,0.8,0.816326530612245,medlm,mimiciii,nursing_note,PROMPT2_entailment
135,221,28,20,8,0.7142857142857143,45,26,19,0.5777777777777777,0.6388206388206389,medlm,mimiciii,nursing_note,PROMPT2_entailment
136,222,3,3,0,1.0,3,3,0,1.0,1.0,medlm,mimiciii,nursing_note,PROMPT2_entailment
137,223,15,5,10,0.3333333333333333,30,22,8,0.7333333333333333,0.4583333333333332,medlm,mimiciii,nursing_note,PROMPT2_entailment
138,224,9,8,1,0.8888888888888888,6,5,1,0.8333333333333334,0.8602150537634408,medlm,mimiciii,nursing_note,PROMPT2_entailment
139,225,29,15,14,0.5172413793103449,45,29,16,0.6444444444444445,0.5738786279683378,medlm,mimiciii,nursing_note,PROMPT2_entailment
140,226,12,11,1,0.9166666666666666,20,15,5,0.75,0.8250000000000001,medlm,mimiciii,nursing_note,PROMPT2_entailment
141,227,14,12,2,0.8571428571428571,15,13,2,0.8666666666666667,0.861878453038674,medlm,mimiciii,nursing_note,PROMPT2_entailment
142,228,25,12,13,0.48,38,32,6,0.8421052631578947,0.6114649681528662,medlm,mimiciii,nursing_note,PROMPT2_entailment
143,229,20,18,2,0.9,22,19,3,0.8636363636363636,0.8814432989690723,medlm,mimiciii,nursing_note,PROMPT2_entailment
144,23,16,12,4,0.75,44,15,29,0.3409090909090909,0.46875,medlm,mimiciii,nursing_note,PROMPT2_entailment
145,230,10,9,1,0.9,7,6,1,0.8571428571428571,0.8780487804878048,medlm,mimiciii,nursing_note,PROMPT2_entailment
146,231,10,9,1,0.9,15,12,3,0.8,0.8470588235294118,medlm,mimiciii,nursing_note,PROMPT2_entailment
147,232,8,6,2,0.75,2,2,0,1.0,0.8571428571428571,medlm,mimiciii,nursing_note,PROMPT2_entailment
148,233,26,13,13,0.5,44,25,19,0.5681818181818182,0.5319148936170213,medlm,mimiciii,nursing_note,PROMPT2_entailment
149,234,12,12,0,1.0,32,28,4,0.875,0.9333333333333332,medlm,mimiciii,nursing_note,PROMPT2_entailment
150,235,12,12,0,1.0,10,9,1,0.9,0.9473684210526316,medlm,mimiciii,nursing_note,PROMPT2_entailment
151,236,8,8,0,1.0,7,6,1,0.8571428571428571,0.923076923076923,medlm,mimiciii,nursing_note,PROMPT2_entailment
152,237,34,29,5,0.8529411764705882,35,23,12,0.6571428571428571,0.7423483583750696,medlm,mimiciii,nursing_note,PROMPT2_entailment
153,238,42,27,15,0.6428571428571429,42,25,17,0.5952380952380952,0.6181318681318682,medlm,mimiciii,nursing_note,PROMPT2_entailment
154,239,22,16,6,0.7272727272727273,21,19,2,0.9047619047619048,0.806366047745358,medlm,mimiciii,nursing_note,PROMPT2_entailment
155,24,8,8,0,1.0,5,5,0,1.0,1.0,medlm,mimiciii,nursing_note,PROMPT2_entailment
156,240,20,16,4,0.8,42,24,18,0.5714285714285714,0.6666666666666666,medlm,mimiciii,nursing_note,PROMPT2_entailment
157,241,19,13,6,0.6842105263157895,21,16,5,0.7619047619047619,0.7209705372616985,medlm,mimiciii,nursing_note,PROMPT2_entailment
158,242,21,15,6,0.7142857142857143,16,12,4,0.75,0.7317073170731706,medlm,mimiciii,nursing_note,PROMPT2_entailment
159,243,6,6,0,1.0,5,4,1,0.8,0.888888888888889,medlm,mimiciii,nursing_note,PROMPT2_entailment
160,244,17,15,2,0.8823529411764706,16,11,5,0.6875,0.7728337236533958,medlm,mimiciii,nursing_note,PROMPT2_entailment
161,245,30,24,6,0.8,37,25,12,0.6756756756756757,0.7326007326007327,medlm,mimiciii,nursing_note,PROMPT2_entailment
162,246,27,24,3,0.8888888888888888,10,7,3,0.7,0.7832167832167831,medlm,mimiciii,nursing_note,PROMPT2_entailment
163,247,8,8,0,1.0,6,5,1,0.8333333333333334,0.9090909090909092,medlm,mimiciii,nursing_note,PROMPT2_entailment
164,248,48,39,9,0.8125,42,37,5,0.8809523809523809,0.8453427065026362,medlm,mimiciii,nursing_note,PROMPT2_entailment
165,249,40,35,5,0.875,39,33,6,0.8461538461538461,0.8603351955307262,medlm,mimiciii,nursing_note,PROMPT2_entailment
166,25,28,25,3,0.8928571428571429,23,16,7,0.6956521739130435,0.7820136852394918,medlm,mimiciii,nursing_note,PROMPT2_entailment
167,26,13,10,3,0.7692307692307693,35,35,0,1.0,0.8695652173913044,medlm,mimiciii,nursing_note,PROMPT2_entailment
168,27,3,3,0,1.0,3,2,1,0.6666666666666666,0.8,medlm,mimiciii,nursing_note,PROMPT2_entailment
169,28,33,29,4,0.8787878787878788,16,13,3,0.8125,0.8443449048152295,medlm,mimiciii,nursing_note,PROMPT2_entailment
170,29,27,24,3,0.8888888888888888,33,27,6,0.8181818181818182,0.8520710059171598,medlm,mimiciii,nursing_note,PROMPT2_entailment
171,3,9,8,1,0.8888888888888888,6,5,1,0.8333333333333334,0.8602150537634408,medlm,mimiciii,nursing_note,PROMPT2_entailment
172,30,11,11,0,1.0,17,10,7,0.5882352941176471,0.7407407407407407,medlm,mimiciii,nursing_note,PROMPT2_entailment
173,31,18,11,7,0.6111111111111112,19,15,4,0.7894736842105263,0.6889352818371608,medlm,mimiciii,nursing_note,PROMPT2_entailment
174,32,36,34,2,0.9444444444444444,44,36,8,0.8181818181818182,0.8767908309455588,medlm,mimiciii,nursing_note,PROMPT2_entailment
175,33,8,8,0,1.0,5,5,0,1.0,1.0,medlm,mimiciii,nursing_note,PROMPT2_entailment
176,34,3,3,0,1.0,3,3,0,1.0,1.0,medlm,mimiciii,nursing_note,PROMPT2_entailment
177,35,5,5,0,1.0,7,6,1,0.8571428571428571,0.923076923076923,medlm,mimiciii,nursing_note,PROMPT2_entailment
178,36,67,45,22,0.6716417910447762,62,58,4,0.935483870967742,0.7819053325344518,medlm,mimiciii,nursing_note,PROMPT2_entailment
179,37,34,21,13,0.6176470588235294,38,19,19,0.5,0.5526315789473685,medlm,mimiciii,nursing_note,PROMPT2_entailment
180,38,13,6,7,0.4615384615384615,26,17,9,0.6538461538461539,0.5411140583554377,medlm,mimiciii,nursing_note,PROMPT2_entailment
181,39,10,8,2,0.8,3,0,3,0.0,0.0,medlm,mimiciii,nursing_note,PROMPT2_entailment
182,4,23,16,7,0.6956521739130435,26,16,10,0.6153846153846154,0.6530612244897959,medlm,mimiciii,nursing_note,PROMPT2_entailment
183,40,7,7,0,1.0,3,3,0,1.0,1.0,medlm,mimiciii,nursing_note,PROMPT2_entailment
184,41,39,35,4,0.8974358974358975,50,42,8,0.84,0.8677685950413223,medlm,mimiciii,nursing_note,PROMPT2_entailment
185,42,23,18,5,0.782608695652174,7,6,1,0.8571428571428571,0.8181818181818182,medlm,mimiciii,nursing_note,PROMPT2_entailment
186,43,22,20,2,0.9090909090909092,14,13,1,0.9285714285714286,0.9187279151943464,medlm,mimiciii,nursing_note,PROMPT2_entailment
187,44,6,5,1,0.8333333333333334,3,3,0,1.0,0.9090909090909092,medlm,mimiciii,nursing_note,PROMPT2_entailment
188,45,24,24,0,1.0,34,29,5,0.8529411764705882,0.9206349206349206,medlm,mimiciii,nursing_note,PROMPT2_entailment
189,46,29,26,3,0.896551724137931,33,25,8,0.7575757575757576,0.82122552116235,medlm,mimiciii,nursing_note,PROMPT2_entailment
190,47,20,18,2,0.9,14,10,4,0.7142857142857143,0.7964601769911505,medlm,mimiciii,nursing_note,PROMPT2_entailment
191,48,11,11,0,1.0,9,8,1,0.8888888888888888,0.9411764705882352,medlm,mimiciii,nursing_note,PROMPT2_entailment
192,49,6,6,0,1.0,3,2,1,0.6666666666666666,0.8,medlm,mimiciii,nursing_note,PROMPT2_entailment
193,5,20,14,6,0.7,15,13,2,0.8666666666666667,0.774468085106383,medlm,mimiciii,nursing_note,PROMPT2_entailment
194,50,14,12,2,0.8571428571428571,16,7,9,0.4375,0.5793103448275861,medlm,mimiciii,nursing_note,PROMPT2_entailment
195,51,4,4,0,1.0,6,5,1,0.8333333333333334,0.9090909090909092,medlm,mimiciii,nursing_note,PROMPT2_entailment
196,52,34,28,6,0.8235294117647058,38,26,12,0.6842105263157895,0.7474332648870635,medlm,mimiciii,nursing_note,PROMPT2_entailment
197,53,7,7,0,1.0,6,5,1,0.8333333333333334,0.9090909090909092,medlm,mimiciii,nursing_note,PROMPT2_entailment
198,54,8,7,1,0.875,37,31,6,0.8378378378378378,0.8560157790927022,medlm,mimiciii,nursing_note,PROMPT2_entailment
199,55,35,31,4,0.8857142857142857,35,23,12,0.6571428571428571,0.7544973544973546,medlm,mimiciii,nursing_note,PROMPT2_entailment
200,56,6,6,0,1.0,2,2,0,1.0,1.0,medlm,mimiciii,nursing_note,PROMPT2_entailment
201,57,31,28,3,0.9032258064516128,18,12,6,0.6666666666666666,0.7671232876712328,medlm,mimiciii,nursing_note,PROMPT2_entailment
202,58,29,27,2,0.9310344827586208,28,19,9,0.6785714285714286,0.7850038255547054,medlm,mimiciii,nursing_note,PROMPT2_entailment
203,59,8,8,0,1.0,9,8,1,0.8888888888888888,0.9411764705882352,medlm,mimiciii,nursing_note,PROMPT2_entailment
204,6,8,7,1,0.875,8,8,0,1.0,0.9333333333333332,medlm,mimiciii,nursing_note,PROMPT2_entailment
205,60,24,15,9,0.625,27,21,6,0.7777777777777778,0.6930693069306931,medlm,mimiciii,nursing_note,PROMPT2_entailment
206,61,13,9,4,0.6923076923076923,20,11,9,0.55,0.6130030959752323,medlm,mimiciii,nursing_note,PROMPT2_entailment
207,62,26,21,5,0.8076923076923077,37,28,9,0.7567567567567568,0.7813953488372093,medlm,mimiciii,nursing_note,PROMPT2_entailment
208,63,6,6,0,1.0,5,5,0,1.0,1.0,medlm,mimiciii,nursing_note,PROMPT2_entailment
209,64,26,24,2,0.9230769230769232,27,20,7,0.7407407407407407,0.8219178082191781,medlm,mimiciii,nursing_note,PROMPT2_entailment
210,65,17,17,0,1.0,19,17,2,0.8947368421052632,0.9444444444444444,medlm,mimiciii,nursing_note,PROMPT2_entailment
211,66,6,6,0,1.0,1,1,0,1.0,1.0,medlm,mimiciii,nursing_note,PROMPT2_entailment
212,67,10,9,1,0.9,7,6,1,0.8571428571428571,0.8780487804878048,medlm,mimiciii,nursing_note,PROMPT2_entailment
213,68,19,16,3,0.8421052631578947,18,13,5,0.7222222222222222,0.7775700934579438,medlm,mimiciii,nursing_note,PROMPT2_entailment
214,69,26,17,9,0.6538461538461539,25,21,4,0.84,0.7353244078269825,medlm,mimiciii,nursing_note,PROMPT2_entailment
215,7,3,3,0,1.0,2,2,0,1.0,1.0,medlm,mimiciii,nursing_note,PROMPT2_entailment
216,70,47,41,6,0.8723404255319149,45,30,15,0.6666666666666666,0.7557603686635944,medlm,mimiciii,nursing_note,PROMPT2_entailment
217,71,15,5,10,0.3333333333333333,52,25,27,0.4807692307692308,0.3937007874015747,medlm,mimiciii,nursing_note,PROMPT2_entailment
218,72,11,11,0,1.0,12,10,2,0.8333333333333334,0.9090909090909092,medlm,mimiciii,nursing_note,PROMPT2_entailment
219,73,29,23,6,0.7931034482758621,38,25,13,0.6578947368421053,0.7191994996873046,medlm,mimiciii,nursing_note,PROMPT2_entailment
220,74,6,6,0,1.0,8,5,3,0.625,0.7692307692307693,medlm,mimiciii,nursing_note,PROMPT2_entailment
221,75,15,12,3,0.8,27,15,12,0.5555555555555556,0.6557377049180328,medlm,mimiciii,nursing_note,PROMPT2_entailment
222,76,2,2,0,1.0,1,1,0,1.0,1.0,medlm,mimiciii,nursing_note,PROMPT2_entailment
223,77,10,5,5,0.5,59,17,42,0.288135593220339,0.3655913978494624,medlm,mimiciii,nursing_note,PROMPT2_entailment
224,78,19,12,7,0.631578947368421,20,13,7,0.65,0.6406570841889117,medlm,mimiciii,nursing_note,PROMPT2_entailment
225,79,28,27,1,0.9642857142857144,30,30,0,1.0,0.9818181818181818,medlm,mimiciii,nursing_note,PROMPT2_entailment
226,8,7,6,1,0.8571428571428571,14,9,5,0.6428571428571429,0.7346938775510204,medlm,mimiciii,nursing_note,PROMPT2_entailment
227,80,25,21,4,0.84,22,20,2,0.9090909090909092,0.8731808731808731,medlm,mimiciii,nursing_note,PROMPT2_entailment
228,81,23,16,7,0.6956521739130435,22,20,2,0.9090909090909092,0.7881773399014779,medlm,mimiciii,nursing_note,PROMPT2_entailment
229,82,16,14,2,0.875,17,13,4,0.7647058823529411,0.8161434977578476,medlm,mimiciii,nursing_note,PROMPT2_entailment
230,83,18,12,6,0.6666666666666666,34,22,12,0.6470588235294118,0.6567164179104478,medlm,mimiciii,nursing_note,PROMPT2_entailment
231,84,6,6,0,1.0,6,5,1,0.8333333333333334,0.9090909090909092,medlm,mimiciii,nursing_note,PROMPT2_entailment
232,85,19,17,2,0.8947368421052632,27,17,10,0.6296296296296297,0.7391304347826088,medlm,mimiciii,nursing_note,PROMPT2_entailment
233,86,38,28,10,0.7368421052631579,40,21,19,0.525,0.6131386861313869,medlm,mimiciii,nursing_note,PROMPT2_entailment
234,87,14,14,0,1.0,15,10,5,0.6666666666666666,0.8,medlm,mimiciii,nursing_note,PROMPT2_entailment
235,88,13,6,7,0.4615384615384615,15,13,2,0.8666666666666667,0.6023166023166022,medlm,mimiciii,nursing_note,PROMPT2_entailment
236,89,28,22,6,0.7857142857142857,29,24,5,0.8275862068965517,0.8061068702290076,medlm,mimiciii,nursing_note,PROMPT2_entailment
237,9,32,27,5,0.84375,17,13,4,0.7647058823529411,0.8022857142857143,medlm,mimiciii,nursing_note,PROMPT2_entailment
238,90,22,20,2,0.9090909090909092,14,13,1,0.9285714285714286,0.9187279151943464,medlm,mimiciii,nursing_note,PROMPT2_entailment
239,91,20,13,7,0.65,25,20,5,0.8,0.7172413793103448,medlm,mimiciii,nursing_note,PROMPT2_entailment
240,92,26,22,4,0.8461538461538461,28,24,4,0.8571428571428571,0.8516129032258064,medlm,mimiciii,nursing_note,PROMPT2_entailment
241,93,30,24,6,0.8,23,21,2,0.9130434782608696,0.852791878172589,medlm,mimiciii,nursing_note,PROMPT2_entailment
242,94,6,5,1,0.8333333333333334,5,5,0,1.0,0.9090909090909092,medlm,mimiciii,nursing_note,PROMPT2_entailment
243,95,16,10,6,0.625,14,12,2,0.8571428571428571,0.7228915662650602,medlm,mimiciii,nursing_note,PROMPT2_entailment
244,96,7,7,0,1.0,6,6,0,1.0,1.0,medlm,mimiciii,nursing_note,PROMPT2_entailment
245,97,9,9,0,1.0,10,10,0,1.0,1.0,medlm,mimiciii,nursing_note,PROMPT2_entailment
246,98,12,10,2,0.8333333333333334,13,10,3,0.7692307692307693,0.8,medlm,mimiciii,nursing_note,PROMPT2_entailment
247,99,45,40,5,0.8888888888888888,44,35,9,0.7954545454545454,0.8395802098950524,medlm,mimiciii,nursing_note,PROMPT2_entailment
0,0,7,3,4,0.4285714285714285,21,15,6,0.7142857142857143,0.5357142857142858,medlm,mimiciii,radiology_report,PROMPT1_entailment
1,1,5,3,2,0.6,15,9,6,0.6,0.6,medlm,mimiciii,radiology_report,PROMPT1_entailment
2,10,6,3,3,0.5,18,14,4,0.7777777777777778,0.6086956521739131,medlm,mimiciii,radiology_report,PROMPT1_entailment
3,100,4,3,1,0.75,9,6,3,0.6666666666666666,0.7058823529411765,medlm,mimiciii,radiology_report,PROMPT1_entailment
4,101,6,5,1,0.8333333333333334,15,9,6,0.6,0.6976744186046512,medlm,mimiciii,radiology_report,PROMPT1_entailment
5,102,5,5,0,1.0,16,9,7,0.5625,0.72,medlm,mimiciii,radiology_report,PROMPT1_entailment
6,103,6,4,2,0.6666666666666666,19,14,5,0.7368421052631579,0.7,medlm,mimiciii,radiology_report,PROMPT1_entailment
7,104,6,1,5,0.1666666666666666,17,8,9,0.4705882352941176,0.2461538461538461,medlm,mimiciii,radiology_report,PROMPT1_entailment
8,105,4,4,0,1.0,8,5,3,0.625,0.7692307692307693,medlm,mimiciii,radiology_report,PROMPT1_entailment
9,106,5,4,1,0.8,12,9,3,0.75,0.7741935483870969,medlm,mimiciii,radiology_report,PROMPT1_entailment
10,107,10,6,4,0.6,19,12,7,0.631578947368421,0.6153846153846154,medlm,mimiciii,radiology_report,PROMPT1_entailment
11,108,5,4,1,0.8,13,11,2,0.8461538461538461,0.8224299065420562,medlm,mimiciii,radiology_report,PROMPT1_entailment
12,109,6,2,4,0.3333333333333333,20,16,4,0.8,0.4705882352941176,medlm,mimiciii,radiology_report,PROMPT1_entailment
13,11,10,9,1,0.9,24,19,5,0.7916666666666666,0.8423645320197045,medlm,mimiciii,radiology_report,PROMPT1_entailment
14,110,5,3,2,0.6,17,10,7,0.5882352941176471,0.5940594059405941,medlm,mimiciii,radiology_report,PROMPT1_entailment
15,111,7,3,4,0.4285714285714285,20,16,4,0.8,0.5581395348837209,medlm,mimiciii,radiology_report,PROMPT1_entailment
16,112,9,9,0,1.0,14,12,2,0.8571428571428571,0.923076923076923,medlm,mimiciii,radiology_report,PROMPT1_entailment
17,113,7,2,5,0.2857142857142857,20,13,7,0.65,0.3969465648854962,medlm,mimiciii,radiology_report,PROMPT1_entailment
18,114,7,4,3,0.5714285714285714,23,17,6,0.7391304347826086,0.6445497630331753,medlm,mimiciii,radiology_report,PROMPT1_entailment
19,115,9,7,2,0.7777777777777778,20,17,3,0.85,0.8122866894197952,medlm,mimiciii,radiology_report,PROMPT1_entailment
20,116,6,5,1,0.8333333333333334,13,9,4,0.6923076923076923,0.7563025210084034,medlm,mimiciii,radiology_report,PROMPT1_entailment
21,117,6,4,2,0.6666666666666666,16,12,4,0.75,0.7058823529411765,medlm,mimiciii,radiology_report,PROMPT1_entailment
22,118,8,5,3,0.625,24,17,7,0.7083333333333334,0.6640625,medlm,mimiciii,radiology_report,PROMPT1_entailment
23,119,6,5,1,0.8333333333333334,17,12,5,0.7058823529411765,0.7643312101910827,medlm,mimiciii,radiology_report,PROMPT1_entailment
24,12,7,7,0,1.0,17,14,3,0.8235294117647058,0.9032258064516128,medlm,mimiciii,radiology_report,PROMPT1_entailment
25,120,6,3,3,0.5,16,10,6,0.625,0.5555555555555556,medlm,mimiciii,radiology_report,PROMPT1_entailment
26,121,9,6,3,0.6666666666666666,26,18,8,0.6923076923076923,0.6792452830188679,medlm,mimiciii,radiology_report,PROMPT1_entailment
27,122,6,5,1,0.8333333333333334,20,16,4,0.8,0.816326530612245,medlm,mimiciii,radiology_report,PROMPT1_entailment
28,123,6,6,0,1.0,13,12,1,0.9230769230769232,0.96,medlm,mimiciii,radiology_report,PROMPT1_entailment
29,124,6,5,1,0.8333333333333334,12,9,3,0.75,0.7894736842105262,medlm,mimiciii,radiology_report,PROMPT1_entailment
30,125,10,5,5,0.5,23,17,6,0.7391304347826086,0.5964912280701754,medlm,mimiciii,radiology_report,PROMPT1_entailment
31,126,3,2,1,0.6666666666666666,9,5,4,0.5555555555555556,0.606060606060606,medlm,mimiciii,radiology_report,PROMPT1_entailment
32,127,15,14,1,0.9333333333333332,50,28,22,0.56,0.7000000000000001,medlm,mimiciii,radiology_report,PROMPT1_entailment
33,128,5,3,2,0.6,14,11,3,0.7857142857142857,0.6804123711340206,medlm,mimiciii,radiology_report,PROMPT1_entailment
34,129,6,4,2,0.6666666666666666,16,12,4,0.75,0.7058823529411765,medlm,mimiciii,radiology_report,PROMPT1_entailment
35,13,6,6,0,1.0,17,15,2,0.8823529411764706,0.9375,medlm,mimiciii,radiology_report,PROMPT1_entailment
36,130,7,7,0,1.0,29,18,11,0.6206896551724138,0.7659574468085107,medlm,mimiciii,radiology_report,PROMPT1_entailment
37,131,8,8,0,1.0,45,35,10,0.7777777777777778,0.8750000000000001,medlm,mimiciii,radiology_report,PROMPT1_entailment
38,132,8,3,5,0.375,23,14,9,0.6086956521739131,0.4640883977900553,medlm,mimiciii,radiology_report,PROMPT1_entailment
39,133,6,5,1,0.8333333333333334,21,10,11,0.4761904761904761,0.6060606060606061,medlm,mimiciii,radiology_report,PROMPT1_entailment
40,134,3,3,0,1.0,23,14,9,0.6086956521739131,0.7567567567567568,medlm,mimiciii,radiology_report,PROMPT1_entailment
41,135,6,5,1,0.8333333333333334,20,13,7,0.65,0.7303370786516855,medlm,mimiciii,radiology_report,PROMPT1_entailment
42,136,6,3,3,0.5,14,10,4,0.7142857142857143,0.588235294117647,medlm,mimiciii,radiology_report,PROMPT1_entailment
43,137,4,3,1,0.75,10,7,3,0.7,0.7241379310344827,medlm,mimiciii,radiology_report,PROMPT1_entailment
44,138,5,3,2,0.6,14,10,4,0.7142857142857143,0.6521739130434783,medlm,mimiciii,radiology_report,PROMPT1_entailment
45,139,7,4,3,0.5714285714285714,13,8,5,0.6153846153846154,0.5925925925925927,medlm,mimiciii,radiology_report,PROMPT1_entailment
46,14,6,6,0,1.0,12,9,3,0.75,0.8571428571428571,medlm,mimiciii,radiology_report,PROMPT1_entailment
47,140,7,6,1,0.8571428571428571,18,10,8,0.5555555555555556,0.6741573033707865,medlm,mimiciii,radiology_report,PROMPT1_entailment
48,141,8,6,2,0.75,16,11,5,0.6875,0.717391304347826,medlm,mimiciii,radiology_report,PROMPT1_entailment
49,142,9,8,1,0.8888888888888888,14,11,3,0.7857142857142857,0.8341232227488152,medlm,mimiciii,radiology_report,PROMPT1_entailment
50,143,11,11,0,1.0,32,21,11,0.65625,0.7924528301886793,medlm,mimiciii,radiology_report,PROMPT1_entailment
51,144,4,3,1,0.75,26,15,11,0.5769230769230769,0.6521739130434783,medlm,mimiciii,radiology_report,PROMPT1_entailment
52,145,7,3,4,0.4285714285714285,18,14,4,0.7777777777777778,0.5526315789473685,medlm,mimiciii,radiology_report,PROMPT1_entailment
53,146,6,5,1,0.8333333333333334,11,8,3,0.7272727272727273,0.7766990291262137,medlm,mimiciii,radiology_report,PROMPT1_entailment
54,147,6,3,3,0.5,10,6,4,0.6,0.5454545454545454,medlm,mimiciii,radiology_report,PROMPT1_entailment
55,148,5,4,1,0.8,32,16,16,0.5,0.6153846153846154,medlm,mimiciii,radiology_report,PROMPT1_entailment
56,149,6,4,2,0.6666666666666666,20,14,6,0.7,0.6829268292682926,medlm,mimiciii,radiology_report,PROMPT1_entailment
57,15,8,4,4,0.5,29,13,16,0.4482758620689655,0.4727272727272727,medlm,mimiciii,radiology_report,PROMPT1_entailment
58,150,7,2,5,0.2857142857142857,14,11,3,0.7857142857142857,0.419047619047619,medlm,mimiciii,radiology_report,PROMPT1_entailment
59,151,4,2,2,0.5,15,7,8,0.4666666666666667,0.4827586206896552,medlm,mimiciii,radiology_report,PROMPT1_entailment
60,152,8,6,2,0.75,18,11,7,0.6111111111111112,0.6734693877551021,medlm,mimiciii,radiology_report,PROMPT1_entailment
61,153,5,3,2,0.6,16,12,4,0.75,0.6666666666666665,medlm,mimiciii,radiology_report,PROMPT1_entailment
62,154,9,2,7,0.2222222222222222,23,16,7,0.6956521739130435,0.3368421052631579,medlm,mimiciii,radiology_report,PROMPT1_entailment
63,155,16,15,1,0.9375,47,34,13,0.723404255319149,0.8166533226581265,medlm,mimiciii,radiology_report,PROMPT1_entailment
64,156,11,6,5,0.5454545454545454,20,13,7,0.65,0.5931558935361217,medlm,mimiciii,radiology_report,PROMPT1_entailment
65,157,7,7,0,1.0,12,8,4,0.6666666666666666,0.8,medlm,mimiciii,radiology_report,PROMPT1_entailment
66,158,3,3,0,1.0,6,3,3,0.5,0.6666666666666666,medlm,mimiciii,radiology_report,PROMPT1_entailment
67,159,7,5,2,0.7142857142857143,13,10,3,0.7692307692307693,0.7407407407407408,medlm,mimiciii,radiology_report,PROMPT1_entailment
68,16,6,6,0,1.0,17,12,5,0.7058823529411765,0.8275862068965517,medlm,mimiciii,radiology_report,PROMPT1_entailment
69,160,5,5,0,1.0,12,7,5,0.5833333333333334,0.7368421052631579,medlm,mimiciii,radiology_report,PROMPT1_entailment
70,161,4,3,1,0.75,13,8,5,0.6153846153846154,0.676056338028169,medlm,mimiciii,radiology_report,PROMPT1_entailment
71,162,4,3,1,0.75,11,7,4,0.6363636363636364,0.6885245901639345,medlm,mimiciii,radiology_report,PROMPT1_entailment
72,163,6,6,0,1.0,8,5,3,0.625,0.7692307692307693,medlm,mimiciii,radiology_report,PROMPT1_entailment
73,164,4,4,0,1.0,10,7,3,0.7,0.8235294117647058,medlm,mimiciii,radiology_report,PROMPT1_entailment
74,165,9,7,2,0.7777777777777778,31,20,11,0.6451612903225806,0.7052896725440806,medlm,mimiciii,radiology_report,PROMPT1_entailment
75,166,6,3,3,0.5,26,15,11,0.5769230769230769,0.5357142857142857,medlm,mimiciii,radiology_report,PROMPT1_entailment
76,167,4,4,0,1.0,10,8,2,0.8,0.888888888888889,medlm,mimiciii,radiology_report,PROMPT1_entailment
77,168,6,5,1,0.8333333333333334,13,8,5,0.6153846153846154,0.7079646017699115,medlm,mimiciii,radiology_report,PROMPT1_entailment
78,169,9,6,3,0.6666666666666666,22,13,9,0.5909090909090909,0.6265060240963856,medlm,mimiciii,radiology_report,PROMPT1_entailment
79,17,4,3,1,0.75,12,10,2,0.8333333333333334,0.7894736842105262,medlm,mimiciii,radiology_report,PROMPT1_entailment
80,170,10,6,4,0.6,24,17,7,0.7083333333333334,0.6496815286624203,medlm,mimiciii,radiology_report,PROMPT1_entailment
81,171,4,4,0,1.0,7,4,3,0.5714285714285714,0.7272727272727273,medlm,mimiciii,radiology_report,PROMPT1_entailment
82,172,5,4,1,0.8,14,10,4,0.7142857142857143,0.7547169811320756,medlm,mimiciii,radiology_report,PROMPT1_entailment
83,173,5,2,3,0.4,12,9,3,0.75,0.5217391304347827,medlm,mimiciii,radiology_report,PROMPT1_entailment
84,174,5,3,2,0.6,20,13,7,0.65,0.624,medlm,mimiciii,radiology_report,PROMPT1_entailment
85,175,3,3,0,1.0,8,5,3,0.625,0.7692307692307693,medlm,mimiciii,radiology_report,PROMPT1_entailment
86,176,5,2,3,0.4,19,13,6,0.6842105263157895,0.5048543689320388,medlm,mimiciii,radiology_report,PROMPT1_entailment
87,177,3,2,1,0.6666666666666666,16,8,8,0.5,0.5714285714285715,medlm,mimiciii,radiology_report,PROMPT1_entailment
88,178,7,4,3,0.5714285714285714,25,19,6,0.76,0.6523605150214592,medlm,mimiciii,radiology_report,PROMPT1_entailment
89,179,5,5,0,1.0,20,13,7,0.65,0.787878787878788,medlm,mimiciii,radiology_report,PROMPT1_entailment
90,18,4,4,0,1.0,17,5,12,0.2941176470588235,0.4545454545454545,medlm,mimiciii,radiology_report,PROMPT1_entailment
91,180,4,4,0,1.0,11,9,2,0.8181818181818182,0.9,medlm,mimiciii,radiology_report,PROMPT1_entailment
92,181,10,5,5,0.5,26,14,12,0.5384615384615384,0.5185185185185186,medlm,mimiciii,radiology_report,PROMPT1_entailment
93,183,8,4,4,0.5,17,12,5,0.7058823529411765,0.5853658536585366,medlm,mimiciii,radiology_report,PROMPT1_entailment
94,184,6,6,0,1.0,15,12,3,0.8,0.888888888888889,medlm,mimiciii,radiology_report,PROMPT1_entailment
95,185,2,2,0,1.0,6,4,2,0.6666666666666666,0.8,medlm,mimiciii,radiology_report,PROMPT1_entailment
96,186,7,5,2,0.7142857142857143,26,21,5,0.8076923076923077,0.7581227436823106,medlm,mimiciii,radiology_report,PROMPT1_entailment
97,187,6,3,3,0.5,14,8,6,0.5714285714285714,0.5333333333333333,medlm,mimiciii,radiology_report,PROMPT1_entailment
98,188,6,4,2,0.6666666666666666,22,13,9,0.5909090909090909,0.6265060240963856,medlm,mimiciii,radiology_report,PROMPT1_entailment
99,189,8,7,1,0.875,15,12,3,0.8,0.8358208955223881,medlm,mimiciii,radiology_report,PROMPT1_entailment
100,19,5,5,0,1.0,14,7,7,0.5,0.6666666666666666,medlm,mimiciii,radiology_report,PROMPT1_entailment
101,190,5,4,1,0.8,17,10,7,0.5882352941176471,0.6779661016949153,medlm,mimiciii,radiology_report,PROMPT1_entailment
102,191,5,2,3,0.4,15,10,5,0.6666666666666666,0.5,medlm,mimiciii,radiology_report,PROMPT1_entailment
103,192,9,6,3,0.6666666666666666,28,19,9,0.6785714285714286,0.6725663716814159,medlm,mimiciii,radiology_report,PROMPT1_entailment
104,193,8,8,0,1.0,14,12,2,0.8571428571428571,0.923076923076923,medlm,mimiciii,radiology_report,PROMPT1_entailment
105,194,11,11,0,1.0,49,18,31,0.3673469387755102,0.5373134328358209,medlm,mimiciii,radiology_report,PROMPT1_entailment
106,195,7,3,4,0.4285714285714285,21,13,8,0.6190476190476191,0.5064935064935066,medlm,mimiciii,radiology_report,PROMPT1_entailment
107,196,6,3,3,0.5,18,8,10,0.4444444444444444,0.4705882352941176,medlm,mimiciii,radiology_report,PROMPT1_entailment
108,197,5,5,0,1.0,15,8,7,0.5333333333333333,0.6956521739130436,medlm,mimiciii,radiology_report,PROMPT1_entailment
109,198,4,1,3,0.25,9,7,2,0.7777777777777778,0.3783783783783784,medlm,mimiciii,radiology_report,PROMPT1_entailment
110,199,9,4,5,0.4444444444444444,23,16,7,0.6956521739130435,0.5423728813559322,medlm,mimiciii,radiology_report,PROMPT1_entailment
111,2,6,4,2,0.6666666666666666,15,8,7,0.5333333333333333,0.5925925925925926,medlm,mimiciii,radiology_report,PROMPT1_entailment
112,20,9,9,0,1.0,42,20,22,0.4761904761904761,0.6451612903225806,medlm,mimiciii,radiology_report,PROMPT1_entailment
113,200,4,2,2,0.5,14,12,2,0.8571428571428571,0.631578947368421,medlm,mimiciii,radiology_report,PROMPT1_entailment
114,201,7,3,4,0.4285714285714285,18,13,5,0.7222222222222222,0.5379310344827586,medlm,mimiciii,radiology_report,PROMPT1_entailment
115,202,7,4,3,0.5714285714285714,25,14,11,0.56,0.5656565656565656,medlm,mimiciii,radiology_report,PROMPT1_entailment
116,203,5,2,3,0.4,19,11,8,0.5789473684210527,0.4731182795698925,medlm,mimiciii,radiology_report,PROMPT1_entailment
117,204,7,4,3,0.5714285714285714,23,13,10,0.5652173913043478,0.5683060109289616,medlm,mimiciii,radiology_report,PROMPT1_entailment
118,205,6,6,0,1.0,14,10,4,0.7142857142857143,0.8333333333333333,medlm,mimiciii,radiology_report,PROMPT1_entailment
119,206,5,5,0,1.0,13,7,6,0.5384615384615384,0.7000000000000001,medlm,mimiciii,radiology_report,PROMPT1_entailment
120,207,3,3,0,1.0,9,5,4,0.5555555555555556,0.7142857142857143,medlm,mimiciii,radiology_report,PROMPT1_entailment
121,208,6,4,2,0.6666666666666666,18,12,6,0.6666666666666666,0.6666666666666666,medlm,mimiciii,radiology_report,PROMPT1_entailment
122,209,6,3,3,0.5,16,15,1,0.9375,0.6521739130434783,medlm,mimiciii,radiology_report,PROMPT1_entailment
123,21,8,5,3,0.625,27,16,11,0.5925925925925926,0.6083650190114068,medlm,mimiciii,radiology_report,PROMPT1_entailment
124,210,5,3,2,0.6,14,10,4,0.7142857142857143,0.6521739130434783,medlm,mimiciii,radiology_report,PROMPT1_entailment
125,211,5,5,0,1.0,13,10,3,0.7692307692307693,0.8695652173913044,medlm,mimiciii,radiology_report,PROMPT1_entailment
126,212,5,3,2,0.6,19,15,4,0.7894736842105263,0.6818181818181819,medlm,mimiciii,radiology_report,PROMPT1_entailment
127,213,7,5,2,0.7142857142857143,22,13,9,0.5909090909090909,0.6467661691542289,medlm,mimiciii,radiology_report,PROMPT1_entailment
128,214,6,3,3,0.5,23,12,11,0.5217391304347826,0.5106382978723404,medlm,mimiciii,radiology_report,PROMPT1_entailment
129,215,4,3,1,0.75,10,8,2,0.8,0.7741935483870969,medlm,mimiciii,radiology_report,PROMPT1_entailment
130,216,5,4,1,0.8,19,9,10,0.4736842105263157,0.5950413223140496,medlm,mimiciii,radiology_report,PROMPT1_entailment
131,217,5,2,3,0.4,20,12,8,0.6,0.48,medlm,mimiciii,radiology_report,PROMPT1_entailment
132,218,6,2,4,0.3333333333333333,15,10,5,0.6666666666666666,0.4444444444444444,medlm,mimiciii,radiology_report,PROMPT1_entailment
133,219,5,3,2,0.6,13,8,5,0.6153846153846154,0.6075949367088608,medlm,mimiciii,radiology_report,PROMPT1_entailment
134,22,6,5,1,0.8333333333333334,19,15,4,0.7894736842105263,0.8108108108108109,medlm,mimiciii,radiology_report,PROMPT1_entailment
135,220,4,2,2,0.5,19,7,12,0.3684210526315789,0.4242424242424242,medlm,mimiciii,radiology_report,PROMPT1_entailment
136,221,10,7,3,0.7,27,18,9,0.6666666666666666,0.6829268292682926,medlm,mimiciii,radiology_report,PROMPT1_entailment
137,222,5,2,3,0.4,16,10,6,0.625,0.4878048780487805,medlm,mimiciii,radiology_report,PROMPT1_entailment
138,223,10,9,1,0.9,21,16,5,0.7619047619047619,0.8252148997134672,medlm,mimiciii,radiology_report,PROMPT1_entailment
139,224,8,6,2,0.75,17,16,1,0.9411764705882352,0.8347826086956521,medlm,mimiciii,radiology_report,PROMPT1_entailment
140,225,4,3,1,0.75,11,9,2,0.8181818181818182,0.7826086956521738,medlm,mimiciii,radiology_report,PROMPT1_entailment
141,226,6,4,2,0.6666666666666666,18,12,6,0.6666666666666666,0.6666666666666666,medlm,mimiciii,radiology_report,PROMPT1_entailment
142,227,6,5,1,0.8333333333333334,18,14,4,0.7777777777777778,0.8045977011494253,medlm,mimiciii,radiology_report,PROMPT1_entailment
143,228,5,4,1,0.8,17,13,4,0.7647058823529411,0.7819548872180452,medlm,mimiciii,radiology_report,PROMPT1_entailment
144,229,7,7,0,1.0,49,27,22,0.5510204081632653,0.7105263157894737,medlm,mimiciii,radiology_report,PROMPT1_entailment
145,23,5,1,4,0.2,15,11,4,0.7333333333333333,0.3142857142857143,medlm,mimiciii,radiology_report,PROMPT1_entailment
146,230,6,3,3,0.5,17,13,4,0.7647058823529411,0.6046511627906976,medlm,mimiciii,radiology_report,PROMPT1_entailment
147,231,6,6,0,1.0,13,10,3,0.7692307692307693,0.8695652173913044,medlm,mimiciii,radiology_report,PROMPT1_entailment
148,232,4,1,3,0.25,18,13,5,0.7222222222222222,0.3714285714285714,medlm,mimiciii,radiology_report,PROMPT1_entailment
149,233,6,3,3,0.5,17,14,3,0.8235294117647058,0.6222222222222222,medlm,mimiciii,radiology_report,PROMPT1_entailment
150,234,4,4,0,1.0,11,7,4,0.6363636363636364,0.7777777777777778,medlm,mimiciii,radiology_report,PROMPT1_entailment
151,235,5,2,3,0.4,14,9,5,0.6428571428571429,0.4931506849315069,medlm,mimiciii,radiology_report,PROMPT1_entailment
152,236,6,4,2,0.6666666666666666,11,7,4,0.6363636363636364,0.6511627906976744,medlm,mimiciii,radiology_report,PROMPT1_entailment
153,237,5,2,3,0.4,17,12,5,0.7058823529411765,0.5106382978723405,medlm,mimiciii,radiology_report,PROMPT1_entailment
154,238,11,8,3,0.7272727272727273,20,14,6,0.7,0.7133757961783439,medlm,mimiciii,radiology_report,PROMPT1_entailment
155,239,3,2,1,0.6666666666666666,17,8,9,0.4705882352941176,0.5517241379310345,medlm,mimiciii,radiology_report,PROMPT1_entailment
156,24,7,5,2,0.7142857142857143,18,11,7,0.6111111111111112,0.6586826347305389,medlm,mimiciii,radiology_report,PROMPT1_entailment
157,240,7,7,0,1.0,13,10,3,0.7692307692307693,0.8695652173913044,medlm,mimiciii,radiology_report,PROMPT1_entailment
158,241,6,5,1,0.8333333333333334,16,11,5,0.6875,0.7534246575342466,medlm,mimiciii,radiology_report,PROMPT1_entailment
159,242,6,5,1,0.8333333333333334,18,9,9,0.5,0.625,medlm,mimiciii,radiology_report,PROMPT1_entailment
160,243,5,4,1,0.8,13,9,4,0.6923076923076923,0.7422680412371134,medlm,mimiciii,radiology_report,PROMPT1_entailment
161,244,6,1,5,0.1666666666666666,17,11,6,0.6470588235294118,0.2650602409638554,medlm,mimiciii,radiology_report,PROMPT1_entailment
162,245,11,4,7,0.3636363636363636,28,20,8,0.7142857142857143,0.4819277108433735,medlm,mimiciii,radiology_report,PROMPT1_entailment
163,246,7,7,0,1.0,12,7,5,0.5833333333333334,0.7368421052631579,medlm,mimiciii,radiology_report,PROMPT1_entailment
164,247,6,6,0,1.0,12,6,6,0.5,0.6666666666666666,medlm,mimiciii,radiology_report,PROMPT1_entailment
165,248,6,4,2,0.6666666666666666,17,11,6,0.6470588235294118,0.6567164179104478,medlm,mimiciii,radiology_report,PROMPT1_entailment
166,249,6,4,2,0.6666666666666666,23,9,14,0.391304347826087,0.4931506849315068,medlm,mimiciii,radiology_report,PROMPT1_entailment
167,25,16,9,7,0.5625,27,13,14,0.4814814814814814,0.5188470066518847,medlm,mimiciii,radiology_report,PROMPT1_entailment
168,250,4,4,0,1.0,8,4,4,0.5,0.6666666666666666,medlm,mimiciii,radiology_report,PROMPT1_entailment
169,251,8,1,7,0.125,22,12,10,0.5454545454545454,0.2033898305084745,medlm,mimiciii,radiology_report,PROMPT1_entailment
170,252,4,2,2,0.5,10,5,5,0.5,0.5,medlm,mimiciii,radiology_report,PROMPT1_entailment
171,253,9,7,2,0.7777777777777778,24,20,4,0.8333333333333334,0.8045977011494253,medlm,mimiciii,radiology_report,PROMPT1_entailment
172,254,5,3,2,0.6,13,8,5,0.6153846153846154,0.6075949367088608,medlm,mimiciii,radiology_report,PROMPT1_entailment
173,255,6,3,3,0.5,16,10,6,0.625,0.5555555555555556,medlm,mimiciii,radiology_report,PROMPT1_entailment
174,256,3,1,2,0.3333333333333333,19,12,7,0.631578947368421,0.4363636363636364,medlm,mimiciii,radiology_report,PROMPT1_entailment
175,257,6,3,3,0.5,15,12,3,0.8,0.6153846153846154,medlm,mimiciii,radiology_report,PROMPT1_entailment
176,258,7,5,2,0.7142857142857143,20,12,8,0.6,0.6521739130434783,medlm,mimiciii,radiology_report,PROMPT1_entailment
177,259,6,2,4,0.3333333333333333,17,12,5,0.7058823529411765,0.4528301886792452,medlm,mimiciii,radiology_report,PROMPT1_entailment
178,26,10,9,1,0.9,18,11,7,0.6111111111111112,0.7279411764705883,medlm,mimiciii,radiology_report,PROMPT1_entailment
179,260,7,4,3,0.5714285714285714,20,9,11,0.45,0.5034965034965034,medlm,mimiciii,radiology_report,PROMPT1_entailment
180,261,11,8,3,0.7272727272727273,31,23,8,0.7419354838709677,0.7345309381237525,medlm,mimiciii,radiology_report,PROMPT1_entailment
181,262,7,3,4,0.4285714285714285,23,15,8,0.6521739130434783,0.5172413793103448,medlm,mimiciii,radiology_report,PROMPT1_entailment
182,264,8,6,2,0.75,20,13,7,0.65,0.6964285714285715,medlm,mimiciii,radiology_report,PROMPT1_entailment
183,265,5,4,1,0.8,9,8,1,0.8888888888888888,0.8421052631578948,medlm,mimiciii,radiology_report,PROMPT1_entailment
184,266,5,5,0,1.0,18,13,5,0.7222222222222222,0.8387096774193548,medlm,mimiciii,radiology_report,PROMPT1_entailment
185,267,4,2,2,0.5,16,9,7,0.5625,0.5294117647058824,medlm,mimiciii,radiology_report,PROMPT1_entailment
186,268,8,5,3,0.625,20,12,8,0.6,0.6122448979591836,medlm,mimiciii,radiology_report,PROMPT1_entailment
187,269,12,10,2,0.8333333333333334,30,14,16,0.4666666666666667,0.5982905982905983,medlm,mimiciii,radiology_report,PROMPT1_entailment
188,27,9,7,2,0.7777777777777778,14,11,3,0.7857142857142857,0.7817258883248731,medlm,mimiciii,radiology_report,PROMPT1_entailment
189,270,9,7,2,0.7777777777777778,17,15,2,0.8823529411764706,0.8267716535433072,medlm,mimiciii,radiology_report,PROMPT1_entailment
190,271,6,4,2,0.6666666666666666,20,11,9,0.55,0.6027397260273972,medlm,mimiciii,radiology_report,PROMPT1_entailment
191,272,6,5,1,0.8333333333333334,17,14,3,0.8235294117647058,0.8284023668639053,medlm,mimiciii,radiology_report,PROMPT1_entailment
192,273,5,4,1,0.8,12,7,5,0.5833333333333334,0.674698795180723,medlm,mimiciii,radiology_report,PROMPT1_entailment
193,274,9,7,2,0.7777777777777778,20,16,4,0.8,0.7887323943661971,medlm,mimiciii,radiology_report,PROMPT1_entailment
194,275,8,8,0,1.0,12,8,4,0.6666666666666666,0.8,medlm,mimiciii,radiology_report,PROMPT1_entailment
195,276,3,2,1,0.6666666666666666,29,18,11,0.6206896551724138,0.6428571428571429,medlm,mimiciii,radiology_report,PROMPT1_entailment
196,277,8,5,3,0.625,25,21,4,0.84,0.7167235494880547,medlm,mimiciii,radiology_report,PROMPT1_entailment
197,278,7,4,3,0.5714285714285714,16,9,7,0.5625,0.5669291338582677,medlm,mimiciii,radiology_report,PROMPT1_entailment
198,279,7,7,0,1.0,10,7,3,0.7,0.8235294117647058,medlm,mimiciii,radiology_report,PROMPT1_entailment
199,28,7,4,3,0.5714285714285714,30,23,7,0.7666666666666667,0.6548042704626333,medlm,mimiciii,radiology_report,PROMPT1_entailment
200,280,5,3,2,0.6,12,8,4,0.6666666666666666,0.631578947368421,medlm,mimiciii,radiology_report,PROMPT1_entailment
201,281,12,10,2,0.8333333333333334,24,14,10,0.5833333333333334,0.6862745098039216,medlm,mimiciii,radiology_report,PROMPT1_entailment
202,282,6,5,1,0.8333333333333334,12,8,4,0.6666666666666666,0.7407407407407408,medlm,mimiciii,radiology_report,PROMPT1_entailment
203,283,6,5,1,0.8333333333333334,28,21,7,0.75,0.7894736842105262,medlm,mimiciii,radiology_report,PROMPT1_entailment
204,284,5,1,4,0.2,14,8,6,0.5714285714285714,0.2962962962962963,medlm,mimiciii,radiology_report,PROMPT1_entailment
205,285,8,4,4,0.5,18,14,4,0.7777777777777778,0.6086956521739131,medlm,mimiciii,radiology_report,PROMPT1_entailment
206,286,3,3,0,1.0,6,4,2,0.6666666666666666,0.8,medlm,mimiciii,radiology_report,PROMPT1_entailment
207,287,5,5,0,1.0,18,11,7,0.6111111111111112,0.7586206896551725,medlm,mimiciii,radiology_report,PROMPT1_entailment
208,288,9,5,4,0.5555555555555556,32,22,10,0.6875,0.6145251396648045,medlm,mimiciii,radiology_report,PROMPT1_entailment
209,289,9,6,3,0.6666666666666666,20,17,3,0.85,0.7472527472527473,medlm,mimiciii,radiology_report,PROMPT1_entailment
210,29,3,2,1,0.6666666666666666,8,5,3,0.625,0.6451612903225806,medlm,mimiciii,radiology_report,PROMPT1_entailment
211,290,8,7,1,0.875,11,8,3,0.7272727272727273,0.7943262411347517,medlm,mimiciii,radiology_report,PROMPT1_entailment
212,291,10,8,2,0.8,24,15,9,0.625,0.7017543859649122,medlm,mimiciii,radiology_report,PROMPT1_entailment
213,292,10,4,6,0.4,21,16,5,0.7619047619047619,0.5245901639344264,medlm,mimiciii,radiology_report,PROMPT1_entailment
214,293,5,4,1,0.8,18,13,5,0.7222222222222222,0.759124087591241,medlm,mimiciii,radiology_report,PROMPT1_entailment
215,294,6,4,2,0.6666666666666666,22,15,7,0.6818181818181818,0.6741573033707865,medlm,mimiciii,radiology_report,PROMPT1_entailment
216,295,8,5,3,0.625,39,18,21,0.4615384615384615,0.5309734513274336,medlm,mimiciii,radiology_report,PROMPT1_entailment
217,296,8,4,4,0.5,17,15,2,0.8823529411764706,0.6382978723404256,medlm,mimiciii,radiology_report,PROMPT1_entailment
218,297,9,6,3,0.6666666666666666,24,15,9,0.625,0.6451612903225806,medlm,mimiciii,radiology_report,PROMPT1_entailment
219,298,8,8,0,1.0,20,14,6,0.7,0.8235294117647058,medlm,mimiciii,radiology_report,PROMPT1_entailment
220,299,9,8,1,0.8888888888888888,32,21,11,0.65625,0.7550561797752808,medlm,mimiciii,radiology_report,PROMPT1_entailment
221,3,7,5,2,0.7142857142857143,20,14,6,0.7,0.7070707070707072,medlm,mimiciii,radiology_report,PROMPT1_entailment
222,30,5,4,1,0.8,25,18,7,0.72,0.7578947368421052,medlm,mimiciii,radiology_report,PROMPT1_entailment
223,300,8,7,1,0.875,13,7,6,0.5384615384615384,0.6666666666666667,medlm,mimiciii,radiology_report,PROMPT1_entailment
224,301,4,4,0,1.0,19,11,8,0.5789473684210527,0.7333333333333334,medlm,mimiciii,radiology_report,PROMPT1_entailment
225,302,10,9,1,0.9,15,13,2,0.8666666666666667,0.8830188679245283,medlm,mimiciii,radiology_report,PROMPT1_entailment
226,303,10,3,7,0.3,24,14,10,0.5833333333333334,0.3962264150943397,medlm,mimiciii,radiology_report,PROMPT1_entailment
227,304,9,9,0,1.0,21,14,7,0.6666666666666666,0.8,medlm,mimiciii,radiology_report,PROMPT1_entailment
228,305,7,4,3,0.5714285714285714,24,12,12,0.5,0.5333333333333333,medlm,mimiciii,radiology_report,PROMPT1_entailment
229,306,7,5,2,0.7142857142857143,14,9,5,0.6428571428571429,0.6766917293233083,medlm,mimiciii,radiology_report,PROMPT1_entailment
230,307,7,7,0,1.0,17,13,4,0.7647058823529411,0.8666666666666666,medlm,mimiciii,radiology_report,PROMPT1_entailment
231,308,8,3,5,0.375,15,12,3,0.8,0.5106382978723405,medlm,mimiciii,radiology_report,PROMPT1_entailment
232,309,4,4,0,1.0,29,16,13,0.5517241379310345,0.7111111111111111,medlm,mimiciii,radiology_report,PROMPT1_entailment
233,31,7,2,5,0.2857142857142857,19,10,9,0.5263157894736842,0.3703703703703703,medlm,mimiciii,radiology_report,PROMPT1_entailment
234,310,8,6,2,0.75,24,14,10,0.5833333333333334,0.6562499999999999,medlm,mimiciii,radiology_report,PROMPT1_entailment
235,311,6,4,2,0.6666666666666666,15,11,4,0.7333333333333333,0.6984126984126984,medlm,mimiciii,radiology_report,PROMPT1_entailment
236,312,5,4,1,0.8,18,9,9,0.5,0.6153846153846154,medlm,mimiciii,radiology_report,PROMPT1_entailment
237,313,6,4,2,0.6666666666666666,17,14,3,0.8235294117647058,0.7368421052631577,medlm,mimiciii,radiology_report,PROMPT1_entailment
238,314,5,3,2,0.6,15,11,4,0.7333333333333333,0.6599999999999999,medlm,mimiciii,radiology_report,PROMPT1_entailment
239,315,11,7,4,0.6363636363636364,25,15,10,0.6,0.6176470588235293,medlm,mimiciii,radiology_report,PROMPT1_entailment
240,316,4,3,1,0.75,10,7,3,0.7,0.7241379310344827,medlm,mimiciii,radiology_report,PROMPT1_entailment
241,317,8,4,4,0.5,26,15,11,0.5769230769230769,0.5357142857142857,medlm,mimiciii,radiology_report,PROMPT1_entailment
242,318,5,3,2,0.6,21,19,2,0.9047619047619048,0.7215189873417721,medlm,mimiciii,radiology_report,PROMPT1_entailment
243,319,7,6,1,0.8571428571428571,12,11,1,0.9166666666666666,0.8859060402684563,medlm,mimiciii,radiology_report,PROMPT1_entailment
244,32,7,7,0,1.0,15,10,5,0.6666666666666666,0.8,medlm,mimiciii,radiology_report,PROMPT1_entailment
245,320,5,5,0,1.0,11,9,2,0.8181818181818182,0.9,medlm,mimiciii,radiology_report,PROMPT1_entailment
246,321,7,4,3,0.5714285714285714,21,16,5,0.7619047619047619,0.6530612244897959,medlm,mimiciii,radiology_report,PROMPT1_entailment
247,322,3,3,0,1.0,8,7,1,0.875,0.9333333333333332,medlm,mimiciii,radiology_report,PROMPT1_entailment
248,323,3,3,0,1.0,29,17,12,0.5862068965517241,0.7391304347826086,medlm,mimiciii,radiology_report,PROMPT1_entailment
249,324,8,3,5,0.375,18,15,3,0.8333333333333334,0.5172413793103448,medlm,mimiciii,radiology_report,PROMPT1_entailment
250,325,6,4,2,0.6666666666666666,22,15,7,0.6818181818181818,0.6741573033707865,medlm,mimiciii,radiology_report,PROMPT1_entailment
251,326,7,5,2,0.7142857142857143,23,18,5,0.782608695652174,0.7468879668049793,medlm,mimiciii,radiology_report,PROMPT1_entailment
252,327,5,5,0,1.0,9,6,3,0.6666666666666666,0.8,medlm,mimiciii,radiology_report,PROMPT1_entailment
253,329,3,3,0,1.0,28,5,23,0.1785714285714285,0.303030303030303,medlm,mimiciii,radiology_report,PROMPT1_entailment
254,33,5,4,1,0.8,9,6,3,0.6666666666666666,0.7272727272727272,medlm,mimiciii,radiology_report,PROMPT1_entailment
255,330,7,7,0,1.0,11,9,2,0.8181818181818182,0.9,medlm,mimiciii,radiology_report,PROMPT1_entailment
256,331,9,7,2,0.7777777777777778,15,12,3,0.8,0.7887323943661971,medlm,mimiciii,radiology_report,PROMPT1_entailment
257,332,7,4,3,0.5714285714285714,20,15,5,0.75,0.6486486486486486,medlm,mimiciii,radiology_report,PROMPT1_entailment
258,333,6,3,3,0.5,13,8,5,0.6153846153846154,0.5517241379310345,medlm,mimiciii,radiology_report,PROMPT1_entailment
259,334,9,6,3,0.6666666666666666,20,15,5,0.75,0.7058823529411765,medlm,mimiciii,radiology_report,PROMPT1_entailment
260,335,7,6,1,0.8571428571428571,17,13,4,0.7647058823529411,0.8082901554404144,medlm,mimiciii,radiology_report,PROMPT1_entailment
261,336,7,4,3,0.5714285714285714,16,13,3,0.8125,0.6709677419354838,medlm,mimiciii,radiology_report,PROMPT1_entailment
262,337,7,7,0,1.0,16,12,4,0.75,0.8571428571428571,medlm,mimiciii,radiology_report,PROMPT1_entailment
263,338,6,5,1,0.8333333333333334,13,9,4,0.6923076923076923,0.7563025210084034,medlm,mimiciii,radiology_report,PROMPT1_entailment
264,339,8,3,5,0.375,28,21,7,0.75,0.5,medlm,mimiciii,radiology_report,PROMPT1_entailment
265,34,6,5,1,0.8333333333333334,14,10,4,0.7142857142857143,0.7692307692307692,medlm,mimiciii,radiology_report,PROMPT1_entailment
266,340,6,5,1,0.8333333333333334,15,12,3,0.8,0.816326530612245,medlm,mimiciii,radiology_report,PROMPT1_entailment
267,341,2,1,1,0.5,6,3,3,0.5,0.5,medlm,mimiciii,radiology_report,PROMPT1_entailment
268,342,6,6,0,1.0,15,10,5,0.6666666666666666,0.8,medlm,mimiciii,radiology_report,PROMPT1_entailment
269,343,6,4,2,0.6666666666666666,26,14,12,0.5384615384615384,0.5957446808510638,medlm,mimiciii,radiology_report,PROMPT1_entailment
270,344,7,4,3,0.5714285714285714,19,15,4,0.7894736842105263,0.6629834254143646,medlm,mimiciii,radiology_report,PROMPT1_entailment
271,345,8,7,1,0.875,22,16,6,0.7272727272727273,0.7943262411347517,medlm,mimiciii,radiology_report,PROMPT1_entailment
272,346,6,4,2,0.6666666666666666,15,11,4,0.7333333333333333,0.6984126984126984,medlm,mimiciii,radiology_report,PROMPT1_entailment
273,347,5,4,1,0.8,15,10,5,0.6666666666666666,0.7272727272727272,medlm,mimiciii,radiology_report,PROMPT1_entailment
274,348,4,0,4,0.0,12,8,4,0.6666666666666666,0.0,medlm,mimiciii,radiology_report,PROMPT1_entailment
275,349,4,4,0,1.0,16,7,9,0.4375,0.6086956521739131,medlm,mimiciii,radiology_report,PROMPT1_entailment
276,35,9,5,4,0.5555555555555556,21,13,8,0.6190476190476191,0.5855855855855856,medlm,mimiciii,radiology_report,PROMPT1_entailment
277,350,8,7,1,0.875,21,12,9,0.5714285714285714,0.691358024691358,medlm,mimiciii,radiology_report,PROMPT1_entailment
278,351,8,2,6,0.25,21,18,3,0.8571428571428571,0.3870967741935483,medlm,mimiciii,radiology_report,PROMPT1_entailment
279,352,7,5,2,0.7142857142857143,22,14,8,0.6363636363636364,0.673076923076923,medlm,mimiciii,radiology_report,PROMPT1_entailment
280,353,5,4,1,0.8,26,19,7,0.7307692307692307,0.763819095477387,medlm,mimiciii,radiology_report,PROMPT1_entailment
281,354,6,3,3,0.5,26,16,10,0.6153846153846154,0.5517241379310345,medlm,mimiciii,radiology_report,PROMPT1_entailment
282,355,10,9,1,0.9,18,14,4,0.7777777777777778,0.8344370860927153,medlm,mimiciii,radiology_report,PROMPT1_entailment
283,356,8,5,3,0.625,22,19,3,0.8636363636363636,0.7251908396946565,medlm,mimiciii,radiology_report,PROMPT1_entailment
284,357,6,0,6,0.0,15,8,7,0.5333333333333333,0.0,medlm,mimiciii,radiology_report,PROMPT1_entailment
285,358,7,4,3,0.5714285714285714,12,8,4,0.6666666666666666,0.6153846153846153,medlm,mimiciii,radiology_report,PROMPT1_entailment
286,359,8,6,2,0.75,18,15,3,0.8333333333333334,0.7894736842105262,medlm,mimiciii,radiology_report,PROMPT1_entailment
287,36,6,5,1,0.8333333333333334,22,14,8,0.6363636363636364,0.7216494845360825,medlm,mimiciii,radiology_report,PROMPT1_entailment
288,360,8,3,5,0.375,15,9,6,0.6,0.4615384615384615,medlm,mimiciii,radiology_report,PROMPT1_entailment
289,361,5,3,2,0.6,23,12,11,0.5217391304347826,0.5581395348837209,medlm,mimiciii,radiology_report,PROMPT1_entailment
290,362,9,3,6,0.3333333333333333,24,11,13,0.4583333333333333,0.3859649122807017,medlm,mimiciii,radiology_report,PROMPT1_entailment
291,363,9,5,4,0.5555555555555556,22,14,8,0.6363636363636364,0.5932203389830508,medlm,mimiciii,radiology_report,PROMPT1_entailment
292,364,3,3,0,1.0,11,6,5,0.5454545454545454,0.7058823529411764,medlm,mimiciii,radiology_report,PROMPT1_entailment
293,365,8,5,3,0.625,29,18,11,0.6206896551724138,0.6228373702422145,medlm,mimiciii,radiology_report,PROMPT1_entailment
294,366,6,6,0,1.0,13,9,4,0.6923076923076923,0.8181818181818181,medlm,mimiciii,radiology_report,PROMPT1_entailment
295,367,9,7,2,0.7777777777777778,16,10,6,0.625,0.6930693069306931,medlm,mimiciii,radiology_report,PROMPT1_entailment
296,368,5,3,2,0.6,20,10,10,0.5,0.5454545454545454,medlm,mimiciii,radiology_report,PROMPT1_entailment
297,369,9,7,2,0.7777777777777778,20,15,5,0.75,0.7636363636363638,medlm,mimiciii,radiology_report,PROMPT1_entailment
298,37,4,3,1,0.75,21,12,9,0.5714285714285714,0.6486486486486486,medlm,mimiciii,radiology_report,PROMPT1_entailment
299,370,6,5,1,0.8333333333333334,19,6,13,0.3157894736842105,0.4580152671755725,medlm,mimiciii,radiology_report,PROMPT1_entailment
300,371,9,6,3,0.6666666666666666,17,14,3,0.8235294117647058,0.7368421052631577,medlm,mimiciii,radiology_report,PROMPT1_entailment
301,372,7,6,1,0.8571428571428571,31,18,13,0.5806451612903226,0.6923076923076923,medlm,mimiciii,radiology_report,PROMPT1_entailment
302,373,9,9,0,1.0,23,17,6,0.7391304347826086,0.85,medlm,mimiciii,radiology_report,PROMPT1_entailment
303,374,6,6,0,1.0,11,7,4,0.6363636363636364,0.7777777777777778,medlm,mimiciii,radiology_report,PROMPT1_entailment
304,375,7,6,1,0.8571428571428571,16,11,5,0.6875,0.7630057803468208,medlm,mimiciii,radiology_report,PROMPT1_entailment
305,376,9,5,4,0.5555555555555556,18,15,3,0.8333333333333334,0.6666666666666667,medlm,mimiciii,radiology_report,PROMPT1_entailment
306,377,5,5,0,1.0,10,7,3,0.7,0.8235294117647058,medlm,mimiciii,radiology_report,PROMPT1_entailment
307,378,8,8,0,1.0,24,14,10,0.5833333333333334,0.7368421052631579,medlm,mimiciii,radiology_report,PROMPT1_entailment
308,379,8,6,2,0.75,18,13,5,0.7222222222222222,0.7358490566037735,medlm,mimiciii,radiology_report,PROMPT1_entailment
309,38,8,7,1,0.875,19,14,5,0.7368421052631579,0.7999999999999999,medlm,mimiciii,radiology_report,PROMPT1_entailment
310,380,3,3,0,1.0,8,6,2,0.75,0.8571428571428571,medlm,mimiciii,radiology_report,PROMPT1_entailment
311,381,3,1,2,0.3333333333333333,14,6,8,0.4285714285714285,0.375,medlm,mimiciii,radiology_report,PROMPT1_entailment
312,382,5,5,0,1.0,16,11,5,0.6875,0.8148148148148148,medlm,mimiciii,radiology_report,PROMPT1_entailment
313,383,7,5,2,0.7142857142857143,17,14,3,0.8235294117647058,0.7650273224043717,medlm,mimiciii,radiology_report,PROMPT1_entailment
314,384,6,5,1,0.8333333333333334,13,11,2,0.8461538461538461,0.8396946564885497,medlm,mimiciii,radiology_report,PROMPT1_entailment
315,385,7,5,2,0.7142857142857143,27,20,7,0.7407407407407407,0.7272727272727273,medlm,mimiciii,radiology_report,PROMPT1_entailment
316,386,8,8,0,1.0,18,12,6,0.6666666666666666,0.8,medlm,mimiciii,radiology_report,PROMPT1_entailment
317,387,5,4,1,0.8,19,13,6,0.6842105263157895,0.7375886524822695,medlm,mimiciii,radiology_report,PROMPT1_entailment
318,388,6,5,1,0.8333333333333334,33,23,10,0.696969696969697,0.7590759075907592,medlm,mimiciii,radiology_report,PROMPT1_entailment
319,389,4,4,0,1.0,12,7,5,0.5833333333333334,0.7368421052631579,medlm,mimiciii,radiology_report,PROMPT1_entailment
320,39,6,5,1,0.8333333333333334,10,6,4,0.6,0.6976744186046512,medlm,mimiciii,radiology_report,PROMPT1_entailment
321,390,5,4,1,0.8,14,8,6,0.5714285714285714,0.6666666666666666,medlm,mimiciii,radiology_report,PROMPT1_entailment
322,391,6,4,2,0.6666666666666666,13,8,5,0.6153846153846154,0.64,medlm,mimiciii,radiology_report,PROMPT1_entailment
323,392,6,4,2,0.6666666666666666,15,10,5,0.6666666666666666,0.6666666666666666,medlm,mimiciii,radiology_report,PROMPT1_entailment
324,393,6,3,3,0.5,19,12,7,0.631578947368421,0.5581395348837209,medlm,mimiciii,radiology_report,PROMPT1_entailment
325,394,10,9,1,0.9,18,16,2,0.8888888888888888,0.8944099378881988,medlm,mimiciii,radiology_report,PROMPT1_entailment
326,395,6,1,5,0.1666666666666666,16,10,6,0.625,0.2631578947368421,medlm,mimiciii,radiology_report,PROMPT1_entailment
327,396,8,5,3,0.625,19,10,9,0.5263157894736842,0.5714285714285714,medlm,mimiciii,radiology_report,PROMPT1_entailment
328,397,11,10,1,0.9090909090909092,18,13,5,0.7222222222222222,0.8049535603715171,medlm,mimiciii,radiology_report,PROMPT1_entailment
329,398,7,3,4,0.4285714285714285,21,16,5,0.7619047619047619,0.5485714285714285,medlm,mimiciii,radiology_report,PROMPT1_entailment
330,399,7,4,3,0.5714285714285714,19,15,4,0.7894736842105263,0.6629834254143646,medlm,mimiciii,radiology_report,PROMPT1_entailment
331,4,8,6,2,0.75,16,14,2,0.875,0.8076923076923077,medlm,mimiciii,radiology_report,PROMPT1_entailment
332,40,5,4,1,0.8,17,12,5,0.7058823529411765,0.7500000000000001,medlm,mimiciii,radiology_report,PROMPT1_entailment
333,400,7,6,1,0.8571428571428571,13,11,2,0.8461538461538461,0.8516129032258064,medlm,mimiciii,radiology_report,PROMPT1_entailment
334,401,4,4,0,1.0,9,7,2,0.7777777777777778,0.8750000000000001,medlm,mimiciii,radiology_report,PROMPT1_entailment
335,402,10,4,6,0.4,20,18,2,0.9,0.5538461538461539,medlm,mimiciii,radiology_report,PROMPT1_entailment
336,403,6,4,2,0.6666666666666666,18,11,7,0.6111111111111112,0.6376811594202899,medlm,mimiciii,radiology_report,PROMPT1_entailment
337,404,11,7,4,0.6363636363636364,19,14,5,0.7368421052631579,0.6829268292682926,medlm,mimiciii,radiology_report,PROMPT1_entailment
338,405,6,3,3,0.5,14,10,4,0.7142857142857143,0.588235294117647,medlm,mimiciii,radiology_report,PROMPT1_entailment
339,406,12,8,4,0.6666666666666666,25,20,5,0.8,0.7272727272727272,medlm,mimiciii,radiology_report,PROMPT1_entailment
340,407,6,1,5,0.1666666666666666,20,13,7,0.65,0.2653061224489796,medlm,mimiciii,radiology_report,PROMPT1_entailment
341,408,8,5,3,0.625,20,13,7,0.65,0.6372549019607844,medlm,mimiciii,radiology_report,PROMPT1_entailment
342,409,4,2,2,0.5,21,9,12,0.4285714285714285,0.4615384615384615,medlm,mimiciii,radiology_report,PROMPT1_entailment
343,41,9,6,3,0.6666666666666666,26,14,12,0.5384615384615384,0.5957446808510638,medlm,mimiciii,radiology_report,PROMPT1_entailment
344,410,9,9,0,1.0,20,13,7,0.65,0.787878787878788,medlm,mimiciii,radiology_report,PROMPT1_entailment
345,411,3,3,0,1.0,6,5,1,0.8333333333333334,0.9090909090909092,medlm,mimiciii,radiology_report,PROMPT1_entailment
346,412,7,7,0,1.0,26,14,12,0.5384615384615384,0.7000000000000001,medlm,mimiciii,radiology_report,PROMPT1_entailment
347,413,4,3,1,0.75,14,10,4,0.7142857142857143,0.7317073170731706,medlm,mimiciii,radiology_report,PROMPT1_entailment
348,414,11,7,4,0.6363636363636364,28,19,9,0.6785714285714286,0.6567901234567901,medlm,mimiciii,radiology_report,PROMPT1_entailment
349,415,6,5,1,0.8333333333333334,20,16,4,0.8,0.816326530612245,medlm,mimiciii,radiology_report,PROMPT1_entailment
350,416,4,4,0,1.0,19,10,9,0.5263157894736842,0.6896551724137931,medlm,mimiciii,radiology_report,PROMPT1_entailment
351,417,5,3,2,0.6,20,15,5,0.75,0.6666666666666665,medlm,mimiciii,radiology_report,PROMPT1_entailment
352,418,7,6,1,0.8571428571428571,14,9,5,0.6428571428571429,0.7346938775510204,medlm,mimiciii,radiology_report,PROMPT1_entailment
353,419,7,5,2,0.7142857142857143,16,12,4,0.75,0.7317073170731706,medlm,mimiciii,radiology_report,PROMPT1_entailment
354,42,4,2,2,0.5,14,10,4,0.7142857142857143,0.588235294117647,medlm,mimiciii,radiology_report,PROMPT1_entailment
355,420,6,3,3,0.5,15,8,7,0.5333333333333333,0.5161290322580646,medlm,mimiciii,radiology_report,PROMPT1_entailment
356,421,10,9,1,0.9,23,20,3,0.8695652173913043,0.8845208845208845,medlm,mimiciii,radiology_report,PROMPT1_entailment
357,422,6,4,2,0.6666666666666666,20,12,8,0.6,0.631578947368421,medlm,mimiciii,radiology_report,PROMPT1_entailment
358,423,4,4,0,1.0,12,5,7,0.4166666666666667,0.5882352941176471,medlm,mimiciii,radiology_report,PROMPT1_entailment
359,424,4,4,0,1.0,9,7,2,0.7777777777777778,0.8750000000000001,medlm,mimiciii,radiology_report,PROMPT1_entailment
360,425,8,2,6,0.25,19,12,7,0.631578947368421,0.3582089552238806,medlm,mimiciii,radiology_report,PROMPT1_entailment
361,426,5,4,1,0.8,16,13,3,0.8125,0.8062015503875969,medlm,mimiciii,radiology_report,PROMPT1_entailment
362,427,6,6,0,1.0,15,7,8,0.4666666666666667,0.6363636363636364,medlm,mimiciii,radiology_report,PROMPT1_entailment
363,428,6,6,0,1.0,15,11,4,0.7333333333333333,0.846153846153846,medlm,mimiciii,radiology_report,PROMPT1_entailment
364,429,9,5,4,0.5555555555555556,13,7,6,0.5384615384615384,0.5468749999999999,medlm,mimiciii,radiology_report,PROMPT1_entailment
365,43,3,3,0,1.0,7,6,1,0.8571428571428571,0.923076923076923,medlm,mimiciii,radiology_report,PROMPT1_entailment
366,430,4,4,0,1.0,7,6,1,0.8571428571428571,0.923076923076923,medlm,mimiciii,radiology_report,PROMPT1_entailment
367,431,6,2,4,0.3333333333333333,18,11,7,0.6111111111111112,0.4313725490196078,medlm,mimiciii,radiology_report,PROMPT1_entailment
368,432,4,2,2,0.5,13,8,5,0.6153846153846154,0.5517241379310345,medlm,mimiciii,radiology_report,PROMPT1_entailment
369,433,7,5,2,0.7142857142857143,18,15,3,0.8333333333333334,0.7692307692307692,medlm,mimiciii,radiology_report,PROMPT1_entailment
370,434,7,0,7,0.0,27,15,12,0.5555555555555556,0.0,medlm,mimiciii,radiology_report,PROMPT1_entailment
371,435,5,2,3,0.4,13,11,2,0.8461538461538461,0.5432098765432098,medlm,mimiciii,radiology_report,PROMPT1_entailment
372,436,6,2,4,0.3333333333333333,25,19,6,0.76,0.4634146341463414,medlm,mimiciii,radiology_report,PROMPT1_entailment
373,437,3,3,0,1.0,7,4,3,0.5714285714285714,0.7272727272727273,medlm,mimiciii,radiology_report,PROMPT1_entailment
374,438,9,9,0,1.0,19,14,5,0.7368421052631579,0.8484848484848484,medlm,mimiciii,radiology_report,PROMPT1_entailment
375,439,10,5,5,0.5,22,17,5,0.7727272727272727,0.6071428571428571,medlm,mimiciii,radiology_report,PROMPT1_entailment
376,44,6,5,1,0.8333333333333334,16,11,5,0.6875,0.7534246575342466,medlm,mimiciii,radiology_report,PROMPT1_entailment
377,440,7,7,0,1.0,19,13,6,0.6842105263157895,0.8125000000000001,medlm,mimiciii,radiology_report,PROMPT1_entailment
378,441,7,4,3,0.5714285714285714,17,13,4,0.7647058823529411,0.6540880503144654,medlm,mimiciii,radiology_report,PROMPT1_entailment
379,442,3,3,0,1.0,12,4,8,0.3333333333333333,0.5,medlm,mimiciii,radiology_report,PROMPT1_entailment
380,443,6,3,3,0.5,21,12,9,0.5714285714285714,0.5333333333333333,medlm,mimiciii,radiology_report,PROMPT1_entailment
381,444,4,4,0,1.0,8,4,4,0.5,0.6666666666666666,medlm,mimiciii,radiology_report,PROMPT1_entailment
382,445,8,6,2,0.75,22,18,4,0.8181818181818182,0.7826086956521738,medlm,mimiciii,radiology_report,PROMPT1_entailment
383,446,7,4,3,0.5714285714285714,22,13,9,0.5909090909090909,0.5810055865921787,medlm,mimiciii,radiology_report,PROMPT1_entailment
384,447,5,4,1,0.8,14,11,3,0.7857142857142857,0.7927927927927927,medlm,mimiciii,radiology_report,PROMPT1_entailment
385,448,8,6,2,0.75,36,23,13,0.6388888888888888,0.69,medlm,mimiciii,radiology_report,PROMPT1_entailment
386,449,3,1,2,0.3333333333333333,9,6,3,0.6666666666666666,0.4444444444444444,medlm,mimiciii,radiology_report,PROMPT1_entailment
387,45,6,2,4,0.3333333333333333,20,12,8,0.6,0.4285714285714285,medlm,mimiciii,radiology_report,PROMPT1_entailment
388,450,7,6,1,0.8571428571428571,21,16,5,0.7619047619047619,0.8067226890756302,medlm,mimiciii,radiology_report,PROMPT1_entailment
389,451,4,4,0,1.0,10,9,1,0.9,0.9473684210526316,medlm,mimiciii,radiology_report,PROMPT1_entailment
390,452,6,6,0,1.0,16,10,6,0.625,0.7692307692307693,medlm,mimiciii,radiology_report,PROMPT1_entailment
391,453,5,4,1,0.8,14,8,6,0.5714285714285714,0.6666666666666666,medlm,mimiciii,radiology_report,PROMPT1_entailment
392,454,4,3,1,0.75,10,6,4,0.6,0.6666666666666665,medlm,mimiciii,radiology_report,PROMPT1_entailment
393,455,5,3,2,0.6,16,10,6,0.625,0.6122448979591836,medlm,mimiciii,radiology_report,PROMPT1_entailment
394,456,6,5,1,0.8333333333333334,21,18,3,0.8571428571428571,0.8450704225352113,medlm,mimiciii,radiology_report,PROMPT1_entailment
395,457,4,4,0,1.0,12,8,4,0.6666666666666666,0.8,medlm,mimiciii,radiology_report,PROMPT1_entailment
396,458,6,5,1,0.8333333333333334,16,11,5,0.6875,0.7534246575342466,medlm,mimiciii,radiology_report,PROMPT1_entailment
397,459,5,4,1,0.8,13,8,5,0.6153846153846154,0.6956521739130435,medlm,mimiciii,radiology_report,PROMPT1_entailment
398,46,8,8,0,1.0,26,13,13,0.5,0.6666666666666666,medlm,mimiciii,radiology_report,PROMPT1_entailment
399,460,10,8,2,0.8,20,18,2,0.9,0.8470588235294118,medlm,mimiciii,radiology_report,PROMPT1_entailment
400,461,10,7,3,0.7,22,13,9,0.5909090909090909,0.6408450704225351,medlm,mimiciii,radiology_report,PROMPT1_entailment
401,462,7,5,2,0.7142857142857143,20,15,5,0.75,0.7317073170731706,medlm,mimiciii,radiology_report,PROMPT1_entailment
402,463,5,5,0,1.0,12,8,4,0.6666666666666666,0.8,medlm,mimiciii,radiology_report,PROMPT1_entailment
403,464,6,4,2,0.6666666666666666,25,15,10,0.6,0.631578947368421,medlm,mimiciii,radiology_report,PROMPT1_entailment
404,465,12,11,1,0.9166666666666666,33,26,7,0.7878787878787878,0.8474074074074074,medlm,mimiciii,radiology_report,PROMPT1_entailment
405,466,6,5,1,0.8333333333333334,22,14,8,0.6363636363636364,0.7216494845360825,medlm,mimiciii,radiology_report,PROMPT1_entailment
406,467,5,4,1,0.8,14,9,5,0.6428571428571429,0.7128712871287128,medlm,mimiciii,radiology_report,PROMPT1_entailment
407,468,11,8,3,0.7272727272727273,18,14,4,0.7777777777777778,0.7516778523489932,medlm,mimiciii,radiology_report,PROMPT1_entailment
408,469,9,6,3,0.6666666666666666,25,19,6,0.76,0.7102803738317756,medlm,mimiciii,radiology_report,PROMPT1_entailment
409,47,6,5,1,0.8333333333333334,15,9,6,0.6,0.6976744186046512,medlm,mimiciii,radiology_report,PROMPT1_entailment
410,470,5,4,1,0.8,15,11,4,0.7333333333333333,0.7652173913043478,medlm,mimiciii,radiology_report,PROMPT1_entailment
411,471,7,3,4,0.4285714285714285,18,12,6,0.6666666666666666,0.5217391304347826,medlm,mimiciii,radiology_report,PROMPT1_entailment
412,472,9,8,1,0.8888888888888888,16,9,7,0.5625,0.6889952153110048,medlm,mimiciii,radiology_report,PROMPT1_entailment
413,473,4,4,0,1.0,11,8,3,0.7272727272727273,0.8421052631578948,medlm,mimiciii,radiology_report,PROMPT1_entailment
414,474,10,8,2,0.8,25,18,7,0.72,0.7578947368421052,medlm,mimiciii,radiology_report,PROMPT1_entailment
415,475,4,4,0,1.0,7,2,5,0.2857142857142857,0.4444444444444445,medlm,mimiciii,radiology_report,PROMPT1_entailment
416,476,7,5,2,0.7142857142857143,12,10,2,0.8333333333333334,0.7692307692307692,medlm,mimiciii,radiology_report,PROMPT1_entailment
417,477,6,2,4,0.3333333333333333,16,11,5,0.6875,0.4489795918367347,medlm,mimiciii,radiology_report,PROMPT1_entailment
418,478,7,7,0,1.0,21,12,9,0.5714285714285714,0.7272727272727273,medlm,mimiciii,radiology_report,PROMPT1_entailment
419,479,8,6,2,0.75,22,15,7,0.6818181818181818,0.7142857142857143,medlm,mimiciii,radiology_report,PROMPT1_entailment
420,48,7,5,2,0.7142857142857143,21,13,8,0.6190476190476191,0.6632653061224489,medlm,mimiciii,radiology_report,PROMPT1_entailment
421,480,3,1,2,0.3333333333333333,10,7,3,0.7,0.4516129032258064,medlm,mimiciii,radiology_report,PROMPT1_entailment
422,481,5,1,4,0.2,17,11,6,0.6470588235294118,0.3055555555555555,medlm,mimiciii,radiology_report,PROMPT1_entailment
423,482,4,3,1,0.75,19,12,7,0.631578947368421,0.6857142857142857,medlm,mimiciii,radiology_report,PROMPT1_entailment
424,483,9,8,1,0.8888888888888888,27,22,5,0.8148148148148148,0.8502415458937197,medlm,mimiciii,radiology_report,PROMPT1_entailment
425,484,7,6,1,0.8571428571428571,13,10,3,0.7692307692307693,0.8108108108108107,medlm,mimiciii,radiology_report,PROMPT1_entailment
426,485,8,6,2,0.75,27,16,11,0.5925925925925926,0.6620689655172414,medlm,mimiciii,radiology_report,PROMPT1_entailment
427,486,3,3,0,1.0,11,7,4,0.6363636363636364,0.7777777777777778,medlm,mimiciii,radiology_report,PROMPT1_entailment
428,487,6,2,4,0.3333333333333333,20,12,8,0.6,0.4285714285714285,medlm,mimiciii,radiology_report,PROMPT1_entailment
429,488,5,3,2,0.6,15,6,9,0.4,0.48,medlm,mimiciii,radiology_report,PROMPT1_entailment
430,489,13,9,4,0.6923076923076923,18,12,6,0.6666666666666666,0.6792452830188679,medlm,mimiciii,radiology_report,PROMPT1_entailment
431,49,3,2,1,0.6666666666666666,24,16,8,0.6666666666666666,0.6666666666666666,medlm,mimiciii,radiology_report,PROMPT1_entailment
432,490,3,3,0,1.0,8,2,6,0.25,0.4,medlm,mimiciii,radiology_report,PROMPT1_entailment
433,491,6,4,2,0.6666666666666666,17,9,8,0.5294117647058824,0.5901639344262295,medlm,mimiciii,radiology_report,PROMPT1_entailment
434,492,5,4,1,0.8,13,8,5,0.6153846153846154,0.6956521739130435,medlm,mimiciii,radiology_report,PROMPT1_entailment
435,493,6,6,0,1.0,9,4,5,0.4444444444444444,0.6153846153846153,medlm,mimiciii,radiology_report,PROMPT1_entailment
436,494,4,3,1,0.75,8,4,4,0.5,0.6,medlm,mimiciii,radiology_report,PROMPT1_entailment
437,495,5,5,0,1.0,12,9,3,0.75,0.8571428571428571,medlm,mimiciii,radiology_report,PROMPT1_entailment
438,496,12,12,0,1.0,36,20,16,0.5555555555555556,0.7142857142857143,medlm,mimiciii,radiology_report,PROMPT1_entailment
439,497,7,6,1,0.8571428571428571,25,16,9,0.64,0.732824427480916,medlm,mimiciii,radiology_report,PROMPT1_entailment
440,498,7,3,4,0.4285714285714285,22,16,6,0.7272727272727273,0.5393258426966292,medlm,mimiciii,radiology_report,PROMPT1_entailment
441,499,7,7,0,1.0,17,15,2,0.8823529411764706,0.9375,medlm,mimiciii,radiology_report,PROMPT1_entailment
442,5,9,8,1,0.8888888888888888,22,13,9,0.5909090909090909,0.7098976109215018,medlm,mimiciii,radiology_report,PROMPT1_entailment
443,50,5,3,2,0.6,15,8,7,0.5333333333333333,0.5647058823529412,medlm,mimiciii,radiology_report,PROMPT1_entailment
444,51,6,5,1,0.8333333333333334,13,8,5,0.6153846153846154,0.7079646017699115,medlm,mimiciii,radiology_report,PROMPT1_entailment
445,52,7,3,4,0.4285714285714285,21,13,8,0.6190476190476191,0.5064935064935066,medlm,mimiciii,radiology_report,PROMPT1_entailment
446,53,6,4,2,0.6666666666666666,12,7,5,0.5833333333333334,0.6222222222222222,medlm,mimiciii,radiology_report,PROMPT1_entailment
447,54,6,5,1,0.8333333333333334,10,6,4,0.6,0.6976744186046512,medlm,mimiciii,radiology_report,PROMPT1_entailment
448,55,6,3,3,0.5,18,13,5,0.7222222222222222,0.5909090909090908,medlm,mimiciii,radiology_report,PROMPT1_entailment
449,56,4,2,2,0.5,21,11,10,0.5238095238095238,0.5116279069767442,medlm,mimiciii,radiology_report,PROMPT1_entailment
450,57,5,5,0,1.0,10,6,4,0.6,0.7499999999999999,medlm,mimiciii,radiology_report,PROMPT1_entailment
451,58,8,8,0,1.0,16,11,5,0.6875,0.8148148148148148,medlm,mimiciii,radiology_report,PROMPT1_entailment
452,59,7,7,0,1.0,16,12,4,0.75,0.8571428571428571,medlm,mimiciii,radiology_report,PROMPT1_entailment
453,6,4,4,0,1.0,8,7,1,0.875,0.9333333333333332,medlm,mimiciii,radiology_report,PROMPT1_entailment
454,60,8,6,2,0.75,19,10,9,0.5263157894736842,0.6185567010309279,medlm,mimiciii,radiology_report,PROMPT1_entailment
455,61,6,4,2,0.6666666666666666,22,16,6,0.7272727272727273,0.6956521739130435,medlm,mimiciii,radiology_report,PROMPT1_entailment
456,62,3,2,1,0.6666666666666666,13,7,6,0.5384615384615384,0.5957446808510638,medlm,mimiciii,radiology_report,PROMPT1_entailment
457,63,5,5,0,1.0,15,6,9,0.4,0.5714285714285715,medlm,mimiciii,radiology_report,PROMPT1_entailment
458,64,6,4,2,0.6666666666666666,20,11,9,0.55,0.6027397260273972,medlm,mimiciii,radiology_report,PROMPT1_entailment
459,65,6,4,2,0.6666666666666666,18,14,4,0.7777777777777778,0.717948717948718,medlm,mimiciii,radiology_report,PROMPT1_entailment
460,66,3,3,0,1.0,34,24,10,0.7058823529411765,0.8275862068965517,medlm,mimiciii,radiology_report,PROMPT1_entailment
461,67,9,7,2,0.7777777777777778,28,17,11,0.6071428571428571,0.6819484240687679,medlm,mimiciii,radiology_report,PROMPT1_entailment
462,68,6,5,1,0.8333333333333334,35,24,11,0.6857142857142857,0.7523510971786835,medlm,mimiciii,radiology_report,PROMPT1_entailment
463,69,12,6,6,0.5,31,15,16,0.4838709677419355,0.4918032786885246,medlm,mimiciii,radiology_report,PROMPT1_entailment
464,7,7,6,1,0.8571428571428571,16,15,1,0.9375,0.8955223880597014,medlm,mimiciii,radiology_report,PROMPT1_entailment
465,70,5,2,3,0.4,17,14,3,0.8235294117647058,0.5384615384615384,medlm,mimiciii,radiology_report,PROMPT1_entailment
466,71,5,3,2,0.6,18,9,9,0.5,0.5454545454545454,medlm,mimiciii,radiology_report,PROMPT1_entailment
467,72,5,4,1,0.8,13,9,4,0.6923076923076923,0.7422680412371134,medlm,mimiciii,radiology_report,PROMPT1_entailment
468,73,7,7,0,1.0,34,18,16,0.5294117647058824,0.6923076923076924,medlm,mimiciii,radiology_report,PROMPT1_entailment
469,74,6,4,2,0.6666666666666666,18,11,7,0.6111111111111112,0.6376811594202899,medlm,mimiciii,radiology_report,PROMPT1_entailment
470,75,5,4,1,0.8,12,11,1,0.9166666666666666,0.854368932038835,medlm,mimiciii,radiology_report,PROMPT1_entailment
471,76,7,6,1,0.8571428571428571,14,12,2,0.8571428571428571,0.8571428571428571,medlm,mimiciii,radiology_report,PROMPT1_entailment
472,77,10,9,1,0.9,26,17,9,0.6538461538461539,0.7574257425742574,medlm,mimiciii,radiology_report,PROMPT1_entailment
473,78,13,11,2,0.8461538461538461,33,22,11,0.6666666666666666,0.7457627118644068,medlm,mimiciii,radiology_report,PROMPT1_entailment
474,79,7,6,1,0.8571428571428571,17,10,7,0.5882352941176471,0.6976744186046512,medlm,mimiciii,radiology_report,PROMPT1_entailment
475,8,6,6,0,1.0,15,14,1,0.9333333333333332,0.9655172413793104,medlm,mimiciii,radiology_report,PROMPT1_entailment
476,80,7,5,2,0.7142857142857143,25,19,6,0.76,0.7364341085271319,medlm,mimiciii,radiology_report,PROMPT1_entailment
477,81,7,5,2,0.7142857142857143,15,9,6,0.6,0.6521739130434783,medlm,mimiciii,radiology_report,PROMPT1_entailment
478,82,7,6,1,0.8571428571428571,14,12,2,0.8571428571428571,0.8571428571428571,medlm,mimiciii,radiology_report,PROMPT1_entailment
479,83,4,1,3,0.25,17,11,6,0.6470588235294118,0.360655737704918,medlm,mimiciii,radiology_report,PROMPT1_entailment
480,84,10,8,2,0.8,20,14,6,0.7,0.7466666666666666,medlm,mimiciii,radiology_report,PROMPT1_entailment
481,85,5,5,0,1.0,14,11,3,0.7857142857142857,0.88,medlm,mimiciii,radiology_report,PROMPT1_entailment
482,86,6,5,1,0.8333333333333334,10,8,2,0.8,0.816326530612245,medlm,mimiciii,radiology_report,PROMPT1_entailment
483,87,8,7,1,0.875,14,10,4,0.7142857142857143,0.7865168539325842,medlm,mimiciii,radiology_report,PROMPT1_entailment
484,88,9,6,3,0.6666666666666666,19,18,1,0.9473684210526316,0.782608695652174,medlm,mimiciii,radiology_report,PROMPT1_entailment
485,89,7,6,1,0.8571428571428571,18,12,6,0.6666666666666666,0.75,medlm,mimiciii,radiology_report,PROMPT1_entailment
486,9,5,4,1,0.8,13,9,4,0.6923076923076923,0.7422680412371134,medlm,mimiciii,radiology_report,PROMPT1_entailment
487,90,5,2,3,0.4,14,9,5,0.6428571428571429,0.4931506849315069,medlm,mimiciii,radiology_report,PROMPT1_entailment
488,91,5,5,0,1.0,13,9,4,0.6923076923076923,0.8181818181818181,medlm,mimiciii,radiology_report,PROMPT1_entailment
489,92,9,6,3,0.6666666666666666,21,16,5,0.7619047619047619,0.7111111111111111,medlm,mimiciii,radiology_report,PROMPT1_entailment
490,93,8,5,3,0.625,15,11,4,0.7333333333333333,0.6748466257668712,medlm,mimiciii,radiology_report,PROMPT1_entailment
491,94,11,8,3,0.7272727272727273,28,18,10,0.6428571428571429,0.6824644549763033,medlm,mimiciii,radiology_report,PROMPT1_entailment
492,95,9,9,0,1.0,18,11,7,0.6111111111111112,0.7586206896551725,medlm,mimiciii,radiology_report,PROMPT1_entailment
493,96,7,6,1,0.8571428571428571,21,13,8,0.6190476190476191,0.7188940092165899,medlm,mimiciii,radiology_report,PROMPT1_entailment
494,97,9,6,3,0.6666666666666666,23,15,8,0.6521739130434783,0.6593406593406593,medlm,mimiciii,radiology_report,PROMPT1_entailment
495,98,6,4,2,0.6666666666666666,19,11,8,0.5789473684210527,0.619718309859155,medlm,mimiciii,radiology_report,PROMPT1_entailment
496,99,4,2,2,0.5,13,9,4,0.6923076923076923,0.5806451612903226,medlm,mimiciii,radiology_report,PROMPT1_entailment
0,0,13,5,8,0.3846153846153846,21,11,10,0.5238095238095238,0.4435483870967742,medlm,mimiciii,radiology_report,PROMPT1_ICL_entailment
1,1,8,5,3,0.625,15,11,4,0.7333333333333333,0.6748466257668712,medlm,mimiciii,radiology_report,PROMPT1_ICL_entailment
2,10,6,5,1,0.8333333333333334,18,9,9,0.5,0.625,medlm,mimiciii,radiology_report,PROMPT1_ICL_entailment
3,100,6,6,0,1.0,9,6,3,0.6666666666666666,0.8,medlm,mimiciii,radiology_report,PROMPT1_ICL_entailment
4,101,6,5,1,0.8333333333333334,15,9,6,0.6,0.6976744186046512,medlm,mimiciii,radiology_report,PROMPT1_ICL_entailment
5,102,7,7,0,1.0,16,9,7,0.5625,0.72,medlm,mimiciii,radiology_report,PROMPT1_ICL_entailment
6,103,7,6,1,0.8571428571428571,19,15,4,0.7894736842105263,0.8219178082191781,medlm,mimiciii,radiology_report,PROMPT1_ICL_entailment
7,104,12,7,5,0.5833333333333334,17,10,7,0.5882352941176471,0.5857740585774059,medlm,mimiciii,radiology_report,PROMPT1_ICL_entailment
8,105,6,5,1,0.8333333333333334,8,5,3,0.625,0.7142857142857143,medlm,mimiciii,radiology_report,PROMPT1_ICL_entailment
9,106,9,7,2,0.7777777777777778,12,8,4,0.6666666666666666,0.717948717948718,medlm,mimiciii,radiology_report,PROMPT1_ICL_entailment
10,107,8,4,4,0.5,19,12,7,0.631578947368421,0.5581395348837209,medlm,mimiciii,radiology_report,PROMPT1_ICL_entailment
11,108,5,4,1,0.8,13,11,2,0.8461538461538461,0.8224299065420562,medlm,mimiciii,radiology_report,PROMPT1_ICL_entailment
12,109,8,4,4,0.5,20,15,5,0.75,0.6,medlm,mimiciii,radiology_report,PROMPT1_ICL_entailment
13,11,10,10,0,1.0,24,12,12,0.5,0.6666666666666666,medlm,mimiciii,radiology_report,PROMPT1_ICL_entailment
14,110,9,8,1,0.8888888888888888,17,10,7,0.5882352941176471,0.7079646017699115,medlm,mimiciii,radiology_report,PROMPT1_ICL_entailment
15,111,7,3,4,0.4285714285714285,20,16,4,0.8,0.5581395348837209,medlm,mimiciii,radiology_report,PROMPT1_ICL_entailment
16,112,8,8,0,1.0,14,9,5,0.6428571428571429,0.782608695652174,medlm,mimiciii,radiology_report,PROMPT1_ICL_entailment
17,113,17,6,11,0.3529411764705882,20,15,5,0.75,0.48,medlm,mimiciii,radiology_report,PROMPT1_ICL_entailment
18,114,8,2,6,0.25,23,17,6,0.7391304347826086,0.3736263736263736,medlm,mimiciii,radiology_report,PROMPT1_ICL_entailment
19,115,9,7,2,0.7777777777777778,20,15,5,0.75,0.7636363636363638,medlm,mimiciii,radiology_report,PROMPT1_ICL_entailment
20,116,5,5,0,1.0,13,9,4,0.6923076923076923,0.8181818181818181,medlm,mimiciii,radiology_report,PROMPT1_ICL_entailment
21,117,7,5,2,0.7142857142857143,16,11,5,0.6875,0.7006369426751592,medlm,mimiciii,radiology_report,PROMPT1_ICL_entailment
22,118,8,5,3,0.625,24,17,7,0.7083333333333334,0.6640625,medlm,mimiciii,radiology_report,PROMPT1_ICL_entailment
23,119,6,5,1,0.8333333333333334,17,12,5,0.7058823529411765,0.7643312101910827,medlm,mimiciii,radiology_report,PROMPT1_ICL_entailment
24,12,7,7,0,1.0,17,14,3,0.8235294117647058,0.9032258064516128,medlm,mimiciii,radiology_report,PROMPT1_ICL_entailment
25,120,9,3,6,0.3333333333333333,16,11,5,0.6875,0.4489795918367347,medlm,mimiciii,radiology_report,PROMPT1_ICL_entailment
26,121,9,6,3,0.6666666666666666,26,17,9,0.6538461538461539,0.6601941747572816,medlm,mimiciii,radiology_report,PROMPT1_ICL_entailment
27,122,6,5,1,0.8333333333333334,20,16,4,0.8,0.816326530612245,medlm,mimiciii,radiology_report,PROMPT1_ICL_entailment
28,123,9,8,1,0.8888888888888888,13,9,4,0.6923076923076923,0.7783783783783783,medlm,mimiciii,radiology_report,PROMPT1_ICL_entailment
29,124,7,6,1,0.8571428571428571,12,8,4,0.6666666666666666,0.75,medlm,mimiciii,radiology_report,PROMPT1_ICL_entailment
30,125,10,7,3,0.7,23,15,8,0.6521739130434783,0.6752411575562701,medlm,mimiciii,radiology_report,PROMPT1_ICL_entailment
31,126,3,1,2,0.3333333333333333,9,5,4,0.5555555555555556,0.4166666666666667,medlm,mimiciii,radiology_report,PROMPT1_ICL_entailment
32,127,9,9,0,1.0,50,25,25,0.5,0.6666666666666666,medlm,mimiciii,radiology_report,PROMPT1_ICL_entailment
33,128,7,5,2,0.7142857142857143,14,7,7,0.5,0.588235294117647,medlm,mimiciii,radiology_report,PROMPT1_ICL_entailment
34,129,6,2,4,0.3333333333333333,16,12,4,0.75,0.4615384615384615,medlm,mimiciii,radiology_report,PROMPT1_ICL_entailment
35,13,9,7,2,0.7777777777777778,17,13,4,0.7647058823529411,0.7711864406779662,medlm,mimiciii,radiology_report,PROMPT1_ICL_entailment
36,130,5,5,0,1.0,29,15,14,0.5172413793103449,0.6818181818181819,medlm,mimiciii,radiology_report,PROMPT1_ICL_entailment
37,131,6,5,1,0.8333333333333334,45,13,32,0.2888888888888888,0.429042904290429,medlm,mimiciii,radiology_report,PROMPT1_ICL_entailment
38,132,9,5,4,0.5555555555555556,23,11,12,0.4782608695652174,0.514018691588785,medlm,mimiciii,radiology_report,PROMPT1_ICL_entailment
39,133,9,7,2,0.7777777777777778,21,13,8,0.6190476190476191,0.6893939393939394,medlm,mimiciii,radiology_report,PROMPT1_ICL_entailment
40,134,10,7,3,0.7,23,17,6,0.7391304347826086,0.7190332326283987,medlm,mimiciii,radiology_report,PROMPT1_ICL_entailment
41,135,6,4,2,0.6666666666666666,20,13,7,0.65,0.6582278481012659,medlm,mimiciii,radiology_report,PROMPT1_ICL_entailment
42,136,9,7,2,0.7777777777777778,14,10,4,0.7142857142857143,0.7446808510638298,medlm,mimiciii,radiology_report,PROMPT1_ICL_entailment
43,137,4,3,1,0.75,10,7,3,0.7,0.7241379310344827,medlm,mimiciii,radiology_report,PROMPT1_ICL_entailment
44,138,8,6,2,0.75,14,10,4,0.7142857142857143,0.7317073170731706,medlm,mimiciii,radiology_report,PROMPT1_ICL_entailment
45,139,7,4,3,0.5714285714285714,13,8,5,0.6153846153846154,0.5925925925925927,medlm,mimiciii,radiology_report,PROMPT1_ICL_entailment
46,14,7,7,0,1.0,12,8,4,0.6666666666666666,0.8,medlm,mimiciii,radiology_report,PROMPT1_ICL_entailment
47,140,11,8,3,0.7272727272727273,18,13,5,0.7222222222222222,0.7247386759581883,medlm,mimiciii,radiology_report,PROMPT1_ICL_entailment
48,141,10,5,5,0.5,16,11,5,0.6875,0.5789473684210527,medlm,mimiciii,radiology_report,PROMPT1_ICL_entailment
49,142,9,8,1,0.8888888888888888,14,11,3,0.7857142857142857,0.8341232227488152,medlm,mimiciii,radiology_report,PROMPT1_ICL_entailment
50,143,7,7,0,1.0,32,16,16,0.5,0.6666666666666666,medlm,mimiciii,radiology_report,PROMPT1_ICL_entailment
51,144,8,5,3,0.625,26,17,9,0.6538461538461539,0.6390977443609023,medlm,mimiciii,radiology_report,PROMPT1_ICL_entailment
52,145,8,5,3,0.625,18,15,3,0.8333333333333334,0.7142857142857143,medlm,mimiciii,radiology_report,PROMPT1_ICL_entailment
53,146,8,7,1,0.875,11,8,3,0.7272727272727273,0.7943262411347517,medlm,mimiciii,radiology_report,PROMPT1_ICL_entailment
54,147,5,4,1,0.8,10,6,4,0.6,0.6857142857142857,medlm,mimiciii,radiology_report,PROMPT1_ICL_entailment
55,148,6,5,1,0.8333333333333334,32,20,12,0.625,0.7142857142857143,medlm,mimiciii,radiology_report,PROMPT1_ICL_entailment
56,149,10,9,1,0.9,20,12,8,0.6,0.7200000000000001,medlm,mimiciii,radiology_report,PROMPT1_ICL_entailment
57,15,9,5,4,0.5555555555555556,29,19,10,0.6551724137931034,0.6012658227848101,medlm,mimiciii,radiology_report,PROMPT1_ICL_entailment
58,150,7,3,4,0.4285714285714285,14,10,4,0.7142857142857143,0.5357142857142858,medlm,mimiciii,radiology_report,PROMPT1_ICL_entailment
59,151,4,2,2,0.5,15,7,8,0.4666666666666667,0.4827586206896552,medlm,mimiciii,radiology_report,PROMPT1_ICL_entailment
60,152,11,7,4,0.6363636363636364,18,12,6,0.6666666666666666,0.6511627906976744,medlm,mimiciii,radiology_report,PROMPT1_ICL_entailment
61,153,2,2,0,1.0,16,3,13,0.1875,0.3157894736842105,medlm,mimiciii,radiology_report,PROMPT1_ICL_entailment
62,154,11,5,6,0.4545454545454545,23,15,8,0.6521739130434783,0.5357142857142857,medlm,mimiciii,radiology_report,PROMPT1_ICL_entailment
63,155,17,16,1,0.9411764705882352,47,32,15,0.6808510638297872,0.7901234567901235,medlm,mimiciii,radiology_report,PROMPT1_ICL_entailment
64,156,9,5,4,0.5555555555555556,20,14,6,0.7,0.6194690265486726,medlm,mimiciii,radiology_report,PROMPT1_ICL_entailment
65,157,11,10,1,0.9090909090909092,12,10,2,0.8333333333333334,0.8695652173913043,medlm,mimiciii,radiology_report,PROMPT1_ICL_entailment
66,158,4,4,0,1.0,6,1,5,0.1666666666666666,0.2857142857142857,medlm,mimiciii,radiology_report,PROMPT1_ICL_entailment
67,159,8,5,3,0.625,13,10,3,0.7692307692307693,0.6896551724137931,medlm,mimiciii,radiology_report,PROMPT1_ICL_entailment
68,16,3,3,0,1.0,17,11,6,0.6470588235294118,0.7857142857142858,medlm,mimiciii,radiology_report,PROMPT1_ICL_entailment
69,160,8,8,0,1.0,12,8,4,0.6666666666666666,0.8,medlm,mimiciii,radiology_report,PROMPT1_ICL_entailment
70,161,7,5,2,0.7142857142857143,13,9,4,0.6923076923076923,0.7031250000000001,medlm,mimiciii,radiology_report,PROMPT1_ICL_entailment
71,162,10,9,1,0.9,11,6,5,0.5454545454545454,0.679245283018868,medlm,mimiciii,radiology_report,PROMPT1_ICL_entailment
72,163,7,7,0,1.0,8,5,3,0.625,0.7692307692307693,medlm,mimiciii,radiology_report,PROMPT1_ICL_entailment
73,164,6,5,1,0.8333333333333334,10,6,4,0.6,0.6976744186046512,medlm,mimiciii,radiology_report,PROMPT1_ICL_entailment
74,165,10,7,3,0.7,31,24,7,0.7741935483870968,0.7352297592997812,medlm,mimiciii,radiology_report,PROMPT1_ICL_entailment
75,166,9,7,2,0.7777777777777778,26,17,9,0.6538461538461539,0.7104477611940297,medlm,mimiciii,radiology_report,PROMPT1_ICL_entailment
76,167,5,5,0,1.0,10,8,2,0.8,0.888888888888889,medlm,mimiciii,radiology_report,PROMPT1_ICL_entailment
77,168,8,4,4,0.5,13,7,6,0.5384615384615384,0.5185185185185186,medlm,mimiciii,radiology_report,PROMPT1_ICL_entailment
78,169,9,5,4,0.5555555555555556,22,14,8,0.6363636363636364,0.5932203389830508,medlm,mimiciii,radiology_report,PROMPT1_ICL_entailment
79,17,6,5,1,0.8333333333333334,12,9,3,0.75,0.7894736842105262,medlm,mimiciii,radiology_report,PROMPT1_ICL_entailment
80,170,10,7,3,0.7,24,18,6,0.75,0.7241379310344827,medlm,mimiciii,radiology_report,PROMPT1_ICL_entailment
81,171,4,4,0,1.0,7,4,3,0.5714285714285714,0.7272727272727273,medlm,mimiciii,radiology_report,PROMPT1_ICL_entailment
82,172,7,5,2,0.7142857142857143,14,9,5,0.6428571428571429,0.6766917293233083,medlm,mimiciii,radiology_report,PROMPT1_ICL_entailment
83,173,5,2,3,0.4,12,9,3,0.75,0.5217391304347827,medlm,mimiciii,radiology_report,PROMPT1_ICL_entailment
84,174,9,7,2,0.7777777777777778,20,13,7,0.65,0.7081712062256809,medlm,mimiciii,radiology_report,PROMPT1_ICL_entailment
85,175,4,4,0,1.0,8,5,3,0.625,0.7692307692307693,medlm,mimiciii,radiology_report,PROMPT1_ICL_entailment
86,176,7,2,5,0.2857142857142857,19,16,3,0.8421052631578947,0.4266666666666667,medlm,mimiciii,radiology_report,PROMPT1_ICL_entailment
87,177,6,6,0,1.0,16,8,8,0.5,0.6666666666666666,medlm,mimiciii,radiology_report,PROMPT1_ICL_entailment
88,178,10,5,5,0.5,25,18,7,0.72,0.5901639344262295,medlm,mimiciii,radiology_report,PROMPT1_ICL_entailment
89,179,10,9,1,0.9,20,14,6,0.7,0.7875,medlm,mimiciii,radiology_report,PROMPT1_ICL_entailment
90,18,11,9,2,0.8181818181818182,17,12,5,0.7058823529411765,0.7578947368421053,medlm,mimiciii,radiology_report,PROMPT1_ICL_entailment
91,180,5,5,0,1.0,11,10,1,0.9090909090909092,0.9523809523809524,medlm,mimiciii,radiology_report,PROMPT1_ICL_entailment
92,181,10,5,5,0.5,26,14,12,0.5384615384615384,0.5185185185185186,medlm,mimiciii,radiology_report,PROMPT1_ICL_entailment
93,182,12,6,6,0.5,23,19,4,0.8260869565217391,0.6229508196721311,medlm,mimiciii,radiology_report,PROMPT1_ICL_entailment
94,183,8,4,4,0.5,17,13,4,0.7647058823529411,0.6046511627906976,medlm,mimiciii,radiology_report,PROMPT1_ICL_entailment
95,184,8,8,0,1.0,15,11,4,0.7333333333333333,0.846153846153846,medlm,mimiciii,radiology_report,PROMPT1_ICL_entailment
96,185,5,4,1,0.8,6,3,3,0.5,0.6153846153846154,medlm,mimiciii,radiology_report,PROMPT1_ICL_entailment
97,186,7,5,2,0.7142857142857143,26,20,6,0.7692307692307693,0.7407407407407408,medlm,mimiciii,radiology_report,PROMPT1_ICL_entailment
98,187,6,2,4,0.3333333333333333,14,7,7,0.5,0.4,medlm,mimiciii,radiology_report,PROMPT1_ICL_entailment
99,188,8,5,3,0.625,22,14,8,0.6363636363636364,0.6306306306306306,medlm,mimiciii,radiology_report,PROMPT1_ICL_entailment
100,189,6,5,1,0.8333333333333334,15,11,4,0.7333333333333333,0.7801418439716311,medlm,mimiciii,radiology_report,PROMPT1_ICL_entailment
101,19,7,7,0,1.0,14,10,4,0.7142857142857143,0.8333333333333333,medlm,mimiciii,radiology_report,PROMPT1_ICL_entailment
102,190,6,4,2,0.6666666666666666,17,12,5,0.7058823529411765,0.6857142857142857,medlm,mimiciii,radiology_report,PROMPT1_ICL_entailment
103,191,6,4,2,0.6666666666666666,15,9,6,0.6,0.631578947368421,medlm,mimiciii,radiology_report,PROMPT1_ICL_entailment
104,192,19,13,6,0.6842105263157895,28,21,7,0.75,0.7155963302752295,medlm,mimiciii,radiology_report,PROMPT1_ICL_entailment
105,193,9,8,1,0.8888888888888888,14,12,2,0.8571428571428571,0.8727272727272727,medlm,mimiciii,radiology_report,PROMPT1_ICL_entailment
106,194,9,9,0,1.0,49,20,29,0.4081632653061224,0.5797101449275363,medlm,mimiciii,radiology_report,PROMPT1_ICL_entailment
107,195,13,8,5,0.6153846153846154,21,14,7,0.6666666666666666,0.64,medlm,mimiciii,radiology_report,PROMPT1_ICL_entailment
108,196,6,4,2,0.6666666666666666,18,13,5,0.7222222222222222,0.6933333333333334,medlm,mimiciii,radiology_report,PROMPT1_ICL_entailment
109,197,5,5,0,1.0,15,8,7,0.5333333333333333,0.6956521739130436,medlm,mimiciii,radiology_report,PROMPT1_ICL_entailment
110,198,4,2,2,0.5,9,6,3,0.6666666666666666,0.5714285714285715,medlm,mimiciii,radiology_report,PROMPT1_ICL_entailment
111,199,13,8,5,0.6153846153846154,23,15,8,0.6521739130434783,0.633245382585752,medlm,mimiciii,radiology_report,PROMPT1_ICL_entailment
112,2,9,6,3,0.6666666666666666,15,10,5,0.6666666666666666,0.6666666666666666,medlm,mimiciii,radiology_report,PROMPT1_ICL_entailment
113,20,10,10,0,1.0,42,22,20,0.5238095238095238,0.6875000000000001,medlm,mimiciii,radiology_report,PROMPT1_ICL_entailment
114,200,9,9,0,1.0,14,12,2,0.8571428571428571,0.923076923076923,medlm,mimiciii,radiology_report,PROMPT1_ICL_entailment
115,201,9,4,5,0.4444444444444444,18,13,5,0.7222222222222222,0.5502645502645503,medlm,mimiciii,radiology_report,PROMPT1_ICL_entailment
116,202,11,9,2,0.8181818181818182,25,13,12,0.52,0.6358695652173912,medlm,mimiciii,radiology_report,PROMPT1_ICL_entailment
117,203,12,5,7,0.4166666666666667,19,9,10,0.4736842105263157,0.4433497536945813,medlm,mimiciii,radiology_report,PROMPT1_ICL_entailment
118,204,7,3,4,0.4285714285714285,23,16,7,0.6956521739130435,0.5303867403314916,medlm,mimiciii,radiology_report,PROMPT1_ICL_entailment
119,205,7,6,1,0.8571428571428571,14,9,5,0.6428571428571429,0.7346938775510204,medlm,mimiciii,radiology_report,PROMPT1_ICL_entailment
120,206,6,6,0,1.0,13,8,5,0.6153846153846154,0.761904761904762,medlm,mimiciii,radiology_report,PROMPT1_ICL_entailment
121,207,5,5,0,1.0,9,6,3,0.6666666666666666,0.8,medlm,mimiciii,radiology_report,PROMPT1_ICL_entailment
122,208,9,7,2,0.7777777777777778,18,9,9,0.5,0.6086956521739131,medlm,mimiciii,radiology_report,PROMPT1_ICL_entailment
123,209,5,1,4,0.2,16,14,2,0.875,0.3255813953488372,medlm,mimiciii,radiology_report,PROMPT1_ICL_entailment
124,21,16,14,2,0.875,27,15,12,0.5555555555555556,0.6796116504854369,medlm,mimiciii,radiology_report,PROMPT1_ICL_entailment
125,210,7,5,2,0.7142857142857143,14,7,7,0.5,0.588235294117647,medlm,mimiciii,radiology_report,PROMPT1_ICL_entailment
126,211,5,5,0,1.0,13,10,3,0.7692307692307693,0.8695652173913044,medlm,mimiciii,radiology_report,PROMPT1_ICL_entailment
127,212,9,6,3,0.6666666666666666,19,14,5,0.7368421052631579,0.7,medlm,mimiciii,radiology_report,PROMPT1_ICL_entailment
128,213,7,6,1,0.8571428571428571,22,13,9,0.5909090909090909,0.6995515695067264,medlm,mimiciii,radiology_report,PROMPT1_ICL_entailment
129,214,9,5,4,0.5555555555555556,23,15,8,0.6521739130434783,0.6,medlm,mimiciii,radiology_report,PROMPT1_ICL_entailment
130,215,6,5,1,0.8333333333333334,10,7,3,0.7,0.7608695652173915,medlm,mimiciii,radiology_report,PROMPT1_ICL_entailment
131,216,6,5,1,0.8333333333333334,19,8,11,0.4210526315789473,0.5594405594405594,medlm,mimiciii,radiology_report,PROMPT1_ICL_entailment
132,217,8,4,4,0.5,20,11,9,0.55,0.5238095238095238,medlm,mimiciii,radiology_report,PROMPT1_ICL_entailment
133,218,7,2,5,0.2857142857142857,15,11,4,0.7333333333333333,0.411214953271028,medlm,mimiciii,radiology_report,PROMPT1_ICL_entailment
134,219,7,6,1,0.8571428571428571,13,7,6,0.5384615384615384,0.6614173228346457,medlm,mimiciii,radiology_report,PROMPT1_ICL_entailment
135,22,7,6,1,0.8571428571428571,19,15,4,0.7894736842105263,0.8219178082191781,medlm,mimiciii,radiology_report,PROMPT1_ICL_entailment
136,220,7,5,2,0.7142857142857143,19,6,13,0.3157894736842105,0.437956204379562,medlm,mimiciii,radiology_report,PROMPT1_ICL_entailment
137,221,18,13,5,0.7222222222222222,27,20,7,0.7407407407407407,0.7313642756680733,medlm,mimiciii,radiology_report,PROMPT1_ICL_entailment
138,222,7,5,2,0.7142857142857143,16,8,8,0.5,0.588235294117647,medlm,mimiciii,radiology_report,PROMPT1_ICL_entailment
139,223,12,10,2,0.8333333333333334,21,13,8,0.6190476190476191,0.7103825136612022,medlm,mimiciii,radiology_report,PROMPT1_ICL_entailment
140,224,9,7,2,0.7777777777777778,17,12,5,0.7058823529411765,0.7400881057268723,medlm,mimiciii,radiology_report,PROMPT1_ICL_entailment
141,225,5,3,2,0.6,11,9,2,0.8181818181818182,0.6923076923076923,medlm,mimiciii,radiology_report,PROMPT1_ICL_entailment
142,226,6,4,2,0.6666666666666666,18,12,6,0.6666666666666666,0.6666666666666666,medlm,mimiciii,radiology_report,PROMPT1_ICL_entailment
143,227,8,7,1,0.875,18,15,3,0.8333333333333334,0.8536585365853658,medlm,mimiciii,radiology_report,PROMPT1_ICL_entailment
144,228,6,3,3,0.5,17,14,3,0.8235294117647058,0.6222222222222222,medlm,mimiciii,radiology_report,PROMPT1_ICL_entailment
145,229,10,10,0,1.0,49,28,21,0.5714285714285714,0.7272727272727273,medlm,mimiciii,radiology_report,PROMPT1_ICL_entailment
146,23,5,1,4,0.2,15,11,4,0.7333333333333333,0.3142857142857143,medlm,mimiciii,radiology_report,PROMPT1_ICL_entailment
147,230,7,4,3,0.5714285714285714,17,15,2,0.8823529411764706,0.6936416184971098,medlm,mimiciii,radiology_report,PROMPT1_ICL_entailment
148,231,6,6,0,1.0,13,9,4,0.6923076923076923,0.8181818181818181,medlm,mimiciii,radiology_report,PROMPT1_ICL_entailment
149,232,7,4,3,0.5714285714285714,18,12,6,0.6666666666666666,0.6153846153846153,medlm,mimiciii,radiology_report,PROMPT1_ICL_entailment
150,233,7,4,3,0.5714285714285714,17,10,7,0.5882352941176471,0.5797101449275363,medlm,mimiciii,radiology_report,PROMPT1_ICL_entailment
151,234,5,5,0,1.0,11,8,3,0.7272727272727273,0.8421052631578948,medlm,mimiciii,radiology_report,PROMPT1_ICL_entailment
152,235,7,4,3,0.5714285714285714,14,8,6,0.5714285714285714,0.5714285714285714,medlm,mimiciii,radiology_report,PROMPT1_ICL_entailment
153,236,9,8,1,0.8888888888888888,11,9,2,0.8181818181818182,0.8520710059171598,medlm,mimiciii,radiology_report,PROMPT1_ICL_entailment
154,237,11,6,5,0.5454545454545454,17,11,6,0.6470588235294118,0.5919282511210763,medlm,mimiciii,radiology_report,PROMPT1_ICL_entailment
155,238,11,4,7,0.3636363636363636,20,13,7,0.65,0.4663677130044843,medlm,mimiciii,radiology_report,PROMPT1_ICL_entailment
156,239,10,3,7,0.3,17,11,6,0.6470588235294118,0.4099378881987577,medlm,mimiciii,radiology_report,PROMPT1_ICL_entailment
157,24,7,5,2,0.7142857142857143,18,11,7,0.6111111111111112,0.6586826347305389,medlm,mimiciii,radiology_report,PROMPT1_ICL_entailment
158,240,8,8,0,1.0,13,10,3,0.7692307692307693,0.8695652173913044,medlm,mimiciii,radiology_report,PROMPT1_ICL_entailment
159,241,7,7,0,1.0,16,12,4,0.75,0.8571428571428571,medlm,mimiciii,radiology_report,PROMPT1_ICL_entailment
160,242,6,5,1,0.8333333333333334,18,9,9,0.5,0.625,medlm,mimiciii,radiology_report,PROMPT1_ICL_entailment
161,243,6,6,0,1.0,13,8,5,0.6153846153846154,0.761904761904762,medlm,mimiciii,radiology_report,PROMPT1_ICL_entailment
162,244,6,2,4,0.3333333333333333,17,12,5,0.7058823529411765,0.4528301886792452,medlm,mimiciii,radiology_report,PROMPT1_ICL_entailment
163,245,11,4,7,0.3636363636363636,28,20,8,0.7142857142857143,0.4819277108433735,medlm,mimiciii,radiology_report,PROMPT1_ICL_entailment
164,246,7,7,0,1.0,12,8,4,0.6666666666666666,0.8,medlm,mimiciii,radiology_report,PROMPT1_ICL_entailment
165,247,6,6,0,1.0,12,6,6,0.5,0.6666666666666666,medlm,mimiciii,radiology_report,PROMPT1_ICL_entailment
166,248,10,10,0,1.0,17,8,9,0.4705882352941176,0.6399999999999999,medlm,mimiciii,radiology_report,PROMPT1_ICL_entailment
167,249,10,7,3,0.7,23,13,10,0.5652173913043478,0.6254295532646047,medlm,mimiciii,radiology_report,PROMPT1_ICL_entailment
168,25,9,7,2,0.7777777777777778,27,13,14,0.4814814814814814,0.5947712418300652,medlm,mimiciii,radiology_report,PROMPT1_ICL_entailment
169,250,5,5,0,1.0,8,4,4,0.5,0.6666666666666666,medlm,mimiciii,radiology_report,PROMPT1_ICL_entailment
170,251,8,2,6,0.25,22,12,10,0.5454545454545454,0.3428571428571428,medlm,mimiciii,radiology_report,PROMPT1_ICL_entailment
171,252,5,4,1,0.8,10,5,5,0.5,0.6153846153846154,medlm,mimiciii,radiology_report,PROMPT1_ICL_entailment
172,253,9,4,5,0.4444444444444444,24,18,6,0.75,0.5581395348837209,medlm,mimiciii,radiology_report,PROMPT1_ICL_entailment
173,254,5,4,1,0.8,13,8,5,0.6153846153846154,0.6956521739130435,medlm,mimiciii,radiology_report,PROMPT1_ICL_entailment
174,255,8,8,0,1.0,16,10,6,0.625,0.7692307692307693,medlm,mimiciii,radiology_report,PROMPT1_ICL_entailment
175,256,11,7,4,0.6363636363636364,19,10,9,0.5263157894736842,0.5761316872427983,medlm,mimiciii,radiology_report,PROMPT1_ICL_entailment
176,257,6,2,4,0.3333333333333333,15,13,2,0.8666666666666667,0.4814814814814814,medlm,mimiciii,radiology_report,PROMPT1_ICL_entailment
177,258,12,9,3,0.75,20,11,9,0.55,0.6346153846153847,medlm,mimiciii,radiology_report,PROMPT1_ICL_entailment
178,259,7,5,2,0.7142857142857143,17,13,4,0.7647058823529411,0.7386363636363635,medlm,mimiciii,radiology_report,PROMPT1_ICL_entailment
179,26,8,7,1,0.875,18,13,5,0.7222222222222222,0.7913043478260868,medlm,mimiciii,radiology_report,PROMPT1_ICL_entailment
180,260,8,3,5,0.375,20,10,10,0.5,0.4285714285714285,medlm,mimiciii,radiology_report,PROMPT1_ICL_entailment
181,261,14,10,4,0.7142857142857143,31,21,10,0.6774193548387096,0.695364238410596,medlm,mimiciii,radiology_report,PROMPT1_ICL_entailment
182,262,5,4,1,0.8,23,13,10,0.5652173913043478,0.6624203821656051,medlm,mimiciii,radiology_report,PROMPT1_ICL_entailment
183,263,9,6,3,0.6666666666666666,27,18,9,0.6666666666666666,0.6666666666666666,medlm,mimiciii,radiology_report,PROMPT1_ICL_entailment
184,264,8,6,2,0.75,20,13,7,0.65,0.6964285714285715,medlm,mimiciii,radiology_report,PROMPT1_ICL_entailment
185,265,6,5,1,0.8333333333333334,9,6,3,0.6666666666666666,0.7407407407407408,medlm,mimiciii,radiology_report,PROMPT1_ICL_entailment
186,266,7,4,3,0.5714285714285714,18,14,4,0.7777777777777778,0.6588235294117646,medlm,mimiciii,radiology_report,PROMPT1_ICL_entailment
187,267,6,6,0,1.0,16,9,7,0.5625,0.72,medlm,mimiciii,radiology_report,PROMPT1_ICL_entailment
188,268,8,4,4,0.5,20,13,7,0.65,0.5652173913043479,medlm,mimiciii,radiology_report,PROMPT1_ICL_entailment
189,269,16,16,0,1.0,30,14,16,0.4666666666666667,0.6363636363636364,medlm,mimiciii,radiology_report,PROMPT1_ICL_entailment
190,27,12,8,4,0.6666666666666666,14,10,4,0.7142857142857143,0.689655172413793,medlm,mimiciii,radiology_report,PROMPT1_ICL_entailment
191,270,11,10,1,0.9090909090909092,17,15,2,0.8823529411764706,0.8955223880597014,medlm,mimiciii,radiology_report,PROMPT1_ICL_entailment
192,271,7,7,0,1.0,20,10,10,0.5,0.6666666666666666,medlm,mimiciii,radiology_report,PROMPT1_ICL_entailment
193,272,5,4,1,0.8,17,11,6,0.6470588235294118,0.7154471544715447,medlm,mimiciii,radiology_report,PROMPT1_ICL_entailment
194,273,6,6,0,1.0,12,7,5,0.5833333333333334,0.7368421052631579,medlm,mimiciii,radiology_report,PROMPT1_ICL_entailment
195,274,9,6,3,0.6666666666666666,20,17,3,0.85,0.7472527472527473,medlm,mimiciii,radiology_report,PROMPT1_ICL_entailment
196,275,9,9,0,1.0,12,9,3,0.75,0.8571428571428571,medlm,mimiciii,radiology_report,PROMPT1_ICL_entailment
197,276,8,6,2,0.75,29,14,15,0.4827586206896552,0.5874125874125874,medlm,mimiciii,radiology_report,PROMPT1_ICL_entailment
198,277,12,7,5,0.5833333333333334,25,18,7,0.72,0.6445012787723785,medlm,mimiciii,radiology_report,PROMPT1_ICL_entailment
199,278,7,4,3,0.5714285714285714,16,9,7,0.5625,0.5669291338582677,medlm,mimiciii,radiology_report,PROMPT1_ICL_entailment
200,279,5,4,1,0.8,10,4,6,0.4,0.5333333333333333,medlm,mimiciii,radiology_report,PROMPT1_ICL_entailment
201,28,8,3,5,0.375,30,18,12,0.6,0.4615384615384615,medlm,mimiciii,radiology_report,PROMPT1_ICL_entailment
202,280,8,6,2,0.75,12,10,2,0.8333333333333334,0.7894736842105262,medlm,mimiciii,radiology_report,PROMPT1_ICL_entailment
203,281,11,9,2,0.8181818181818182,24,16,8,0.6666666666666666,0.7346938775510203,medlm,mimiciii,radiology_report,PROMPT1_ICL_entailment
204,282,10,9,1,0.9,12,9,3,0.75,0.8181818181818182,medlm,mimiciii,radiology_report,PROMPT1_ICL_entailment
205,283,7,6,1,0.8571428571428571,28,13,15,0.4642857142857143,0.6023166023166023,medlm,mimiciii,radiology_report,PROMPT1_ICL_entailment
206,284,5,1,4,0.2,14,8,6,0.5714285714285714,0.2962962962962963,medlm,mimiciii,radiology_report,PROMPT1_ICL_entailment
207,285,9,6,3,0.6666666666666666,18,15,3,0.8333333333333334,0.7407407407407408,medlm,mimiciii,radiology_report,PROMPT1_ICL_entailment
208,286,5,5,0,1.0,6,5,1,0.8333333333333334,0.9090909090909092,medlm,mimiciii,radiology_report,PROMPT1_ICL_entailment
209,287,12,10,2,0.8333333333333334,18,11,7,0.6111111111111112,0.7051282051282051,medlm,mimiciii,radiology_report,PROMPT1_ICL_entailment
210,288,9,5,4,0.5555555555555556,32,21,11,0.65625,0.6017191977077364,medlm,mimiciii,radiology_report,PROMPT1_ICL_entailment
211,289,7,5,2,0.7142857142857143,20,14,6,0.7,0.7070707070707072,medlm,mimiciii,radiology_report,PROMPT1_ICL_entailment
212,29,5,5,0,1.0,8,5,3,0.625,0.7692307692307693,medlm,mimiciii,radiology_report,PROMPT1_ICL_entailment
213,290,10,9,1,0.9,11,8,3,0.7272727272727273,0.8044692737430167,medlm,mimiciii,radiology_report,PROMPT1_ICL_entailment
214,291,10,8,2,0.8,24,14,10,0.5833333333333334,0.674698795180723,medlm,mimiciii,radiology_report,PROMPT1_ICL_entailment
215,292,6,3,3,0.5,21,13,8,0.6190476190476191,0.5531914893617021,medlm,mimiciii,radiology_report,PROMPT1_ICL_entailment
216,293,7,5,2,0.7142857142857143,18,15,3,0.8333333333333334,0.7692307692307692,medlm,mimiciii,radiology_report,PROMPT1_ICL_entailment
217,294,7,2,5,0.2857142857142857,22,15,7,0.6818181818181818,0.4026845637583892,medlm,mimiciii,radiology_report,PROMPT1_ICL_entailment
218,295,5,3,2,0.6,39,13,26,0.3333333333333333,0.4285714285714285,medlm,mimiciii,radiology_report,PROMPT1_ICL_entailment
219,296,7,3,4,0.4285714285714285,17,11,6,0.6470588235294118,0.515625,medlm,mimiciii,radiology_report,PROMPT1_ICL_entailment
220,297,10,6,4,0.6,24,15,9,0.625,0.6122448979591836,medlm,mimiciii,radiology_report,PROMPT1_ICL_entailment
221,298,8,6,2,0.75,20,14,6,0.7,0.7241379310344827,medlm,mimiciii,radiology_report,PROMPT1_ICL_entailment
222,299,5,5,0,1.0,32,20,12,0.625,0.7692307692307693,medlm,mimiciii,radiology_report,PROMPT1_ICL_entailment
223,3,9,4,5,0.4444444444444444,20,15,5,0.75,0.5581395348837209,medlm,mimiciii,radiology_report,PROMPT1_ICL_entailment
224,30,9,7,2,0.7777777777777778,25,19,6,0.76,0.7687861271676301,medlm,mimiciii,radiology_report,PROMPT1_ICL_entailment
225,300,7,6,1,0.8571428571428571,13,6,7,0.4615384615384615,0.6,medlm,mimiciii,radiology_report,PROMPT1_ICL_entailment
226,301,4,4,0,1.0,19,8,11,0.4210526315789473,0.5925925925925926,medlm,mimiciii,radiology_report,PROMPT1_ICL_entailment
227,302,10,9,1,0.9,15,10,5,0.6666666666666666,0.7659574468085106,medlm,mimiciii,radiology_report,PROMPT1_ICL_entailment
228,303,10,2,8,0.2,24,14,10,0.5833333333333334,0.2978723404255319,medlm,mimiciii,radiology_report,PROMPT1_ICL_entailment
229,304,12,11,1,0.9166666666666666,21,16,5,0.7619047619047619,0.8321513002364067,medlm,mimiciii,radiology_report,PROMPT1_ICL_entailment
230,305,7,4,3,0.5714285714285714,24,11,13,0.4583333333333333,0.5086705202312138,medlm,mimiciii,radiology_report,PROMPT1_ICL_entailment
231,306,4,3,1,0.75,14,8,6,0.5714285714285714,0.6486486486486486,medlm,mimiciii,radiology_report,PROMPT1_ICL_entailment
232,307,7,7,0,1.0,17,13,4,0.7647058823529411,0.8666666666666666,medlm,mimiciii,radiology_report,PROMPT1_ICL_entailment
233,308,12,9,3,0.75,15,11,4,0.7333333333333333,0.7415730337078651,medlm,mimiciii,radiology_report,PROMPT1_ICL_entailment
234,309,10,9,1,0.9,29,17,12,0.5862068965517241,0.7099767981438514,medlm,mimiciii,radiology_report,PROMPT1_ICL_entailment
235,31,7,3,4,0.4285714285714285,19,11,8,0.5789473684210527,0.4925373134328357,medlm,mimiciii,radiology_report,PROMPT1_ICL_entailment
236,310,10,7,3,0.7,24,13,11,0.5416666666666666,0.6107382550335569,medlm,mimiciii,radiology_report,PROMPT1_ICL_entailment
237,311,7,6,1,0.8571428571428571,15,11,4,0.7333333333333333,0.7904191616766466,medlm,mimiciii,radiology_report,PROMPT1_ICL_entailment
238,312,10,9,1,0.9,18,11,7,0.6111111111111112,0.7279411764705883,medlm,mimiciii,radiology_report,PROMPT1_ICL_entailment
239,313,8,4,4,0.5,17,11,6,0.6470588235294118,0.5641025641025642,medlm,mimiciii,radiology_report,PROMPT1_ICL_entailment
240,314,6,4,2,0.6666666666666666,15,12,3,0.8,0.7272727272727272,medlm,mimiciii,radiology_report,PROMPT1_ICL_entailment
241,315,7,2,5,0.2857142857142857,25,14,11,0.56,0.3783783783783783,medlm,mimiciii,radiology_report,PROMPT1_ICL_entailment
242,316,3,2,1,0.6666666666666666,10,6,4,0.6,0.631578947368421,medlm,mimiciii,radiology_report,PROMPT1_ICL_entailment
243,317,9,5,4,0.5555555555555556,26,16,10,0.6153846153846154,0.583941605839416,medlm,mimiciii,radiology_report,PROMPT1_ICL_entailment
244,318,5,5,0,1.0,21,10,11,0.4761904761904761,0.6451612903225806,medlm,mimiciii,radiology_report,PROMPT1_ICL_entailment
245,319,11,10,1,0.9090909090909092,12,11,1,0.9166666666666666,0.9128630705394192,medlm,mimiciii,radiology_report,PROMPT1_ICL_entailment
246,32,7,7,0,1.0,15,10,5,0.6666666666666666,0.8,medlm,mimiciii,radiology_report,PROMPT1_ICL_entailment
247,320,5,5,0,1.0,11,10,1,0.9090909090909092,0.9523809523809524,medlm,mimiciii,radiology_report,PROMPT1_ICL_entailment
248,321,9,5,4,0.5555555555555556,21,17,4,0.8095238095238095,0.6589147286821706,medlm,mimiciii,radiology_report,PROMPT1_ICL_entailment
249,322,6,6,0,1.0,8,6,2,0.75,0.8571428571428571,medlm,mimiciii,radiology_report,PROMPT1_ICL_entailment
250,323,6,5,1,0.8333333333333334,29,17,12,0.5862068965517241,0.6882591093117408,medlm,mimiciii,radiology_report,PROMPT1_ICL_entailment
251,324,7,4,3,0.5714285714285714,18,10,8,0.5555555555555556,0.5633802816901409,medlm,mimiciii,radiology_report,PROMPT1_ICL_entailment
252,325,10,6,4,0.6,22,12,10,0.5454545454545454,0.5714285714285713,medlm,mimiciii,radiology_report,PROMPT1_ICL_entailment
253,326,11,9,2,0.8181818181818182,23,18,5,0.782608695652174,0.8,medlm,mimiciii,radiology_report,PROMPT1_ICL_entailment
254,327,5,5,0,1.0,9,7,2,0.7777777777777778,0.8750000000000001,medlm,mimiciii,radiology_report,PROMPT1_ICL_entailment
255,328,8,5,3,0.625,17,10,7,0.5882352941176471,0.6060606060606061,medlm,mimiciii,radiology_report,PROMPT1_ICL_entailment
256,329,8,6,2,0.75,28,11,17,0.3928571428571428,0.515625,medlm,mimiciii,radiology_report,PROMPT1_ICL_entailment
257,33,5,5,0,1.0,9,6,3,0.6666666666666666,0.8,medlm,mimiciii,radiology_report,PROMPT1_ICL_entailment
258,330,4,4,0,1.0,11,6,5,0.5454545454545454,0.7058823529411764,medlm,mimiciii,radiology_report,PROMPT1_ICL_entailment
259,331,9,7,2,0.7777777777777778,15,12,3,0.8,0.7887323943661971,medlm,mimiciii,radiology_report,PROMPT1_ICL_entailment
260,332,9,5,4,0.5555555555555556,20,14,6,0.7,0.6194690265486726,medlm,mimiciii,radiology_report,PROMPT1_ICL_entailment
261,333,6,4,2,0.6666666666666666,13,8,5,0.6153846153846154,0.64,medlm,mimiciii,radiology_report,PROMPT1_ICL_entailment
262,334,9,7,2,0.7777777777777778,20,14,6,0.7,0.7368421052631577,medlm,mimiciii,radiology_report,PROMPT1_ICL_entailment
263,335,7,6,1,0.8571428571428571,17,13,4,0.7647058823529411,0.8082901554404144,medlm,mimiciii,radiology_report,PROMPT1_ICL_entailment
264,336,6,2,4,0.3333333333333333,16,12,4,0.75,0.4615384615384615,medlm,mimiciii,radiology_report,PROMPT1_ICL_entailment
265,337,16,14,2,0.875,16,12,4,0.75,0.8076923076923077,medlm,mimiciii,radiology_report,PROMPT1_ICL_entailment
266,338,7,6,1,0.8571428571428571,13,10,3,0.7692307692307693,0.8108108108108107,medlm,mimiciii,radiology_report,PROMPT1_ICL_entailment
267,339,9,3,6,0.3333333333333333,28,18,10,0.6428571428571429,0.4390243902439024,medlm,mimiciii,radiology_report,PROMPT1_ICL_entailment
268,34,8,6,2,0.75,14,10,4,0.7142857142857143,0.7317073170731706,medlm,mimiciii,radiology_report,PROMPT1_ICL_entailment
269,340,21,9,12,0.4285714285714285,15,12,3,0.8,0.5581395348837209,medlm,mimiciii,radiology_report,PROMPT1_ICL_entailment
270,341,7,6,1,0.8571428571428571,6,4,2,0.6666666666666666,0.75,medlm,mimiciii,radiology_report,PROMPT1_ICL_entailment
271,342,8,8,0,1.0,15,9,6,0.6,0.7499999999999999,medlm,mimiciii,radiology_report,PROMPT1_ICL_entailment
272,343,6,4,2,0.6666666666666666,26,14,12,0.5384615384615384,0.5957446808510638,medlm,mimiciii,radiology_report,PROMPT1_ICL_entailment
273,344,9,3,6,0.3333333333333333,19,12,7,0.631578947368421,0.4363636363636364,medlm,mimiciii,radiology_report,PROMPT1_ICL_entailment
274,345,13,8,5,0.6153846153846154,22,14,8,0.6363636363636364,0.6256983240223464,medlm,mimiciii,radiology_report,PROMPT1_ICL_entailment
275,346,7,5,2,0.7142857142857143,15,8,7,0.5333333333333333,0.6106870229007633,medlm,mimiciii,radiology_report,PROMPT1_ICL_entailment
276,347,10,5,5,0.5,15,12,3,0.8,0.6153846153846154,medlm,mimiciii,radiology_report,PROMPT1_ICL_entailment
277,348,7,3,4,0.4285714285714285,12,7,5,0.5833333333333334,0.4941176470588235,medlm,mimiciii,radiology_report,PROMPT1_ICL_entailment
278,349,5,5,0,1.0,16,10,6,0.625,0.7692307692307693,medlm,mimiciii,radiology_report,PROMPT1_ICL_entailment
279,35,10,2,8,0.2,21,14,7,0.6666666666666666,0.3076923076923076,medlm,mimiciii,radiology_report,PROMPT1_ICL_entailment
280,350,9,7,2,0.7777777777777778,21,12,9,0.5714285714285714,0.6588235294117646,medlm,mimiciii,radiology_report,PROMPT1_ICL_entailment
281,351,7,3,4,0.4285714285714285,21,9,12,0.4285714285714285,0.4285714285714285,medlm,mimiciii,radiology_report,PROMPT1_ICL_entailment
282,352,7,5,2,0.7142857142857143,22,14,8,0.6363636363636364,0.673076923076923,medlm,mimiciii,radiology_report,PROMPT1_ICL_entailment
283,353,7,4,3,0.5714285714285714,26,17,9,0.6538461538461539,0.6098654708520179,medlm,mimiciii,radiology_report,PROMPT1_ICL_entailment
284,354,6,3,3,0.5,26,9,17,0.3461538461538461,0.409090909090909,medlm,mimiciii,radiology_report,PROMPT1_ICL_entailment
285,355,7,5,2,0.7142857142857143,18,14,4,0.7777777777777778,0.7446808510638298,medlm,mimiciii,radiology_report,PROMPT1_ICL_entailment
286,356,14,10,4,0.7142857142857143,22,18,4,0.8181818181818182,0.7627118644067797,medlm,mimiciii,radiology_report,PROMPT1_ICL_entailment
287,357,6,1,5,0.1666666666666666,15,8,7,0.5333333333333333,0.2539682539682539,medlm,mimiciii,radiology_report,PROMPT1_ICL_entailment
288,358,13,11,2,0.8461538461538461,12,8,4,0.6666666666666666,0.7457627118644068,medlm,mimiciii,radiology_report,PROMPT1_ICL_entailment
289,359,8,6,2,0.75,18,15,3,0.8333333333333334,0.7894736842105262,medlm,mimiciii,radiology_report,PROMPT1_ICL_entailment
290,36,14,8,6,0.5714285714285714,22,17,5,0.7727272727272727,0.6570048309178744,medlm,mimiciii,radiology_report,PROMPT1_ICL_entailment
291,360,8,8,0,1.0,15,10,5,0.6666666666666666,0.8,medlm,mimiciii,radiology_report,PROMPT1_ICL_entailment
292,361,12,7,5,0.5833333333333334,23,17,6,0.7391304347826086,0.6520547945205479,medlm,mimiciii,radiology_report,PROMPT1_ICL_entailment
293,362,9,3,6,0.3333333333333333,24,11,13,0.4583333333333333,0.3859649122807017,medlm,mimiciii,radiology_report,PROMPT1_ICL_entailment
294,363,5,4,1,0.8,22,10,12,0.4545454545454545,0.5797101449275363,medlm,mimiciii,radiology_report,PROMPT1_ICL_entailment
295,364,4,4,0,1.0,11,6,5,0.5454545454545454,0.7058823529411764,medlm,mimiciii,radiology_report,PROMPT1_ICL_entailment
296,365,13,9,4,0.6923076923076923,29,19,10,0.6551724137931034,0.6732283464566929,medlm,mimiciii,radiology_report,PROMPT1_ICL_entailment
297,366,9,9,0,1.0,13,9,4,0.6923076923076923,0.8181818181818181,medlm,mimiciii,radiology_report,PROMPT1_ICL_entailment
298,367,11,8,3,0.7272727272727273,16,11,5,0.6875,0.7068273092369478,medlm,mimiciii,radiology_report,PROMPT1_ICL_entailment
299,368,9,6,3,0.6666666666666666,20,10,10,0.5,0.5714285714285715,medlm,mimiciii,radiology_report,PROMPT1_ICL_entailment
300,369,13,9,4,0.6923076923076923,20,15,5,0.75,0.7199999999999999,medlm,mimiciii,radiology_report,PROMPT1_ICL_entailment
301,37,7,5,2,0.7142857142857143,21,14,7,0.6666666666666666,0.689655172413793,medlm,mimiciii,radiology_report,PROMPT1_ICL_entailment
302,370,6,5,1,0.8333333333333334,19,8,11,0.4210526315789473,0.5594405594405594,medlm,mimiciii,radiology_report,PROMPT1_ICL_entailment
303,371,8,7,1,0.875,17,14,3,0.8235294117647058,0.8484848484848485,medlm,mimiciii,radiology_report,PROMPT1_ICL_entailment
304,372,8,7,1,0.875,31,20,11,0.6451612903225806,0.7427055702917772,medlm,mimiciii,radiology_report,PROMPT1_ICL_entailment
305,373,9,8,1,0.8888888888888888,23,17,6,0.7391304347826086,0.8071216617210683,medlm,mimiciii,radiology_report,PROMPT1_ICL_entailment
306,374,7,7,0,1.0,11,7,4,0.6363636363636364,0.7777777777777778,medlm,mimiciii,radiology_report,PROMPT1_ICL_entailment
307,375,8,8,0,1.0,16,11,5,0.6875,0.8148148148148148,medlm,mimiciii,radiology_report,PROMPT1_ICL_entailment
308,376,8,5,3,0.625,18,14,4,0.7777777777777778,0.6930693069306931,medlm,mimiciii,radiology_report,PROMPT1_ICL_entailment
309,377,5,4,1,0.8,10,6,4,0.6,0.6857142857142857,medlm,mimiciii,radiology_report,PROMPT1_ICL_entailment
310,378,10,9,1,0.9,24,15,9,0.625,0.7377049180327869,medlm,mimiciii,radiology_report,PROMPT1_ICL_entailment
311,379,8,6,2,0.75,18,14,4,0.7777777777777778,0.7636363636363638,medlm,mimiciii,radiology_report,PROMPT1_ICL_entailment
312,38,9,6,3,0.6666666666666666,19,18,1,0.9473684210526316,0.782608695652174,medlm,mimiciii,radiology_report,PROMPT1_ICL_entailment
313,380,5,5,0,1.0,8,7,1,0.875,0.9333333333333332,medlm,mimiciii,radiology_report,PROMPT1_ICL_entailment
314,381,4,2,2,0.5,14,6,8,0.4285714285714285,0.4615384615384615,medlm,mimiciii,radiology_report,PROMPT1_ICL_entailment
315,382,7,7,0,1.0,16,9,7,0.5625,0.72,medlm,mimiciii,radiology_report,PROMPT1_ICL_entailment
316,383,9,4,5,0.4444444444444444,17,15,2,0.8823529411764706,0.5911330049261083,medlm,mimiciii,radiology_report,PROMPT1_ICL_entailment
317,384,6,6,0,1.0,13,11,2,0.8461538461538461,0.9166666666666666,medlm,mimiciii,radiology_report,PROMPT1_ICL_entailment
318,385,10,6,4,0.6,27,20,7,0.7407407407407407,0.6629834254143647,medlm,mimiciii,radiology_report,PROMPT1_ICL_entailment
319,386,9,8,1,0.8888888888888888,18,12,6,0.6666666666666666,0.761904761904762,medlm,mimiciii,radiology_report,PROMPT1_ICL_entailment
320,387,5,4,1,0.8,19,12,7,0.631578947368421,0.7058823529411765,medlm,mimiciii,radiology_report,PROMPT1_ICL_entailment
321,388,10,8,2,0.8,33,26,7,0.7878787878787878,0.7938931297709925,medlm,mimiciii,radiology_report,PROMPT1_ICL_entailment
322,389,6,6,0,1.0,12,9,3,0.75,0.8571428571428571,medlm,mimiciii,radiology_report,PROMPT1_ICL_entailment
323,39,7,6,1,0.8571428571428571,10,7,3,0.7,0.7706422018348624,medlm,mimiciii,radiology_report,PROMPT1_ICL_entailment
324,390,6,5,1,0.8333333333333334,14,9,5,0.6428571428571429,0.7258064516129034,medlm,mimiciii,radiology_report,PROMPT1_ICL_entailment
325,391,8,8,0,1.0,13,9,4,0.6923076923076923,0.8181818181818181,medlm,mimiciii,radiology_report,PROMPT1_ICL_entailment
326,392,11,7,4,0.6363636363636364,15,9,6,0.6,0.6176470588235293,medlm,mimiciii,radiology_report,PROMPT1_ICL_entailment
327,393,6,3,3,0.5,19,12,7,0.631578947368421,0.5581395348837209,medlm,mimiciii,radiology_report,PROMPT1_ICL_entailment
328,394,10,10,0,1.0,18,14,4,0.7777777777777778,0.8750000000000001,medlm,mimiciii,radiology_report,PROMPT1_ICL_entailment
329,395,6,3,3,0.5,16,11,5,0.6875,0.5789473684210527,medlm,mimiciii,radiology_report,PROMPT1_ICL_entailment
330,396,8,6,2,0.75,19,10,9,0.5263157894736842,0.6185567010309279,medlm,mimiciii,radiology_report,PROMPT1_ICL_entailment
331,397,8,6,2,0.75,18,11,7,0.6111111111111112,0.6734693877551021,medlm,mimiciii,radiology_report,PROMPT1_ICL_entailment
332,398,7,3,4,0.4285714285714285,21,16,5,0.7619047619047619,0.5485714285714285,medlm,mimiciii,radiology_report,PROMPT1_ICL_entailment
333,399,7,5,2,0.7142857142857143,19,15,4,0.7894736842105263,0.7500000000000001,medlm,mimiciii,radiology_report,PROMPT1_ICL_entailment
334,4,7,6,1,0.8571428571428571,16,11,5,0.6875,0.7630057803468208,medlm,mimiciii,radiology_report,PROMPT1_ICL_entailment
335,40,8,6,2,0.75,17,13,4,0.7647058823529411,0.7572815533980582,medlm,mimiciii,radiology_report,PROMPT1_ICL_entailment
336,400,7,6,1,0.8571428571428571,13,11,2,0.8461538461538461,0.8516129032258064,medlm,mimiciii,radiology_report,PROMPT1_ICL_entailment
337,401,6,5,1,0.8333333333333334,9,7,2,0.7777777777777778,0.8045977011494253,medlm,mimiciii,radiology_report,PROMPT1_ICL_entailment
338,402,7,2,5,0.2857142857142857,20,10,10,0.5,0.3636363636363636,medlm,mimiciii,radiology_report,PROMPT1_ICL_entailment
339,403,8,7,1,0.875,18,13,5,0.7222222222222222,0.7913043478260868,medlm,mimiciii,radiology_report,PROMPT1_ICL_entailment
340,404,8,5,3,0.625,19,14,5,0.7368421052631579,0.6763285024154588,medlm,mimiciii,radiology_report,PROMPT1_ICL_entailment
341,405,8,3,5,0.375,14,9,5,0.6428571428571429,0.4736842105263159,medlm,mimiciii,radiology_report,PROMPT1_ICL_entailment
342,406,6,3,3,0.5,25,12,13,0.48,0.4897959183673469,medlm,mimiciii,radiology_report,PROMPT1_ICL_entailment
343,407,5,2,3,0.4,20,10,10,0.5,0.4444444444444445,medlm,mimiciii,radiology_report,PROMPT1_ICL_entailment
344,408,11,7,4,0.6363636363636364,20,13,7,0.65,0.6431095406360424,medlm,mimiciii,radiology_report,PROMPT1_ICL_entailment
345,409,8,5,3,0.625,21,11,10,0.5238095238095238,0.5699481865284974,medlm,mimiciii,radiology_report,PROMPT1_ICL_entailment
346,41,11,8,3,0.7272727272727273,26,14,12,0.5384615384615384,0.6187845303867403,medlm,mimiciii,radiology_report,PROMPT1_ICL_entailment
347,410,9,9,0,1.0,20,13,7,0.65,0.787878787878788,medlm,mimiciii,radiology_report,PROMPT1_ICL_entailment
348,411,6,5,1,0.8333333333333334,6,4,2,0.6666666666666666,0.7407407407407408,medlm,mimiciii,radiology_report,PROMPT1_ICL_entailment
349,412,7,7,0,1.0,26,14,12,0.5384615384615384,0.7000000000000001,medlm,mimiciii,radiology_report,PROMPT1_ICL_entailment
350,413,5,3,2,0.6,14,10,4,0.7142857142857143,0.6521739130434783,medlm,mimiciii,radiology_report,PROMPT1_ICL_entailment
351,414,11,8,3,0.7272727272727273,28,18,10,0.6428571428571429,0.6824644549763033,medlm,mimiciii,radiology_report,PROMPT1_ICL_entailment
352,415,6,5,1,0.8333333333333334,20,17,3,0.85,0.8415841584158417,medlm,mimiciii,radiology_report,PROMPT1_ICL_entailment
353,416,5,4,1,0.8,19,11,8,0.5789473684210527,0.6717557251908397,medlm,mimiciii,radiology_report,PROMPT1_ICL_entailment
354,417,9,6,3,0.6666666666666666,20,14,6,0.7,0.6829268292682926,medlm,mimiciii,radiology_report,PROMPT1_ICL_entailment
355,418,8,6,2,0.75,14,10,4,0.7142857142857143,0.7317073170731706,medlm,mimiciii,radiology_report,PROMPT1_ICL_entailment
356,419,5,1,4,0.2,16,10,6,0.625,0.303030303030303,medlm,mimiciii,radiology_report,PROMPT1_ICL_entailment
357,42,11,6,5,0.5454545454545454,14,9,5,0.6428571428571429,0.5901639344262296,medlm,mimiciii,radiology_report,PROMPT1_ICL_entailment
358,420,10,6,4,0.6,15,8,7,0.5333333333333333,0.5647058823529412,medlm,mimiciii,radiology_report,PROMPT1_ICL_entailment
359,421,11,4,7,0.3636363636363636,23,16,7,0.6956521739130435,0.4776119402985074,medlm,mimiciii,radiology_report,PROMPT1_ICL_entailment
360,422,8,4,4,0.5,20,12,8,0.6,0.5454545454545454,medlm,mimiciii,radiology_report,PROMPT1_ICL_entailment
361,423,6,5,1,0.8333333333333334,12,5,7,0.4166666666666667,0.5555555555555556,medlm,mimiciii,radiology_report,PROMPT1_ICL_entailment
362,424,5,5,0,1.0,9,5,4,0.5555555555555556,0.7142857142857143,medlm,mimiciii,radiology_report,PROMPT1_ICL_entailment
363,425,10,6,4,0.6,19,13,6,0.6842105263157895,0.639344262295082,medlm,mimiciii,radiology_report,PROMPT1_ICL_entailment
364,426,6,5,1,0.8333333333333334,16,14,2,0.875,0.8536585365853658,medlm,mimiciii,radiology_report,PROMPT1_ICL_entailment
365,427,5,5,0,1.0,15,8,7,0.5333333333333333,0.6956521739130436,medlm,mimiciii,radiology_report,PROMPT1_ICL_entailment
366,428,7,6,1,0.8571428571428571,15,13,2,0.8666666666666667,0.861878453038674,medlm,mimiciii,radiology_report,PROMPT1_ICL_entailment
367,429,10,9,1,0.9,13,8,5,0.6153846153846154,0.7309644670050762,medlm,mimiciii,radiology_report,PROMPT1_ICL_entailment
368,43,6,6,0,1.0,7,5,2,0.7142857142857143,0.8333333333333333,medlm,mimiciii,radiology_report,PROMPT1_ICL_entailment
369,430,3,3,0,1.0,7,5,2,0.7142857142857143,0.8333333333333333,medlm,mimiciii,radiology_report,PROMPT1_ICL_entailment
370,431,6,2,4,0.3333333333333333,18,11,7,0.6111111111111112,0.4313725490196078,medlm,mimiciii,radiology_report,PROMPT1_ICL_entailment
371,432,4,2,2,0.5,13,8,5,0.6153846153846154,0.5517241379310345,medlm,mimiciii,radiology_report,PROMPT1_ICL_entailment
372,433,8,6,2,0.75,18,16,2,0.8888888888888888,0.8135593220338982,medlm,mimiciii,radiology_report,PROMPT1_ICL_entailment
373,434,9,5,4,0.5555555555555556,27,15,12,0.5555555555555556,0.5555555555555556,medlm,mimiciii,radiology_report,PROMPT1_ICL_entailment
374,435,7,5,2,0.7142857142857143,13,11,2,0.8461538461538461,0.7746478873239436,medlm,mimiciii,radiology_report,PROMPT1_ICL_entailment
375,436,6,3,3,0.5,25,18,7,0.72,0.5901639344262295,medlm,mimiciii,radiology_report,PROMPT1_ICL_entailment
376,437,4,4,0,1.0,7,4,3,0.5714285714285714,0.7272727272727273,medlm,mimiciii,radiology_report,PROMPT1_ICL_entailment
377,438,9,9,0,1.0,19,14,5,0.7368421052631579,0.8484848484848484,medlm,mimiciii,radiology_report,PROMPT1_ICL_entailment
378,439,16,12,4,0.75,22,17,5,0.7727272727272727,0.7611940298507464,medlm,mimiciii,radiology_report,PROMPT1_ICL_entailment
379,44,8,7,1,0.875,16,11,5,0.6875,0.77,medlm,mimiciii,radiology_report,PROMPT1_ICL_entailment
380,440,7,6,1,0.8571428571428571,19,13,6,0.6842105263157895,0.7609756097560976,medlm,mimiciii,radiology_report,PROMPT1_ICL_entailment
381,441,9,6,3,0.6666666666666666,17,14,3,0.8235294117647058,0.7368421052631577,medlm,mimiciii,radiology_report,PROMPT1_ICL_entailment
382,442,6,6,0,1.0,12,5,7,0.4166666666666667,0.5882352941176471,medlm,mimiciii,radiology_report,PROMPT1_ICL_entailment
383,443,14,9,5,0.6428571428571429,21,14,7,0.6666666666666666,0.6545454545454545,medlm,mimiciii,radiology_report,PROMPT1_ICL_entailment
384,444,8,8,0,1.0,8,6,2,0.75,0.8571428571428571,medlm,mimiciii,radiology_report,PROMPT1_ICL_entailment
385,445,8,6,2,0.75,22,18,4,0.8181818181818182,0.7826086956521738,medlm,mimiciii,radiology_report,PROMPT1_ICL_entailment
386,446,15,10,5,0.6666666666666666,22,15,7,0.6818181818181818,0.6741573033707865,medlm,mimiciii,radiology_report,PROMPT1_ICL_entailment
387,447,7,5,2,0.7142857142857143,14,12,2,0.8571428571428571,0.7792207792207793,medlm,mimiciii,radiology_report,PROMPT1_ICL_entailment
388,448,15,12,3,0.8,36,17,19,0.4722222222222222,0.5938864628820961,medlm,mimiciii,radiology_report,PROMPT1_ICL_entailment
389,449,3,3,0,1.0,9,6,3,0.6666666666666666,0.8,medlm,mimiciii,radiology_report,PROMPT1_ICL_entailment
390,45,12,6,6,0.5,20,11,9,0.55,0.5238095238095238,medlm,mimiciii,radiology_report,PROMPT1_ICL_entailment
391,450,8,4,4,0.5,21,16,5,0.7619047619047619,0.6037735849056604,medlm,mimiciii,radiology_report,PROMPT1_ICL_entailment
392,451,10,9,1,0.9,10,7,3,0.7,0.7875,medlm,mimiciii,radiology_report,PROMPT1_ICL_entailment
393,452,12,12,0,1.0,16,14,2,0.875,0.9333333333333332,medlm,mimiciii,radiology_report,PROMPT1_ICL_entailment
394,453,10,8,2,0.8,14,11,3,0.7857142857142857,0.7927927927927927,medlm,mimiciii,radiology_report,PROMPT1_ICL_entailment
395,454,6,5,1,0.8333333333333334,10,7,3,0.7,0.7608695652173915,medlm,mimiciii,radiology_report,PROMPT1_ICL_entailment
396,455,5,3,2,0.6,16,10,6,0.625,0.6122448979591836,medlm,mimiciii,radiology_report,PROMPT1_ICL_entailment
397,456,8,6,2,0.75,21,17,4,0.8095238095238095,0.7786259541984734,medlm,mimiciii,radiology_report,PROMPT1_ICL_entailment
398,457,7,7,0,1.0,12,8,4,0.6666666666666666,0.8,medlm,mimiciii,radiology_report,PROMPT1_ICL_entailment
399,458,5,4,1,0.8,16,9,7,0.5625,0.6605504587155964,medlm,mimiciii,radiology_report,PROMPT1_ICL_entailment
400,459,5,4,1,0.8,13,6,7,0.4615384615384615,0.5853658536585367,medlm,mimiciii,radiology_report,PROMPT1_ICL_entailment
401,46,7,7,0,1.0,26,16,10,0.6153846153846154,0.761904761904762,medlm,mimiciii,radiology_report,PROMPT1_ICL_entailment
402,460,12,8,4,0.6666666666666666,20,14,6,0.7,0.6829268292682926,medlm,mimiciii,radiology_report,PROMPT1_ICL_entailment
403,461,7,4,3,0.5714285714285714,22,7,15,0.3181818181818182,0.4087591240875912,medlm,mimiciii,radiology_report,PROMPT1_ICL_entailment
404,462,7,2,5,0.2857142857142857,20,15,5,0.75,0.4137931034482759,medlm,mimiciii,radiology_report,PROMPT1_ICL_entailment
405,463,5,5,0,1.0,12,8,4,0.6666666666666666,0.8,medlm,mimiciii,radiology_report,PROMPT1_ICL_entailment
406,464,14,8,6,0.5714285714285714,25,18,7,0.72,0.6371681415929202,medlm,mimiciii,radiology_report,PROMPT1_ICL_entailment
407,465,10,8,2,0.8,33,15,18,0.4545454545454545,0.5797101449275363,medlm,mimiciii,radiology_report,PROMPT1_ICL_entailment
408,466,6,4,2,0.6666666666666666,22,10,12,0.4545454545454545,0.5405405405405405,medlm,mimiciii,radiology_report,PROMPT1_ICL_entailment
409,467,5,4,1,0.8,14,9,5,0.6428571428571429,0.7128712871287128,medlm,mimiciii,radiology_report,PROMPT1_ICL_entailment
410,468,7,6,1,0.8571428571428571,18,12,6,0.6666666666666666,0.75,medlm,mimiciii,radiology_report,PROMPT1_ICL_entailment
411,469,14,10,4,0.7142857142857143,25,15,10,0.6,0.6521739130434783,medlm,mimiciii,radiology_report,PROMPT1_ICL_entailment
412,47,6,5,1,0.8333333333333334,15,8,7,0.5333333333333333,0.6504065040650406,medlm,mimiciii,radiology_report,PROMPT1_ICL_entailment
413,470,8,5,3,0.625,15,11,4,0.7333333333333333,0.6748466257668712,medlm,mimiciii,radiology_report,PROMPT1_ICL_entailment
414,471,9,6,3,0.6666666666666666,18,12,6,0.6666666666666666,0.6666666666666666,medlm,mimiciii,radiology_report,PROMPT1_ICL_entailment
415,472,10,9,1,0.9,16,8,8,0.5,0.6428571428571429,medlm,mimiciii,radiology_report,PROMPT1_ICL_entailment
416,473,5,3,2,0.6,11,7,4,0.6363636363636364,0.6176470588235293,medlm,mimiciii,radiology_report,PROMPT1_ICL_entailment
417,474,10,9,1,0.9,25,17,8,0.68,0.7746835443037976,medlm,mimiciii,radiology_report,PROMPT1_ICL_entailment
418,475,3,3,0,1.0,7,3,4,0.4285714285714285,0.6,medlm,mimiciii,radiology_report,PROMPT1_ICL_entailment
419,476,15,12,3,0.8,12,8,4,0.6666666666666666,0.7272727272727272,medlm,mimiciii,radiology_report,PROMPT1_ICL_entailment
420,477,10,6,4,0.6,16,12,4,0.75,0.6666666666666665,medlm,mimiciii,radiology_report,PROMPT1_ICL_entailment
421,478,11,11,0,1.0,21,14,7,0.6666666666666666,0.8,medlm,mimiciii,radiology_report,PROMPT1_ICL_entailment
422,479,10,7,3,0.7,22,16,6,0.7272727272727273,0.7133757961783439,medlm,mimiciii,radiology_report,PROMPT1_ICL_entailment
423,48,7,5,2,0.7142857142857143,21,12,9,0.5714285714285714,0.634920634920635,medlm,mimiciii,radiology_report,PROMPT1_ICL_entailment
424,480,3,3,0,1.0,10,4,6,0.4,0.5714285714285715,medlm,mimiciii,radiology_report,PROMPT1_ICL_entailment
425,481,7,3,4,0.4285714285714285,17,12,5,0.7058823529411765,0.5333333333333333,medlm,mimiciii,radiology_report,PROMPT1_ICL_entailment
426,482,9,3,6,0.3333333333333333,19,11,8,0.5789473684210527,0.4230769230769231,medlm,mimiciii,radiology_report,PROMPT1_ICL_entailment
427,483,16,15,1,0.9375,27,13,14,0.4814814814814814,0.6362153344208809,medlm,mimiciii,radiology_report,PROMPT1_ICL_entailment
428,484,5,4,1,0.8,13,7,6,0.5384615384615384,0.6436781609195402,medlm,mimiciii,radiology_report,PROMPT1_ICL_entailment
429,485,8,8,0,1.0,27,12,15,0.4444444444444444,0.6153846153846153,medlm,mimiciii,radiology_report,PROMPT1_ICL_entailment
430,486,6,6,0,1.0,11,8,3,0.7272727272727273,0.8421052631578948,medlm,mimiciii,radiology_report,PROMPT1_ICL_entailment
431,487,7,5,2,0.7142857142857143,20,12,8,0.6,0.6521739130434783,medlm,mimiciii,radiology_report,PROMPT1_ICL_entailment
432,488,8,3,5,0.375,15,8,7,0.5333333333333333,0.4403669724770642,medlm,mimiciii,radiology_report,PROMPT1_ICL_entailment
433,489,7,4,3,0.5714285714285714,18,9,9,0.5,0.5333333333333333,medlm,mimiciii,radiology_report,PROMPT1_ICL_entailment
434,49,11,9,2,0.8181818181818182,24,16,8,0.6666666666666666,0.7346938775510203,medlm,mimiciii,radiology_report,PROMPT1_ICL_entailment
435,490,3,2,1,0.6666666666666666,8,2,6,0.25,0.3636363636363636,medlm,mimiciii,radiology_report,PROMPT1_ICL_entailment
436,491,6,5,1,0.8333333333333334,17,8,9,0.4705882352941176,0.6015037593984962,medlm,mimiciii,radiology_report,PROMPT1_ICL_entailment
437,492,8,8,0,1.0,13,9,4,0.6923076923076923,0.8181818181818181,medlm,mimiciii,radiology_report,PROMPT1_ICL_entailment
438,493,7,5,2,0.7142857142857143,9,4,5,0.4444444444444444,0.5479452054794521,medlm,mimiciii,radiology_report,PROMPT1_ICL_entailment
439,494,7,7,0,1.0,8,5,3,0.625,0.7692307692307693,medlm,mimiciii,radiology_report,PROMPT1_ICL_entailment
440,495,5,5,0,1.0,12,9,3,0.75,0.8571428571428571,medlm,mimiciii,radiology_report,PROMPT1_ICL_entailment
441,496,16,16,0,1.0,36,21,15,0.5833333333333334,0.7368421052631579,medlm,mimiciii,radiology_report,PROMPT1_ICL_entailment
442,497,6,5,1,0.8333333333333334,25,13,12,0.52,0.6403940886699507,medlm,mimiciii,radiology_report,PROMPT1_ICL_entailment
443,498,6,3,3,0.5,22,17,5,0.7727272727272727,0.6071428571428571,medlm,mimiciii,radiology_report,PROMPT1_ICL_entailment
444,499,13,10,3,0.7692307692307693,17,14,3,0.8235294117647058,0.7954545454545454,medlm,mimiciii,radiology_report,PROMPT1_ICL_entailment
445,5,9,8,1,0.8888888888888888,22,12,10,0.5454545454545454,0.676056338028169,medlm,mimiciii,radiology_report,PROMPT1_ICL_entailment
446,50,6,4,2,0.6666666666666666,15,9,6,0.6,0.631578947368421,medlm,mimiciii,radiology_report,PROMPT1_ICL_entailment
447,51,6,5,1,0.8333333333333334,13,9,4,0.6923076923076923,0.7563025210084034,medlm,mimiciii,radiology_report,PROMPT1_ICL_entailment
448,52,7,2,5,0.2857142857142857,21,13,8,0.6190476190476191,0.3909774436090225,medlm,mimiciii,radiology_report,PROMPT1_ICL_entailment
449,53,8,7,1,0.875,12,10,2,0.8333333333333334,0.8536585365853658,medlm,mimiciii,radiology_report,PROMPT1_ICL_entailment
450,54,9,8,1,0.8888888888888888,10,5,5,0.5,0.64,medlm,mimiciii,radiology_report,PROMPT1_ICL_entailment
451,55,12,6,6,0.5,18,14,4,0.7777777777777778,0.6086956521739131,medlm,mimiciii,radiology_report,PROMPT1_ICL_entailment
452,56,11,5,6,0.4545454545454545,21,12,9,0.5714285714285714,0.5063291139240506,medlm,mimiciii,radiology_report,PROMPT1_ICL_entailment
453,57,5,5,0,1.0,10,6,4,0.6,0.7499999999999999,medlm,mimiciii,radiology_report,PROMPT1_ICL_entailment
454,58,8,8,0,1.0,16,11,5,0.6875,0.8148148148148148,medlm,mimiciii,radiology_report,PROMPT1_ICL_entailment
455,59,7,6,1,0.8571428571428571,16,13,3,0.8125,0.8342245989304812,medlm,mimiciii,radiology_report,PROMPT1_ICL_entailment
456,6,3,3,0,1.0,8,6,2,0.75,0.8571428571428571,medlm,mimiciii,radiology_report,PROMPT1_ICL_entailment
457,60,10,7,3,0.7,19,9,10,0.4736842105263157,0.5650224215246636,medlm,mimiciii,radiology_report,PROMPT1_ICL_entailment
458,61,6,4,2,0.6666666666666666,22,13,9,0.5909090909090909,0.6265060240963856,medlm,mimiciii,radiology_report,PROMPT1_ICL_entailment
459,62,15,8,7,0.5333333333333333,13,7,6,0.5384615384615384,0.5358851674641149,medlm,mimiciii,radiology_report,PROMPT1_ICL_entailment
460,63,6,6,0,1.0,15,7,8,0.4666666666666667,0.6363636363636364,medlm,mimiciii,radiology_report,PROMPT1_ICL_entailment
461,64,7,6,1,0.8571428571428571,20,11,9,0.55,0.6700507614213198,medlm,mimiciii,radiology_report,PROMPT1_ICL_entailment
462,65,9,8,1,0.8888888888888888,18,13,5,0.7222222222222222,0.7969348659003831,medlm,mimiciii,radiology_report,PROMPT1_ICL_entailment
463,66,7,4,3,0.5714285714285714,34,22,12,0.6470588235294118,0.6068965517241379,medlm,mimiciii,radiology_report,PROMPT1_ICL_entailment
464,67,7,5,2,0.7142857142857143,28,20,8,0.7142857142857143,0.7142857142857143,medlm,mimiciii,radiology_report,PROMPT1_ICL_entailment
465,68,8,7,1,0.875,35,28,7,0.8,0.8358208955223881,medlm,mimiciii,radiology_report,PROMPT1_ICL_entailment
466,69,12,6,6,0.5,31,16,15,0.5161290322580645,0.5079365079365079,medlm,mimiciii,radiology_report,PROMPT1_ICL_entailment
467,7,8,7,1,0.875,16,15,1,0.9375,0.9051724137931034,medlm,mimiciii,radiology_report,PROMPT1_ICL_entailment
468,70,5,2,3,0.4,17,13,4,0.7647058823529411,0.5252525252525253,medlm,mimiciii,radiology_report,PROMPT1_ICL_entailment
469,71,8,7,1,0.875,18,10,8,0.5555555555555556,0.6796116504854369,medlm,mimiciii,radiology_report,PROMPT1_ICL_entailment
470,72,6,5,1,0.8333333333333334,13,9,4,0.6923076923076923,0.7563025210084034,medlm,mimiciii,radiology_report,PROMPT1_ICL_entailment
471,73,14,10,4,0.7142857142857143,34,14,20,0.4117647058823529,0.5223880597014926,medlm,mimiciii,radiology_report,PROMPT1_ICL_entailment
472,74,6,4,2,0.6666666666666666,18,12,6,0.6666666666666666,0.6666666666666666,medlm,mimiciii,radiology_report,PROMPT1_ICL_entailment
473,75,9,6,3,0.6666666666666666,12,9,3,0.75,0.7058823529411765,medlm,mimiciii,radiology_report,PROMPT1_ICL_entailment
474,76,10,8,2,0.8,14,10,4,0.7142857142857143,0.7547169811320756,medlm,mimiciii,radiology_report,PROMPT1_ICL_entailment
475,77,11,11,0,1.0,26,18,8,0.6923076923076923,0.8181818181818181,medlm,mimiciii,radiology_report,PROMPT1_ICL_entailment
476,78,13,11,2,0.8461538461538461,33,22,11,0.6666666666666666,0.7457627118644068,medlm,mimiciii,radiology_report,PROMPT1_ICL_entailment
477,79,7,6,1,0.8571428571428571,17,10,7,0.5882352941176471,0.6976744186046512,medlm,mimiciii,radiology_report,PROMPT1_ICL_entailment
478,8,10,8,2,0.8,15,13,2,0.8666666666666667,0.832,medlm,mimiciii,radiology_report,PROMPT1_ICL_entailment
479,80,10,7,3,0.7,25,17,8,0.68,0.6898550724637681,medlm,mimiciii,radiology_report,PROMPT1_ICL_entailment
480,81,5,2,3,0.4,15,8,7,0.5333333333333333,0.4571428571428572,medlm,mimiciii,radiology_report,PROMPT1_ICL_entailment
481,82,9,8,1,0.8888888888888888,14,12,2,0.8571428571428571,0.8727272727272727,medlm,mimiciii,radiology_report,PROMPT1_ICL_entailment
482,83,10,7,3,0.7,17,11,6,0.6470588235294118,0.6724890829694322,medlm,mimiciii,radiology_report,PROMPT1_ICL_entailment
483,84,10,8,2,0.8,20,14,6,0.7,0.7466666666666666,medlm,mimiciii,radiology_report,PROMPT1_ICL_entailment
484,85,12,10,2,0.8333333333333334,14,12,2,0.8571428571428571,0.8450704225352113,medlm,mimiciii,radiology_report,PROMPT1_ICL_entailment
485,86,6,6,0,1.0,10,6,4,0.6,0.7499999999999999,medlm,mimiciii,radiology_report,PROMPT1_ICL_entailment
486,87,6,6,0,1.0,14,7,7,0.5,0.6666666666666666,medlm,mimiciii,radiology_report,PROMPT1_ICL_entailment
487,88,10,6,4,0.6,19,17,2,0.8947368421052632,0.7183098591549296,medlm,mimiciii,radiology_report,PROMPT1_ICL_entailment
488,89,9,5,4,0.5555555555555556,18,12,6,0.6666666666666666,0.606060606060606,medlm,mimiciii,radiology_report,PROMPT1_ICL_entailment
489,9,5,4,1,0.8,13,8,5,0.6153846153846154,0.6956521739130435,medlm,mimiciii,radiology_report,PROMPT1_ICL_entailment
490,90,6,5,1,0.8333333333333334,14,9,5,0.6428571428571429,0.7258064516129034,medlm,mimiciii,radiology_report,PROMPT1_ICL_entailment
491,91,5,5,0,1.0,13,9,4,0.6923076923076923,0.8181818181818181,medlm,mimiciii,radiology_report,PROMPT1_ICL_entailment
492,92,4,3,1,0.75,21,9,12,0.4285714285714285,0.5454545454545454,medlm,mimiciii,radiology_report,PROMPT1_ICL_entailment
493,93,8,5,3,0.625,15,11,4,0.7333333333333333,0.6748466257668712,medlm,mimiciii,radiology_report,PROMPT1_ICL_entailment
494,94,13,9,4,0.6923076923076923,28,20,8,0.7142857142857143,0.7031250000000001,medlm,mimiciii,radiology_report,PROMPT1_ICL_entailment
495,95,10,10,0,1.0,18,10,8,0.5555555555555556,0.7142857142857143,medlm,mimiciii,radiology_report,PROMPT1_ICL_entailment
496,96,11,9,2,0.8181818181818182,21,15,6,0.7142857142857143,0.7627118644067797,medlm,mimiciii,radiology_report,PROMPT1_ICL_entailment
497,97,9,7,2,0.7777777777777778,23,14,9,0.6086956521739131,0.6829268292682927,medlm,mimiciii,radiology_report,PROMPT1_ICL_entailment
498,98,9,6,3,0.6666666666666666,19,12,7,0.631578947368421,0.6486486486486486,medlm,mimiciii,radiology_report,PROMPT1_ICL_entailment
499,99,4,2,2,0.5,13,9,4,0.6923076923076923,0.5806451612903226,medlm,mimiciii,radiology_report,PROMPT1_ICL_entailment
0,0,13,5,8,0.3846153846153846,21,11,10,0.5238095238095238,0.4435483870967742,medlm,mimiciii,radiology_report,PROMPT2_ICL_entailment
1,1,7,4,3,0.5714285714285714,15,10,5,0.6666666666666666,0.6153846153846153,medlm,mimiciii,radiology_report,PROMPT2_ICL_entailment
2,10,6,5,1,0.8333333333333334,18,9,9,0.5,0.625,medlm,mimiciii,radiology_report,PROMPT2_ICL_entailment
3,100,6,6,0,1.0,9,7,2,0.7777777777777778,0.8750000000000001,medlm,mimiciii,radiology_report,PROMPT2_ICL_entailment
4,101,6,5,1,0.8333333333333334,15,9,6,0.6,0.6976744186046512,medlm,mimiciii,radiology_report,PROMPT2_ICL_entailment
5,102,8,8,0,1.0,16,7,9,0.4375,0.6086956521739131,medlm,mimiciii,radiology_report,PROMPT2_ICL_entailment
6,103,9,6,3,0.6666666666666666,19,13,6,0.6842105263157895,0.6753246753246753,medlm,mimiciii,radiology_report,PROMPT2_ICL_entailment
7,104,12,6,6,0.5,17,10,7,0.5882352941176471,0.5405405405405405,medlm,mimiciii,radiology_report,PROMPT2_ICL_entailment
8,105,4,4,0,1.0,8,5,3,0.625,0.7692307692307693,medlm,mimiciii,radiology_report,PROMPT2_ICL_entailment
9,106,7,6,1,0.8571428571428571,12,6,6,0.5,0.631578947368421,medlm,mimiciii,radiology_report,PROMPT2_ICL_entailment
10,107,8,4,4,0.5,19,10,9,0.5263157894736842,0.5128205128205129,medlm,mimiciii,radiology_report,PROMPT2_ICL_entailment
11,108,8,8,0,1.0,13,7,6,0.5384615384615384,0.7000000000000001,medlm,mimiciii,radiology_report,PROMPT2_ICL_entailment
12,109,8,7,1,0.875,20,14,6,0.7,0.7777777777777777,medlm,mimiciii,radiology_report,PROMPT2_ICL_entailment
13,11,6,6,0,1.0,24,13,11,0.5416666666666666,0.7027027027027027,medlm,mimiciii,radiology_report,PROMPT2_ICL_entailment
14,110,9,6,3,0.6666666666666666,17,10,7,0.5882352941176471,0.625,medlm,mimiciii,radiology_report,PROMPT2_ICL_entailment
15,111,7,3,4,0.4285714285714285,20,16,4,0.8,0.5581395348837209,medlm,mimiciii,radiology_report,PROMPT2_ICL_entailment
16,112,7,7,0,1.0,14,9,5,0.6428571428571429,0.782608695652174,medlm,mimiciii,radiology_report,PROMPT2_ICL_entailment
17,113,7,4,3,0.5714285714285714,20,10,10,0.5,0.5333333333333333,medlm,mimiciii,radiology_report,PROMPT2_ICL_entailment
18,114,9,2,7,0.2222222222222222,23,14,9,0.6086956521739131,0.3255813953488372,medlm,mimiciii,radiology_report,PROMPT2_ICL_entailment
19,115,6,6,0,1.0,20,9,11,0.45,0.6206896551724138,medlm,mimiciii,radiology_report,PROMPT2_ICL_entailment
20,116,8,8,0,1.0,13,8,5,0.6153846153846154,0.761904761904762,medlm,mimiciii,radiology_report,PROMPT2_ICL_entailment
21,117,7,5,2,0.7142857142857143,16,9,7,0.5625,0.6293706293706294,medlm,mimiciii,radiology_report,PROMPT2_ICL_entailment
22,118,8,3,5,0.375,24,18,6,0.75,0.5,medlm,mimiciii,radiology_report,PROMPT2_ICL_entailment
23,119,10,9,1,0.9,17,11,6,0.6470588235294118,0.752851711026616,medlm,mimiciii,radiology_report,PROMPT2_ICL_entailment
24,12,8,7,1,0.875,17,14,3,0.8235294117647058,0.8484848484848485,medlm,mimiciii,radiology_report,PROMPT2_ICL_entailment
25,120,7,2,5,0.2857142857142857,16,10,6,0.625,0.392156862745098,medlm,mimiciii,radiology_report,PROMPT2_ICL_entailment
26,121,9,6,3,0.6666666666666666,26,19,7,0.7307692307692307,0.6972477064220183,medlm,mimiciii,radiology_report,PROMPT2_ICL_entailment
27,122,9,7,2,0.7777777777777778,20,15,5,0.75,0.7636363636363638,medlm,mimiciii,radiology_report,PROMPT2_ICL_entailment
28,123,8,7,1,0.875,13,10,3,0.7692307692307693,0.8187134502923977,medlm,mimiciii,radiology_report,PROMPT2_ICL_entailment
29,124,4,4,0,1.0,12,7,5,0.5833333333333334,0.7368421052631579,medlm,mimiciii,radiology_report,PROMPT2_ICL_entailment
30,125,10,7,3,0.7,23,14,9,0.6086956521739131,0.6511627906976744,medlm,mimiciii,radiology_report,PROMPT2_ICL_entailment
31,126,2,1,1,0.5,9,4,5,0.4444444444444444,0.4705882352941176,medlm,mimiciii,radiology_report,PROMPT2_ICL_entailment
32,127,7,7,0,1.0,50,22,28,0.44,0.6111111111111112,medlm,mimiciii,radiology_report,PROMPT2_ICL_entailment
33,128,8,7,1,0.875,14,10,4,0.7142857142857143,0.7865168539325842,medlm,mimiciii,radiology_report,PROMPT2_ICL_entailment
34,129,8,4,4,0.5,16,11,5,0.6875,0.5789473684210527,medlm,mimiciii,radiology_report,PROMPT2_ICL_entailment
35,13,11,8,3,0.7272727272727273,17,15,2,0.8823529411764706,0.7973421926910299,medlm,mimiciii,radiology_report,PROMPT2_ICL_entailment
36,130,9,9,0,1.0,29,16,13,0.5517241379310345,0.7111111111111111,medlm,mimiciii,radiology_report,PROMPT2_ICL_entailment
37,131,6,5,1,0.8333333333333334,45,14,31,0.3111111111111111,0.453074433656958,medlm,mimiciii,radiology_report,PROMPT2_ICL_entailment
38,132,3,3,0,1.0,23,9,14,0.391304347826087,0.5625,medlm,mimiciii,radiology_report,PROMPT2_ICL_entailment
39,133,10,9,1,0.9,21,11,10,0.5238095238095238,0.6622073578595318,medlm,mimiciii,radiology_report,PROMPT2_ICL_entailment
40,134,10,5,5,0.5,23,16,7,0.6956521739130435,0.5818181818181818,medlm,mimiciii,radiology_report,PROMPT2_ICL_entailment
41,135,8,7,1,0.875,20,14,6,0.7,0.7777777777777777,medlm,mimiciii,radiology_report,PROMPT2_ICL_entailment
42,136,8,6,2,0.75,14,9,5,0.6428571428571429,0.6923076923076924,medlm,mimiciii,radiology_report,PROMPT2_ICL_entailment
43,137,4,4,0,1.0,10,7,3,0.7,0.8235294117647058,medlm,mimiciii,radiology_report,PROMPT2_ICL_entailment
44,138,8,6,2,0.75,14,10,4,0.7142857142857143,0.7317073170731706,medlm,mimiciii,radiology_report,PROMPT2_ICL_entailment
45,139,4,3,1,0.75,13,6,7,0.4615384615384615,0.5714285714285714,medlm,mimiciii,radiology_report,PROMPT2_ICL_entailment
46,14,7,7,0,1.0,12,9,3,0.75,0.8571428571428571,medlm,mimiciii,radiology_report,PROMPT2_ICL_entailment
47,140,12,8,4,0.6666666666666666,18,13,5,0.7222222222222222,0.6933333333333334,medlm,mimiciii,radiology_report,PROMPT2_ICL_entailment
48,141,8,6,2,0.75,16,8,8,0.5,0.6,medlm,mimiciii,radiology_report,PROMPT2_ICL_entailment
49,142,11,8,3,0.7272727272727273,14,11,3,0.7857142857142857,0.7553648068669527,medlm,mimiciii,radiology_report,PROMPT2_ICL_entailment
50,143,7,6,1,0.8571428571428571,32,16,16,0.5,0.631578947368421,medlm,mimiciii,radiology_report,PROMPT2_ICL_entailment
51,144,8,6,2,0.75,26,13,13,0.5,0.6,medlm,mimiciii,radiology_report,PROMPT2_ICL_entailment
52,145,10,9,1,0.9,18,15,3,0.8333333333333334,0.8653846153846153,medlm,mimiciii,radiology_report,PROMPT2_ICL_entailment
53,146,6,5,1,0.8333333333333334,11,8,3,0.7272727272727273,0.7766990291262137,medlm,mimiciii,radiology_report,PROMPT2_ICL_entailment
54,147,6,4,2,0.6666666666666666,10,6,4,0.6,0.631578947368421,medlm,mimiciii,radiology_report,PROMPT2_ICL_entailment
55,148,8,7,1,0.875,32,15,17,0.46875,0.6104651162790697,medlm,mimiciii,radiology_report,PROMPT2_ICL_entailment
56,149,10,9,1,0.9,20,13,7,0.65,0.7548387096774194,medlm,mimiciii,radiology_report,PROMPT2_ICL_entailment
57,15,9,4,5,0.4444444444444444,29,19,10,0.6551724137931034,0.5296167247386759,medlm,mimiciii,radiology_report,PROMPT2_ICL_entailment
58,150,6,4,2,0.6666666666666666,14,9,5,0.6428571428571429,0.6545454545454545,medlm,mimiciii,radiology_report,PROMPT2_ICL_entailment
59,151,8,4,4,0.5,15,7,8,0.4666666666666667,0.4827586206896552,medlm,mimiciii,radiology_report,PROMPT2_ICL_entailment
60,152,6,4,2,0.6666666666666666,18,10,8,0.5555555555555556,0.606060606060606,medlm,mimiciii,radiology_report,PROMPT2_ICL_entailment
61,153,2,0,2,0.0,16,3,13,0.1875,0.0,medlm,mimiciii,radiology_report,PROMPT2_ICL_entailment
62,154,10,5,5,0.5,23,12,11,0.5217391304347826,0.5106382978723404,medlm,mimiciii,radiology_report,PROMPT2_ICL_entailment
63,155,25,24,1,0.96,47,33,14,0.7021276595744681,0.8110599078341013,medlm,mimiciii,radiology_report,PROMPT2_ICL_entailment
64,156,4,3,1,0.75,20,7,13,0.35,0.4772727272727271,medlm,mimiciii,radiology_report,PROMPT2_ICL_entailment
65,157,11,10,1,0.9090909090909092,12,10,2,0.8333333333333334,0.8695652173913043,medlm,mimiciii,radiology_report,PROMPT2_ICL_entailment
66,158,3,3,0,1.0,6,1,5,0.1666666666666666,0.2857142857142857,medlm,mimiciii,radiology_report,PROMPT2_ICL_entailment
67,159,6,4,2,0.6666666666666666,13,9,4,0.6923076923076923,0.6792452830188679,medlm,mimiciii,radiology_report,PROMPT2_ICL_entailment
68,16,6,6,0,1.0,17,12,5,0.7058823529411765,0.8275862068965517,medlm,mimiciii,radiology_report,PROMPT2_ICL_entailment
69,160,7,7,0,1.0,12,7,5,0.5833333333333334,0.7368421052631579,medlm,mimiciii,radiology_report,PROMPT2_ICL_entailment
70,161,3,1,2,0.3333333333333333,13,4,9,0.3076923076923077,0.32,medlm,mimiciii,radiology_report,PROMPT2_ICL_entailment
71,162,11,10,1,0.9090909090909092,11,8,3,0.7272727272727273,0.8080808080808082,medlm,mimiciii,radiology_report,PROMPT2_ICL_entailment
72,163,7,7,0,1.0,8,5,3,0.625,0.7692307692307693,medlm,mimiciii,radiology_report,PROMPT2_ICL_entailment
73,164,5,4,1,0.8,10,4,6,0.4,0.5333333333333333,medlm,mimiciii,radiology_report,PROMPT2_ICL_entailment
74,165,11,8,3,0.7272727272727273,31,24,7,0.7741935483870968,0.7500000000000001,medlm,mimiciii,radiology_report,PROMPT2_ICL_entailment
75,166,9,6,3,0.6666666666666666,26,18,8,0.6923076923076923,0.6792452830188679,medlm,mimiciii,radiology_report,PROMPT2_ICL_entailment
76,167,5,5,0,1.0,10,8,2,0.8,0.888888888888889,medlm,mimiciii,radiology_report,PROMPT2_ICL_entailment
77,168,5,5,0,1.0,13,7,6,0.5384615384615384,0.7000000000000001,medlm,mimiciii,radiology_report,PROMPT2_ICL_entailment
78,169,10,6,4,0.6,22,16,6,0.7272727272727273,0.6575342465753425,medlm,mimiciii,radiology_report,PROMPT2_ICL_entailment
79,17,4,3,1,0.75,12,4,8,0.3333333333333333,0.4615384615384615,medlm,mimiciii,radiology_report,PROMPT2_ICL_entailment
80,170,13,10,3,0.7692307692307693,24,15,9,0.625,0.6896551724137931,medlm,mimiciii,radiology_report,PROMPT2_ICL_entailment
81,171,5,5,0,1.0,7,6,1,0.8571428571428571,0.923076923076923,medlm,mimiciii,radiology_report,PROMPT2_ICL_entailment
82,172,7,4,3,0.5714285714285714,14,9,5,0.6428571428571429,0.6050420168067226,medlm,mimiciii,radiology_report,PROMPT2_ICL_entailment
83,173,6,4,2,0.6666666666666666,12,9,3,0.75,0.7058823529411765,medlm,mimiciii,radiology_report,PROMPT2_ICL_entailment
84,174,8,6,2,0.75,20,15,5,0.75,0.75,medlm,mimiciii,radiology_report,PROMPT2_ICL_entailment
85,175,4,4,0,1.0,8,5,3,0.625,0.7692307692307693,medlm,mimiciii,radiology_report,PROMPT2_ICL_entailment
86,176,8,5,3,0.625,19,13,6,0.6842105263157895,0.6532663316582915,medlm,mimiciii,radiology_report,PROMPT2_ICL_entailment
87,177,7,7,0,1.0,16,8,8,0.5,0.6666666666666666,medlm,mimiciii,radiology_report,PROMPT2_ICL_entailment
88,178,10,6,4,0.6,25,19,6,0.76,0.6705882352941176,medlm,mimiciii,radiology_report,PROMPT2_ICL_entailment
89,179,9,8,1,0.8888888888888888,20,11,9,0.55,0.6795366795366796,medlm,mimiciii,radiology_report,PROMPT2_ICL_entailment
90,18,11,10,1,0.9090909090909092,17,12,5,0.7058823529411765,0.794701986754967,medlm,mimiciii,radiology_report,PROMPT2_ICL_entailment
91,180,6,5,1,0.8333333333333334,11,9,2,0.8181818181818182,0.8256880733944955,medlm,mimiciii,radiology_report,PROMPT2_ICL_entailment
92,181,10,4,6,0.4,26,14,12,0.5384615384615384,0.4590163934426229,medlm,mimiciii,radiology_report,PROMPT2_ICL_entailment
93,182,10,6,4,0.6,23,15,8,0.6521739130434783,0.6250000000000001,medlm,mimiciii,radiology_report,PROMPT2_ICL_entailment
94,183,11,10,1,0.9090909090909092,17,10,7,0.5882352941176471,0.7142857142857143,medlm,mimiciii,radiology_report,PROMPT2_ICL_entailment
95,184,6,6,0,1.0,15,9,6,0.6,0.7499999999999999,medlm,mimiciii,radiology_report,PROMPT2_ICL_entailment
96,185,5,4,1,0.8,6,3,3,0.5,0.6153846153846154,medlm,mimiciii,radiology_report,PROMPT2_ICL_entailment
97,186,9,7,2,0.7777777777777778,26,18,8,0.6923076923076923,0.7325581395348836,medlm,mimiciii,radiology_report,PROMPT2_ICL_entailment
98,187,9,5,4,0.5555555555555556,14,8,6,0.5714285714285714,0.5633802816901409,medlm,mimiciii,radiology_report,PROMPT2_ICL_entailment
99,188,3,2,1,0.6666666666666666,22,7,15,0.3181818181818182,0.4307692307692307,medlm,mimiciii,radiology_report,PROMPT2_ICL_entailment
100,189,9,8,1,0.8888888888888888,15,13,2,0.8666666666666667,0.8776371308016878,medlm,mimiciii,radiology_report,PROMPT2_ICL_entailment
101,19,6,6,0,1.0,14,10,4,0.7142857142857143,0.8333333333333333,medlm,mimiciii,radiology_report,PROMPT2_ICL_entailment
102,190,6,5,1,0.8333333333333334,17,12,5,0.7058823529411765,0.7643312101910827,medlm,mimiciii,radiology_report,PROMPT2_ICL_entailment
103,191,2,1,1,0.5,15,5,10,0.3333333333333333,0.4,medlm,mimiciii,radiology_report,PROMPT2_ICL_entailment
104,192,16,8,8,0.5,28,20,8,0.7142857142857143,0.588235294117647,medlm,mimiciii,radiology_report,PROMPT2_ICL_entailment
105,193,7,7,0,1.0,14,8,6,0.5714285714285714,0.7272727272727273,medlm,mimiciii,radiology_report,PROMPT2_ICL_entailment
106,194,9,9,0,1.0,49,20,29,0.4081632653061224,0.5797101449275363,medlm,mimiciii,radiology_report,PROMPT2_ICL_entailment
107,195,13,8,5,0.6153846153846154,21,14,7,0.6666666666666666,0.64,medlm,mimiciii,radiology_report,PROMPT2_ICL_entailment
108,196,6,2,4,0.3333333333333333,18,7,11,0.3888888888888889,0.358974358974359,medlm,mimiciii,radiology_report,PROMPT2_ICL_entailment
109,197,5,5,0,1.0,15,8,7,0.5333333333333333,0.6956521739130436,medlm,mimiciii,radiology_report,PROMPT2_ICL_entailment
110,198,4,4,0,1.0,9,6,3,0.6666666666666666,0.8,medlm,mimiciii,radiology_report,PROMPT2_ICL_entailment
111,199,9,4,5,0.4444444444444444,23,17,6,0.7391304347826086,0.5551020408163265,medlm,mimiciii,radiology_report,PROMPT2_ICL_entailment
112,2,9,7,2,0.7777777777777778,15,9,6,0.6,0.6774193548387097,medlm,mimiciii,radiology_report,PROMPT2_ICL_entailment
113,20,10,10,0,1.0,42,19,23,0.4523809523809524,0.6229508196721312,medlm,mimiciii,radiology_report,PROMPT2_ICL_entailment
114,200,5,5,0,1.0,14,12,2,0.8571428571428571,0.923076923076923,medlm,mimiciii,radiology_report,PROMPT2_ICL_entailment
115,201,8,3,5,0.375,18,11,7,0.6111111111111112,0.4647887323943662,medlm,mimiciii,radiology_report,PROMPT2_ICL_entailment
116,202,11,9,2,0.8181818181818182,25,16,9,0.64,0.7182044887780549,medlm,mimiciii,radiology_report,PROMPT2_ICL_entailment
117,203,11,4,7,0.3636363636363636,19,9,10,0.4736842105263157,0.4114285714285713,medlm,mimiciii,radiology_report,PROMPT2_ICL_entailment
118,204,10,4,6,0.4,23,13,10,0.5652173913043478,0.4684684684684684,medlm,mimiciii,radiology_report,PROMPT2_ICL_entailment
119,205,5,5,0,1.0,14,10,4,0.7142857142857143,0.8333333333333333,medlm,mimiciii,radiology_report,PROMPT2_ICL_entailment
120,206,6,6,0,1.0,13,9,4,0.6923076923076923,0.8181818181818181,medlm,mimiciii,radiology_report,PROMPT2_ICL_entailment
121,207,5,5,0,1.0,9,5,4,0.5555555555555556,0.7142857142857143,medlm,mimiciii,radiology_report,PROMPT2_ICL_entailment
122,208,12,7,5,0.5833333333333334,18,10,8,0.5555555555555556,0.5691056910569107,medlm,mimiciii,radiology_report,PROMPT2_ICL_entailment
123,209,10,8,2,0.8,16,11,5,0.6875,0.7394957983193278,medlm,mimiciii,radiology_report,PROMPT2_ICL_entailment
124,21,16,15,1,0.9375,27,15,12,0.5555555555555556,0.6976744186046512,medlm,mimiciii,radiology_report,PROMPT2_ICL_entailment
125,210,7,6,1,0.8571428571428571,14,7,7,0.5,0.631578947368421,medlm,mimiciii,radiology_report,PROMPT2_ICL_entailment
126,211,5,5,0,1.0,13,10,3,0.7692307692307693,0.8695652173913044,medlm,mimiciii,radiology_report,PROMPT2_ICL_entailment
127,212,8,5,3,0.625,19,14,5,0.7368421052631579,0.6763285024154588,medlm,mimiciii,radiology_report,PROMPT2_ICL_entailment
128,213,7,6,1,0.8571428571428571,22,13,9,0.5909090909090909,0.6995515695067264,medlm,mimiciii,radiology_report,PROMPT2_ICL_entailment
129,214,8,3,5,0.375,23,15,8,0.6521739130434783,0.4761904761904762,medlm,mimiciii,radiology_report,PROMPT2_ICL_entailment
130,215,7,6,1,0.8571428571428571,10,7,3,0.7,0.7706422018348624,medlm,mimiciii,radiology_report,PROMPT2_ICL_entailment
131,216,5,4,1,0.8,19,8,11,0.4210526315789473,0.5517241379310345,medlm,mimiciii,radiology_report,PROMPT2_ICL_entailment
132,217,5,4,1,0.8,20,10,10,0.5,0.6153846153846154,medlm,mimiciii,radiology_report,PROMPT2_ICL_entailment
133,218,7,3,4,0.4285714285714285,15,11,4,0.7333333333333333,0.540983606557377,medlm,mimiciii,radiology_report,PROMPT2_ICL_entailment
134,219,10,6,4,0.6,13,7,6,0.5384615384615384,0.5675675675675675,medlm,mimiciii,radiology_report,PROMPT2_ICL_entailment
135,22,11,8,3,0.7272727272727273,19,14,5,0.7368421052631579,0.7320261437908497,medlm,mimiciii,radiology_report,PROMPT2_ICL_entailment
136,220,7,5,2,0.7142857142857143,19,6,13,0.3157894736842105,0.437956204379562,medlm,mimiciii,radiology_report,PROMPT2_ICL_entailment
137,221,19,14,5,0.7368421052631579,27,20,7,0.7407407407407407,0.7387862796833774,medlm,mimiciii,radiology_report,PROMPT2_ICL_entailment
138,222,8,5,3,0.625,16,8,8,0.5,0.5555555555555556,medlm,mimiciii,radiology_report,PROMPT2_ICL_entailment
139,223,12,10,2,0.8333333333333334,21,15,6,0.7142857142857143,0.7692307692307692,medlm,mimiciii,radiology_report,PROMPT2_ICL_entailment
140,224,2,2,0,1.0,17,7,10,0.4117647058823529,0.5833333333333334,medlm,mimiciii,radiology_report,PROMPT2_ICL_entailment
141,225,5,4,1,0.8,11,8,3,0.7272727272727273,0.761904761904762,medlm,mimiciii,radiology_report,PROMPT2_ICL_entailment
142,226,3,2,1,0.6666666666666666,18,6,12,0.3333333333333333,0.4444444444444444,medlm,mimiciii,radiology_report,PROMPT2_ICL_entailment
143,227,8,7,1,0.875,18,15,3,0.8333333333333334,0.8536585365853658,medlm,mimiciii,radiology_report,PROMPT2_ICL_entailment
144,228,6,4,2,0.6666666666666666,17,13,4,0.7647058823529411,0.7123287671232877,medlm,mimiciii,radiology_report,PROMPT2_ICL_entailment
145,229,5,5,0,1.0,49,19,30,0.3877551020408163,0.5588235294117647,medlm,mimiciii,radiology_report,PROMPT2_ICL_entailment
146,23,8,7,1,0.875,15,12,3,0.8,0.8358208955223881,medlm,mimiciii,radiology_report,PROMPT2_ICL_entailment
147,230,7,1,6,0.1428571428571428,17,12,5,0.7058823529411765,0.2376237623762376,medlm,mimiciii,radiology_report,PROMPT2_ICL_entailment
148,231,6,6,0,1.0,13,9,4,0.6923076923076923,0.8181818181818181,medlm,mimiciii,radiology_report,PROMPT2_ICL_entailment
149,232,6,4,2,0.6666666666666666,18,12,6,0.6666666666666666,0.6666666666666666,medlm,mimiciii,radiology_report,PROMPT2_ICL_entailment
150,233,8,5,3,0.625,17,12,5,0.7058823529411765,0.6629834254143646,medlm,mimiciii,radiology_report,PROMPT2_ICL_entailment
151,234,4,4,0,1.0,11,7,4,0.6363636363636364,0.7777777777777778,medlm,mimiciii,radiology_report,PROMPT2_ICL_entailment
152,235,7,5,2,0.7142857142857143,14,9,5,0.6428571428571429,0.6766917293233083,medlm,mimiciii,radiology_report,PROMPT2_ICL_entailment
153,236,8,8,0,1.0,11,9,2,0.8181818181818182,0.9,medlm,mimiciii,radiology_report,PROMPT2_ICL_entailment
154,237,10,7,3,0.7,17,13,4,0.7647058823529411,0.7309236947791163,medlm,mimiciii,radiology_report,PROMPT2_ICL_entailment
155,238,10,4,6,0.4,20,12,8,0.6,0.48,medlm,mimiciii,radiology_report,PROMPT2_ICL_entailment
156,239,7,1,6,0.1428571428571428,17,13,4,0.7647058823529411,0.2407407407407407,medlm,mimiciii,radiology_report,PROMPT2_ICL_entailment
157,24,7,5,2,0.7142857142857143,18,11,7,0.6111111111111112,0.6586826347305389,medlm,mimiciii,radiology_report,PROMPT2_ICL_entailment
158,240,8,8,0,1.0,13,10,3,0.7692307692307693,0.8695652173913044,medlm,mimiciii,radiology_report,PROMPT2_ICL_entailment
159,241,7,6,1,0.8571428571428571,16,11,5,0.6875,0.7630057803468208,medlm,mimiciii,radiology_report,PROMPT2_ICL_entailment
160,242,12,10,2,0.8333333333333334,18,10,8,0.5555555555555556,0.6666666666666667,medlm,mimiciii,radiology_report,PROMPT2_ICL_entailment
161,243,7,6,1,0.8571428571428571,13,10,3,0.7692307692307693,0.8108108108108107,medlm,mimiciii,radiology_report,PROMPT2_ICL_entailment
162,244,6,3,3,0.5,17,13,4,0.7647058823529411,0.6046511627906976,medlm,mimiciii,radiology_report,PROMPT2_ICL_entailment
163,245,6,3,3,0.5,28,9,19,0.3214285714285714,0.391304347826087,medlm,mimiciii,radiology_report,PROMPT2_ICL_entailment
164,246,7,7,0,1.0,12,9,3,0.75,0.8571428571428571,medlm,mimiciii,radiology_report,PROMPT2_ICL_entailment
165,247,6,6,0,1.0,12,6,6,0.5,0.6666666666666666,medlm,mimiciii,radiology_report,PROMPT2_ICL_entailment
166,248,11,9,2,0.8181818181818182,17,9,8,0.5294117647058824,0.6428571428571428,medlm,mimiciii,radiology_report,PROMPT2_ICL_entailment
167,249,8,7,1,0.875,23,11,12,0.4782608695652174,0.6184738955823293,medlm,mimiciii,radiology_report,PROMPT2_ICL_entailment
168,25,10,6,4,0.6,27,17,10,0.6296296296296297,0.6144578313253012,medlm,mimiciii,radiology_report,PROMPT2_ICL_entailment
169,250,3,3,0,1.0,8,5,3,0.625,0.7692307692307693,medlm,mimiciii,radiology_report,PROMPT2_ICL_entailment
170,251,7,4,3,0.5714285714285714,22,12,10,0.5454545454545454,0.5581395348837208,medlm,mimiciii,radiology_report,PROMPT2_ICL_entailment
171,252,5,4,1,0.8,10,5,5,0.5,0.6153846153846154,medlm,mimiciii,radiology_report,PROMPT2_ICL_entailment
172,253,9,7,2,0.7777777777777778,24,15,9,0.625,0.6930693069306931,medlm,mimiciii,radiology_report,PROMPT2_ICL_entailment
173,254,7,6,1,0.8571428571428571,13,8,5,0.6153846153846154,0.7164179104477612,medlm,mimiciii,radiology_report,PROMPT2_ICL_entailment
174,255,8,8,0,1.0,16,11,5,0.6875,0.8148148148148148,medlm,mimiciii,radiology_report,PROMPT2_ICL_entailment
175,256,6,4,2,0.6666666666666666,19,12,7,0.631578947368421,0.6486486486486486,medlm,mimiciii,radiology_report,PROMPT2_ICL_entailment
176,257,6,5,1,0.8333333333333334,15,10,5,0.6666666666666666,0.7407407407407408,medlm,mimiciii,radiology_report,PROMPT2_ICL_entailment
177,258,12,11,1,0.9166666666666666,20,8,12,0.4,0.5569620253164558,medlm,mimiciii,radiology_report,PROMPT2_ICL_entailment
178,259,6,4,2,0.6666666666666666,17,11,6,0.6470588235294118,0.6567164179104478,medlm,mimiciii,radiology_report,PROMPT2_ICL_entailment
179,26,8,7,1,0.875,18,13,5,0.7222222222222222,0.7913043478260868,medlm,mimiciii,radiology_report,PROMPT2_ICL_entailment
180,260,9,7,2,0.7777777777777778,20,7,13,0.35,0.4827586206896551,medlm,mimiciii,radiology_report,PROMPT2_ICL_entailment
181,261,14,10,4,0.7142857142857143,31,21,10,0.6774193548387096,0.695364238410596,medlm,mimiciii,radiology_report,PROMPT2_ICL_entailment
182,262,6,5,1,0.8333333333333334,23,13,10,0.5652173913043478,0.6735751295336787,medlm,mimiciii,radiology_report,PROMPT2_ICL_entailment
183,263,10,8,2,0.8,27,21,6,0.7777777777777778,0.7887323943661971,medlm,mimiciii,radiology_report,PROMPT2_ICL_entailment
184,264,7,6,1,0.8571428571428571,20,12,8,0.6,0.7058823529411764,medlm,mimiciii,radiology_report,PROMPT2_ICL_entailment
185,265,5,5,0,1.0,9,5,4,0.5555555555555556,0.7142857142857143,medlm,mimiciii,radiology_report,PROMPT2_ICL_entailment
186,266,9,6,3,0.6666666666666666,18,13,5,0.7222222222222222,0.6933333333333334,medlm,mimiciii,radiology_report,PROMPT2_ICL_entailment
187,267,5,5,0,1.0,16,8,8,0.5,0.6666666666666666,medlm,mimiciii,radiology_report,PROMPT2_ICL_entailment
188,268,9,6,3,0.6666666666666666,20,14,6,0.7,0.6829268292682926,medlm,mimiciii,radiology_report,PROMPT2_ICL_entailment
189,269,16,16,0,1.0,30,14,16,0.4666666666666667,0.6363636363636364,medlm,mimiciii,radiology_report,PROMPT2_ICL_entailment
190,27,4,4,0,1.0,14,3,11,0.2142857142857142,0.3529411764705882,medlm,mimiciii,radiology_report,PROMPT2_ICL_entailment
191,270,9,8,1,0.8888888888888888,17,14,3,0.8235294117647058,0.8549618320610687,medlm,mimiciii,radiology_report,PROMPT2_ICL_entailment
192,271,8,7,1,0.875,20,11,9,0.55,0.6754385964912282,medlm,mimiciii,radiology_report,PROMPT2_ICL_entailment
193,272,4,4,0,1.0,17,9,8,0.5294117647058824,0.6923076923076924,medlm,mimiciii,radiology_report,PROMPT2_ICL_entailment
194,273,5,5,0,1.0,12,4,8,0.3333333333333333,0.5,medlm,mimiciii,radiology_report,PROMPT2_ICL_entailment
195,274,10,5,5,0.5,20,12,8,0.6,0.5454545454545454,medlm,mimiciii,radiology_report,PROMPT2_ICL_entailment
196,275,7,7,0,1.0,12,6,6,0.5,0.6666666666666666,medlm,mimiciii,radiology_report,PROMPT2_ICL_entailment
197,276,3,3,0,1.0,29,16,13,0.5517241379310345,0.7111111111111111,medlm,mimiciii,radiology_report,PROMPT2_ICL_entailment
198,277,12,5,7,0.4166666666666667,25,16,9,0.64,0.5047318611987381,medlm,mimiciii,radiology_report,PROMPT2_ICL_entailment
199,278,5,3,2,0.6,16,10,6,0.625,0.6122448979591836,medlm,mimiciii,radiology_report,PROMPT2_ICL_entailment
200,279,5,5,0,1.0,10,3,7,0.3,0.4615384615384615,medlm,mimiciii,radiology_report,PROMPT2_ICL_entailment
201,28,10,4,6,0.4,30,19,11,0.6333333333333333,0.4903225806451614,medlm,mimiciii,radiology_report,PROMPT2_ICL_entailment
202,280,6,3,3,0.5,12,7,5,0.5833333333333334,0.5384615384615384,medlm,mimiciii,radiology_report,PROMPT2_ICL_entailment
203,281,11,9,2,0.8181818181818182,24,17,7,0.7083333333333334,0.7593052109181142,medlm,mimiciii,radiology_report,PROMPT2_ICL_entailment
204,282,8,6,2,0.75,12,9,3,0.75,0.75,medlm,mimiciii,radiology_report,PROMPT2_ICL_entailment
205,283,7,5,2,0.7142857142857143,28,17,11,0.6071428571428571,0.6563706563706564,medlm,mimiciii,radiology_report,PROMPT2_ICL_entailment
206,284,6,3,3,0.5,14,7,7,0.5,0.5,medlm,mimiciii,radiology_report,PROMPT2_ICL_entailment
207,285,7,6,1,0.8571428571428571,18,10,8,0.5555555555555556,0.6741573033707865,medlm,mimiciii,radiology_report,PROMPT2_ICL_entailment
208,286,4,4,0,1.0,6,4,2,0.6666666666666666,0.8,medlm,mimiciii,radiology_report,PROMPT2_ICL_entailment
209,287,8,7,1,0.875,18,11,7,0.6111111111111112,0.7196261682242991,medlm,mimiciii,radiology_report,PROMPT2_ICL_entailment
210,288,10,6,4,0.6,32,24,8,0.75,0.6666666666666665,medlm,mimiciii,radiology_report,PROMPT2_ICL_entailment
211,289,10,9,1,0.9,20,14,6,0.7,0.7875,medlm,mimiciii,radiology_report,PROMPT2_ICL_entailment
212,29,6,5,1,0.8333333333333334,8,5,3,0.625,0.7142857142857143,medlm,mimiciii,radiology_report,PROMPT2_ICL_entailment
213,290,7,6,1,0.8571428571428571,11,7,4,0.6363636363636364,0.7304347826086957,medlm,mimiciii,radiology_report,PROMPT2_ICL_entailment
214,291,6,4,2,0.6666666666666666,24,8,16,0.3333333333333333,0.4444444444444444,medlm,mimiciii,radiology_report,PROMPT2_ICL_entailment
215,292,11,8,3,0.7272727272727273,21,13,8,0.6190476190476191,0.6688102893890675,medlm,mimiciii,radiology_report,PROMPT2_ICL_entailment
216,293,7,5,2,0.7142857142857143,18,14,4,0.7777777777777778,0.7446808510638298,medlm,mimiciii,radiology_report,PROMPT2_ICL_entailment
217,294,8,3,5,0.375,22,10,12,0.4545454545454545,0.410958904109589,medlm,mimiciii,radiology_report,PROMPT2_ICL_entailment
218,295,6,4,2,0.6666666666666666,39,18,21,0.4615384615384615,0.5454545454545455,medlm,mimiciii,radiology_report,PROMPT2_ICL_entailment
219,296,8,5,3,0.625,17,12,5,0.7058823529411765,0.6629834254143646,medlm,mimiciii,radiology_report,PROMPT2_ICL_entailment
220,297,10,8,2,0.8,24,15,9,0.625,0.7017543859649122,medlm,mimiciii,radiology_report,PROMPT2_ICL_entailment
221,298,10,10,0,1.0,20,14,6,0.7,0.8235294117647058,medlm,mimiciii,radiology_report,PROMPT2_ICL_entailment
222,299,9,8,1,0.8888888888888888,32,18,14,0.5625,0.6889952153110048,medlm,mimiciii,radiology_report,PROMPT2_ICL_entailment
223,3,9,6,3,0.6666666666666666,20,13,7,0.65,0.6582278481012659,medlm,mimiciii,radiology_report,PROMPT2_ICL_entailment
224,30,6,5,1,0.8333333333333334,25,20,5,0.8,0.816326530612245,medlm,mimiciii,radiology_report,PROMPT2_ICL_entailment
225,300,7,6,1,0.8571428571428571,13,5,8,0.3846153846153846,0.5309734513274336,medlm,mimiciii,radiology_report,PROMPT2_ICL_entailment
226,301,4,4,0,1.0,19,8,11,0.4210526315789473,0.5925925925925926,medlm,mimiciii,radiology_report,PROMPT2_ICL_entailment
227,302,9,7,2,0.7777777777777778,15,12,3,0.8,0.7887323943661971,medlm,mimiciii,radiology_report,PROMPT2_ICL_entailment
228,303,12,8,4,0.6666666666666666,24,13,11,0.5416666666666666,0.5977011494252873,medlm,mimiciii,radiology_report,PROMPT2_ICL_entailment
229,304,10,8,2,0.8,21,16,5,0.7619047619047619,0.7804878048780488,medlm,mimiciii,radiology_report,PROMPT2_ICL_entailment
230,305,12,6,6,0.5,24,11,13,0.4583333333333333,0.4782608695652174,medlm,mimiciii,radiology_report,PROMPT2_ICL_entailment
231,306,4,3,1,0.75,14,7,7,0.5,0.6,medlm,mimiciii,radiology_report,PROMPT2_ICL_entailment
232,307,7,6,1,0.8571428571428571,17,13,4,0.7647058823529411,0.8082901554404144,medlm,mimiciii,radiology_report,PROMPT2_ICL_entailment
233,308,7,3,4,0.4285714285714285,15,11,4,0.7333333333333333,0.540983606557377,medlm,mimiciii,radiology_report,PROMPT2_ICL_entailment
234,309,7,5,2,0.7142857142857143,29,16,13,0.5517241379310345,0.6225680933852141,medlm,mimiciii,radiology_report,PROMPT2_ICL_entailment
235,31,6,2,4,0.3333333333333333,19,10,9,0.5263157894736842,0.4081632653061224,medlm,mimiciii,radiology_report,PROMPT2_ICL_entailment
236,310,7,5,2,0.7142857142857143,24,13,11,0.5416666666666666,0.6161137440758293,medlm,mimiciii,radiology_report,PROMPT2_ICL_entailment
237,311,5,5,0,1.0,15,9,6,0.6,0.7499999999999999,medlm,mimiciii,radiology_report,PROMPT2_ICL_entailment
238,312,5,4,1,0.8,18,9,9,0.5,0.6153846153846154,medlm,mimiciii,radiology_report,PROMPT2_ICL_entailment
239,313,9,5,4,0.5555555555555556,17,13,4,0.7647058823529411,0.6435643564356436,medlm,mimiciii,radiology_report,PROMPT2_ICL_entailment
240,314,6,4,2,0.6666666666666666,15,12,3,0.8,0.7272727272727272,medlm,mimiciii,radiology_report,PROMPT2_ICL_entailment
241,315,7,3,4,0.4285714285714285,25,14,11,0.56,0.4855491329479768,medlm,mimiciii,radiology_report,PROMPT2_ICL_entailment
242,316,3,2,1,0.6666666666666666,10,7,3,0.7,0.6829268292682926,medlm,mimiciii,radiology_report,PROMPT2_ICL_entailment
243,317,9,5,4,0.5555555555555556,26,16,10,0.6153846153846154,0.583941605839416,medlm,mimiciii,radiology_report,PROMPT2_ICL_entailment
244,318,6,4,2,0.6666666666666666,21,17,4,0.8095238095238095,0.7311827956989246,medlm,mimiciii,radiology_report,PROMPT2_ICL_entailment
245,319,11,10,1,0.9090909090909092,12,10,2,0.8333333333333334,0.8695652173913043,medlm,mimiciii,radiology_report,PROMPT2_ICL_entailment
246,32,9,9,0,1.0,15,10,5,0.6666666666666666,0.8,medlm,mimiciii,radiology_report,PROMPT2_ICL_entailment
247,320,5,5,0,1.0,11,6,5,0.5454545454545454,0.7058823529411764,medlm,mimiciii,radiology_report,PROMPT2_ICL_entailment
248,321,8,6,2,0.75,21,10,11,0.4761904761904761,0.58252427184466,medlm,mimiciii,radiology_report,PROMPT2_ICL_entailment
249,322,3,3,0,1.0,8,7,1,0.875,0.9333333333333332,medlm,mimiciii,radiology_report,PROMPT2_ICL_entailment
250,323,4,4,0,1.0,29,17,12,0.5862068965517241,0.7391304347826086,medlm,mimiciii,radiology_report,PROMPT2_ICL_entailment
251,324,7,5,2,0.7142857142857143,18,11,7,0.6111111111111112,0.6586826347305389,medlm,mimiciii,radiology_report,PROMPT2_ICL_entailment
252,325,9,5,4,0.5555555555555556,22,9,13,0.4090909090909091,0.4712041884816754,medlm,mimiciii,radiology_report,PROMPT2_ICL_entailment
253,326,7,4,3,0.5714285714285714,23,18,5,0.782608695652174,0.6605504587155963,medlm,mimiciii,radiology_report,PROMPT2_ICL_entailment
254,327,5,4,1,0.8,9,7,2,0.7777777777777778,0.7887323943661971,medlm,mimiciii,radiology_report,PROMPT2_ICL_entailment
255,328,9,6,3,0.6666666666666666,17,12,5,0.7058823529411765,0.6857142857142857,medlm,mimiciii,radiology_report,PROMPT2_ICL_entailment
256,329,8,7,1,0.875,28,11,17,0.3928571428571428,0.5422535211267606,medlm,mimiciii,radiology_report,PROMPT2_ICL_entailment
257,33,5,5,0,1.0,9,6,3,0.6666666666666666,0.8,medlm,mimiciii,radiology_report,PROMPT2_ICL_entailment
258,330,4,4,0,1.0,11,6,5,0.5454545454545454,0.7058823529411764,medlm,mimiciii,radiology_report,PROMPT2_ICL_entailment
259,331,9,5,4,0.5555555555555556,15,12,3,0.8,0.6557377049180328,medlm,mimiciii,radiology_report,PROMPT2_ICL_entailment
260,332,10,7,3,0.7,20,14,6,0.7,0.7,medlm,mimiciii,radiology_report,PROMPT2_ICL_entailment
261,333,7,5,2,0.7142857142857143,13,9,4,0.6923076923076923,0.7031250000000001,medlm,mimiciii,radiology_report,PROMPT2_ICL_entailment
262,334,14,11,3,0.7857142857142857,20,10,10,0.5,0.6111111111111112,medlm,mimiciii,radiology_report,PROMPT2_ICL_entailment
263,335,8,6,2,0.75,17,13,4,0.7647058823529411,0.7572815533980582,medlm,mimiciii,radiology_report,PROMPT2_ICL_entailment
264,336,6,2,4,0.3333333333333333,16,13,3,0.8125,0.4727272727272727,medlm,mimiciii,radiology_report,PROMPT2_ICL_entailment
265,337,16,14,2,0.875,16,11,5,0.6875,0.77,medlm,mimiciii,radiology_report,PROMPT2_ICL_entailment
266,338,7,6,1,0.8571428571428571,13,9,4,0.6923076923076923,0.7659574468085107,medlm,mimiciii,radiology_report,PROMPT2_ICL_entailment
267,339,8,3,5,0.375,28,19,9,0.6785714285714286,0.483050847457627,medlm,mimiciii,radiology_report,PROMPT2_ICL_entailment
268,34,8,6,2,0.75,14,10,4,0.7142857142857143,0.7317073170731706,medlm,mimiciii,radiology_report,PROMPT2_ICL_entailment
269,340,3,2,1,0.6666666666666666,15,7,8,0.4666666666666667,0.5490196078431373,medlm,mimiciii,radiology_report,PROMPT2_ICL_entailment
270,341,2,1,1,0.5,6,3,3,0.5,0.5,medlm,mimiciii,radiology_report,PROMPT2_ICL_entailment
271,342,6,6,0,1.0,15,10,5,0.6666666666666666,0.8,medlm,mimiciii,radiology_report,PROMPT2_ICL_entailment
272,343,6,4,2,0.6666666666666666,26,13,13,0.5,0.5714285714285715,medlm,mimiciii,radiology_report,PROMPT2_ICL_entailment
273,344,7,5,2,0.7142857142857143,19,11,8,0.5789473684210527,0.6395348837209303,medlm,mimiciii,radiology_report,PROMPT2_ICL_entailment
274,345,14,9,5,0.6428571428571429,22,15,7,0.6818181818181818,0.6617647058823529,medlm,mimiciii,radiology_report,PROMPT2_ICL_entailment
275,346,7,5,2,0.7142857142857143,15,8,7,0.5333333333333333,0.6106870229007633,medlm,mimiciii,radiology_report,PROMPT2_ICL_entailment
276,347,7,4,3,0.5714285714285714,15,6,9,0.4,0.4705882352941176,medlm,mimiciii,radiology_report,PROMPT2_ICL_entailment
277,348,7,3,4,0.4285714285714285,12,8,4,0.6666666666666666,0.5217391304347826,medlm,mimiciii,radiology_report,PROMPT2_ICL_entailment
278,349,5,5,0,1.0,16,10,6,0.625,0.7692307692307693,medlm,mimiciii,radiology_report,PROMPT2_ICL_entailment
279,35,10,2,8,0.2,21,14,7,0.6666666666666666,0.3076923076923076,medlm,mimiciii,radiology_report,PROMPT2_ICL_entailment
280,350,10,8,2,0.8,21,15,6,0.7142857142857143,0.7547169811320756,medlm,mimiciii,radiology_report,PROMPT2_ICL_entailment
281,351,8,2,6,0.25,21,11,10,0.5238095238095238,0.3384615384615385,medlm,mimiciii,radiology_report,PROMPT2_ICL_entailment
282,352,8,6,2,0.75,22,13,9,0.5909090909090909,0.6610169491525425,medlm,mimiciii,radiology_report,PROMPT2_ICL_entailment
283,353,7,5,2,0.7142857142857143,26,17,9,0.6538461538461539,0.6827309236947792,medlm,mimiciii,radiology_report,PROMPT2_ICL_entailment
284,354,7,3,4,0.4285714285714285,26,17,9,0.6538461538461539,0.5177664974619289,medlm,mimiciii,radiology_report,PROMPT2_ICL_entailment
285,355,6,6,0,1.0,18,13,5,0.7222222222222222,0.8387096774193548,medlm,mimiciii,radiology_report,PROMPT2_ICL_entailment
286,356,10,7,3,0.7,22,17,5,0.7727272727272727,0.7345679012345679,medlm,mimiciii,radiology_report,PROMPT2_ICL_entailment
287,357,6,2,4,0.3333333333333333,15,8,7,0.5333333333333333,0.4102564102564102,medlm,mimiciii,radiology_report,PROMPT2_ICL_entailment
288,358,7,4,3,0.5714285714285714,12,5,7,0.4166666666666667,0.4819277108433734,medlm,mimiciii,radiology_report,PROMPT2_ICL_entailment
289,359,8,6,2,0.75,18,14,4,0.7777777777777778,0.7636363636363638,medlm,mimiciii,radiology_report,PROMPT2_ICL_entailment
290,36,11,9,2,0.8181818181818182,22,10,12,0.4545454545454545,0.5844155844155845,medlm,mimiciii,radiology_report,PROMPT2_ICL_entailment
291,360,7,6,1,0.8571428571428571,15,9,6,0.6,0.7058823529411764,medlm,mimiciii,radiology_report,PROMPT2_ICL_entailment
292,361,7,4,3,0.5714285714285714,23,11,12,0.4782608695652174,0.5207100591715976,medlm,mimiciii,radiology_report,PROMPT2_ICL_entailment
293,362,13,5,8,0.3846153846153846,24,13,11,0.5416666666666666,0.4498269896193771,medlm,mimiciii,radiology_report,PROMPT2_ICL_entailment
294,363,9,7,2,0.7777777777777778,22,15,7,0.6818181818181818,0.726643598615917,medlm,mimiciii,radiology_report,PROMPT2_ICL_entailment
295,364,3,3,0,1.0,11,7,4,0.6363636363636364,0.7777777777777778,medlm,mimiciii,radiology_report,PROMPT2_ICL_entailment
296,365,13,8,5,0.6153846153846154,29,17,12,0.5862068965517241,0.6004415011037527,medlm,mimiciii,radiology_report,PROMPT2_ICL_entailment
297,366,9,9,0,1.0,13,9,4,0.6923076923076923,0.8181818181818181,medlm,mimiciii,radiology_report,PROMPT2_ICL_entailment
298,367,10,7,3,0.7,16,11,5,0.6875,0.6936936936936936,medlm,mimiciii,radiology_report,PROMPT2_ICL_entailment
299,368,4,3,1,0.75,20,9,11,0.45,0.5625000000000001,medlm,mimiciii,radiology_report,PROMPT2_ICL_entailment
300,369,9,5,4,0.5555555555555556,20,15,5,0.75,0.6382978723404256,medlm,mimiciii,radiology_report,PROMPT2_ICL_entailment
301,37,7,6,1,0.8571428571428571,21,12,9,0.5714285714285714,0.6857142857142857,medlm,mimiciii,radiology_report,PROMPT2_ICL_entailment
302,370,6,4,2,0.6666666666666666,19,7,12,0.3684210526315789,0.4745762711864407,medlm,mimiciii,radiology_report,PROMPT2_ICL_entailment
303,371,7,6,1,0.8571428571428571,17,14,3,0.8235294117647058,0.84,medlm,mimiciii,radiology_report,PROMPT2_ICL_entailment
304,372,6,6,0,1.0,31,16,15,0.5161290322580645,0.6808510638297872,medlm,mimiciii,radiology_report,PROMPT2_ICL_entailment
305,373,9,8,1,0.8888888888888888,23,16,7,0.6956521739130435,0.7804878048780488,medlm,mimiciii,radiology_report,PROMPT2_ICL_entailment
306,374,6,6,0,1.0,11,7,4,0.6363636363636364,0.7777777777777778,medlm,mimiciii,radiology_report,PROMPT2_ICL_entailment
307,375,6,6,0,1.0,16,9,7,0.5625,0.72,medlm,mimiciii,radiology_report,PROMPT2_ICL_entailment
308,376,12,8,4,0.6666666666666666,18,12,6,0.6666666666666666,0.6666666666666666,medlm,mimiciii,radiology_report,PROMPT2_ICL_entailment
309,377,6,4,2,0.6666666666666666,10,7,3,0.7,0.6829268292682926,medlm,mimiciii,radiology_report,PROMPT2_ICL_entailment
310,378,10,9,1,0.9,24,13,11,0.5416666666666666,0.676300578034682,medlm,mimiciii,radiology_report,PROMPT2_ICL_entailment
311,379,8,5,3,0.625,18,13,5,0.7222222222222222,0.6701030927835051,medlm,mimiciii,radiology_report,PROMPT2_ICL_entailment
312,38,7,4,3,0.5714285714285714,19,9,10,0.4736842105263157,0.5179856115107914,medlm,mimiciii,radiology_report,PROMPT2_ICL_entailment
313,380,4,4,0,1.0,8,6,2,0.75,0.8571428571428571,medlm,mimiciii,radiology_report,PROMPT2_ICL_entailment
314,381,4,2,2,0.5,14,7,7,0.5,0.5,medlm,mimiciii,radiology_report,PROMPT2_ICL_entailment
315,382,6,6,0,1.0,16,9,7,0.5625,0.72,medlm,mimiciii,radiology_report,PROMPT2_ICL_entailment
316,383,10,5,5,0.5,17,13,4,0.7647058823529411,0.6046511627906976,medlm,mimiciii,radiology_report,PROMPT2_ICL_entailment
317,384,6,6,0,1.0,13,11,2,0.8461538461538461,0.9166666666666666,medlm,mimiciii,radiology_report,PROMPT2_ICL_entailment
318,385,10,6,4,0.6,27,14,13,0.5185185185185185,0.5562913907284768,medlm,mimiciii,radiology_report,PROMPT2_ICL_entailment
319,386,9,9,0,1.0,18,13,5,0.7222222222222222,0.8387096774193548,medlm,mimiciii,radiology_report,PROMPT2_ICL_entailment
320,387,7,6,1,0.8571428571428571,19,11,8,0.5789473684210527,0.6910994764397905,medlm,mimiciii,radiology_report,PROMPT2_ICL_entailment
321,388,13,9,4,0.6923076923076923,33,25,8,0.7575757575757576,0.7234726688102894,medlm,mimiciii,radiology_report,PROMPT2_ICL_entailment
322,389,6,3,3,0.5,12,9,3,0.75,0.6,medlm,mimiciii,radiology_report,PROMPT2_ICL_entailment
323,39,5,5,0,1.0,10,6,4,0.6,0.7499999999999999,medlm,mimiciii,radiology_report,PROMPT2_ICL_entailment
324,390,6,6,0,1.0,14,8,6,0.5714285714285714,0.7272727272727273,medlm,mimiciii,radiology_report,PROMPT2_ICL_entailment
325,391,8,8,0,1.0,13,9,4,0.6923076923076923,0.8181818181818181,medlm,mimiciii,radiology_report,PROMPT2_ICL_entailment
326,392,8,4,4,0.5,15,9,6,0.6,0.5454545454545454,medlm,mimiciii,radiology_report,PROMPT2_ICL_entailment
327,393,11,7,4,0.6363636363636364,19,11,8,0.5789473684210527,0.6062992125984253,medlm,mimiciii,radiology_report,PROMPT2_ICL_entailment
328,394,11,11,0,1.0,18,15,3,0.8333333333333334,0.9090909090909092,medlm,mimiciii,radiology_report,PROMPT2_ICL_entailment
329,395,7,5,2,0.7142857142857143,16,10,6,0.625,0.6666666666666666,medlm,mimiciii,radiology_report,PROMPT2_ICL_entailment
330,396,9,7,2,0.7777777777777778,19,11,8,0.5789473684210527,0.6637931034482759,medlm,mimiciii,radiology_report,PROMPT2_ICL_entailment
331,397,8,6,2,0.75,18,10,8,0.5555555555555556,0.6382978723404256,medlm,mimiciii,radiology_report,PROMPT2_ICL_entailment
332,398,14,8,6,0.5714285714285714,21,11,10,0.5238095238095238,0.5465838509316769,medlm,mimiciii,radiology_report,PROMPT2_ICL_entailment
333,399,6,4,2,0.6666666666666666,19,10,9,0.5263157894736842,0.5882352941176471,medlm,mimiciii,radiology_report,PROMPT2_ICL_entailment
334,4,7,7,0,1.0,16,13,3,0.8125,0.896551724137931,medlm,mimiciii,radiology_report,PROMPT2_ICL_entailment
335,40,10,8,2,0.8,17,11,6,0.6470588235294118,0.7154471544715447,medlm,mimiciii,radiology_report,PROMPT2_ICL_entailment
336,400,9,8,1,0.8888888888888888,13,6,7,0.4615384615384615,0.6075949367088607,medlm,mimiciii,radiology_report,PROMPT2_ICL_entailment
337,401,5,4,1,0.8,9,7,2,0.7777777777777778,0.7887323943661971,medlm,mimiciii,radiology_report,PROMPT2_ICL_entailment
338,402,13,5,8,0.3846153846153846,20,14,6,0.7,0.4964539007092198,medlm,mimiciii,radiology_report,PROMPT2_ICL_entailment
339,403,6,5,1,0.8333333333333334,18,10,8,0.5555555555555556,0.6666666666666667,medlm,mimiciii,radiology_report,PROMPT2_ICL_entailment
340,404,11,9,2,0.8181818181818182,19,14,5,0.7368421052631579,0.7753846153846154,medlm,mimiciii,radiology_report,PROMPT2_ICL_entailment
341,405,10,7,3,0.7,14,10,4,0.7142857142857143,0.7070707070707072,medlm,mimiciii,radiology_report,PROMPT2_ICL_entailment
342,406,9,5,4,0.5555555555555556,25,17,8,0.68,0.6115107913669066,medlm,mimiciii,radiology_report,PROMPT2_ICL_entailment
343,407,11,9,2,0.8181818181818182,20,10,10,0.5,0.6206896551724137,medlm,mimiciii,radiology_report,PROMPT2_ICL_entailment
344,408,9,3,6,0.3333333333333333,20,10,10,0.5,0.4,medlm,mimiciii,radiology_report,PROMPT2_ICL_entailment
345,409,8,4,4,0.5,21,10,11,0.4761904761904761,0.4878048780487805,medlm,mimiciii,radiology_report,PROMPT2_ICL_entailment
346,41,8,5,3,0.625,26,13,13,0.5,0.5555555555555556,medlm,mimiciii,radiology_report,PROMPT2_ICL_entailment
347,410,16,15,1,0.9375,20,13,7,0.65,0.767716535433071,medlm,mimiciii,radiology_report,PROMPT2_ICL_entailment
348,411,4,4,0,1.0,6,5,1,0.8333333333333334,0.9090909090909092,medlm,mimiciii,radiology_report,PROMPT2_ICL_entailment
349,412,4,4,0,1.0,26,12,14,0.4615384615384615,0.631578947368421,medlm,mimiciii,radiology_report,PROMPT2_ICL_entailment
350,413,5,4,1,0.8,14,9,5,0.6428571428571429,0.7128712871287128,medlm,mimiciii,radiology_report,PROMPT2_ICL_entailment
351,414,10,8,2,0.8,28,13,15,0.4642857142857143,0.5875706214689266,medlm,mimiciii,radiology_report,PROMPT2_ICL_entailment
352,415,11,9,2,0.8181818181818182,20,14,6,0.7,0.7544910179640719,medlm,mimiciii,radiology_report,PROMPT2_ICL_entailment
353,416,3,3,0,1.0,19,10,9,0.5263157894736842,0.6896551724137931,medlm,mimiciii,radiology_report,PROMPT2_ICL_entailment
354,417,12,8,4,0.6666666666666666,20,11,9,0.55,0.6027397260273972,medlm,mimiciii,radiology_report,PROMPT2_ICL_entailment
355,418,7,5,2,0.7142857142857143,14,9,5,0.6428571428571429,0.6766917293233083,medlm,mimiciii,radiology_report,PROMPT2_ICL_entailment
356,419,6,2,4,0.3333333333333333,16,10,6,0.625,0.4347826086956521,medlm,mimiciii,radiology_report,PROMPT2_ICL_entailment
357,42,11,8,3,0.7272727272727273,14,9,5,0.6428571428571429,0.6824644549763033,medlm,mimiciii,radiology_report,PROMPT2_ICL_entailment
358,420,9,5,4,0.5555555555555556,15,8,7,0.5333333333333333,0.5442176870748299,medlm,mimiciii,radiology_report,PROMPT2_ICL_entailment
359,421,8,3,5,0.375,23,15,8,0.6521739130434783,0.4761904761904762,medlm,mimiciii,radiology_report,PROMPT2_ICL_entailment
360,422,8,3,5,0.375,20,12,8,0.6,0.4615384615384615,medlm,mimiciii,radiology_report,PROMPT2_ICL_entailment
361,423,6,5,1,0.8333333333333334,12,5,7,0.4166666666666667,0.5555555555555556,medlm,mimiciii,radiology_report,PROMPT2_ICL_entailment
362,424,1,1,0,1.0,9,3,6,0.3333333333333333,0.5,medlm,mimiciii,radiology_report,PROMPT2_ICL_entailment
363,425,10,4,6,0.4,19,13,6,0.6842105263157895,0.5048543689320388,medlm,mimiciii,radiology_report,PROMPT2_ICL_entailment
364,426,5,5,0,1.0,16,11,5,0.6875,0.8148148148148148,medlm,mimiciii,radiology_report,PROMPT2_ICL_entailment
365,427,7,6,1,0.8571428571428571,15,6,9,0.4,0.5454545454545455,medlm,mimiciii,radiology_report,PROMPT2_ICL_entailment
366,428,7,6,1,0.8571428571428571,15,13,2,0.8666666666666667,0.861878453038674,medlm,mimiciii,radiology_report,PROMPT2_ICL_entailment
367,429,6,5,1,0.8333333333333334,13,7,6,0.5384615384615384,0.6542056074766356,medlm,mimiciii,radiology_report,PROMPT2_ICL_entailment
368,43,6,6,0,1.0,7,5,2,0.7142857142857143,0.8333333333333333,medlm,mimiciii,radiology_report,PROMPT2_ICL_entailment
369,430,5,5,0,1.0,7,5,2,0.7142857142857143,0.8333333333333333,medlm,mimiciii,radiology_report,PROMPT2_ICL_entailment
370,431,7,2,5,0.2857142857142857,18,13,5,0.7222222222222222,0.4094488188976378,medlm,mimiciii,radiology_report,PROMPT2_ICL_entailment
371,432,12,9,3,0.75,13,6,7,0.4615384615384615,0.5714285714285714,medlm,mimiciii,radiology_report,PROMPT2_ICL_entailment
372,433,6,6,0,1.0,18,8,10,0.4444444444444444,0.6153846153846153,medlm,mimiciii,radiology_report,PROMPT2_ICL_entailment
373,434,9,6,3,0.6666666666666666,27,16,11,0.5925925925925926,0.627450980392157,medlm,mimiciii,radiology_report,PROMPT2_ICL_entailment
374,435,5,2,3,0.4,13,9,4,0.6923076923076923,0.5070422535211268,medlm,mimiciii,radiology_report,PROMPT2_ICL_entailment
375,436,6,4,2,0.6666666666666666,25,17,8,0.68,0.6732673267326733,medlm,mimiciii,radiology_report,PROMPT2_ICL_entailment
376,437,4,4,0,1.0,7,4,3,0.5714285714285714,0.7272727272727273,medlm,mimiciii,radiology_report,PROMPT2_ICL_entailment
377,438,9,9,0,1.0,19,14,5,0.7368421052631579,0.8484848484848484,medlm,mimiciii,radiology_report,PROMPT2_ICL_entailment
378,439,6,4,2,0.6666666666666666,22,18,4,0.8181818181818182,0.7346938775510203,medlm,mimiciii,radiology_report,PROMPT2_ICL_entailment
379,44,8,7,1,0.875,16,12,4,0.75,0.8076923076923077,medlm,mimiciii,radiology_report,PROMPT2_ICL_entailment
380,440,7,4,3,0.5714285714285714,19,11,8,0.5789473684210527,0.5751633986928104,medlm,mimiciii,radiology_report,PROMPT2_ICL_entailment
381,441,10,7,3,0.7,17,14,3,0.8235294117647058,0.7567567567567567,medlm,mimiciii,radiology_report,PROMPT2_ICL_entailment
382,442,6,5,1,0.8333333333333334,12,5,7,0.4166666666666667,0.5555555555555556,medlm,mimiciii,radiology_report,PROMPT2_ICL_entailment
383,443,11,5,6,0.4545454545454545,21,10,11,0.4761904761904761,0.4651162790697674,medlm,mimiciii,radiology_report,PROMPT2_ICL_entailment
384,444,7,7,0,1.0,8,5,3,0.625,0.7692307692307693,medlm,mimiciii,radiology_report,PROMPT2_ICL_entailment
385,445,10,6,4,0.6,22,17,5,0.7727272727272727,0.6754966887417219,medlm,mimiciii,radiology_report,PROMPT2_ICL_entailment
386,446,10,8,2,0.8,22,14,8,0.6363636363636364,0.7088607594936709,medlm,mimiciii,radiology_report,PROMPT2_ICL_entailment
387,447,7,6,1,0.8571428571428571,14,10,4,0.7142857142857143,0.7792207792207793,medlm,mimiciii,radiology_report,PROMPT2_ICL_entailment
388,448,15,11,4,0.7333333333333333,36,17,19,0.4722222222222222,0.5745007680491552,medlm,mimiciii,radiology_report,PROMPT2_ICL_entailment
389,449,5,5,0,1.0,9,6,3,0.6666666666666666,0.8,medlm,mimiciii,radiology_report,PROMPT2_ICL_entailment
390,45,11,4,7,0.3636363636363636,20,14,6,0.7,0.4786324786324786,medlm,mimiciii,radiology_report,PROMPT2_ICL_entailment
391,450,9,8,1,0.8888888888888888,21,14,7,0.6666666666666666,0.761904761904762,medlm,mimiciii,radiology_report,PROMPT2_ICL_entailment
392,451,7,7,0,1.0,10,9,1,0.9,0.9473684210526316,medlm,mimiciii,radiology_report,PROMPT2_ICL_entailment
393,452,7,7,0,1.0,16,9,7,0.5625,0.72,medlm,mimiciii,radiology_report,PROMPT2_ICL_entailment
394,453,5,4,1,0.8,14,10,4,0.7142857142857143,0.7547169811320756,medlm,mimiciii,radiology_report,PROMPT2_ICL_entailment
395,454,5,2,3,0.4,10,6,4,0.6,0.48,medlm,mimiciii,radiology_report,PROMPT2_ICL_entailment
396,455,7,6,1,0.8571428571428571,16,9,7,0.5625,0.6792452830188678,medlm,mimiciii,radiology_report,PROMPT2_ICL_entailment
397,456,8,5,3,0.625,21,18,3,0.8571428571428571,0.7228915662650602,medlm,mimiciii,radiology_report,PROMPT2_ICL_entailment
398,457,5,5,0,1.0,12,8,4,0.6666666666666666,0.8,medlm,mimiciii,radiology_report,PROMPT2_ICL_entailment
399,458,5,3,2,0.6,16,8,8,0.5,0.5454545454545454,medlm,mimiciii,radiology_report,PROMPT2_ICL_entailment
400,459,5,4,1,0.8,13,6,7,0.4615384615384615,0.5853658536585367,medlm,mimiciii,radiology_report,PROMPT2_ICL_entailment
401,46,8,7,1,0.875,26,14,12,0.5384615384615384,0.6666666666666667,medlm,mimiciii,radiology_report,PROMPT2_ICL_entailment
402,460,6,5,1,0.8333333333333334,20,14,6,0.7,0.7608695652173915,medlm,mimiciii,radiology_report,PROMPT2_ICL_entailment
403,461,7,3,4,0.4285714285714285,22,6,16,0.2727272727272727,0.3333333333333332,medlm,mimiciii,radiology_report,PROMPT2_ICL_entailment
404,462,11,6,5,0.5454545454545454,20,15,5,0.75,0.631578947368421,medlm,mimiciii,radiology_report,PROMPT2_ICL_entailment
405,463,5,4,1,0.8,12,6,6,0.5,0.6153846153846154,medlm,mimiciii,radiology_report,PROMPT2_ICL_entailment
406,464,8,4,4,0.5,25,14,11,0.56,0.5283018867924528,medlm,mimiciii,radiology_report,PROMPT2_ICL_entailment
407,465,10,8,2,0.8,33,18,15,0.5454545454545454,0.6486486486486486,medlm,mimiciii,radiology_report,PROMPT2_ICL_entailment
408,466,6,5,1,0.8333333333333334,22,10,12,0.4545454545454545,0.5882352941176471,medlm,mimiciii,radiology_report,PROMPT2_ICL_entailment
409,467,5,5,0,1.0,14,8,6,0.5714285714285714,0.7272727272727273,medlm,mimiciii,radiology_report,PROMPT2_ICL_entailment
410,468,7,6,1,0.8571428571428571,18,12,6,0.6666666666666666,0.75,medlm,mimiciii,radiology_report,PROMPT2_ICL_entailment
411,469,14,10,4,0.7142857142857143,25,15,10,0.6,0.6521739130434783,medlm,mimiciii,radiology_report,PROMPT2_ICL_entailment
412,47,7,6,1,0.8571428571428571,15,7,8,0.4666666666666667,0.60431654676259,medlm,mimiciii,radiology_report,PROMPT2_ICL_entailment
413,470,8,5,3,0.625,15,10,5,0.6666666666666666,0.6451612903225806,medlm,mimiciii,radiology_report,PROMPT2_ICL_entailment
414,471,10,8,2,0.8,18,12,6,0.6666666666666666,0.7272727272727272,medlm,mimiciii,radiology_report,PROMPT2_ICL_entailment
415,472,6,5,1,0.8333333333333334,16,10,6,0.625,0.7142857142857143,medlm,mimiciii,radiology_report,PROMPT2_ICL_entailment
416,473,7,5,2,0.7142857142857143,11,8,3,0.7272727272727273,0.7207207207207208,medlm,mimiciii,radiology_report,PROMPT2_ICL_entailment
417,474,11,10,1,0.9090909090909092,25,18,7,0.72,0.8035714285714286,medlm,mimiciii,radiology_report,PROMPT2_ICL_entailment
418,475,3,2,1,0.6666666666666666,7,3,4,0.4285714285714285,0.5217391304347826,medlm,mimiciii,radiology_report,PROMPT2_ICL_entailment
419,476,10,7,3,0.7,12,9,3,0.75,0.7241379310344827,medlm,mimiciii,radiology_report,PROMPT2_ICL_entailment
420,477,10,6,4,0.6,16,12,4,0.75,0.6666666666666665,medlm,mimiciii,radiology_report,PROMPT2_ICL_entailment
421,478,12,11,1,0.9166666666666666,21,14,7,0.6666666666666666,0.7719298245614035,medlm,mimiciii,radiology_report,PROMPT2_ICL_entailment
422,479,11,8,3,0.7272727272727273,22,13,9,0.5909090909090909,0.6520376175548589,medlm,mimiciii,radiology_report,PROMPT2_ICL_entailment
423,48,7,6,1,0.8571428571428571,21,12,9,0.5714285714285714,0.6857142857142857,medlm,mimiciii,radiology_report,PROMPT2_ICL_entailment
424,480,3,3,0,1.0,10,3,7,0.3,0.4615384615384615,medlm,mimiciii,radiology_report,PROMPT2_ICL_entailment
425,481,9,4,5,0.4444444444444444,17,12,5,0.7058823529411765,0.5454545454545455,medlm,mimiciii,radiology_report,PROMPT2_ICL_entailment
426,482,7,2,5,0.2857142857142857,19,12,7,0.631578947368421,0.3934426229508196,medlm,mimiciii,radiology_report,PROMPT2_ICL_entailment
427,483,16,15,1,0.9375,27,14,13,0.5185185185185185,0.6677265500794912,medlm,mimiciii,radiology_report,PROMPT2_ICL_entailment
428,484,6,6,0,1.0,13,9,4,0.6923076923076923,0.8181818181818181,medlm,mimiciii,radiology_report,PROMPT2_ICL_entailment
429,485,8,6,2,0.75,27,15,12,0.5555555555555556,0.6382978723404256,medlm,mimiciii,radiology_report,PROMPT2_ICL_entailment
430,486,7,7,0,1.0,11,8,3,0.7272727272727273,0.8421052631578948,medlm,mimiciii,radiology_report,PROMPT2_ICL_entailment
431,487,7,5,2,0.7142857142857143,20,12,8,0.6,0.6521739130434783,medlm,mimiciii,radiology_report,PROMPT2_ICL_entailment
432,488,8,5,3,0.625,15,5,10,0.3333333333333333,0.4347826086956521,medlm,mimiciii,radiology_report,PROMPT2_ICL_entailment
433,489,7,5,2,0.7142857142857143,18,9,9,0.5,0.588235294117647,medlm,mimiciii,radiology_report,PROMPT2_ICL_entailment
434,49,12,10,2,0.8333333333333334,24,15,9,0.625,0.7142857142857143,medlm,mimiciii,radiology_report,PROMPT2_ICL_entailment
435,490,3,2,1,0.6666666666666666,8,2,6,0.25,0.3636363636363636,medlm,mimiciii,radiology_report,PROMPT2_ICL_entailment
436,491,6,5,1,0.8333333333333334,17,8,9,0.4705882352941176,0.6015037593984962,medlm,mimiciii,radiology_report,PROMPT2_ICL_entailment
437,492,7,7,0,1.0,13,8,5,0.6153846153846154,0.761904761904762,medlm,mimiciii,radiology_report,PROMPT2_ICL_entailment
438,493,6,4,2,0.6666666666666666,9,4,5,0.4444444444444444,0.5333333333333333,medlm,mimiciii,radiology_report,PROMPT2_ICL_entailment
439,494,5,5,0,1.0,8,4,4,0.5,0.6666666666666666,medlm,mimiciii,radiology_report,PROMPT2_ICL_entailment
440,495,5,5,0,1.0,12,9,3,0.75,0.8571428571428571,medlm,mimiciii,radiology_report,PROMPT2_ICL_entailment
441,496,15,15,0,1.0,36,17,19,0.4722222222222222,0.6415094339622641,medlm,mimiciii,radiology_report,PROMPT2_ICL_entailment
442,497,7,6,1,0.8571428571428571,25,10,15,0.4,0.5454545454545455,medlm,mimiciii,radiology_report,PROMPT2_ICL_entailment
443,498,6,3,3,0.5,22,13,9,0.5909090909090909,0.5416666666666667,medlm,mimiciii,radiology_report,PROMPT2_ICL_entailment
444,499,12,9,3,0.75,17,14,3,0.8235294117647058,0.7850467289719627,medlm,mimiciii,radiology_report,PROMPT2_ICL_entailment
445,5,9,8,1,0.8888888888888888,22,13,9,0.5909090909090909,0.7098976109215018,medlm,mimiciii,radiology_report,PROMPT2_ICL_entailment
446,50,6,4,2,0.6666666666666666,15,9,6,0.6,0.631578947368421,medlm,mimiciii,radiology_report,PROMPT2_ICL_entailment
447,51,7,6,1,0.8571428571428571,13,8,5,0.6153846153846154,0.7164179104477612,medlm,mimiciii,radiology_report,PROMPT2_ICL_entailment
448,52,9,5,4,0.5555555555555556,21,12,9,0.5714285714285714,0.5633802816901409,medlm,mimiciii,radiology_report,PROMPT2_ICL_entailment
449,53,7,5,2,0.7142857142857143,12,5,7,0.4166666666666667,0.5263157894736842,medlm,mimiciii,radiology_report,PROMPT2_ICL_entailment
450,54,6,4,2,0.6666666666666666,10,6,4,0.6,0.631578947368421,medlm,mimiciii,radiology_report,PROMPT2_ICL_entailment
451,55,12,6,6,0.5,18,13,5,0.7222222222222222,0.5909090909090908,medlm,mimiciii,radiology_report,PROMPT2_ICL_entailment
452,56,7,2,5,0.2857142857142857,21,13,8,0.6190476190476191,0.3909774436090225,medlm,mimiciii,radiology_report,PROMPT2_ICL_entailment
453,57,5,5,0,1.0,10,6,4,0.6,0.7499999999999999,medlm,mimiciii,radiology_report,PROMPT2_ICL_entailment
454,58,8,7,1,0.875,16,11,5,0.6875,0.77,medlm,mimiciii,radiology_report,PROMPT2_ICL_entailment
455,59,7,6,1,0.8571428571428571,16,12,4,0.75,0.7999999999999999,medlm,mimiciii,radiology_report,PROMPT2_ICL_entailment
456,6,3,3,0,1.0,8,6,2,0.75,0.8571428571428571,medlm,mimiciii,radiology_report,PROMPT2_ICL_entailment
457,60,10,8,2,0.8,19,10,9,0.5263157894736842,0.6349206349206348,medlm,mimiciii,radiology_report,PROMPT2_ICL_entailment
458,61,9,6,3,0.6666666666666666,22,14,8,0.6363636363636364,0.6511627906976744,medlm,mimiciii,radiology_report,PROMPT2_ICL_entailment
459,62,6,3,3,0.5,13,7,6,0.5384615384615384,0.5185185185185186,medlm,mimiciii,radiology_report,PROMPT2_ICL_entailment
460,63,6,6,0,1.0,15,7,8,0.4666666666666667,0.6363636363636364,medlm,mimiciii,radiology_report,PROMPT2_ICL_entailment
461,64,8,8,0,1.0,20,10,10,0.5,0.6666666666666666,medlm,mimiciii,radiology_report,PROMPT2_ICL_entailment
462,65,9,7,2,0.7777777777777778,18,13,5,0.7222222222222222,0.7489711934156379,medlm,mimiciii,radiology_report,PROMPT2_ICL_entailment
463,66,9,7,2,0.7777777777777778,34,20,14,0.5882352941176471,0.6698564593301436,medlm,mimiciii,radiology_report,PROMPT2_ICL_entailment
464,67,7,5,2,0.7142857142857143,28,20,8,0.7142857142857143,0.7142857142857143,medlm,mimiciii,radiology_report,PROMPT2_ICL_entailment
465,68,6,5,1,0.8333333333333334,35,28,7,0.8,0.816326530612245,medlm,mimiciii,radiology_report,PROMPT2_ICL_entailment
466,69,15,8,7,0.5333333333333333,31,18,13,0.5806451612903226,0.555984555984556,medlm,mimiciii,radiology_report,PROMPT2_ICL_entailment
467,7,8,7,1,0.875,16,15,1,0.9375,0.9051724137931034,medlm,mimiciii,radiology_report,PROMPT2_ICL_entailment
468,70,7,6,1,0.8571428571428571,17,10,7,0.5882352941176471,0.6976744186046512,medlm,mimiciii,radiology_report,PROMPT2_ICL_entailment
469,71,8,6,2,0.75,18,10,8,0.5555555555555556,0.6382978723404256,medlm,mimiciii,radiology_report,PROMPT2_ICL_entailment
470,72,6,5,1,0.8333333333333334,13,8,5,0.6153846153846154,0.7079646017699115,medlm,mimiciii,radiology_report,PROMPT2_ICL_entailment
471,73,14,11,3,0.7857142857142857,34,15,19,0.4411764705882353,0.5650684931506849,medlm,mimiciii,radiology_report,PROMPT2_ICL_entailment
472,74,9,7,2,0.7777777777777778,18,10,8,0.5555555555555556,0.6481481481481481,medlm,mimiciii,radiology_report,PROMPT2_ICL_entailment
473,75,9,6,3,0.6666666666666666,12,9,3,0.75,0.7058823529411765,medlm,mimiciii,radiology_report,PROMPT2_ICL_entailment
474,76,7,5,2,0.7142857142857143,14,10,4,0.7142857142857143,0.7142857142857143,medlm,mimiciii,radiology_report,PROMPT2_ICL_entailment
475,77,9,9,0,1.0,26,14,12,0.5384615384615384,0.7000000000000001,medlm,mimiciii,radiology_report,PROMPT2_ICL_entailment
476,78,13,11,2,0.8461538461538461,33,21,12,0.6363636363636364,0.7264150943396226,medlm,mimiciii,radiology_report,PROMPT2_ICL_entailment
477,79,8,6,2,0.75,17,9,8,0.5294117647058824,0.6206896551724139,medlm,mimiciii,radiology_report,PROMPT2_ICL_entailment
478,8,10,8,2,0.8,15,11,4,0.7333333333333333,0.7652173913043478,medlm,mimiciii,radiology_report,PROMPT2_ICL_entailment
479,80,10,8,2,0.8,25,17,8,0.68,0.7351351351351352,medlm,mimiciii,radiology_report,PROMPT2_ICL_entailment
480,81,6,5,1,0.8333333333333334,15,9,6,0.6,0.6976744186046512,medlm,mimiciii,radiology_report,PROMPT2_ICL_entailment
481,82,10,9,1,0.9,14,12,2,0.8571428571428571,0.8780487804878048,medlm,mimiciii,radiology_report,PROMPT2_ICL_entailment
482,83,4,1,3,0.25,17,10,7,0.5882352941176471,0.3508771929824561,medlm,mimiciii,radiology_report,PROMPT2_ICL_entailment
483,84,13,8,5,0.6153846153846154,20,15,5,0.75,0.676056338028169,medlm,mimiciii,radiology_report,PROMPT2_ICL_entailment
484,85,6,6,0,1.0,14,12,2,0.8571428571428571,0.923076923076923,medlm,mimiciii,radiology_report,PROMPT2_ICL_entailment
485,86,4,4,0,1.0,10,6,4,0.6,0.7499999999999999,medlm,mimiciii,radiology_report,PROMPT2_ICL_entailment
486,87,7,6,1,0.8571428571428571,14,8,6,0.5714285714285714,0.6857142857142857,medlm,mimiciii,radiology_report,PROMPT2_ICL_entailment
487,88,8,8,0,1.0,19,13,6,0.6842105263157895,0.8125000000000001,medlm,mimiciii,radiology_report,PROMPT2_ICL_entailment
488,89,15,12,3,0.8,18,14,4,0.7777777777777778,0.7887323943661971,medlm,mimiciii,radiology_report,PROMPT2_ICL_entailment
489,9,5,4,1,0.8,13,8,5,0.6153846153846154,0.6956521739130435,medlm,mimiciii,radiology_report,PROMPT2_ICL_entailment
490,90,5,5,0,1.0,14,7,7,0.5,0.6666666666666666,medlm,mimiciii,radiology_report,PROMPT2_ICL_entailment
491,91,5,5,0,1.0,13,8,5,0.6153846153846154,0.761904761904762,medlm,mimiciii,radiology_report,PROMPT2_ICL_entailment
492,92,6,5,1,0.8333333333333334,21,10,11,0.4761904761904761,0.6060606060606061,medlm,mimiciii,radiology_report,PROMPT2_ICL_entailment
493,93,8,7,1,0.875,15,11,4,0.7333333333333333,0.7979274611398963,medlm,mimiciii,radiology_report,PROMPT2_ICL_entailment
494,94,10,6,4,0.6,28,15,13,0.5357142857142857,0.5660377358490566,medlm,mimiciii,radiology_report,PROMPT2_ICL_entailment
495,95,9,9,0,1.0,18,11,7,0.6111111111111112,0.7586206896551725,medlm,mimiciii,radiology_report,PROMPT2_ICL_entailment
496,96,12,9,3,0.75,21,13,8,0.6190476190476191,0.6782608695652174,medlm,mimiciii,radiology_report,PROMPT2_ICL_entailment
497,97,9,6,3,0.6666666666666666,23,17,6,0.7391304347826086,0.7010309278350515,medlm,mimiciii,radiology_report,PROMPT2_ICL_entailment
498,98,7,2,5,0.2857142857142857,19,12,7,0.631578947368421,0.3934426229508196,medlm,mimiciii,radiology_report,PROMPT2_ICL_entailment
499,99,7,6,1,0.8571428571428571,13,8,5,0.6153846153846154,0.7164179104477612,medlm,mimiciii,radiology_report,PROMPT2_ICL_entailment
0,0,7,4,3,0.5714285714285714,21,13,8,0.6190476190476191,0.5942857142857143,medlm,mimiciii,radiology_report,PROMPT2_entailment
1,1,6,4,2,0.6666666666666666,15,9,6,0.6,0.631578947368421,medlm,mimiciii,radiology_report,PROMPT2_entailment
2,10,7,5,2,0.7142857142857143,18,13,5,0.7222222222222222,0.7182320441988951,medlm,mimiciii,radiology_report,PROMPT2_entailment
3,100,5,5,0,1.0,9,6,3,0.6666666666666666,0.8,medlm,mimiciii,radiology_report,PROMPT2_entailment
4,101,6,5,1,0.8333333333333334,15,9,6,0.6,0.6976744186046512,medlm,mimiciii,radiology_report,PROMPT2_entailment
5,102,8,6,2,0.75,16,8,8,0.5,0.6,medlm,mimiciii,radiology_report,PROMPT2_entailment
6,103,8,8,0,1.0,19,14,5,0.7368421052631579,0.8484848484848484,medlm,mimiciii,radiology_report,PROMPT2_entailment
7,104,6,2,4,0.3333333333333333,17,8,9,0.4705882352941176,0.3902439024390243,medlm,mimiciii,radiology_report,PROMPT2_entailment
8,105,5,5,0,1.0,8,6,2,0.75,0.8571428571428571,medlm,mimiciii,radiology_report,PROMPT2_entailment
9,106,7,6,1,0.8571428571428571,12,7,5,0.5833333333333334,0.6942148760330579,medlm,mimiciii,radiology_report,PROMPT2_entailment
10,107,9,5,4,0.5555555555555556,19,12,7,0.631578947368421,0.5911330049261083,medlm,mimiciii,radiology_report,PROMPT2_entailment
11,108,6,6,0,1.0,13,11,2,0.8461538461538461,0.9166666666666666,medlm,mimiciii,radiology_report,PROMPT2_entailment
12,109,10,4,6,0.4,20,17,3,0.85,0.544,medlm,mimiciii,radiology_report,PROMPT2_entailment
13,11,9,8,1,0.8888888888888888,24,15,9,0.625,0.7339449541284404,medlm,mimiciii,radiology_report,PROMPT2_entailment
14,110,9,9,0,1.0,17,11,6,0.6470588235294118,0.7857142857142858,medlm,mimiciii,radiology_report,PROMPT2_entailment
15,111,7,4,3,0.5714285714285714,20,16,4,0.8,0.6666666666666666,medlm,mimiciii,radiology_report,PROMPT2_entailment
16,112,6,4,2,0.6666666666666666,14,9,5,0.6428571428571429,0.6545454545454545,medlm,mimiciii,radiology_report,PROMPT2_entailment
17,113,6,4,2,0.6666666666666666,20,11,9,0.55,0.6027397260273972,medlm,mimiciii,radiology_report,PROMPT2_entailment
18,114,8,3,5,0.375,23,17,6,0.7391304347826086,0.4975609756097561,medlm,mimiciii,radiology_report,PROMPT2_entailment
19,115,7,6,1,0.8571428571428571,20,15,5,0.75,0.7999999999999999,medlm,mimiciii,radiology_report,PROMPT2_entailment
20,116,5,5,0,1.0,13,6,7,0.4615384615384615,0.631578947368421,medlm,mimiciii,radiology_report,PROMPT2_entailment
21,117,7,5,2,0.7142857142857143,16,10,6,0.625,0.6666666666666666,medlm,mimiciii,radiology_report,PROMPT2_entailment
22,118,8,4,4,0.5,24,16,8,0.6666666666666666,0.5714285714285715,medlm,mimiciii,radiology_report,PROMPT2_entailment
23,119,7,6,1,0.8571428571428571,17,11,6,0.6470588235294118,0.7374301675977654,medlm,mimiciii,radiology_report,PROMPT2_entailment
24,12,7,7,0,1.0,17,14,3,0.8235294117647058,0.9032258064516128,medlm,mimiciii,radiology_report,PROMPT2_entailment
25,120,7,4,3,0.5714285714285714,16,10,6,0.625,0.5970149253731343,medlm,mimiciii,radiology_report,PROMPT2_entailment
26,121,10,6,4,0.6,26,19,7,0.7307692307692307,0.6589595375722542,medlm,mimiciii,radiology_report,PROMPT2_entailment
27,122,7,6,1,0.8571428571428571,20,14,6,0.7,0.7706422018348624,medlm,mimiciii,radiology_report,PROMPT2_entailment
28,123,10,8,2,0.8,13,8,5,0.6153846153846154,0.6956521739130435,medlm,mimiciii,radiology_report,PROMPT2_entailment
29,124,9,8,1,0.8888888888888888,12,8,4,0.6666666666666666,0.761904761904762,medlm,mimiciii,radiology_report,PROMPT2_entailment
30,125,8,4,4,0.5,23,17,6,0.7391304347826086,0.5964912280701754,medlm,mimiciii,radiology_report,PROMPT2_entailment
31,126,5,3,2,0.6,9,5,4,0.5555555555555556,0.576923076923077,medlm,mimiciii,radiology_report,PROMPT2_entailment
32,127,16,15,1,0.9375,50,30,20,0.6,0.7317073170731707,medlm,mimiciii,radiology_report,PROMPT2_entailment
33,128,5,4,1,0.8,14,9,5,0.6428571428571429,0.7128712871287128,medlm,mimiciii,radiology_report,PROMPT2_entailment
34,129,8,4,4,0.5,16,11,5,0.6875,0.5789473684210527,medlm,mimiciii,radiology_report,PROMPT2_entailment
35,13,7,5,2,0.7142857142857143,17,15,2,0.8823529411764706,0.7894736842105262,medlm,mimiciii,radiology_report,PROMPT2_entailment
36,130,9,9,0,1.0,29,20,9,0.6896551724137931,0.8163265306122449,medlm,mimiciii,radiology_report,PROMPT2_entailment
37,131,6,5,1,0.8333333333333334,45,14,31,0.3111111111111111,0.453074433656958,medlm,mimiciii,radiology_report,PROMPT2_entailment
38,132,6,3,3,0.5,23,11,12,0.4782608695652174,0.4888888888888889,medlm,mimiciii,radiology_report,PROMPT2_entailment
39,133,6,5,1,0.8333333333333334,21,10,11,0.4761904761904761,0.6060606060606061,medlm,mimiciii,radiology_report,PROMPT2_entailment
40,134,6,6,0,1.0,23,16,7,0.6956521739130435,0.8205128205128205,medlm,mimiciii,radiology_report,PROMPT2_entailment
41,135,7,7,0,1.0,20,13,7,0.65,0.787878787878788,medlm,mimiciii,radiology_report,PROMPT2_entailment
42,136,5,2,3,0.4,14,9,5,0.6428571428571429,0.4931506849315069,medlm,mimiciii,radiology_report,PROMPT2_entailment
43,137,7,7,0,1.0,10,9,1,0.9,0.9473684210526316,medlm,mimiciii,radiology_report,PROMPT2_entailment
44,138,6,5,1,0.8333333333333334,14,11,3,0.7857142857142857,0.8088235294117647,medlm,mimiciii,radiology_report,PROMPT2_entailment
45,139,8,7,1,0.875,13,9,4,0.6923076923076923,0.7730061349693251,medlm,mimiciii,radiology_report,PROMPT2_entailment
46,14,6,6,0,1.0,12,8,4,0.6666666666666666,0.8,medlm,mimiciii,radiology_report,PROMPT2_entailment
47,140,9,7,2,0.7777777777777778,18,12,6,0.6666666666666666,0.717948717948718,medlm,mimiciii,radiology_report,PROMPT2_entailment
48,141,9,6,3,0.6666666666666666,16,8,8,0.5,0.5714285714285715,medlm,mimiciii,radiology_report,PROMPT2_entailment
49,142,9,8,1,0.8888888888888888,14,11,3,0.7857142857142857,0.8341232227488152,medlm,mimiciii,radiology_report,PROMPT2_entailment
50,143,7,7,0,1.0,32,19,13,0.59375,0.7450980392156863,medlm,mimiciii,radiology_report,PROMPT2_entailment
51,144,4,4,0,1.0,26,14,12,0.5384615384615384,0.7000000000000001,medlm,mimiciii,radiology_report,PROMPT2_entailment
52,145,7,3,4,0.4285714285714285,18,15,3,0.8333333333333334,0.5660377358490566,medlm,mimiciii,radiology_report,PROMPT2_entailment
53,146,6,5,1,0.8333333333333334,11,8,3,0.7272727272727273,0.7766990291262137,medlm,mimiciii,radiology_report,PROMPT2_entailment
54,147,7,6,1,0.8571428571428571,10,7,3,0.7,0.7706422018348624,medlm,mimiciii,radiology_report,PROMPT2_entailment
55,148,5,4,1,0.8,32,22,10,0.6875,0.7394957983193278,medlm,mimiciii,radiology_report,PROMPT2_entailment
56,149,6,4,2,0.6666666666666666,20,14,6,0.7,0.6829268292682926,medlm,mimiciii,radiology_report,PROMPT2_entailment
57,15,12,7,5,0.5833333333333334,29,19,10,0.6551724137931034,0.617169373549884,medlm,mimiciii,radiology_report,PROMPT2_entailment
58,150,7,5,2,0.7142857142857143,14,12,2,0.8571428571428571,0.7792207792207793,medlm,mimiciii,radiology_report,PROMPT2_entailment
59,151,5,3,2,0.6,15,8,7,0.5333333333333333,0.5647058823529412,medlm,mimiciii,radiology_report,PROMPT2_entailment
60,152,5,4,1,0.8,18,10,8,0.5555555555555556,0.6557377049180328,medlm,mimiciii,radiology_report,PROMPT2_entailment
61,153,5,3,2,0.6,16,10,6,0.625,0.6122448979591836,medlm,mimiciii,radiology_report,PROMPT2_entailment
62,154,8,3,5,0.375,23,13,10,0.5652173913043478,0.4508670520231214,medlm,mimiciii,radiology_report,PROMPT2_entailment
63,155,18,17,1,0.9444444444444444,47,37,10,0.7872340425531915,0.8587030716723549,medlm,mimiciii,radiology_report,PROMPT2_entailment
64,156,11,6,5,0.5454545454545454,20,13,7,0.65,0.5931558935361217,medlm,mimiciii,radiology_report,PROMPT2_entailment
65,157,9,7,2,0.7777777777777778,12,10,2,0.8333333333333334,0.8045977011494253,medlm,mimiciii,radiology_report,PROMPT2_entailment
66,158,4,4,0,1.0,6,1,5,0.1666666666666666,0.2857142857142857,medlm,mimiciii,radiology_report,PROMPT2_entailment
67,159,7,4,3,0.5714285714285714,13,10,3,0.7692307692307693,0.6557377049180327,medlm,mimiciii,radiology_report,PROMPT2_entailment
68,16,6,6,0,1.0,17,11,6,0.6470588235294118,0.7857142857142858,medlm,mimiciii,radiology_report,PROMPT2_entailment
69,160,7,7,0,1.0,12,7,5,0.5833333333333334,0.7368421052631579,medlm,mimiciii,radiology_report,PROMPT2_entailment
70,161,5,3,2,0.6,13,8,5,0.6153846153846154,0.6075949367088608,medlm,mimiciii,radiology_report,PROMPT2_entailment
71,162,9,9,0,1.0,11,9,2,0.8181818181818182,0.9,medlm,mimiciii,radiology_report,PROMPT2_entailment
72,163,7,6,1,0.8571428571428571,8,5,3,0.625,0.7228915662650602,medlm,mimiciii,radiology_report,PROMPT2_entailment
73,164,6,6,0,1.0,10,6,4,0.6,0.7499999999999999,medlm,mimiciii,radiology_report,PROMPT2_entailment
74,165,10,8,2,0.8,31,26,5,0.8387096774193549,0.8188976377952757,medlm,mimiciii,radiology_report,PROMPT2_entailment
75,166,7,5,2,0.7142857142857143,26,16,10,0.6153846153846154,0.6611570247933884,medlm,mimiciii,radiology_report,PROMPT2_entailment
76,167,5,5,0,1.0,10,6,4,0.6,0.7499999999999999,medlm,mimiciii,radiology_report,PROMPT2_entailment
77,168,7,5,2,0.7142857142857143,13,7,6,0.5384615384615384,0.6140350877192982,medlm,mimiciii,radiology_report,PROMPT2_entailment
78,169,8,6,2,0.75,22,15,7,0.6818181818181818,0.7142857142857143,medlm,mimiciii,radiology_report,PROMPT2_entailment
79,17,4,4,0,1.0,12,7,5,0.5833333333333334,0.7368421052631579,medlm,mimiciii,radiology_report,PROMPT2_entailment
80,170,10,7,3,0.7,24,16,8,0.6666666666666666,0.6829268292682926,medlm,mimiciii,radiology_report,PROMPT2_entailment
81,171,6,6,0,1.0,7,6,1,0.8571428571428571,0.923076923076923,medlm,mimiciii,radiology_report,PROMPT2_entailment
82,172,5,3,2,0.6,14,10,4,0.7142857142857143,0.6521739130434783,medlm,mimiciii,radiology_report,PROMPT2_entailment
83,173,5,3,2,0.6,12,8,4,0.6666666666666666,0.631578947368421,medlm,mimiciii,radiology_report,PROMPT2_entailment
84,174,7,7,0,1.0,20,12,8,0.6,0.7499999999999999,medlm,mimiciii,radiology_report,PROMPT2_entailment
85,175,5,5,0,1.0,8,5,3,0.625,0.7692307692307693,medlm,mimiciii,radiology_report,PROMPT2_entailment
86,176,9,6,3,0.6666666666666666,19,11,8,0.5789473684210527,0.619718309859155,medlm,mimiciii,radiology_report,PROMPT2_entailment
87,177,8,7,1,0.875,16,12,4,0.75,0.8076923076923077,medlm,mimiciii,radiology_report,PROMPT2_entailment
88,178,7,1,6,0.1428571428571428,25,17,8,0.68,0.236111111111111,medlm,mimiciii,radiology_report,PROMPT2_entailment
89,179,7,7,0,1.0,20,12,8,0.6,0.7499999999999999,medlm,mimiciii,radiology_report,PROMPT2_entailment
90,18,11,9,2,0.8181818181818182,17,11,6,0.6470588235294118,0.7226277372262774,medlm,mimiciii,radiology_report,PROMPT2_entailment
91,180,6,5,1,0.8333333333333334,11,9,2,0.8181818181818182,0.8256880733944955,medlm,mimiciii,radiology_report,PROMPT2_entailment
92,181,10,6,4,0.6,26,13,13,0.5,0.5454545454545454,medlm,mimiciii,radiology_report,PROMPT2_entailment
93,182,9,6,3,0.6666666666666666,23,16,7,0.6956521739130435,0.6808510638297872,medlm,mimiciii,radiology_report,PROMPT2_entailment
94,183,7,3,4,0.4285714285714285,17,12,5,0.7058823529411765,0.5333333333333333,medlm,mimiciii,radiology_report,PROMPT2_entailment
95,184,8,7,1,0.875,15,12,3,0.8,0.8358208955223881,medlm,mimiciii,radiology_report,PROMPT2_entailment
96,185,5,4,1,0.8,6,4,2,0.6666666666666666,0.7272727272727272,medlm,mimiciii,radiology_report,PROMPT2_entailment
97,186,8,6,2,0.75,26,19,7,0.7307692307692307,0.7402597402597402,medlm,mimiciii,radiology_report,PROMPT2_entailment
98,187,5,1,4,0.2,14,7,7,0.5,0.2857142857142857,medlm,mimiciii,radiology_report,PROMPT2_entailment
99,188,4,1,3,0.25,22,11,11,0.5,0.3333333333333333,medlm,mimiciii,radiology_report,PROMPT2_entailment
100,189,7,6,1,0.8571428571428571,15,12,3,0.8,0.8275862068965518,medlm,mimiciii,radiology_report,PROMPT2_entailment
101,19,7,6,1,0.8571428571428571,14,12,2,0.8571428571428571,0.8571428571428571,medlm,mimiciii,radiology_report,PROMPT2_entailment
102,190,6,5,1,0.8333333333333334,17,12,5,0.7058823529411765,0.7643312101910827,medlm,mimiciii,radiology_report,PROMPT2_entailment
103,191,6,4,2,0.6666666666666666,15,7,8,0.4666666666666667,0.5490196078431373,medlm,mimiciii,radiology_report,PROMPT2_entailment
104,192,8,7,1,0.875,28,21,7,0.75,0.8076923076923077,medlm,mimiciii,radiology_report,PROMPT2_entailment
105,193,8,8,0,1.0,14,11,3,0.7857142857142857,0.88,medlm,mimiciii,radiology_report,PROMPT2_entailment
106,194,9,9,0,1.0,49,21,28,0.4285714285714285,0.6,medlm,mimiciii,radiology_report,PROMPT2_entailment
107,195,10,6,4,0.6,21,13,8,0.6190476190476191,0.609375,medlm,mimiciii,radiology_report,PROMPT2_entailment
108,196,6,3,3,0.5,18,9,9,0.5,0.5,medlm,mimiciii,radiology_report,PROMPT2_entailment
109,197,5,2,3,0.4,15,9,6,0.6,0.48,medlm,mimiciii,radiology_report,PROMPT2_entailment
110,198,5,5,0,1.0,9,6,3,0.6666666666666666,0.8,medlm,mimiciii,radiology_report,PROMPT2_entailment
111,199,6,3,3,0.5,23,12,11,0.5217391304347826,0.5106382978723404,medlm,mimiciii,radiology_report,PROMPT2_entailment
112,2,6,4,2,0.6666666666666666,15,11,4,0.7333333333333333,0.6984126984126984,medlm,mimiciii,radiology_report,PROMPT2_entailment
113,20,10,10,0,1.0,42,22,20,0.5238095238095238,0.6875000000000001,medlm,mimiciii,radiology_report,PROMPT2_entailment
114,200,4,3,1,0.75,14,12,2,0.8571428571428571,0.7999999999999999,medlm,mimiciii,radiology_report,PROMPT2_entailment
115,201,8,4,4,0.5,18,12,6,0.6666666666666666,0.5714285714285715,medlm,mimiciii,radiology_report,PROMPT2_entailment
116,202,8,5,3,0.625,25,16,9,0.64,0.6324110671936759,medlm,mimiciii,radiology_report,PROMPT2_entailment
117,203,9,4,5,0.4444444444444444,19,11,8,0.5789473684210527,0.5028571428571428,medlm,mimiciii,radiology_report,PROMPT2_entailment
118,204,7,4,3,0.5714285714285714,23,13,10,0.5652173913043478,0.5683060109289616,medlm,mimiciii,radiology_report,PROMPT2_entailment
119,205,9,8,1,0.8888888888888888,14,9,5,0.6428571428571429,0.7461139896373057,medlm,mimiciii,radiology_report,PROMPT2_entailment
120,206,5,5,0,1.0,13,8,5,0.6153846153846154,0.761904761904762,medlm,mimiciii,radiology_report,PROMPT2_entailment
121,207,5,4,1,0.8,9,6,3,0.6666666666666666,0.7272727272727272,medlm,mimiciii,radiology_report,PROMPT2_entailment
122,208,8,4,4,0.5,18,12,6,0.6666666666666666,0.5714285714285715,medlm,mimiciii,radiology_report,PROMPT2_entailment
123,209,6,3,3,0.5,16,13,3,0.8125,0.6190476190476191,medlm,mimiciii,radiology_report,PROMPT2_entailment
124,21,8,6,2,0.75,27,14,13,0.5185185185185185,0.6131386861313868,medlm,mimiciii,radiology_report,PROMPT2_entailment
125,210,6,4,2,0.6666666666666666,14,9,5,0.6428571428571429,0.6545454545454545,medlm,mimiciii,radiology_report,PROMPT2_entailment
126,211,6,6,0,1.0,13,10,3,0.7692307692307693,0.8695652173913044,medlm,mimiciii,radiology_report,PROMPT2_entailment
127,212,8,5,3,0.625,19,16,3,0.8421052631578947,0.7174887892376681,medlm,mimiciii,radiology_report,PROMPT2_entailment
128,213,8,8,0,1.0,22,13,9,0.5909090909090909,0.7428571428571429,medlm,mimiciii,radiology_report,PROMPT2_entailment
129,214,7,4,3,0.5714285714285714,23,14,9,0.6086956521739131,0.5894736842105263,medlm,mimiciii,radiology_report,PROMPT2_entailment
130,215,7,5,2,0.7142857142857143,10,7,3,0.7,0.7070707070707072,medlm,mimiciii,radiology_report,PROMPT2_entailment
131,216,6,3,3,0.5,19,9,10,0.4736842105263157,0.4864864864864865,medlm,mimiciii,radiology_report,PROMPT2_entailment
132,217,4,2,2,0.5,20,13,7,0.65,0.5652173913043479,medlm,mimiciii,radiology_report,PROMPT2_entailment
133,218,7,3,4,0.4285714285714285,15,11,4,0.7333333333333333,0.540983606557377,medlm,mimiciii,radiology_report,PROMPT2_entailment
134,219,6,3,3,0.5,13,7,6,0.5384615384615384,0.5185185185185186,medlm,mimiciii,radiology_report,PROMPT2_entailment
135,22,6,5,1,0.8333333333333334,19,14,5,0.7368421052631579,0.782122905027933,medlm,mimiciii,radiology_report,PROMPT2_entailment
136,220,4,2,2,0.5,19,7,12,0.3684210526315789,0.4242424242424242,medlm,mimiciii,radiology_report,PROMPT2_entailment
137,221,13,8,5,0.6153846153846154,27,18,9,0.6666666666666666,0.64,medlm,mimiciii,radiology_report,PROMPT2_entailment
138,222,5,2,3,0.4,16,10,6,0.625,0.4878048780487805,medlm,mimiciii,radiology_report,PROMPT2_entailment
139,223,12,9,3,0.75,21,11,10,0.5238095238095238,0.6168224299065421,medlm,mimiciii,radiology_report,PROMPT2_entailment
140,224,7,6,1,0.8571428571428571,17,10,7,0.5882352941176471,0.6976744186046512,medlm,mimiciii,radiology_report,PROMPT2_entailment
141,225,6,4,2,0.6666666666666666,11,8,3,0.7272727272727273,0.6956521739130435,medlm,mimiciii,radiology_report,PROMPT2_entailment
142,226,7,7,0,1.0,18,13,5,0.7222222222222222,0.8387096774193548,medlm,mimiciii,radiology_report,PROMPT2_entailment
143,227,9,8,1,0.8888888888888888,18,15,3,0.8333333333333334,0.8602150537634408,medlm,mimiciii,radiology_report,PROMPT2_entailment
144,228,6,4,2,0.6666666666666666,17,14,3,0.8235294117647058,0.7368421052631577,medlm,mimiciii,radiology_report,PROMPT2_entailment
145,229,4,4,0,1.0,49,23,26,0.4693877551020408,0.6388888888888888,medlm,mimiciii,radiology_report,PROMPT2_entailment
146,23,7,5,2,0.7142857142857143,15,11,4,0.7333333333333333,0.7236842105263158,medlm,mimiciii,radiology_report,PROMPT2_entailment
147,230,6,4,2,0.6666666666666666,17,12,5,0.7058823529411765,0.6857142857142857,medlm,mimiciii,radiology_report,PROMPT2_entailment
148,231,6,3,3,0.5,13,9,4,0.6923076923076923,0.5806451612903226,medlm,mimiciii,radiology_report,PROMPT2_entailment
149,232,4,1,3,0.25,18,13,5,0.7222222222222222,0.3714285714285714,medlm,mimiciii,radiology_report,PROMPT2_entailment
150,233,7,3,4,0.4285714285714285,17,10,7,0.5882352941176471,0.4958677685950413,medlm,mimiciii,radiology_report,PROMPT2_entailment
151,234,6,6,0,1.0,11,7,4,0.6363636363636364,0.7777777777777778,medlm,mimiciii,radiology_report,PROMPT2_entailment
152,235,7,5,2,0.7142857142857143,14,8,6,0.5714285714285714,0.634920634920635,medlm,mimiciii,radiology_report,PROMPT2_entailment
153,236,5,3,2,0.6,11,7,4,0.6363636363636364,0.6176470588235293,medlm,mimiciii,radiology_report,PROMPT2_entailment
154,237,10,6,4,0.6,17,13,4,0.7647058823529411,0.6724137931034482,medlm,mimiciii,radiology_report,PROMPT2_entailment
155,238,8,6,2,0.75,20,14,6,0.7,0.7241379310344827,medlm,mimiciii,radiology_report,PROMPT2_entailment
156,239,7,4,3,0.5714285714285714,17,12,5,0.7058823529411765,0.6315789473684211,medlm,mimiciii,radiology_report,PROMPT2_entailment
157,24,7,6,1,0.8571428571428571,18,11,7,0.6111111111111112,0.7135135135135134,medlm,mimiciii,radiology_report,PROMPT2_entailment
158,240,8,8,0,1.0,13,11,2,0.8461538461538461,0.9166666666666666,medlm,mimiciii,radiology_report,PROMPT2_entailment
159,241,7,6,1,0.8571428571428571,16,11,5,0.6875,0.7630057803468208,medlm,mimiciii,radiology_report,PROMPT2_entailment
160,242,6,5,1,0.8333333333333334,18,9,9,0.5,0.625,medlm,mimiciii,radiology_report,PROMPT2_entailment
161,243,6,5,1,0.8333333333333334,13,9,4,0.6923076923076923,0.7563025210084034,medlm,mimiciii,radiology_report,PROMPT2_entailment
162,244,7,4,3,0.5714285714285714,17,12,5,0.7058823529411765,0.6315789473684211,medlm,mimiciii,radiology_report,PROMPT2_entailment
163,245,11,4,7,0.3636363636363636,28,20,8,0.7142857142857143,0.4819277108433735,medlm,mimiciii,radiology_report,PROMPT2_entailment
164,246,7,7,0,1.0,12,9,3,0.75,0.8571428571428571,medlm,mimiciii,radiology_report,PROMPT2_entailment
165,247,6,6,0,1.0,12,6,6,0.5,0.6666666666666666,medlm,mimiciii,radiology_report,PROMPT2_entailment
166,248,7,6,1,0.8571428571428571,17,8,9,0.4705882352941176,0.6075949367088607,medlm,mimiciii,radiology_report,PROMPT2_entailment
167,249,6,4,2,0.6666666666666666,23,13,10,0.5652173913043478,0.6117647058823529,medlm,mimiciii,radiology_report,PROMPT2_entailment
168,25,15,10,5,0.6666666666666666,27,18,9,0.6666666666666666,0.6666666666666666,medlm,mimiciii,radiology_report,PROMPT2_entailment
169,250,3,3,0,1.0,8,5,3,0.625,0.7692307692307693,medlm,mimiciii,radiology_report,PROMPT2_entailment
170,251,8,4,4,0.5,22,14,8,0.6363636363636364,0.56,medlm,mimiciii,radiology_report,PROMPT2_entailment
171,252,6,4,2,0.6666666666666666,10,6,4,0.6,0.631578947368421,medlm,mimiciii,radiology_report,PROMPT2_entailment
172,253,7,5,2,0.7142857142857143,24,19,5,0.7916666666666666,0.7509881422924901,medlm,mimiciii,radiology_report,PROMPT2_entailment
173,254,7,6,1,0.8571428571428571,13,8,5,0.6153846153846154,0.7164179104477612,medlm,mimiciii,radiology_report,PROMPT2_entailment
174,255,6,3,3,0.5,16,10,6,0.625,0.5555555555555556,medlm,mimiciii,radiology_report,PROMPT2_entailment
175,256,8,5,3,0.625,19,12,7,0.631578947368421,0.6282722513089005,medlm,mimiciii,radiology_report,PROMPT2_entailment
176,257,6,3,3,0.5,15,9,6,0.6,0.5454545454545454,medlm,mimiciii,radiology_report,PROMPT2_entailment
177,258,9,6,3,0.6666666666666666,20,9,11,0.45,0.5373134328358209,medlm,mimiciii,radiology_report,PROMPT2_entailment
178,259,6,4,2,0.6666666666666666,17,11,6,0.6470588235294118,0.6567164179104478,medlm,mimiciii,radiology_report,PROMPT2_entailment
179,26,7,7,0,1.0,18,14,4,0.7777777777777778,0.8750000000000001,medlm,mimiciii,radiology_report,PROMPT2_entailment
180,260,7,4,3,0.5714285714285714,20,8,12,0.4,0.4705882352941176,medlm,mimiciii,radiology_report,PROMPT2_entailment
181,261,10,4,6,0.4,31,18,13,0.5806451612903226,0.4736842105263158,medlm,mimiciii,radiology_report,PROMPT2_entailment
182,262,8,4,4,0.5,23,16,7,0.6956521739130435,0.5818181818181818,medlm,mimiciii,radiology_report,PROMPT2_entailment
183,263,6,4,2,0.6666666666666666,27,16,11,0.5925925925925926,0.627450980392157,medlm,mimiciii,radiology_report,PROMPT2_entailment
184,264,7,5,2,0.7142857142857143,20,15,5,0.75,0.7317073170731706,medlm,mimiciii,radiology_report,PROMPT2_entailment
185,265,5,5,0,1.0,9,7,2,0.7777777777777778,0.8750000000000001,medlm,mimiciii,radiology_report,PROMPT2_entailment
186,266,5,3,2,0.6,18,10,8,0.5555555555555556,0.576923076923077,medlm,mimiciii,radiology_report,PROMPT2_entailment
187,267,5,2,3,0.4,16,10,6,0.625,0.4878048780487805,medlm,mimiciii,radiology_report,PROMPT2_entailment
188,268,9,5,4,0.5555555555555556,20,13,7,0.65,0.5990783410138248,medlm,mimiciii,radiology_report,PROMPT2_entailment
189,269,16,16,0,1.0,30,15,15,0.5,0.6666666666666666,medlm,mimiciii,radiology_report,PROMPT2_entailment
190,27,7,5,2,0.7142857142857143,14,10,4,0.7142857142857143,0.7142857142857143,medlm,mimiciii,radiology_report,PROMPT2_entailment
191,270,7,6,1,0.8571428571428571,17,15,2,0.8823529411764706,0.8695652173913043,medlm,mimiciii,radiology_report,PROMPT2_entailment
192,271,8,8,0,1.0,20,15,5,0.75,0.8571428571428571,medlm,mimiciii,radiology_report,PROMPT2_entailment
193,272,6,5,1,0.8333333333333334,17,13,4,0.7647058823529411,0.7975460122699386,medlm,mimiciii,radiology_report,PROMPT2_entailment
194,273,6,6,0,1.0,12,7,5,0.5833333333333334,0.7368421052631579,medlm,mimiciii,radiology_report,PROMPT2_entailment
195,274,7,5,2,0.7142857142857143,20,15,5,0.75,0.7317073170731706,medlm,mimiciii,radiology_report,PROMPT2_entailment
196,275,9,8,1,0.8888888888888888,12,9,3,0.75,0.8135593220338982,medlm,mimiciii,radiology_report,PROMPT2_entailment
197,276,5,4,1,0.8,29,19,10,0.6551724137931034,0.7203791469194314,medlm,mimiciii,radiology_report,PROMPT2_entailment
198,277,8,5,3,0.625,25,20,5,0.8,0.7017543859649122,medlm,mimiciii,radiology_report,PROMPT2_entailment
199,278,9,6,3,0.6666666666666666,16,12,4,0.75,0.7058823529411765,medlm,mimiciii,radiology_report,PROMPT2_entailment
200,279,6,6,0,1.0,10,7,3,0.7,0.8235294117647058,medlm,mimiciii,radiology_report,PROMPT2_entailment
201,28,7,3,4,0.4285714285714285,30,22,8,0.7333333333333333,0.540983606557377,medlm,mimiciii,radiology_report,PROMPT2_entailment
202,280,6,4,2,0.6666666666666666,12,8,4,0.6666666666666666,0.6666666666666666,medlm,mimiciii,radiology_report,PROMPT2_entailment
203,281,9,6,3,0.6666666666666666,24,15,9,0.625,0.6451612903225806,medlm,mimiciii,radiology_report,PROMPT2_entailment
204,282,9,7,2,0.7777777777777778,12,7,5,0.5833333333333334,0.6666666666666666,medlm,mimiciii,radiology_report,PROMPT2_entailment
205,283,5,3,2,0.6,28,17,11,0.6071428571428571,0.6035502958579881,medlm,mimiciii,radiology_report,PROMPT2_entailment
206,284,5,1,4,0.2,14,8,6,0.5714285714285714,0.2962962962962963,medlm,mimiciii,radiology_report,PROMPT2_entailment
207,285,8,6,2,0.75,18,13,5,0.7222222222222222,0.7358490566037735,medlm,mimiciii,radiology_report,PROMPT2_entailment
208,286,4,4,0,1.0,6,5,1,0.8333333333333334,0.9090909090909092,medlm,mimiciii,radiology_report,PROMPT2_entailment
209,287,8,8,0,1.0,18,13,5,0.7222222222222222,0.8387096774193548,medlm,mimiciii,radiology_report,PROMPT2_entailment
210,288,12,10,2,0.8333333333333334,32,24,8,0.75,0.7894736842105262,medlm,mimiciii,radiology_report,PROMPT2_entailment
211,289,11,9,2,0.8181818181818182,20,15,5,0.75,0.7826086956521738,medlm,mimiciii,radiology_report,PROMPT2_entailment
212,29,5,5,0,1.0,8,5,3,0.625,0.7692307692307693,medlm,mimiciii,radiology_report,PROMPT2_entailment
213,290,9,8,1,0.8888888888888888,11,8,3,0.7272727272727273,0.7999999999999999,medlm,mimiciii,radiology_report,PROMPT2_entailment
214,291,9,7,2,0.7777777777777778,24,15,9,0.625,0.6930693069306931,medlm,mimiciii,radiology_report,PROMPT2_entailment
215,292,7,6,1,0.8571428571428571,21,12,9,0.5714285714285714,0.6857142857142857,medlm,mimiciii,radiology_report,PROMPT2_entailment
216,293,8,4,4,0.5,18,13,5,0.7222222222222222,0.5909090909090908,medlm,mimiciii,radiology_report,PROMPT2_entailment
217,294,7,3,4,0.4285714285714285,22,15,7,0.6818181818181818,0.5263157894736843,medlm,mimiciii,radiology_report,PROMPT2_entailment
218,295,5,4,1,0.8,39,23,16,0.5897435897435898,0.6789667896678968,medlm,mimiciii,radiology_report,PROMPT2_entailment
219,296,7,3,4,0.4285714285714285,17,11,6,0.6470588235294118,0.515625,medlm,mimiciii,radiology_report,PROMPT2_entailment
220,297,10,6,4,0.6,24,14,10,0.5833333333333334,0.591549295774648,medlm,mimiciii,radiology_report,PROMPT2_entailment
221,298,8,7,1,0.875,20,15,5,0.75,0.8076923076923077,medlm,mimiciii,radiology_report,PROMPT2_entailment
222,299,8,6,2,0.75,32,16,16,0.5,0.6,medlm,mimiciii,radiology_report,PROMPT2_entailment
223,3,8,4,4,0.5,20,13,7,0.65,0.5652173913043479,medlm,mimiciii,radiology_report,PROMPT2_entailment
224,30,8,7,1,0.875,25,18,7,0.72,0.7899686520376176,medlm,mimiciii,radiology_report,PROMPT2_entailment
225,300,4,3,1,0.75,13,5,8,0.3846153846153846,0.5084745762711865,medlm,mimiciii,radiology_report,PROMPT2_entailment
226,301,4,4,0,1.0,19,11,8,0.5789473684210527,0.7333333333333334,medlm,mimiciii,radiology_report,PROMPT2_entailment
227,302,7,7,0,1.0,15,9,6,0.6,0.7499999999999999,medlm,mimiciii,radiology_report,PROMPT2_entailment
228,303,10,1,9,0.1,24,14,10,0.5833333333333334,0.1707317073170731,medlm,mimiciii,radiology_report,PROMPT2_entailment
229,304,6,6,0,1.0,21,15,6,0.7142857142857143,0.8333333333333333,medlm,mimiciii,radiology_report,PROMPT2_entailment
230,305,7,3,4,0.4285714285714285,24,12,12,0.5,0.4615384615384615,medlm,mimiciii,radiology_report,PROMPT2_entailment
231,306,8,6,2,0.75,14,10,4,0.7142857142857143,0.7317073170731706,medlm,mimiciii,radiology_report,PROMPT2_entailment
232,307,8,7,1,0.875,17,13,4,0.7647058823529411,0.8161434977578476,medlm,mimiciii,radiology_report,PROMPT2_entailment
233,308,7,3,4,0.4285714285714285,15,12,3,0.8,0.5581395348837209,medlm,mimiciii,radiology_report,PROMPT2_entailment
234,309,6,5,1,0.8333333333333334,29,15,14,0.5172413793103449,0.6382978723404256,medlm,mimiciii,radiology_report,PROMPT2_entailment
235,31,6,5,1,0.8333333333333334,19,9,10,0.4736842105263157,0.6040268456375839,medlm,mimiciii,radiology_report,PROMPT2_entailment
236,310,8,6,2,0.75,24,15,9,0.625,0.6818181818181818,medlm,mimiciii,radiology_report,PROMPT2_entailment
237,311,8,7,1,0.875,15,11,4,0.7333333333333333,0.7979274611398963,medlm,mimiciii,radiology_report,PROMPT2_entailment
238,312,5,4,1,0.8,18,9,9,0.5,0.6153846153846154,medlm,mimiciii,radiology_report,PROMPT2_entailment
239,313,6,4,2,0.6666666666666666,17,15,2,0.8823529411764706,0.7594936708860759,medlm,mimiciii,radiology_report,PROMPT2_entailment
240,314,7,5,2,0.7142857142857143,15,11,4,0.7333333333333333,0.7236842105263158,medlm,mimiciii,radiology_report,PROMPT2_entailment
241,315,7,2,5,0.2857142857142857,25,16,9,0.64,0.3950617283950617,medlm,mimiciii,radiology_report,PROMPT2_entailment
242,316,8,6,2,0.75,10,7,3,0.7,0.7241379310344827,medlm,mimiciii,radiology_report,PROMPT2_entailment
243,317,9,6,3,0.6666666666666666,26,16,10,0.6153846153846154,0.64,medlm,mimiciii,radiology_report,PROMPT2_entailment
244,318,8,6,2,0.75,21,20,1,0.9523809523809524,0.8391608391608391,medlm,mimiciii,radiology_report,PROMPT2_entailment
245,319,7,6,1,0.8571428571428571,12,10,2,0.8333333333333334,0.8450704225352113,medlm,mimiciii,radiology_report,PROMPT2_entailment
246,32,7,7,0,1.0,15,9,6,0.6,0.7499999999999999,medlm,mimiciii,radiology_report,PROMPT2_entailment
247,320,6,6,0,1.0,11,9,2,0.8181818181818182,0.9,medlm,mimiciii,radiology_report,PROMPT2_entailment
248,321,7,4,3,0.5714285714285714,21,14,7,0.6666666666666666,0.6153846153846153,medlm,mimiciii,radiology_report,PROMPT2_entailment
249,322,3,3,0,1.0,8,7,1,0.875,0.9333333333333332,medlm,mimiciii,radiology_report,PROMPT2_entailment
250,323,6,6,0,1.0,29,18,11,0.6206896551724138,0.7659574468085107,medlm,mimiciii,radiology_report,PROMPT2_entailment
251,324,8,6,2,0.75,18,12,6,0.6666666666666666,0.7058823529411765,medlm,mimiciii,radiology_report,PROMPT2_entailment
252,325,8,4,4,0.5,22,12,10,0.5454545454545454,0.5217391304347826,medlm,mimiciii,radiology_report,PROMPT2_entailment
253,326,8,5,3,0.625,23,18,5,0.782608695652174,0.694980694980695,medlm,mimiciii,radiology_report,PROMPT2_entailment
254,327,5,5,0,1.0,9,7,2,0.7777777777777778,0.8750000000000001,medlm,mimiciii,radiology_report,PROMPT2_entailment
255,328,9,5,4,0.5555555555555556,17,12,5,0.7058823529411765,0.6217616580310882,medlm,mimiciii,radiology_report,PROMPT2_entailment
256,329,6,5,1,0.8333333333333334,28,10,18,0.3571428571428571,0.5,medlm,mimiciii,radiology_report,PROMPT2_entailment
257,33,7,7,0,1.0,9,6,3,0.6666666666666666,0.8,medlm,mimiciii,radiology_report,PROMPT2_entailment
258,330,5,5,0,1.0,11,7,4,0.6363636363636364,0.7777777777777778,medlm,mimiciii,radiology_report,PROMPT2_entailment
259,331,10,8,2,0.8,15,12,3,0.8,0.8000000000000002,medlm,mimiciii,radiology_report,PROMPT2_entailment
260,332,9,6,3,0.6666666666666666,20,13,7,0.65,0.6582278481012659,medlm,mimiciii,radiology_report,PROMPT2_entailment
261,333,8,6,2,0.75,13,9,4,0.6923076923076923,0.7199999999999999,medlm,mimiciii,radiology_report,PROMPT2_entailment
262,334,10,7,3,0.7,20,17,3,0.85,0.767741935483871,medlm,mimiciii,radiology_report,PROMPT2_entailment
263,335,6,5,1,0.8333333333333334,17,13,4,0.7647058823529411,0.7975460122699386,medlm,mimiciii,radiology_report,PROMPT2_entailment
264,336,7,3,4,0.4285714285714285,16,13,3,0.8125,0.5611510791366906,medlm,mimiciii,radiology_report,PROMPT2_entailment
265,337,7,7,0,1.0,16,12,4,0.75,0.8571428571428571,medlm,mimiciii,radiology_report,PROMPT2_entailment
266,338,7,6,1,0.8571428571428571,13,9,4,0.6923076923076923,0.7659574468085107,medlm,mimiciii,radiology_report,PROMPT2_entailment
267,339,5,2,3,0.4,28,19,9,0.6785714285714286,0.5033112582781457,medlm,mimiciii,radiology_report,PROMPT2_entailment
268,34,6,5,1,0.8333333333333334,14,10,4,0.7142857142857143,0.7692307692307692,medlm,mimiciii,radiology_report,PROMPT2_entailment
269,340,3,2,1,0.6666666666666666,15,7,8,0.4666666666666667,0.5490196078431373,medlm,mimiciii,radiology_report,PROMPT2_entailment
270,341,2,1,1,0.5,6,3,3,0.5,0.5,medlm,mimiciii,radiology_report,PROMPT2_entailment
271,342,9,9,0,1.0,15,13,2,0.8666666666666667,0.9285714285714286,medlm,mimiciii,radiology_report,PROMPT2_entailment
272,343,7,4,3,0.5714285714285714,26,18,8,0.6923076923076923,0.6260869565217392,medlm,mimiciii,radiology_report,PROMPT2_entailment
273,344,9,6,3,0.6666666666666666,19,14,5,0.7368421052631579,0.7,medlm,mimiciii,radiology_report,PROMPT2_entailment
274,345,11,5,6,0.4545454545454545,22,17,5,0.7727272727272727,0.5723905723905723,medlm,mimiciii,radiology_report,PROMPT2_entailment
275,346,7,5,2,0.7142857142857143,15,11,4,0.7333333333333333,0.7236842105263158,medlm,mimiciii,radiology_report,PROMPT2_entailment
276,347,6,5,1,0.8333333333333334,15,12,3,0.8,0.816326530612245,medlm,mimiciii,radiology_report,PROMPT2_entailment
277,348,7,4,3,0.5714285714285714,12,7,5,0.5833333333333334,0.577319587628866,medlm,mimiciii,radiology_report,PROMPT2_entailment
278,349,5,5,0,1.0,16,8,8,0.5,0.6666666666666666,medlm,mimiciii,radiology_report,PROMPT2_entailment
279,35,9,5,4,0.5555555555555556,21,13,8,0.6190476190476191,0.5855855855855856,medlm,mimiciii,radiology_report,PROMPT2_entailment
280,350,7,6,1,0.8571428571428571,21,14,7,0.6666666666666666,0.75,medlm,mimiciii,radiology_report,PROMPT2_entailment
281,351,7,2,5,0.2857142857142857,21,15,6,0.7142857142857143,0.4081632653061224,medlm,mimiciii,radiology_report,PROMPT2_entailment
282,352,7,5,2,0.7142857142857143,22,14,8,0.6363636363636364,0.673076923076923,medlm,mimiciii,radiology_report,PROMPT2_entailment
283,353,8,7,1,0.875,26,18,8,0.6923076923076923,0.7730061349693251,medlm,mimiciii,radiology_report,PROMPT2_entailment
284,354,6,3,3,0.5,26,16,10,0.6153846153846154,0.5517241379310345,medlm,mimiciii,radiology_report,PROMPT2_entailment
285,355,6,6,0,1.0,18,13,5,0.7222222222222222,0.8387096774193548,medlm,mimiciii,radiology_report,PROMPT2_entailment
286,356,7,6,1,0.8571428571428571,22,16,6,0.7272727272727273,0.7868852459016394,medlm,mimiciii,radiology_report,PROMPT2_entailment
287,357,6,0,6,0.0,15,8,7,0.5333333333333333,0.0,medlm,mimiciii,radiology_report,PROMPT2_entailment
288,358,4,0,4,0.0,12,5,7,0.4166666666666667,0.0,medlm,mimiciii,radiology_report,PROMPT2_entailment
289,359,7,6,1,0.8571428571428571,18,14,4,0.7777777777777778,0.8155339805825242,medlm,mimiciii,radiology_report,PROMPT2_entailment
290,36,6,6,0,1.0,22,11,11,0.5,0.6666666666666666,medlm,mimiciii,radiology_report,PROMPT2_entailment
291,360,9,8,1,0.8888888888888888,15,10,5,0.6666666666666666,0.761904761904762,medlm,mimiciii,radiology_report,PROMPT2_entailment
292,361,5,5,0,1.0,23,13,10,0.5652173913043478,0.7222222222222222,medlm,mimiciii,radiology_report,PROMPT2_entailment
293,362,9,3,6,0.3333333333333333,24,11,13,0.4583333333333333,0.3859649122807017,medlm,mimiciii,radiology_report,PROMPT2_entailment
294,363,7,5,2,0.7142857142857143,22,13,9,0.5909090909090909,0.6467661691542289,medlm,mimiciii,radiology_report,PROMPT2_entailment
295,364,3,3,0,1.0,11,7,4,0.6363636363636364,0.7777777777777778,medlm,mimiciii,radiology_report,PROMPT2_entailment
296,365,11,8,3,0.7272727272727273,29,19,10,0.6551724137931034,0.6893424036281179,medlm,mimiciii,radiology_report,PROMPT2_entailment
297,366,9,9,0,1.0,13,9,4,0.6923076923076923,0.8181818181818181,medlm,mimiciii,radiology_report,PROMPT2_entailment
298,367,10,8,2,0.8,16,11,5,0.6875,0.7394957983193278,medlm,mimiciii,radiology_report,PROMPT2_entailment
299,368,9,3,6,0.3333333333333333,20,15,5,0.75,0.4615384615384615,medlm,mimiciii,radiology_report,PROMPT2_entailment
300,369,9,7,2,0.7777777777777778,20,16,4,0.8,0.7887323943661971,medlm,mimiciii,radiology_report,PROMPT2_entailment
301,37,7,6,1,0.8571428571428571,21,15,6,0.7142857142857143,0.7792207792207793,medlm,mimiciii,radiology_report,PROMPT2_entailment
302,370,7,6,1,0.8571428571428571,19,10,9,0.5263157894736842,0.6521739130434783,medlm,mimiciii,radiology_report,PROMPT2_entailment
303,371,6,5,1,0.8333333333333334,17,14,3,0.8235294117647058,0.8284023668639053,medlm,mimiciii,radiology_report,PROMPT2_entailment
304,372,3,3,0,1.0,31,17,14,0.5483870967741935,0.7083333333333333,medlm,mimiciii,radiology_report,PROMPT2_entailment
305,373,10,10,0,1.0,23,18,5,0.782608695652174,0.878048780487805,medlm,mimiciii,radiology_report,PROMPT2_entailment
306,374,6,6,0,1.0,11,8,3,0.7272727272727273,0.8421052631578948,medlm,mimiciii,radiology_report,PROMPT2_entailment
307,375,7,6,1,0.8571428571428571,16,10,6,0.625,0.7228915662650602,medlm,mimiciii,radiology_report,PROMPT2_entailment
308,376,8,5,3,0.625,18,14,4,0.7777777777777778,0.6930693069306931,medlm,mimiciii,radiology_report,PROMPT2_entailment
309,377,5,4,1,0.8,10,4,6,0.4,0.5333333333333333,medlm,mimiciii,radiology_report,PROMPT2_entailment
310,378,9,8,1,0.8888888888888888,24,12,12,0.5,0.64,medlm,mimiciii,radiology_report,PROMPT2_entailment
311,379,8,6,2,0.75,18,14,4,0.7777777777777778,0.7636363636363638,medlm,mimiciii,radiology_report,PROMPT2_entailment
312,38,9,2,7,0.2222222222222222,19,13,6,0.6842105263157895,0.3354838709677419,medlm,mimiciii,radiology_report,PROMPT2_entailment
313,380,4,4,0,1.0,8,7,1,0.875,0.9333333333333332,medlm,mimiciii,radiology_report,PROMPT2_entailment
314,381,8,6,2,0.75,14,10,4,0.7142857142857143,0.7317073170731706,medlm,mimiciii,radiology_report,PROMPT2_entailment
315,382,6,5,1,0.8333333333333334,16,10,6,0.625,0.7142857142857143,medlm,mimiciii,radiology_report,PROMPT2_entailment
316,383,9,5,4,0.5555555555555556,17,13,4,0.7647058823529411,0.6435643564356436,medlm,mimiciii,radiology_report,PROMPT2_entailment
317,384,6,6,0,1.0,13,11,2,0.8461538461538461,0.9166666666666666,medlm,mimiciii,radiology_report,PROMPT2_entailment
318,385,7,6,1,0.8571428571428571,27,19,8,0.7037037037037037,0.7728813559322033,medlm,mimiciii,radiology_report,PROMPT2_entailment
319,386,8,8,0,1.0,18,12,6,0.6666666666666666,0.8,medlm,mimiciii,radiology_report,PROMPT2_entailment
320,387,5,4,1,0.8,19,12,7,0.631578947368421,0.7058823529411765,medlm,mimiciii,radiology_report,PROMPT2_entailment
321,388,6,5,1,0.8333333333333334,33,24,9,0.7272727272727273,0.7766990291262137,medlm,mimiciii,radiology_report,PROMPT2_entailment
322,389,4,3,1,0.75,12,7,5,0.5833333333333334,0.6562499999999999,medlm,mimiciii,radiology_report,PROMPT2_entailment
323,39,7,5,2,0.7142857142857143,10,7,3,0.7,0.7070707070707072,medlm,mimiciii,radiology_report,PROMPT2_entailment
324,390,4,3,1,0.75,14,7,7,0.5,0.6,medlm,mimiciii,radiology_report,PROMPT2_entailment
325,391,10,9,1,0.9,13,8,5,0.6153846153846154,0.7309644670050762,medlm,mimiciii,radiology_report,PROMPT2_entailment
326,392,8,4,4,0.5,15,11,4,0.7333333333333333,0.5945945945945945,medlm,mimiciii,radiology_report,PROMPT2_entailment
327,393,11,8,3,0.7272727272727273,19,10,9,0.5263157894736842,0.6106870229007633,medlm,mimiciii,radiology_report,PROMPT2_entailment
328,394,10,9,1,0.9,18,16,2,0.8888888888888888,0.8944099378881988,medlm,mimiciii,radiology_report,PROMPT2_entailment
329,395,6,3,3,0.5,16,11,5,0.6875,0.5789473684210527,medlm,mimiciii,radiology_report,PROMPT2_entailment
330,396,7,5,2,0.7142857142857143,19,12,7,0.631578947368421,0.670391061452514,medlm,mimiciii,radiology_report,PROMPT2_entailment
331,397,9,8,1,0.8888888888888888,18,11,7,0.6111111111111112,0.7242798353909464,medlm,mimiciii,radiology_report,PROMPT2_entailment
332,398,9,6,3,0.6666666666666666,21,12,9,0.5714285714285714,0.6153846153846153,medlm,mimiciii,radiology_report,PROMPT2_entailment
333,399,7,4,3,0.5714285714285714,19,12,7,0.631578947368421,0.6,medlm,mimiciii,radiology_report,PROMPT2_entailment
334,4,6,5,1,0.8333333333333334,16,11,5,0.6875,0.7534246575342466,medlm,mimiciii,radiology_report,PROMPT2_entailment
335,40,4,3,1,0.75,17,8,9,0.4705882352941176,0.5783132530120481,medlm,mimiciii,radiology_report,PROMPT2_entailment
336,400,8,7,1,0.875,13,10,3,0.7692307692307693,0.8187134502923977,medlm,mimiciii,radiology_report,PROMPT2_entailment
337,401,5,5,0,1.0,9,5,4,0.5555555555555556,0.7142857142857143,medlm,mimiciii,radiology_report,PROMPT2_entailment
338,402,8,0,8,0.0,20,15,5,0.75,0.0,medlm,mimiciii,radiology_report,PROMPT2_entailment
339,403,5,4,1,0.8,18,11,7,0.6111111111111112,0.6929133858267716,medlm,mimiciii,radiology_report,PROMPT2_entailment
340,404,10,8,2,0.8,19,15,4,0.7894736842105263,0.794701986754967,medlm,mimiciii,radiology_report,PROMPT2_entailment
341,405,5,2,3,0.4,14,7,7,0.5,0.4444444444444445,medlm,mimiciii,radiology_report,PROMPT2_entailment
342,406,10,6,4,0.6,25,14,11,0.56,0.5793103448275861,medlm,mimiciii,radiology_report,PROMPT2_entailment
343,407,6,2,4,0.3333333333333333,20,15,5,0.75,0.4615384615384615,medlm,mimiciii,radiology_report,PROMPT2_entailment
344,408,8,1,7,0.125,20,14,6,0.7,0.2121212121212121,medlm,mimiciii,radiology_report,PROMPT2_entailment
345,409,5,4,1,0.8,21,5,16,0.238095238095238,0.3669724770642201,medlm,mimiciii,radiology_report,PROMPT2_entailment
346,41,7,5,2,0.7142857142857143,26,14,12,0.5384615384615384,0.6140350877192982,medlm,mimiciii,radiology_report,PROMPT2_entailment
347,410,9,8,1,0.8888888888888888,20,14,6,0.7,0.7832167832167831,medlm,mimiciii,radiology_report,PROMPT2_entailment
348,411,3,3,0,1.0,6,5,1,0.8333333333333334,0.9090909090909092,medlm,mimiciii,radiology_report,PROMPT2_entailment
349,412,8,7,1,0.875,26,14,12,0.5384615384615384,0.6666666666666667,medlm,mimiciii,radiology_report,PROMPT2_entailment
350,413,6,5,1,0.8333333333333334,14,10,4,0.7142857142857143,0.7692307692307692,medlm,mimiciii,radiology_report,PROMPT2_entailment
351,414,11,7,4,0.6363636363636364,28,20,8,0.7142857142857143,0.673076923076923,medlm,mimiciii,radiology_report,PROMPT2_entailment
352,415,12,10,2,0.8333333333333334,20,16,4,0.8,0.816326530612245,medlm,mimiciii,radiology_report,PROMPT2_entailment
353,416,5,5,0,1.0,19,10,9,0.5263157894736842,0.6896551724137931,medlm,mimiciii,radiology_report,PROMPT2_entailment
354,417,9,4,5,0.4444444444444444,20,17,3,0.85,0.5836909871244635,medlm,mimiciii,radiology_report,PROMPT2_entailment
355,418,7,6,1,0.8571428571428571,14,10,4,0.7142857142857143,0.7792207792207793,medlm,mimiciii,radiology_report,PROMPT2_entailment
356,419,5,2,3,0.4,16,10,6,0.625,0.4878048780487805,medlm,mimiciii,radiology_report,PROMPT2_entailment
357,42,8,6,2,0.75,14,8,6,0.5714285714285714,0.6486486486486486,medlm,mimiciii,radiology_report,PROMPT2_entailment
358,420,5,2,3,0.4,15,8,7,0.5333333333333333,0.4571428571428572,medlm,mimiciii,radiology_report,PROMPT2_entailment
359,421,6,5,1,0.8333333333333334,23,17,6,0.7391304347826086,0.783410138248848,medlm,mimiciii,radiology_report,PROMPT2_entailment
360,422,7,2,5,0.2857142857142857,20,11,9,0.55,0.376068376068376,medlm,mimiciii,radiology_report,PROMPT2_entailment
361,423,5,4,1,0.8,12,5,7,0.4166666666666667,0.547945205479452,medlm,mimiciii,radiology_report,PROMPT2_entailment
362,424,6,6,0,1.0,9,7,2,0.7777777777777778,0.8750000000000001,medlm,mimiciii,radiology_report,PROMPT2_entailment
363,425,10,5,5,0.5,19,13,6,0.6842105263157895,0.5777777777777778,medlm,mimiciii,radiology_report,PROMPT2_entailment
364,426,6,4,2,0.6666666666666666,16,12,4,0.75,0.7058823529411765,medlm,mimiciii,radiology_report,PROMPT2_entailment
365,427,6,5,1,0.8333333333333334,15,12,3,0.8,0.816326530612245,medlm,mimiciii,radiology_report,PROMPT2_entailment
366,428,7,5,2,0.7142857142857143,15,13,2,0.8666666666666667,0.7831325301204819,medlm,mimiciii,radiology_report,PROMPT2_entailment
367,429,9,7,2,0.7777777777777778,13,7,6,0.5384615384615384,0.6363636363636364,medlm,mimiciii,radiology_report,PROMPT2_entailment
368,43,6,6,0,1.0,7,5,2,0.7142857142857143,0.8333333333333333,medlm,mimiciii,radiology_report,PROMPT2_entailment
369,430,3,3,0,1.0,7,4,3,0.5714285714285714,0.7272727272727273,medlm,mimiciii,radiology_report,PROMPT2_entailment
370,431,6,1,5,0.1666666666666666,18,10,8,0.5555555555555556,0.2564102564102564,medlm,mimiciii,radiology_report,PROMPT2_entailment
371,432,6,3,3,0.5,13,6,7,0.4615384615384615,0.48,medlm,mimiciii,radiology_report,PROMPT2_entailment
372,433,6,4,2,0.6666666666666666,18,12,6,0.6666666666666666,0.6666666666666666,medlm,mimiciii,radiology_report,PROMPT2_entailment
373,434,7,2,5,0.2857142857142857,27,18,9,0.6666666666666666,0.4,medlm,mimiciii,radiology_report,PROMPT2_entailment
374,435,5,2,3,0.4,13,11,2,0.8461538461538461,0.5432098765432098,medlm,mimiciii,radiology_report,PROMPT2_entailment
375,436,7,3,4,0.4285714285714285,25,20,5,0.8,0.5581395348837209,medlm,mimiciii,radiology_report,PROMPT2_entailment
376,437,5,5,0,1.0,7,5,2,0.7142857142857143,0.8333333333333333,medlm,mimiciii,radiology_report,PROMPT2_entailment
377,438,9,9,0,1.0,19,14,5,0.7368421052631579,0.8484848484848484,medlm,mimiciii,radiology_report,PROMPT2_entailment
378,439,4,2,2,0.5,22,15,7,0.6818181818181818,0.576923076923077,medlm,mimiciii,radiology_report,PROMPT2_entailment
379,44,8,7,1,0.875,16,11,5,0.6875,0.77,medlm,mimiciii,radiology_report,PROMPT2_entailment
380,440,7,6,1,0.8571428571428571,19,13,6,0.6842105263157895,0.7609756097560976,medlm,mimiciii,radiology_report,PROMPT2_entailment
381,441,7,4,3,0.5714285714285714,17,13,4,0.7647058823529411,0.6540880503144654,medlm,mimiciii,radiology_report,PROMPT2_entailment
382,442,6,5,1,0.8333333333333334,12,4,8,0.3333333333333333,0.4761904761904761,medlm,mimiciii,radiology_report,PROMPT2_entailment
383,443,9,7,2,0.7777777777777778,21,15,6,0.7142857142857143,0.7446808510638298,medlm,mimiciii,radiology_report,PROMPT2_entailment
384,444,8,8,0,1.0,8,5,3,0.625,0.7692307692307693,medlm,mimiciii,radiology_report,PROMPT2_entailment
385,445,8,5,3,0.625,22,15,7,0.6818181818181818,0.6521739130434783,medlm,mimiciii,radiology_report,PROMPT2_entailment
386,446,9,6,3,0.6666666666666666,22,14,8,0.6363636363636364,0.6511627906976744,medlm,mimiciii,radiology_report,PROMPT2_entailment
387,447,5,3,2,0.6,14,11,3,0.7857142857142857,0.6804123711340206,medlm,mimiciii,radiology_report,PROMPT2_entailment
388,448,14,12,2,0.8571428571428571,36,19,17,0.5277777777777778,0.6532951289398281,medlm,mimiciii,radiology_report,PROMPT2_entailment
389,449,5,4,1,0.8,9,8,1,0.8888888888888888,0.8421052631578948,medlm,mimiciii,radiology_report,PROMPT2_entailment
390,45,7,3,4,0.4285714285714285,20,13,7,0.65,0.5165562913907286,medlm,mimiciii,radiology_report,PROMPT2_entailment
391,450,8,6,2,0.75,21,15,6,0.7142857142857143,0.7317073170731706,medlm,mimiciii,radiology_report,PROMPT2_entailment
392,451,4,4,0,1.0,10,7,3,0.7,0.8235294117647058,medlm,mimiciii,radiology_report,PROMPT2_entailment
393,452,7,7,0,1.0,16,11,5,0.6875,0.8148148148148148,medlm,mimiciii,radiology_report,PROMPT2_entailment
394,453,6,6,0,1.0,14,11,3,0.7857142857142857,0.88,medlm,mimiciii,radiology_report,PROMPT2_entailment
395,454,6,5,1,0.8333333333333334,10,8,2,0.8,0.816326530612245,medlm,mimiciii,radiology_report,PROMPT2_entailment
396,455,7,6,1,0.8571428571428571,16,13,3,0.8125,0.8342245989304812,medlm,mimiciii,radiology_report,PROMPT2_entailment
397,456,7,5,2,0.7142857142857143,21,20,1,0.9523809523809524,0.8163265306122449,medlm,mimiciii,radiology_report,PROMPT2_entailment
398,457,4,4,0,1.0,12,6,6,0.5,0.6666666666666666,medlm,mimiciii,radiology_report,PROMPT2_entailment
399,458,7,6,1,0.8571428571428571,16,13,3,0.8125,0.8342245989304812,medlm,mimiciii,radiology_report,PROMPT2_entailment
400,459,5,4,1,0.8,13,6,7,0.4615384615384615,0.5853658536585367,medlm,mimiciii,radiology_report,PROMPT2_entailment
401,46,8,8,0,1.0,26,20,6,0.7692307692307693,0.8695652173913044,medlm,mimiciii,radiology_report,PROMPT2_entailment
402,460,7,4,3,0.5714285714285714,20,16,4,0.8,0.6666666666666666,medlm,mimiciii,radiology_report,PROMPT2_entailment
403,461,9,3,6,0.3333333333333333,22,13,9,0.5909090909090909,0.4262295081967213,medlm,mimiciii,radiology_report,PROMPT2_entailment
404,462,6,5,1,0.8333333333333334,20,12,8,0.6,0.6976744186046512,medlm,mimiciii,radiology_report,PROMPT2_entailment
405,463,5,5,0,1.0,12,7,5,0.5833333333333334,0.7368421052631579,medlm,mimiciii,radiology_report,PROMPT2_entailment
406,464,8,4,4,0.5,25,14,11,0.56,0.5283018867924528,medlm,mimiciii,radiology_report,PROMPT2_entailment
407,465,6,5,1,0.8333333333333334,33,18,15,0.5454545454545454,0.6593406593406592,medlm,mimiciii,radiology_report,PROMPT2_entailment
408,466,5,5,0,1.0,22,14,8,0.6363636363636364,0.7777777777777778,medlm,mimiciii,radiology_report,PROMPT2_entailment
409,467,9,8,1,0.8888888888888888,14,13,1,0.9285714285714286,0.9082969432314412,medlm,mimiciii,radiology_report,PROMPT2_entailment
410,468,6,3,3,0.5,18,11,7,0.6111111111111112,0.55,medlm,mimiciii,radiology_report,PROMPT2_entailment
411,469,9,4,5,0.4444444444444444,25,20,5,0.8,0.5714285714285714,medlm,mimiciii,radiology_report,PROMPT2_entailment
412,47,6,5,1,0.8333333333333334,15,9,6,0.6,0.6976744186046512,medlm,mimiciii,radiology_report,PROMPT2_entailment
413,470,6,5,1,0.8333333333333334,15,10,5,0.6666666666666666,0.7407407407407408,medlm,mimiciii,radiology_report,PROMPT2_entailment
414,471,9,8,1,0.8888888888888888,18,9,9,0.5,0.64,medlm,mimiciii,radiology_report,PROMPT2_entailment
415,472,8,7,1,0.875,16,12,4,0.75,0.8076923076923077,medlm,mimiciii,radiology_report,PROMPT2_entailment
416,473,5,3,2,0.6,11,8,3,0.7272727272727273,0.6575342465753425,medlm,mimiciii,radiology_report,PROMPT2_entailment
417,474,10,8,2,0.8,25,19,6,0.76,0.7794871794871796,medlm,mimiciii,radiology_report,PROMPT2_entailment
418,475,3,2,1,0.6666666666666666,7,3,4,0.4285714285714285,0.5217391304347826,medlm,mimiciii,radiology_report,PROMPT2_entailment
419,476,9,8,1,0.8888888888888888,12,11,1,0.9166666666666666,0.9025641025641026,medlm,mimiciii,radiology_report,PROMPT2_entailment
420,477,6,2,4,0.3333333333333333,16,9,7,0.5625,0.4186046511627907,medlm,mimiciii,radiology_report,PROMPT2_entailment
421,478,9,9,0,1.0,21,17,4,0.8095238095238095,0.8947368421052632,medlm,mimiciii,radiology_report,PROMPT2_entailment
422,479,8,6,2,0.75,22,13,9,0.5909090909090909,0.6610169491525425,medlm,mimiciii,radiology_report,PROMPT2_entailment
423,48,7,6,1,0.8571428571428571,21,13,8,0.6190476190476191,0.7188940092165899,medlm,mimiciii,radiology_report,PROMPT2_entailment
424,480,5,4,1,0.8,10,6,4,0.6,0.6857142857142857,medlm,mimiciii,radiology_report,PROMPT2_entailment
425,481,5,1,4,0.2,17,13,4,0.7647058823529411,0.3170731707317074,medlm,mimiciii,radiology_report,PROMPT2_entailment
426,482,10,6,4,0.6,19,15,4,0.7894736842105263,0.6818181818181819,medlm,mimiciii,radiology_report,PROMPT2_entailment
427,483,7,6,1,0.8571428571428571,27,12,15,0.4444444444444444,0.5853658536585367,medlm,mimiciii,radiology_report,PROMPT2_entailment
428,484,6,5,1,0.8333333333333334,13,9,4,0.6923076923076923,0.7563025210084034,medlm,mimiciii,radiology_report,PROMPT2_entailment
429,485,8,6,2,0.75,27,16,11,0.5925925925925926,0.6620689655172414,medlm,mimiciii,radiology_report,PROMPT2_entailment
430,486,7,7,0,1.0,11,8,3,0.7272727272727273,0.8421052631578948,medlm,mimiciii,radiology_report,PROMPT2_entailment
431,487,6,5,1,0.8333333333333334,20,13,7,0.65,0.7303370786516855,medlm,mimiciii,radiology_report,PROMPT2_entailment
432,488,6,4,2,0.6666666666666666,15,8,7,0.5333333333333333,0.5925925925925926,medlm,mimiciii,radiology_report,PROMPT2_entailment
433,489,9,6,3,0.6666666666666666,18,13,5,0.7222222222222222,0.6933333333333334,medlm,mimiciii,radiology_report,PROMPT2_entailment
434,49,5,4,1,0.8,24,15,9,0.625,0.7017543859649122,medlm,mimiciii,radiology_report,PROMPT2_entailment
435,490,6,6,0,1.0,8,4,4,0.5,0.6666666666666666,medlm,mimiciii,radiology_report,PROMPT2_entailment
436,491,7,6,1,0.8571428571428571,17,11,6,0.6470588235294118,0.7374301675977654,medlm,mimiciii,radiology_report,PROMPT2_entailment
437,492,6,5,1,0.8333333333333334,13,8,5,0.6153846153846154,0.7079646017699115,medlm,mimiciii,radiology_report,PROMPT2_entailment
438,493,6,4,2,0.6666666666666666,9,4,5,0.4444444444444444,0.5333333333333333,medlm,mimiciii,radiology_report,PROMPT2_entailment
439,494,6,5,1,0.8333333333333334,8,5,3,0.625,0.7142857142857143,medlm,mimiciii,radiology_report,PROMPT2_entailment
440,495,5,5,0,1.0,12,9,3,0.75,0.8571428571428571,medlm,mimiciii,radiology_report,PROMPT2_entailment
441,496,12,12,0,1.0,36,20,16,0.5555555555555556,0.7142857142857143,medlm,mimiciii,radiology_report,PROMPT2_entailment
442,497,7,6,1,0.8571428571428571,25,13,12,0.52,0.6473029045643154,medlm,mimiciii,radiology_report,PROMPT2_entailment
443,498,6,3,3,0.5,22,17,5,0.7727272727272727,0.6071428571428571,medlm,mimiciii,radiology_report,PROMPT2_entailment
444,499,8,6,2,0.75,17,12,5,0.7058823529411765,0.7272727272727272,medlm,mimiciii,radiology_report,PROMPT2_entailment
445,5,8,7,1,0.875,22,13,9,0.5909090909090909,0.7054263565891474,medlm,mimiciii,radiology_report,PROMPT2_entailment
446,50,5,3,2,0.6,15,9,6,0.6,0.6,medlm,mimiciii,radiology_report,PROMPT2_entailment
447,51,7,6,1,0.8571428571428571,13,8,5,0.6153846153846154,0.7164179104477612,medlm,mimiciii,radiology_report,PROMPT2_entailment
448,52,8,3,5,0.375,21,13,8,0.6190476190476191,0.467065868263473,medlm,mimiciii,radiology_report,PROMPT2_entailment
449,53,8,7,1,0.875,12,8,4,0.6666666666666666,0.7567567567567567,medlm,mimiciii,radiology_report,PROMPT2_entailment
450,54,6,5,1,0.8333333333333334,10,6,4,0.6,0.6976744186046512,medlm,mimiciii,radiology_report,PROMPT2_entailment
451,55,7,5,2,0.7142857142857143,18,13,5,0.7222222222222222,0.7182320441988951,medlm,mimiciii,radiology_report,PROMPT2_entailment
452,56,6,2,4,0.3333333333333333,21,15,6,0.7142857142857143,0.4545454545454545,medlm,mimiciii,radiology_report,PROMPT2_entailment
453,57,5,5,0,1.0,10,6,4,0.6,0.7499999999999999,medlm,mimiciii,radiology_report,PROMPT2_entailment
454,58,9,9,0,1.0,16,11,5,0.6875,0.8148148148148148,medlm,mimiciii,radiology_report,PROMPT2_entailment
455,59,7,7,0,1.0,16,12,4,0.75,0.8571428571428571,medlm,mimiciii,radiology_report,PROMPT2_entailment
456,6,5,5,0,1.0,8,7,1,0.875,0.9333333333333332,medlm,mimiciii,radiology_report,PROMPT2_entailment
457,60,10,8,2,0.8,19,12,7,0.631578947368421,0.7058823529411765,medlm,mimiciii,radiology_report,PROMPT2_entailment
458,61,6,4,2,0.6666666666666666,22,12,10,0.5454545454545454,0.6,medlm,mimiciii,radiology_report,PROMPT2_entailment
459,62,5,3,2,0.6,13,9,4,0.6923076923076923,0.6428571428571429,medlm,mimiciii,radiology_report,PROMPT2_entailment
460,63,9,8,1,0.8888888888888888,15,10,5,0.6666666666666666,0.761904761904762,medlm,mimiciii,radiology_report,PROMPT2_entailment
461,64,10,9,1,0.9,20,18,2,0.9,0.9,medlm,mimiciii,radiology_report,PROMPT2_entailment
462,65,6,6,0,1.0,18,14,4,0.7777777777777778,0.8750000000000001,medlm,mimiciii,radiology_report,PROMPT2_entailment
463,66,3,2,1,0.6666666666666666,34,25,9,0.7352941176470589,0.6993006993006994,medlm,mimiciii,radiology_report,PROMPT2_entailment
464,67,7,5,2,0.7142857142857143,28,20,8,0.7142857142857143,0.7142857142857143,medlm,mimiciii,radiology_report,PROMPT2_entailment
465,68,6,4,2,0.6666666666666666,35,27,8,0.7714285714285715,0.7152317880794701,medlm,mimiciii,radiology_report,PROMPT2_entailment
466,69,13,7,6,0.5384615384615384,31,17,14,0.5483870967741935,0.54337899543379,medlm,mimiciii,radiology_report,PROMPT2_entailment
467,7,8,7,1,0.875,16,15,1,0.9375,0.9051724137931034,medlm,mimiciii,radiology_report,PROMPT2_entailment
468,70,6,4,2,0.6666666666666666,17,14,3,0.8235294117647058,0.7368421052631577,medlm,mimiciii,radiology_report,PROMPT2_entailment
469,71,7,6,1,0.8571428571428571,18,9,9,0.5,0.631578947368421,medlm,mimiciii,radiology_report,PROMPT2_entailment
470,72,3,3,0,1.0,13,7,6,0.5384615384615384,0.7000000000000001,medlm,mimiciii,radiology_report,PROMPT2_entailment
471,73,7,6,1,0.8571428571428571,34,18,16,0.5294117647058824,0.6545454545454545,medlm,mimiciii,radiology_report,PROMPT2_entailment
472,74,6,4,2,0.6666666666666666,18,12,6,0.6666666666666666,0.6666666666666666,medlm,mimiciii,radiology_report,PROMPT2_entailment
473,75,8,6,2,0.75,12,11,1,0.9166666666666666,0.8250000000000001,medlm,mimiciii,radiology_report,PROMPT2_entailment
474,76,8,7,1,0.875,14,11,3,0.7857142857142857,0.8279569892473119,medlm,mimiciii,radiology_report,PROMPT2_entailment
475,77,7,6,1,0.8571428571428571,26,14,12,0.5384615384615384,0.6614173228346457,medlm,mimiciii,radiology_report,PROMPT2_entailment
476,78,13,11,2,0.8461538461538461,33,22,11,0.6666666666666666,0.7457627118644068,medlm,mimiciii,radiology_report,PROMPT2_entailment
477,79,7,7,0,1.0,17,10,7,0.5882352941176471,0.7407407407407407,medlm,mimiciii,radiology_report,PROMPT2_entailment
478,8,9,7,2,0.7777777777777778,15,12,3,0.8,0.7887323943661971,medlm,mimiciii,radiology_report,PROMPT2_entailment
479,80,5,3,2,0.6,25,16,9,0.64,0.6193548387096774,medlm,mimiciii,radiology_report,PROMPT2_entailment
480,81,5,1,4,0.2,15,9,6,0.6,0.3,medlm,mimiciii,radiology_report,PROMPT2_entailment
481,82,8,8,0,1.0,14,11,3,0.7857142857142857,0.88,medlm,mimiciii,radiology_report,PROMPT2_entailment
482,83,6,4,2,0.6666666666666666,17,11,6,0.6470588235294118,0.6567164179104478,medlm,mimiciii,radiology_report,PROMPT2_entailment
483,84,13,8,5,0.6153846153846154,20,15,5,0.75,0.676056338028169,medlm,mimiciii,radiology_report,PROMPT2_entailment
484,85,6,6,0,1.0,14,12,2,0.8571428571428571,0.923076923076923,medlm,mimiciii,radiology_report,PROMPT2_entailment
485,86,6,5,1,0.8333333333333334,10,7,3,0.7,0.7608695652173915,medlm,mimiciii,radiology_report,PROMPT2_entailment
486,87,8,7,1,0.875,14,9,5,0.6428571428571429,0.7411764705882353,medlm,mimiciii,radiology_report,PROMPT2_entailment
487,88,8,5,3,0.625,19,16,3,0.8421052631578947,0.7174887892376681,medlm,mimiciii,radiology_report,PROMPT2_entailment
488,89,9,5,4,0.5555555555555556,18,11,7,0.6111111111111112,0.5820105820105821,medlm,mimiciii,radiology_report,PROMPT2_entailment
489,9,5,4,1,0.8,13,8,5,0.6153846153846154,0.6956521739130435,medlm,mimiciii,radiology_report,PROMPT2_entailment
490,90,6,5,1,0.8333333333333334,14,9,5,0.6428571428571429,0.7258064516129034,medlm,mimiciii,radiology_report,PROMPT2_entailment
491,91,4,4,0,1.0,13,8,5,0.6153846153846154,0.761904761904762,medlm,mimiciii,radiology_report,PROMPT2_entailment
492,92,7,4,3,0.5714285714285714,21,14,7,0.6666666666666666,0.6153846153846153,medlm,mimiciii,radiology_report,PROMPT2_entailment
493,93,9,6,3,0.6666666666666666,15,12,3,0.8,0.7272727272727272,medlm,mimiciii,radiology_report,PROMPT2_entailment
494,94,12,9,3,0.75,28,18,10,0.6428571428571429,0.6923076923076924,medlm,mimiciii,radiology_report,PROMPT2_entailment
495,95,10,10,0,1.0,18,11,7,0.6111111111111112,0.7586206896551725,medlm,mimiciii,radiology_report,PROMPT2_entailment
496,96,8,5,3,0.625,21,15,6,0.7142857142857143,0.6666666666666666,medlm,mimiciii,radiology_report,PROMPT2_entailment
497,97,10,7,3,0.7,23,14,9,0.6086956521739131,0.6511627906976744,medlm,mimiciii,radiology_report,PROMPT2_entailment
498,98,8,7,1,0.875,19,10,9,0.5263157894736842,0.6572769953051644,medlm,mimiciii,radiology_report,PROMPT2_entailment
499,99,3,2,1,0.6666666666666666,13,8,5,0.6153846153846154,0.64,medlm,mimiciii,radiology_report,PROMPT2_entailment
0,0,40,31,9,0.775,118,60,58,0.5084745762711864,0.6140640475404424,medlm,mimiciii,progress_note,PROMPT1_entailment
1,1,24,16,8,0.6666666666666666,320,36,284,0.1125,0.1925133689839572,medlm,mimiciii,progress_note,PROMPT1_entailment
2,10,9,8,1,0.8888888888888888,230,64,166,0.2782608695652174,0.423841059602649,medlm,mimiciii,progress_note,PROMPT1_entailment
3,100,28,21,7,0.75,115,42,73,0.3652173913043478,0.4912280701754385,medlm,mimiciii,progress_note,PROMPT1_entailment
4,101,19,17,2,0.8947368421052632,49,26,23,0.5306122448979592,0.666164280331575,medlm,mimiciii,progress_note,PROMPT1_entailment
5,102,7,5,2,0.7142857142857143,67,30,37,0.4477611940298507,0.5504587155963303,medlm,mimiciii,progress_note,PROMPT1_entailment
6,103,18,16,2,0.8888888888888888,347,81,266,0.2334293948126801,0.3697574893009986,medlm,mimiciii,progress_note,PROMPT1_entailment
7,104,23,13,10,0.5652173913043478,57,28,29,0.4912280701754385,0.5256317689530684,medlm,mimiciii,progress_note,PROMPT1_entailment
8,105,10,7,3,0.7,28,15,13,0.5357142857142857,0.606936416184971,medlm,mimiciii,progress_note,PROMPT1_entailment
9,106,14,12,2,0.8571428571428571,58,22,36,0.3793103448275862,0.5258964143426295,medlm,mimiciii,progress_note,PROMPT1_entailment
10,107,23,21,2,0.9130434782608696,53,16,37,0.3018867924528302,0.4537474679270762,medlm,mimiciii,progress_note,PROMPT1_entailment
11,108,38,35,3,0.9210526315789472,94,46,48,0.4893617021276595,0.6391425168717745,medlm,mimiciii,progress_note,PROMPT1_entailment
12,109,20,19,1,0.95,311,44,267,0.1414790996784566,0.2462807482692591,medlm,mimiciii,progress_note,PROMPT1_entailment
13,11,9,7,2,0.7777777777777778,233,131,102,0.5622317596566524,0.6526690391459076,medlm,mimiciii,progress_note,PROMPT1_entailment
14,110,10,8,2,0.8,358,81,277,0.2262569832402234,0.3527490473598258,medlm,mimiciii,progress_note,PROMPT1_entailment
15,111,14,8,6,0.5714285714285714,389,76,313,0.1953727506426735,0.2911877394636015,medlm,mimiciii,progress_note,PROMPT1_entailment
16,112,12,7,5,0.5833333333333334,400,53,347,0.1325,0.2159487776484284,medlm,mimiciii,progress_note,PROMPT1_entailment
17,113,22,13,9,0.5909090909090909,340,216,124,0.6352941176470588,0.6122982991713913,medlm,mimiciii,progress_note,PROMPT1_entailment
18,114,14,7,7,0.5,401,103,298,0.256857855361596,0.3393739703459637,medlm,mimiciii,progress_note,PROMPT1_entailment
19,115,15,8,7,0.5333333333333333,479,111,368,0.231732776617954,0.3230853192650536,medlm,mimiciii,progress_note,PROMPT1_entailment
20,116,15,14,1,0.9333333333333332,53,29,24,0.5471698113207547,0.6898895497026338,medlm,mimiciii,progress_note,PROMPT1_entailment
21,117,8,5,3,0.625,33,18,15,0.5454545454545454,0.5825242718446602,medlm,mimiciii,progress_note,PROMPT1_entailment
22,118,8,7,1,0.875,41,17,24,0.4146341463414634,0.5626477541371159,medlm,mimiciii,progress_note,PROMPT1_entailment
23,119,13,12,1,0.9230769230769232,21,12,9,0.5714285714285714,0.7058823529411765,medlm,mimiciii,progress_note,PROMPT1_entailment
24,12,19,18,1,0.9473684210526316,388,65,323,0.1675257731958762,0.2847061686336537,medlm,mimiciii,progress_note,PROMPT1_entailment
25,120,24,20,4,0.8333333333333334,95,35,60,0.3684210526315789,0.5109489051094891,medlm,mimiciii,progress_note,PROMPT1_entailment
26,121,7,5,2,0.7142857142857143,23,20,3,0.8695652173913043,0.7843137254901961,medlm,mimiciii,progress_note,PROMPT1_entailment
27,122,4,3,1,0.75,71,22,49,0.3098591549295774,0.4385382059800664,medlm,mimiciii,progress_note,PROMPT1_entailment
28,123,22,20,2,0.9090909090909092,72,34,38,0.4722222222222222,0.6215722120658135,medlm,mimiciii,progress_note,PROMPT1_entailment
29,124,6,5,1,0.8333333333333334,96,40,56,0.4166666666666667,0.5555555555555556,medlm,mimiciii,progress_note,PROMPT1_entailment
30,125,24,24,0,1.0,72,33,39,0.4583333333333333,0.6285714285714286,medlm,mimiciii,progress_note,PROMPT1_entailment
31,126,12,11,1,0.9166666666666666,41,22,19,0.5365853658536586,0.676923076923077,medlm,mimiciii,progress_note,PROMPT1_entailment
32,127,12,11,1,0.9166666666666666,41,35,6,0.8536585365853658,0.8840413318025258,medlm,mimiciii,progress_note,PROMPT1_entailment
33,128,23,20,3,0.8695652173913043,56,30,26,0.5357142857142857,0.6629834254143646,medlm,mimiciii,progress_note,PROMPT1_entailment
34,129,23,16,7,0.6956521739130435,100,44,56,0.44,0.5390505359877489,medlm,mimiciii,progress_note,PROMPT1_entailment
35,13,36,28,8,0.7777777777777778,106,42,64,0.3962264150943396,0.525,medlm,mimiciii,progress_note,PROMPT1_entailment
36,130,17,8,9,0.4705882352941176,64,27,37,0.421875,0.4449021627188465,medlm,mimiciii,progress_note,PROMPT1_entailment
37,131,13,9,4,0.6923076923076923,343,76,267,0.2215743440233236,0.3357055214723926,medlm,mimiciii,progress_note,PROMPT1_entailment
38,132,16,6,10,0.375,333,70,263,0.2102102102102102,0.2694034637588197,medlm,mimiciii,progress_note,PROMPT1_entailment
39,133,13,10,3,0.7692307692307693,271,50,221,0.1845018450184501,0.2976190476190476,medlm,mimiciii,progress_note,PROMPT1_entailment
40,134,11,7,4,0.6363636363636364,24,6,18,0.25,0.358974358974359,medlm,mimiciii,progress_note,PROMPT1_entailment
41,135,27,20,7,0.7407407407407407,50,27,23,0.54,0.6246385193753615,medlm,mimiciii,progress_note,PROMPT1_entailment
42,136,9,9,0,1.0,58,23,35,0.396551724137931,0.5679012345679012,medlm,mimiciii,progress_note,PROMPT1_entailment
43,137,11,7,4,0.6363636363636364,36,14,22,0.3888888888888889,0.4827586206896552,medlm,mimiciii,progress_note,PROMPT1_entailment
44,138,10,10,0,1.0,66,13,53,0.1969696969696969,0.3291139240506329,medlm,mimiciii,progress_note,PROMPT1_entailment
45,139,10,9,1,0.9,70,18,52,0.2571428571428571,0.3999999999999999,medlm,mimiciii,progress_note,PROMPT1_entailment
46,14,40,7,33,0.175,63,2,61,0.0317460317460317,0.0537428023032629,medlm,mimiciii,progress_note,PROMPT1_entailment
47,140,14,8,6,0.5714285714285714,39,16,23,0.4102564102564102,0.4776119402985074,medlm,mimiciii,progress_note,PROMPT1_entailment
48,141,5,5,0,1.0,70,50,20,0.7142857142857143,0.8333333333333333,medlm,mimiciii,progress_note,PROMPT1_entailment
49,142,9,7,2,0.7777777777777778,72,33,39,0.4583333333333333,0.5767790262172284,medlm,mimiciii,progress_note,PROMPT1_entailment
50,143,5,5,0,1.0,16,7,9,0.4375,0.6086956521739131,medlm,mimiciii,progress_note,PROMPT1_entailment
51,144,9,8,1,0.8888888888888888,72,33,39,0.4583333333333333,0.604810996563574,medlm,mimiciii,progress_note,PROMPT1_entailment
52,145,21,16,5,0.7619047619047619,63,28,35,0.4444444444444444,0.5614035087719298,medlm,mimiciii,progress_note,PROMPT1_entailment
53,146,12,9,3,0.75,50,25,25,0.5,0.6,medlm,mimiciii,progress_note,PROMPT1_entailment
54,147,25,21,4,0.84,80,38,42,0.475,0.6068441064638783,medlm,mimiciii,progress_note,PROMPT1_entailment
55,148,5,5,0,1.0,6,5,1,0.8333333333333334,0.9090909090909092,medlm,mimiciii,progress_note,PROMPT1_entailment
56,149,15,11,4,0.7333333333333333,46,22,24,0.4782608695652174,0.5789473684210527,medlm,mimiciii,progress_note,PROMPT1_entailment
57,15,30,28,2,0.9333333333333332,275,67,208,0.2436363636363636,0.3864057672502574,medlm,mimiciii,progress_note,PROMPT1_entailment
58,150,40,28,12,0.7,121,81,40,0.6694214876033058,0.684369342184671,medlm,mimiciii,progress_note,PROMPT1_entailment
59,151,37,34,3,0.918918918918919,340,104,236,0.3058823529411765,0.4589823468328141,medlm,mimiciii,progress_note,PROMPT1_entailment
60,152,42,15,27,0.3571428571428571,65,1,64,0.0153846153846153,0.0294985250737463,medlm,mimiciii,progress_note,PROMPT1_entailment
61,153,23,20,3,0.8695652173913043,368,77,291,0.2092391304347826,0.3373124520862994,medlm,mimiciii,progress_note,PROMPT1_entailment
62,154,8,8,0,1.0,23,23,0,1.0,1.0,medlm,mimiciii,progress_note,PROMPT1_entailment
63,155,20,15,5,0.75,49,28,21,0.5714285714285714,0.6486486486486486,medlm,mimiciii,progress_note,PROMPT1_entailment
64,156,20,16,4,0.8,49,25,24,0.5102040816326531,0.6230529595015576,medlm,mimiciii,progress_note,PROMPT1_entailment
65,157,14,13,1,0.9285714285714286,41,11,30,0.2682926829268293,0.4163027656477439,medlm,mimiciii,progress_note,PROMPT1_entailment
66,158,17,14,3,0.8235294117647058,411,65,346,0.1581508515815085,0.2653448024493366,medlm,mimiciii,progress_note,PROMPT1_entailment
67,159,5,4,1,0.8,35,24,11,0.6857142857142857,0.7384615384615385,medlm,mimiciii,progress_note,PROMPT1_entailment
68,16,8,7,1,0.875,41,13,28,0.3170731707317073,0.4654731457800511,medlm,mimiciii,progress_note,PROMPT1_entailment
69,160,6,4,2,0.6666666666666666,96,41,55,0.4270833333333333,0.5206349206349206,medlm,mimiciii,progress_note,PROMPT1_entailment
70,161,11,10,1,0.9090909090909092,343,31,312,0.0903790087463556,0.1644126226465128,medlm,mimiciii,progress_note,PROMPT1_entailment
71,162,48,29,19,0.6041666666666666,300,79,221,0.2633333333333333,0.366794748639129,medlm,mimiciii,progress_note,PROMPT1_entailment
72,163,13,12,1,0.9230769230769232,39,17,22,0.4358974358974359,0.5921625544267054,medlm,mimiciii,progress_note,PROMPT1_entailment
73,164,21,15,6,0.7142857142857143,82,40,42,0.4878048780487805,0.5797101449275363,medlm,mimiciii,progress_note,PROMPT1_entailment
74,165,6,6,0,1.0,32,19,13,0.59375,0.7450980392156863,medlm,mimiciii,progress_note,PROMPT1_entailment
75,166,22,16,6,0.7272727272727273,59,34,25,0.576271186440678,0.6430260047281324,medlm,mimiciii,progress_note,PROMPT1_entailment
76,167,19,17,2,0.8947368421052632,85,33,52,0.388235294117647,0.5415057915057915,medlm,mimiciii,progress_note,PROMPT1_entailment
77,168,22,17,5,0.7727272727272727,312,66,246,0.2115384615384615,0.3321492007104796,medlm,mimiciii,progress_note,PROMPT1_entailment
78,169,102,64,38,0.6274509803921569,377,264,113,0.7002652519893899,0.6618614854277656,medlm,mimiciii,progress_note,PROMPT1_entailment
79,17,6,5,1,0.8333333333333334,20,17,3,0.85,0.8415841584158417,medlm,mimiciii,progress_note,PROMPT1_entailment
80,170,26,13,13,0.5,318,91,227,0.2861635220125786,0.364,medlm,mimiciii,progress_note,PROMPT1_entailment
81,171,29,26,3,0.896551724137931,387,79,308,0.2041343669250646,0.3325507973771553,medlm,mimiciii,progress_note,PROMPT1_entailment
82,172,11,4,7,0.3636363636363636,342,41,301,0.1198830409356725,0.1803188565145684,medlm,mimiciii,progress_note,PROMPT1_entailment
83,173,17,9,8,0.5294117647058824,299,36,263,0.1204013377926421,0.1961852861035422,medlm,mimiciii,progress_note,PROMPT1_entailment
84,174,70,58,12,0.8285714285714286,351,72,279,0.2051282051282051,0.3288447909284195,medlm,mimiciii,progress_note,PROMPT1_entailment
85,175,13,11,2,0.8461538461538461,354,51,303,0.1440677966101695,0.2462146148782093,medlm,mimiciii,progress_note,PROMPT1_entailment
86,176,22,14,8,0.6363636363636364,330,82,248,0.2484848484848484,0.3574097135740972,medlm,mimiciii,progress_note,PROMPT1_entailment
87,177,27,15,12,0.5555555555555556,330,83,247,0.2515151515151515,0.3462661660408844,medlm,mimiciii,progress_note,PROMPT1_entailment
88,178,14,13,1,0.9285714285714286,23,17,6,0.7391304347826086,0.8230912476722533,medlm,mimiciii,progress_note,PROMPT1_entailment
89,179,10,8,2,0.8,341,54,287,0.158357771260997,0.2643818849449204,medlm,mimiciii,progress_note,PROMPT1_entailment
90,18,9,5,4,0.5555555555555556,29,17,12,0.5862068965517241,0.5704697986577182,medlm,mimiciii,progress_note,PROMPT1_entailment
91,180,20,14,6,0.7,343,42,301,0.1224489795918367,0.2084367245657568,medlm,mimiciii,progress_note,PROMPT1_entailment
92,181,10,9,1,0.9,366,47,319,0.1284153005464481,0.2247608926673751,medlm,mimiciii,progress_note,PROMPT1_entailment
93,182,10,6,4,0.6,367,50,317,0.1362397820163488,0.2220577350111028,medlm,mimiciii,progress_note,PROMPT1_entailment
94,183,28,21,7,0.75,389,68,321,0.1748071979434447,0.2835302293259208,medlm,mimiciii,progress_note,PROMPT1_entailment
95,184,15,14,1,0.9333333333333332,330,34,296,0.103030303030303,0.1855750487329434,medlm,mimiciii,progress_note,PROMPT1_entailment
96,185,19,16,3,0.8421052631578947,69,23,46,0.3333333333333333,0.4776119402985075,medlm,mimiciii,progress_note,PROMPT1_entailment
97,186,9,7,2,0.7777777777777778,352,45,307,0.1278409090909091,0.219588706866504,medlm,mimiciii,progress_note,PROMPT1_entailment
98,187,10,8,2,0.8,295,35,260,0.1186440677966101,0.2066420664206642,medlm,mimiciii,progress_note,PROMPT1_entailment
99,188,22,19,3,0.8636363636363636,357,72,285,0.2016806722689075,0.3269989243456436,medlm,mimiciii,progress_note,PROMPT1_entailment
100,189,36,34,2,0.9444444444444444,394,126,268,0.3197969543147208,0.4778050412670087,medlm,mimiciii,progress_note,PROMPT1_entailment
101,19,9,8,1,0.8888888888888888,54,24,30,0.4444444444444444,0.5925925925925926,medlm,mimiciii,progress_note,PROMPT1_entailment
102,190,33,28,5,0.8484848484848485,390,79,311,0.2025641025641025,0.3270496044947142,medlm,mimiciii,progress_note,PROMPT1_entailment
103,191,23,21,2,0.9130434782608696,359,76,283,0.2116991643454039,0.3437062560568536,medlm,mimiciii,progress_note,PROMPT1_entailment
104,192,16,13,3,0.8125,360,67,293,0.1861111111111111,0.3028511821974965,medlm,mimiciii,progress_note,PROMPT1_entailment
105,193,11,8,3,0.7272727272727273,415,50,365,0.1204819277108433,0.20671834625323,medlm,mimiciii,progress_note,PROMPT1_entailment
106,194,13,13,0,1.0,365,43,322,0.1178082191780822,0.2107843137254902,medlm,mimiciii,progress_note,PROMPT1_entailment
107,195,9,8,1,0.8888888888888888,60,35,25,0.5833333333333334,0.7044025157232704,medlm,mimiciii,progress_note,PROMPT1_entailment
108,196,19,12,7,0.631578947368421,61,28,33,0.4590163934426229,0.5316455696202531,medlm,mimiciii,progress_note,PROMPT1_entailment
109,197,38,33,5,0.868421052631579,137,63,74,0.4598540145985401,0.6013015184381779,medlm,mimiciii,progress_note,PROMPT1_entailment
110,198,18,17,1,0.9444444444444444,47,32,15,0.6808510638297872,0.7912727272727272,medlm,mimiciii,progress_note,PROMPT1_entailment
111,199,27,21,6,0.7777777777777778,76,30,46,0.3947368421052631,0.5236907730673317,medlm,mimiciii,progress_note,PROMPT1_entailment
112,2,19,14,5,0.7368421052631579,242,48,194,0.1983471074380165,0.3125581395348837,medlm,mimiciii,progress_note,PROMPT1_entailment
113,20,12,10,2,0.8333333333333334,47,25,22,0.5319148936170213,0.6493506493506493,medlm,mimiciii,progress_note,PROMPT1_entailment
114,200,35,14,21,0.4,276,45,231,0.1630434782608695,0.2316602316602316,medlm,mimiciii,progress_note,PROMPT1_entailment
115,201,7,7,0,1.0,343,185,158,0.5393586005830904,0.7007575757575758,medlm,mimiciii,progress_note,PROMPT1_entailment
116,202,46,34,12,0.7391304347826086,295,25,270,0.0847457627118644,0.1520572450805009,medlm,mimiciii,progress_note,PROMPT1_entailment
117,203,25,21,4,0.84,367,59,308,0.1607629427792915,0.2698758440426922,medlm,mimiciii,progress_note,PROMPT1_entailment
118,204,22,21,1,0.9545454545454546,349,75,274,0.2148997134670487,0.3508185766789174,medlm,mimiciii,progress_note,PROMPT1_entailment
119,205,49,43,6,0.8775510204081632,329,70,259,0.2127659574468085,0.3424930306650737,medlm,mimiciii,progress_note,PROMPT1_entailment
120,206,35,31,4,0.8857142857142857,421,127,294,0.3016627078384798,0.4500457247370828,medlm,mimiciii,progress_note,PROMPT1_entailment
121,207,6,6,0,1.0,403,191,212,0.4739454094292804,0.6430976430976431,medlm,mimiciii,progress_note,PROMPT1_entailment
122,208,20,10,10,0.5,395,65,330,0.1645569620253164,0.2476190476190476,medlm,mimiciii,progress_note,PROMPT1_entailment
123,209,11,9,2,0.8181818181818182,351,44,307,0.1253561253561253,0.2174032390886631,medlm,mimiciii,progress_note,PROMPT1_entailment
124,21,15,15,0,1.0,373,85,288,0.227882037533512,0.3711790393013101,medlm,mimiciii,progress_note,PROMPT1_entailment
125,210,14,9,5,0.6428571428571429,45,23,22,0.5111111111111111,0.5694635488308116,medlm,mimiciii,progress_note,PROMPT1_entailment
126,211,28,26,2,0.9285714285714286,89,39,50,0.4382022471910112,0.5954198473282443,medlm,mimiciii,progress_note,PROMPT1_entailment
127,213,17,16,1,0.9411764705882352,62,33,29,0.532258064516129,0.6799742433998711,medlm,mimiciii,progress_note,PROMPT1_entailment
128,214,9,6,3,0.6666666666666666,39,26,13,0.6666666666666666,0.6666666666666666,medlm,mimiciii,progress_note,PROMPT1_entailment
129,215,34,20,14,0.5882352941176471,101,40,61,0.396039603960396,0.4733727810650888,medlm,mimiciii,progress_note,PROMPT1_entailment
130,216,23,12,11,0.5217391304347826,103,40,63,0.3883495145631068,0.4452690166975881,medlm,mimiciii,progress_note,PROMPT1_entailment
131,217,11,8,3,0.7272727272727273,114,45,69,0.3947368421052631,0.511727078891258,medlm,mimiciii,progress_note,PROMPT1_entailment
132,218,13,12,1,0.9230769230769232,41,22,19,0.5365853658536586,0.6786632390745502,medlm,mimiciii,progress_note,PROMPT1_entailment
133,219,7,5,2,0.7142857142857143,22,20,2,0.9090909090909092,0.8,medlm,mimiciii,progress_note,PROMPT1_entailment
134,22,10,7,3,0.7,56,22,34,0.3928571428571428,0.5032679738562091,medlm,mimiciii,progress_note,PROMPT1_entailment
135,220,19,16,3,0.8421052631578947,50,27,23,0.54,0.6580350342726581,medlm,mimiciii,progress_note,PROMPT1_entailment
136,221,37,29,8,0.7837837837837838,333,52,281,0.1561561561561561,0.2604265607460495,medlm,mimiciii,progress_note,PROMPT1_entailment
137,222,7,7,0,1.0,458,65,393,0.1419213973799126,0.2485659655831739,medlm,mimiciii,progress_note,PROMPT1_entailment
138,223,10,6,4,0.6,45,42,3,0.9333333333333332,0.7304347826086957,medlm,mimiciii,progress_note,PROMPT1_entailment
139,224,13,10,3,0.7692307692307693,50,26,24,0.52,0.6205250596658711,medlm,mimiciii,progress_note,PROMPT1_entailment
140,225,9,9,0,1.0,56,17,39,0.3035714285714285,0.4657534246575342,medlm,mimiciii,progress_note,PROMPT1_entailment
141,226,17,14,3,0.8235294117647058,50,23,27,0.46,0.5902841429880844,medlm,mimiciii,progress_note,PROMPT1_entailment
142,227,3,2,1,0.6666666666666666,18,3,15,0.1666666666666666,0.2666666666666666,medlm,mimiciii,progress_note,PROMPT1_entailment
143,228,3,2,1,0.6666666666666666,18,3,15,0.1666666666666666,0.2666666666666666,medlm,mimiciii,progress_note,PROMPT1_entailment
144,229,3,2,1,0.6666666666666666,18,3,15,0.1666666666666666,0.2666666666666666,medlm,mimiciii,progress_note,PROMPT1_entailment
145,23,22,16,6,0.7272727272727273,56,20,36,0.3571428571428571,0.4790419161676646,medlm,mimiciii,progress_note,PROMPT1_entailment
146,230,11,9,2,0.8181818181818182,40,14,26,0.35,0.490272373540856,medlm,mimiciii,progress_note,PROMPT1_entailment
147,231,44,40,4,0.9090909090909092,152,128,24,0.8421052631578947,0.8743169398907102,medlm,mimiciii,progress_note,PROMPT1_entailment
148,232,36,23,13,0.6388888888888888,108,47,61,0.4351851851851852,0.51772030651341,medlm,mimiciii,progress_note,PROMPT1_entailment
149,233,45,27,18,0.6,116,55,61,0.4741379310344827,0.5296950240770466,medlm,mimiciii,progress_note,PROMPT1_entailment
150,234,19,13,6,0.6842105263157895,59,28,31,0.4745762711864407,0.5604311008468053,medlm,mimiciii,progress_note,PROMPT1_entailment
151,24,6,4,2,0.6666666666666666,33,23,10,0.696969696969697,0.6814814814814815,medlm,mimiciii,progress_note,PROMPT1_entailment
152,25,12,10,2,0.8333333333333334,35,15,20,0.4285714285714285,0.5660377358490566,medlm,mimiciii,progress_note,PROMPT1_entailment
153,26,11,10,1,0.9090909090909092,35,16,19,0.4571428571428571,0.6083650190114068,medlm,mimiciii,progress_note,PROMPT1_entailment
154,27,7,3,4,0.4285714285714285,32,11,21,0.34375,0.3815028901734104,medlm,mimiciii,progress_note,PROMPT1_entailment
155,28,20,15,5,0.75,85,27,58,0.3176470588235294,0.4462809917355371,medlm,mimiciii,progress_note,PROMPT1_entailment
156,3,88,46,42,0.5227272727272727,273,66,207,0.2417582417582417,0.3306109114668409,medlm,mimiciii,progress_note,PROMPT1_entailment
157,30,10,10,0,1.0,29,11,18,0.3793103448275862,0.5499999999999999,medlm,mimiciii,progress_note,PROMPT1_entailment
158,31,14,13,1,0.9285714285714286,26,11,15,0.4230769230769231,0.5813008130081301,medlm,mimiciii,progress_note,PROMPT1_entailment
159,32,33,27,6,0.8181818181818182,152,72,80,0.4736842105263157,0.6,medlm,mimiciii,progress_note,PROMPT1_entailment
160,33,25,20,5,0.8,106,38,68,0.3584905660377358,0.495114006514658,medlm,mimiciii,progress_note,PROMPT1_entailment
161,34,40,30,10,0.75,98,55,43,0.5612244897959183,0.642023346303502,medlm,mimiciii,progress_note,PROMPT1_entailment
162,35,3,2,1,0.6666666666666666,26,17,9,0.6538461538461539,0.6601941747572816,medlm,mimiciii,progress_note,PROMPT1_entailment
163,36,15,10,5,0.6666666666666666,60,42,18,0.7,0.6829268292682926,medlm,mimiciii,progress_note,PROMPT1_entailment
164,37,13,6,7,0.4615384615384615,344,63,281,0.1831395348837209,0.2622268470343392,medlm,mimiciii,progress_note,PROMPT1_entailment
165,38,23,12,11,0.5217391304347826,278,161,117,0.579136690647482,0.5489416110242931,medlm,mimiciii,progress_note,PROMPT1_entailment
166,39,22,21,1,0.9545454545454546,117,56,61,0.4786324786324786,0.6375711574952562,medlm,mimiciii,progress_note,PROMPT1_entailment
167,4,96,50,46,0.5208333333333334,282,45,237,0.1595744680851064,0.2442996742671009,medlm,mimiciii,progress_note,PROMPT1_entailment
168,40,21,21,0,1.0,117,54,63,0.4615384615384615,0.631578947368421,medlm,mimiciii,progress_note,PROMPT1_entailment
169,41,18,15,3,0.8333333333333334,119,60,59,0.5042016806722689,0.6282722513089005,medlm,mimiciii,progress_note,PROMPT1_entailment
170,42,17,13,4,0.7647058823529411,119,53,66,0.4453781512605042,0.5629084967320261,medlm,mimiciii,progress_note,PROMPT1_entailment
171,43,21,7,14,0.3333333333333333,117,54,63,0.4615384615384615,0.3870967741935484,medlm,mimiciii,progress_note,PROMPT1_entailment
172,44,32,31,1,0.96875,149,72,77,0.4832214765100671,0.6448071645240503,medlm,mimiciii,progress_note,PROMPT1_entailment
173,45,14,11,3,0.7857142857142857,125,41,84,0.328,0.4628014366341714,medlm,mimiciii,progress_note,PROMPT1_entailment
174,46,15,13,2,0.8666666666666667,52,21,31,0.4038461538461538,0.5509586276488396,medlm,mimiciii,progress_note,PROMPT1_entailment
175,47,2,1,1,0.5,12,6,6,0.5,0.5,medlm,mimiciii,progress_note,PROMPT1_entailment
176,49,25,19,6,0.76,87,23,64,0.264367816091954,0.3922800718132854,medlm,mimiciii,progress_note,PROMPT1_entailment
177,5,29,25,4,0.8620689655172413,300,176,124,0.5866666666666667,0.6981910504601713,medlm,mimiciii,progress_note,PROMPT1_entailment
178,50,53,48,5,0.9056603773584906,176,130,46,0.7386363636363636,0.8136654061807277,medlm,mimiciii,progress_note,PROMPT1_entailment
179,51,30,21,9,0.7,302,52,250,0.1721854304635761,0.2763857251328777,medlm,mimiciii,progress_note,PROMPT1_entailment
180,52,29,10,19,0.3448275862068966,302,42,260,0.1390728476821192,0.1982067012741859,medlm,mimiciii,progress_note,PROMPT1_entailment
181,53,17,14,3,0.8235294117647058,382,70,312,0.1832460732984293,0.2997858672376873,medlm,mimiciii,progress_note,PROMPT1_entailment
182,54,13,8,5,0.6153846153846154,219,35,184,0.1598173515981735,0.25373810602628,medlm,mimiciii,progress_note,PROMPT1_entailment
183,55,16,8,8,0.5,286,35,251,0.1223776223776223,0.196629213483146,medlm,mimiciii,progress_note,PROMPT1_entailment
184,56,8,8,0,1.0,48,16,32,0.3333333333333333,0.5,medlm,mimiciii,progress_note,PROMPT1_entailment
185,57,11,8,3,0.7272727272727273,46,19,27,0.4130434782608695,0.5268630849220104,medlm,mimiciii,progress_note,PROMPT1_entailment
186,58,13,10,3,0.7692307692307693,39,23,16,0.5897435897435898,0.6676342525399129,medlm,mimiciii,progress_note,PROMPT1_entailment
187,59,11,7,4,0.6363636363636364,39,16,23,0.4102564102564102,0.4988864142538975,medlm,mimiciii,progress_note,PROMPT1_entailment
188,6,20,8,12,0.4,331,82,249,0.2477341389728096,0.3059701492537313,medlm,mimiciii,progress_note,PROMPT1_entailment
189,60,57,36,21,0.631578947368421,276,38,238,0.1376811594202898,0.226078334159643,medlm,mimiciii,progress_note,PROMPT1_entailment
190,61,15,11,4,0.7333333333333333,56,17,39,0.3035714285714285,0.4293915040183697,medlm,mimiciii,progress_note,PROMPT1_entailment
191,62,22,17,5,0.7727272727272727,56,18,38,0.3214285714285714,0.4540059347181009,medlm,mimiciii,progress_note,PROMPT1_entailment
192,63,45,30,15,0.6666666666666666,142,127,15,0.8943661971830986,0.7639097744360902,medlm,mimiciii,progress_note,PROMPT1_entailment
193,64,1,0,1,0.0,1,0,1,0.0,,medlm,mimiciii,progress_note,PROMPT1_entailment
194,65,4,3,1,0.75,12,7,5,0.5833333333333334,0.6562499999999999,medlm,mimiciii,progress_note,PROMPT1_entailment
195,66,25,25,0,1.0,68,37,31,0.5441176470588235,0.7047619047619048,medlm,mimiciii,progress_note,PROMPT1_entailment
196,67,12,7,5,0.5833333333333334,490,73,417,0.1489795918367347,0.2373432419879238,medlm,mimiciii,progress_note,PROMPT1_entailment
197,68,20,16,4,0.8,348,71,277,0.2040229885057471,0.3251287922152261,medlm,mimiciii,progress_note,PROMPT1_entailment
198,69,61,51,10,0.8360655737704918,373,257,116,0.6890080428954424,0.7554466858789626,medlm,mimiciii,progress_note,PROMPT1_entailment
199,7,14,5,9,0.3571428571428571,331,47,284,0.1419939577039275,0.203199308257674,medlm,mimiciii,progress_note,PROMPT1_entailment
200,70,8,8,0,1.0,374,73,301,0.195187165775401,0.3266219239373601,medlm,mimiciii,progress_note,PROMPT1_entailment
201,71,13,13,0,1.0,372,75,297,0.2016129032258064,0.3355704697986577,medlm,mimiciii,progress_note,PROMPT1_entailment
202,72,5,5,0,1.0,20,10,10,0.5,0.6666666666666666,medlm,mimiciii,progress_note,PROMPT1_entailment
203,73,33,23,10,0.696969696969697,460,100,360,0.217391304347826,0.3314121037463977,medlm,mimiciii,progress_note,PROMPT1_entailment
204,74,63,47,16,0.746031746031746,319,88,231,0.2758620689655172,0.402785216925549,medlm,mimiciii,progress_note,PROMPT1_entailment
205,75,38,35,3,0.9210526315789472,62,28,34,0.4516129032258064,0.6060606060606061,medlm,mimiciii,progress_note,PROMPT1_entailment
206,76,7,5,2,0.7142857142857143,86,20,66,0.2325581395348837,0.3508771929824562,medlm,mimiciii,progress_note,PROMPT1_entailment
207,77,14,14,0,1.0,38,18,20,0.4736842105263157,0.6428571428571429,medlm,mimiciii,progress_note,PROMPT1_entailment
208,78,19,17,2,0.8947368421052632,30,26,4,0.8666666666666667,0.8804780876494024,medlm,mimiciii,progress_note,PROMPT1_entailment
209,79,12,11,1,0.9166666666666666,67,51,16,0.7611940298507462,0.8317272053372868,medlm,mimiciii,progress_note,PROMPT1_entailment
210,8,21,19,2,0.9047619047619048,118,59,59,0.5,0.6440677966101696,medlm,mimiciii,progress_note,PROMPT1_entailment
211,80,17,16,1,0.9411764705882352,32,15,17,0.46875,0.6258148631029987,medlm,mimiciii,progress_note,PROMPT1_entailment
212,81,16,13,3,0.8125,46,21,25,0.4565217391304347,0.5845824411134902,medlm,mimiciii,progress_note,PROMPT1_entailment
213,82,3,2,1,0.6666666666666666,18,3,15,0.1666666666666666,0.2666666666666666,medlm,mimiciii,progress_note,PROMPT1_entailment
214,83,23,18,5,0.782608695652174,66,33,33,0.5,0.6101694915254238,medlm,mimiciii,progress_note,PROMPT1_entailment
215,84,19,16,3,0.8421052631578947,48,24,24,0.5,0.6274509803921569,medlm,mimiciii,progress_note,PROMPT1_entailment
216,85,5,3,2,0.6,77,14,63,0.1818181818181818,0.2790697674418604,medlm,mimiciii,progress_note,PROMPT1_entailment
217,87,2,1,1,0.5,15,4,11,0.2666666666666666,0.3478260869565218,medlm,mimiciii,progress_note,PROMPT1_entailment
218,88,26,21,5,0.8076923076923077,105,50,55,0.4761904761904761,0.5991440798858774,medlm,mimiciii,progress_note,PROMPT1_entailment
219,89,54,25,29,0.4629629629629629,339,46,293,0.135693215339233,0.2098731636098184,medlm,mimiciii,progress_note,PROMPT1_entailment
220,9,20,18,2,0.9,61,31,30,0.5081967213114754,0.6495925494761351,medlm,mimiciii,progress_note,PROMPT1_entailment
221,90,3,3,0,1.0,4,4,0,1.0,1.0,medlm,mimiciii,progress_note,PROMPT1_entailment
222,91,13,11,2,0.8461538461538461,112,46,66,0.4107142857142857,0.5530054644808743,medlm,mimiciii,progress_note,PROMPT1_entailment
223,92,11,8,3,0.7272727272727273,208,39,169,0.1875,0.2981366459627328,medlm,mimiciii,progress_note,PROMPT1_entailment
224,93,10,8,2,0.8,38,15,23,0.3947368421052631,0.5286343612334803,medlm,mimiciii,progress_note,PROMPT1_entailment
225,94,37,31,6,0.8378378378378378,112,53,59,0.4732142857142857,0.6048223817412112,medlm,mimiciii,progress_note,PROMPT1_entailment
226,95,16,9,7,0.5625,49,23,26,0.4693877551020408,0.511742892459827,medlm,mimiciii,progress_note,PROMPT1_entailment
227,96,2,2,0,1.0,14,3,11,0.2142857142857142,0.3529411764705882,medlm,mimiciii,progress_note,PROMPT1_entailment
228,97,4,4,0,1.0,20,15,5,0.75,0.8571428571428571,medlm,mimiciii,progress_note,PROMPT1_entailment
229,98,10,9,1,0.9,35,15,20,0.4285714285714285,0.5806451612903225,medlm,mimiciii,progress_note,PROMPT1_entailment
230,99,36,32,4,0.8888888888888888,104,75,29,0.7211538461538461,0.7962840079628399,medlm,mimiciii,progress_note,PROMPT1_entailment
0,0,47,40,7,0.851063829787234,118,107,11,0.9067796610169492,0.8780387732075084,medlm,mimiciii,progress_note,PROMPT1_ICL_entailment
1,1,106,76,30,0.7169811320754716,320,202,118,0.63125,0.6713898364383801,medlm,mimiciii,progress_note,PROMPT1_ICL_entailment
2,10,32,20,12,0.625,230,43,187,0.1869565217391304,0.2878179384203481,medlm,mimiciii,progress_note,PROMPT1_ICL_entailment
3,100,13,11,2,0.8461538461538461,115,35,80,0.3043478260869565,0.4476744186046511,medlm,mimiciii,progress_note,PROMPT1_ICL_entailment
4,101,19,17,2,0.8947368421052632,49,27,22,0.5510204081632653,0.6820208023774145,medlm,mimiciii,progress_note,PROMPT1_ICL_entailment
5,102,20,17,3,0.85,67,23,44,0.3432835820895522,0.4890556597873671,medlm,mimiciii,progress_note,PROMPT1_ICL_entailment
6,103,18,13,5,0.7222222222222222,347,54,293,0.1556195965417867,0.2560641984315156,medlm,mimiciii,progress_note,PROMPT1_ICL_entailment
7,104,18,12,6,0.6666666666666666,57,30,27,0.5263157894736842,0.5882352941176471,medlm,mimiciii,progress_note,PROMPT1_ICL_entailment
8,105,7,7,0,1.0,28,17,11,0.6071428571428571,0.7555555555555554,medlm,mimiciii,progress_note,PROMPT1_ICL_entailment
9,106,21,18,3,0.8571428571428571,58,46,12,0.7931034482758621,0.8238805970149252,medlm,mimiciii,progress_note,PROMPT1_ICL_entailment
10,107,23,21,2,0.9130434782608696,53,27,26,0.5094339622641509,0.6539792387543253,medlm,mimiciii,progress_note,PROMPT1_ICL_entailment
11,108,38,34,4,0.8947368421052632,94,46,48,0.4893617021276595,0.6326860841423948,medlm,mimiciii,progress_note,PROMPT1_ICL_entailment
12,109,10,10,0,1.0,311,37,274,0.1189710610932476,0.2126436781609195,medlm,mimiciii,progress_note,PROMPT1_ICL_entailment
13,11,74,49,25,0.6621621621621622,233,67,166,0.2875536480686695,0.4009770992366412,medlm,mimiciii,progress_note,PROMPT1_ICL_entailment
14,110,24,15,9,0.625,358,100,258,0.2793296089385474,0.386100386100386,medlm,mimiciii,progress_note,PROMPT1_ICL_entailment
15,111,29,18,11,0.6206896551724138,389,88,301,0.2262210796915167,0.3315888633033284,medlm,mimiciii,progress_note,PROMPT1_ICL_entailment
16,112,15,14,1,0.9333333333333332,400,71,329,0.1775,0.2982745686421605,medlm,mimiciii,progress_note,PROMPT1_ICL_entailment
17,113,10,7,3,0.7,340,51,289,0.15,0.2470588235294117,medlm,mimiciii,progress_note,PROMPT1_ICL_entailment
18,114,19,12,7,0.631578947368421,401,77,324,0.1920199501246882,0.2945019920318725,medlm,mimiciii,progress_note,PROMPT1_ICL_entailment
19,115,15,11,4,0.7333333333333333,479,67,412,0.1398747390396659,0.2349378386993943,medlm,mimiciii,progress_note,PROMPT1_ICL_entailment
20,116,15,14,1,0.9333333333333332,53,30,23,0.5660377358490566,0.7046979865771812,medlm,mimiciii,progress_note,PROMPT1_ICL_entailment
21,117,14,12,2,0.8571428571428571,33,32,1,0.9696969696969696,0.9099526066350708,medlm,mimiciii,progress_note,PROMPT1_ICL_entailment
22,118,16,16,0,1.0,41,21,20,0.5121951219512195,0.6774193548387097,medlm,mimiciii,progress_note,PROMPT1_ICL_entailment
23,119,13,12,1,0.9230769230769232,21,10,11,0.4761904761904761,0.6282722513089005,medlm,mimiciii,progress_note,PROMPT1_ICL_entailment
24,12,16,15,1,0.9375,388,44,344,0.1134020618556701,0.2023298589822194,medlm,mimiciii,progress_note,PROMPT1_ICL_entailment
25,120,31,28,3,0.9032258064516128,95,36,59,0.3789473684210526,0.5338983050847458,medlm,mimiciii,progress_note,PROMPT1_ICL_entailment
26,121,17,10,7,0.5882352941176471,23,17,6,0.7391304347826086,0.6551059730250482,medlm,mimiciii,progress_note,PROMPT1_ICL_entailment
27,122,19,13,6,0.6842105263157895,71,35,36,0.4929577464788732,0.5730478589420654,medlm,mimiciii,progress_note,PROMPT1_ICL_entailment
28,123,33,20,13,0.6060606060606061,72,29,43,0.4027777777777778,0.4839382561535252,medlm,mimiciii,progress_note,PROMPT1_ICL_entailment
29,124,28,23,5,0.8214285714285714,96,41,55,0.4270833333333333,0.5619785458879618,medlm,mimiciii,progress_note,PROMPT1_ICL_entailment
30,125,28,26,2,0.9285714285714286,72,36,36,0.5,0.65,medlm,mimiciii,progress_note,PROMPT1_ICL_entailment
31,126,14,12,2,0.8571428571428571,41,13,28,0.3170731707317073,0.4629080118694362,medlm,mimiciii,progress_note,PROMPT1_ICL_entailment
32,127,21,19,2,0.9047619047619048,41,26,15,0.6341463414634146,0.7456603773584907,medlm,mimiciii,progress_note,PROMPT1_ICL_entailment
33,128,23,19,4,0.8260869565217391,56,29,27,0.5178571428571429,0.6366262276140959,medlm,mimiciii,progress_note,PROMPT1_ICL_entailment
34,129,23,16,7,0.6956521739130435,100,43,57,0.43,0.5314793356508305,medlm,mimiciii,progress_note,PROMPT1_ICL_entailment
35,13,37,28,9,0.7567567567567568,106,55,51,0.5188679245283019,0.6156306216270239,medlm,mimiciii,progress_note,PROMPT1_ICL_entailment
36,130,23,10,13,0.4347826086956521,64,34,30,0.53125,0.4781997187060478,medlm,mimiciii,progress_note,PROMPT1_ICL_entailment
37,131,40,36,4,0.9,343,78,265,0.227405247813411,0.3630721489526764,medlm,mimiciii,progress_note,PROMPT1_ICL_entailment
38,132,37,28,9,0.7567567567567568,333,90,243,0.2702702702702703,0.3982930298719772,medlm,mimiciii,progress_note,PROMPT1_ICL_entailment
39,133,31,27,4,0.8709677419354839,271,44,227,0.1623616236162361,0.2737011864992512,medlm,mimiciii,progress_note,PROMPT1_ICL_entailment
40,134,10,8,2,0.8,24,9,15,0.375,0.5106382978723405,medlm,mimiciii,progress_note,PROMPT1_ICL_entailment
41,135,28,24,4,0.8571428571428571,50,28,22,0.56,0.6774193548387096,medlm,mimiciii,progress_note,PROMPT1_ICL_entailment
42,136,9,8,1,0.8888888888888888,58,24,34,0.4137931034482758,0.5647058823529412,medlm,mimiciii,progress_note,PROMPT1_ICL_entailment
43,137,10,9,1,0.9,36,17,19,0.4722222222222222,0.6194331983805668,medlm,mimiciii,progress_note,PROMPT1_ICL_entailment
44,138,25,25,0,1.0,66,27,39,0.4090909090909091,0.5806451612903226,medlm,mimiciii,progress_note,PROMPT1_ICL_entailment
45,139,20,18,2,0.9,70,27,43,0.3857142857142857,0.5399999999999999,medlm,mimiciii,progress_note,PROMPT1_ICL_entailment
46,14,27,13,14,0.4814814814814814,63,23,40,0.365079365079365,0.4152777777777777,medlm,mimiciii,progress_note,PROMPT1_ICL_entailment
47,140,19,12,7,0.631578947368421,39,17,22,0.4358974358974359,0.515802781289507,medlm,mimiciii,progress_note,PROMPT1_ICL_entailment
48,141,35,32,3,0.9142857142857144,70,34,36,0.4857142857142857,0.6344023323615161,medlm,mimiciii,progress_note,PROMPT1_ICL_entailment
49,142,42,34,8,0.8095238095238095,72,35,37,0.4861111111111111,0.6074527820316488,medlm,mimiciii,progress_note,PROMPT1_ICL_entailment
50,143,6,5,1,0.8333333333333334,16,15,1,0.9375,0.8823529411764706,medlm,mimiciii,progress_note,PROMPT1_ICL_entailment
51,144,38,36,2,0.9473684210526316,72,35,37,0.4861111111111111,0.6425293217746049,medlm,mimiciii,progress_note,PROMPT1_ICL_entailment
52,145,20,16,4,0.8,63,33,30,0.5238095238095238,0.6330935251798562,medlm,mimiciii,progress_note,PROMPT1_ICL_entailment
53,146,27,18,9,0.6666666666666666,50,23,27,0.46,0.544378698224852,medlm,mimiciii,progress_note,PROMPT1_ICL_entailment
54,147,29,27,2,0.9310344827586208,80,42,38,0.525,0.6714031971580817,medlm,mimiciii,progress_note,PROMPT1_ICL_entailment
55,148,6,6,0,1.0,6,3,3,0.5,0.6666666666666666,medlm,mimiciii,progress_note,PROMPT1_ICL_entailment
56,149,14,10,4,0.7142857142857143,46,21,25,0.4565217391304347,0.557029177718833,medlm,mimiciii,progress_note,PROMPT1_ICL_entailment
57,15,47,34,13,0.723404255319149,275,67,208,0.2436363636363636,0.3645091607328586,medlm,mimiciii,progress_note,PROMPT1_ICL_entailment
58,150,53,40,13,0.7547169811320755,121,108,13,0.8925619834710744,0.8178720181749339,medlm,mimiciii,progress_note,PROMPT1_ICL_entailment
59,151,10,8,2,0.8,340,35,305,0.1029411764705882,0.1824104234527687,medlm,mimiciii,progress_note,PROMPT1_ICL_entailment
60,152,8,0,8,0.0,65,5,60,0.0769230769230769,0.0,medlm,mimiciii,progress_note,PROMPT1_ICL_entailment
61,153,39,34,5,0.8717948717948718,368,87,281,0.2364130434782608,0.3719585036152154,medlm,mimiciii,progress_note,PROMPT1_ICL_entailment
62,154,9,9,0,1.0,23,23,0,1.0,1.0,medlm,mimiciii,progress_note,PROMPT1_ICL_entailment
63,155,21,13,8,0.6190476190476191,49,25,24,0.5102040816326531,0.5593803786574871,medlm,mimiciii,progress_note,PROMPT1_ICL_entailment
64,156,20,15,5,0.75,49,26,23,0.5306122448979592,0.6215139442231075,medlm,mimiciii,progress_note,PROMPT1_ICL_entailment
65,157,17,15,2,0.8823529411764706,41,18,23,0.4390243902439024,0.5863192182410424,medlm,mimiciii,progress_note,PROMPT1_ICL_entailment
66,158,23,17,6,0.7391304347826086,411,80,331,0.194647201946472,0.308145462784638,medlm,mimiciii,progress_note,PROMPT1_ICL_entailment
67,159,5,5,0,1.0,35,25,10,0.7142857142857143,0.8333333333333333,medlm,mimiciii,progress_note,PROMPT1_ICL_entailment
68,16,17,15,2,0.8823529411764706,41,18,23,0.4390243902439024,0.5863192182410424,medlm,mimiciii,progress_note,PROMPT1_ICL_entailment
69,160,25,24,1,0.96,96,44,52,0.4583333333333333,0.6204465334900118,medlm,mimiciii,progress_note,PROMPT1_ICL_entailment
70,161,58,45,13,0.7758620689655172,343,76,267,0.2215743440233236,0.3447059416418888,medlm,mimiciii,progress_note,PROMPT1_ICL_entailment
71,162,6,6,0,1.0,300,146,154,0.4866666666666667,0.6547085201793722,medlm,mimiciii,progress_note,PROMPT1_ICL_entailment
72,163,16,16,0,1.0,39,17,22,0.4358974358974359,0.6071428571428571,medlm,mimiciii,progress_note,PROMPT1_ICL_entailment
73,164,33,16,17,0.4848484848484848,82,42,40,0.5121951219512195,0.4981467753891772,medlm,mimiciii,progress_note,PROMPT1_ICL_entailment
74,165,4,4,0,1.0,32,28,4,0.875,0.9333333333333332,medlm,mimiciii,progress_note,PROMPT1_ICL_entailment
75,166,19,14,5,0.7368421052631579,59,33,26,0.559322033898305,0.6359256710254645,medlm,mimiciii,progress_note,PROMPT1_ICL_entailment
76,167,30,28,2,0.9333333333333332,85,34,51,0.4,0.5599999999999999,medlm,mimiciii,progress_note,PROMPT1_ICL_entailment
77,168,10,8,2,0.8,312,54,258,0.173076923076923,0.2845849802371541,medlm,mimiciii,progress_note,PROMPT1_ICL_entailment
78,169,13,10,3,0.7692307692307693,377,79,298,0.2095490716180371,0.3293725244944757,medlm,mimiciii,progress_note,PROMPT1_ICL_entailment
79,17,6,6,0,1.0,20,17,3,0.85,0.9189189189189187,medlm,mimiciii,progress_note,PROMPT1_ICL_entailment
80,170,29,26,3,0.896551724137931,318,114,204,0.3584905660377358,0.512182477967859,medlm,mimiciii,progress_note,PROMPT1_ICL_entailment
81,171,28,25,3,0.8928571428571429,387,87,300,0.2248062015503876,0.3591776071340104,medlm,mimiciii,progress_note,PROMPT1_ICL_entailment
82,172,20,19,1,0.95,342,86,256,0.2514619883040935,0.3976636651253346,medlm,mimiciii,progress_note,PROMPT1_ICL_entailment
83,173,10,3,7,0.3,299,42,257,0.1404682274247491,0.1913439635535307,medlm,mimiciii,progress_note,PROMPT1_ICL_entailment
84,174,43,7,36,0.1627906976744186,351,60,291,0.1709401709401709,0.1667659321024419,medlm,mimiciii,progress_note,PROMPT1_ICL_entailment
85,175,36,28,8,0.7777777777777778,354,79,275,0.2231638418079096,0.3468171840702415,medlm,mimiciii,progress_note,PROMPT1_ICL_entailment
86,176,17,11,6,0.6470588235294118,330,58,272,0.1757575757575757,0.2764298093587521,medlm,mimiciii,progress_note,PROMPT1_ICL_entailment
87,177,31,16,15,0.5161290322580645,330,71,259,0.2151515151515151,0.3037027135409704,medlm,mimiciii,progress_note,PROMPT1_ICL_entailment
88,178,16,16,0,1.0,23,15,8,0.6521739130434783,0.7894736842105263,medlm,mimiciii,progress_note,PROMPT1_ICL_entailment
89,179,16,14,2,0.875,341,48,293,0.1407624633431085,0.2425117286178275,medlm,mimiciii,progress_note,PROMPT1_ICL_entailment
90,18,15,11,4,0.7333333333333333,29,18,11,0.6206896551724138,0.6723259762308998,medlm,mimiciii,progress_note,PROMPT1_ICL_entailment
91,180,20,17,3,0.85,343,73,270,0.2128279883381924,0.3404196955150185,medlm,mimiciii,progress_note,PROMPT1_ICL_entailment
92,181,22,20,2,0.9090909090909092,366,86,280,0.2349726775956284,0.3734259661311333,medlm,mimiciii,progress_note,PROMPT1_ICL_entailment
93,182,59,44,15,0.7457627118644068,367,87,280,0.2370572207084468,0.3597575301912504,medlm,mimiciii,progress_note,PROMPT1_ICL_entailment
94,183,36,28,8,0.7777777777777778,389,88,301,0.2262210796915167,0.35049786628734,medlm,mimiciii,progress_note,PROMPT1_ICL_entailment
95,184,14,14,0,1.0,330,39,291,0.1181818181818181,0.2113821138211382,medlm,mimiciii,progress_note,PROMPT1_ICL_entailment
96,185,28,25,3,0.8928571428571429,69,32,37,0.463768115942029,0.6104540251812286,medlm,mimiciii,progress_note,PROMPT1_ICL_entailment
97,186,14,13,1,0.9285714285714286,352,45,307,0.1278409090909091,0.2247406838263541,medlm,mimiciii,progress_note,PROMPT1_ICL_entailment
98,187,10,8,2,0.8,295,25,270,0.0847457627118644,0.1532567049808429,medlm,mimiciii,progress_note,PROMPT1_ICL_entailment
99,188,81,59,22,0.7283950617283951,357,116,241,0.3249299719887955,0.4493909846022522,medlm,mimiciii,progress_note,PROMPT1_ICL_entailment
100,189,30,24,6,0.8,394,76,318,0.1928934010152284,0.310838445807771,medlm,mimiciii,progress_note,PROMPT1_ICL_entailment
101,19,15,14,1,0.9333333333333332,54,27,27,0.5,0.6511627906976745,medlm,mimiciii,progress_note,PROMPT1_ICL_entailment
102,190,23,18,5,0.782608695652174,390,81,309,0.2076923076923077,0.3282674772036474,medlm,mimiciii,progress_note,PROMPT1_ICL_entailment
103,191,22,21,1,0.9545454545454546,359,97,262,0.2701949860724233,0.421172335366484,medlm,mimiciii,progress_note,PROMPT1_ICL_entailment
104,192,27,26,1,0.9629629629629628,360,95,265,0.2638888888888889,0.4142557651991614,medlm,mimiciii,progress_note,PROMPT1_ICL_entailment
105,193,545,16,529,0.0293577981651376,415,262,153,0.6313253012048192,0.0561065381784113,medlm,mimiciii,progress_note,PROMPT1_ICL_entailment
106,194,13,11,2,0.8461538461538461,365,47,318,0.1287671232876712,0.2235192390834414,medlm,mimiciii,progress_note,PROMPT1_ICL_entailment
107,195,9,8,1,0.8888888888888888,60,24,36,0.4,0.5517241379310346,medlm,mimiciii,progress_note,PROMPT1_ICL_entailment
108,196,31,23,8,0.7419354838709677,61,26,35,0.4262295081967213,0.5414214576731552,medlm,mimiciii,progress_note,PROMPT1_ICL_entailment
109,197,83,69,14,0.8313253012048193,133,55,78,0.4135338345864661,0.5523213506039878,medlm,mimiciii,progress_note,PROMPT1_ICL_entailment
110,198,17,15,2,0.8823529411764706,34,24,10,0.7058823529411765,0.784313725490196,medlm,mimiciii,progress_note,PROMPT1_ICL_entailment
111,199,14,11,3,0.7857142857142857,52,34,18,0.6538461538461539,0.7137404580152671,medlm,mimiciii,progress_note,PROMPT1_ICL_entailment
112,2,60,39,21,0.65,242,59,183,0.2438016528925619,0.3546000924641701,medlm,mimiciii,progress_note,PROMPT1_ICL_entailment
113,20,12,10,2,0.8333333333333334,47,20,27,0.425531914893617,0.5633802816901409,medlm,mimiciii,progress_note,PROMPT1_ICL_entailment
114,200,33,21,12,0.6363636363636364,164,59,105,0.3597560975609756,0.459654980523094,medlm,mimiciii,progress_note,PROMPT1_ICL_entailment
115,201,9,9,0,1.0,200,39,161,0.195,0.3263598326359833,medlm,mimiciii,progress_note,PROMPT1_ICL_entailment
116,202,18,15,3,0.8333333333333334,176,60,116,0.3409090909090909,0.4838709677419354,medlm,mimiciii,progress_note,PROMPT1_ICL_entailment
117,203,19,17,2,0.8947368421052632,211,72,139,0.3412322274881517,0.4940464177598385,medlm,mimiciii,progress_note,PROMPT1_ICL_entailment
118,204,120,43,77,0.3583333333333333,201,99,102,0.4925373134328358,0.4148516298786727,medlm,mimiciii,progress_note,PROMPT1_ICL_entailment
119,205,105,92,13,0.8761904761904762,195,100,95,0.5128205128205128,0.6469760900140646,medlm,mimiciii,progress_note,PROMPT1_ICL_entailment
120,206,15,14,1,0.9333333333333332,239,70,169,0.2928870292887029,0.445859872611465,medlm,mimiciii,progress_note,PROMPT1_ICL_entailment
121,207,14,14,0,1.0,233,67,166,0.2875536480686695,0.4466666666666666,medlm,mimiciii,progress_note,PROMPT1_ICL_entailment
122,208,17,13,4,0.7647058823529411,229,81,148,0.3537117903930131,0.4836931557188791,medlm,mimiciii,progress_note,PROMPT1_ICL_entailment
123,209,14,12,2,0.8571428571428571,205,70,135,0.3414634146341463,0.4883720930232558,medlm,mimiciii,progress_note,PROMPT1_ICL_entailment
124,21,17,17,0,1.0,373,95,278,0.2546916890080429,0.405982905982906,medlm,mimiciii,progress_note,PROMPT1_ICL_entailment
125,210,13,10,3,0.7692307692307693,28,22,6,0.7857142857142857,0.7773851590106008,medlm,mimiciii,progress_note,PROMPT1_ICL_entailment
126,211,30,29,1,0.9666666666666668,54,42,12,0.7777777777777778,0.861995753715499,medlm,mimiciii,progress_note,PROMPT1_ICL_entailment
127,212,15,10,5,0.6666666666666666,14,11,3,0.7857142857142857,0.721311475409836,medlm,mimiciii,progress_note,PROMPT1_ICL_entailment
128,213,18,18,0,1.0,41,33,8,0.8048780487804879,0.8918918918918919,medlm,mimiciii,progress_note,PROMPT1_ICL_entailment
129,214,9,7,2,0.7777777777777778,27,22,5,0.8148148148148148,0.7958656330749354,medlm,mimiciii,progress_note,PROMPT1_ICL_entailment
130,215,43,23,20,0.5348837209302325,66,50,16,0.7575757575757576,0.6270447110141767,medlm,mimiciii,progress_note,PROMPT1_ICL_entailment
131,216,22,14,8,0.6363636363636364,67,46,21,0.6865671641791045,0.6605128205128205,medlm,mimiciii,progress_note,PROMPT1_ICL_entailment
132,217,23,16,7,0.6956521739130435,73,41,32,0.5616438356164384,0.621506395073425,medlm,mimiciii,progress_note,PROMPT1_ICL_entailment
133,218,13,12,1,0.9230769230769232,27,17,10,0.6296296296296297,0.7486238532110092,medlm,mimiciii,progress_note,PROMPT1_ICL_entailment
134,219,7,6,1,0.8571428571428571,17,13,4,0.7647058823529411,0.8082901554404144,medlm,mimiciii,progress_note,PROMPT1_ICL_entailment
135,22,11,7,4,0.6363636363636364,56,24,32,0.4285714285714285,0.5121951219512195,medlm,mimiciii,progress_note,PROMPT1_ICL_entailment
136,220,22,18,4,0.8181818181818182,34,29,5,0.8529411764705882,0.8352,medlm,mimiciii,progress_note,PROMPT1_ICL_entailment
137,221,16,14,2,0.875,188,59,129,0.3138297872340425,0.4619686800894854,medlm,mimiciii,progress_note,PROMPT1_ICL_entailment
138,222,15,15,0,1.0,263,85,178,0.3231939163498099,0.4885057471264367,medlm,mimiciii,progress_note,PROMPT1_ICL_entailment
139,223,12,11,1,0.9166666666666666,30,19,11,0.6333333333333333,0.7491039426523297,medlm,mimiciii,progress_note,PROMPT1_ICL_entailment
140,224,15,13,2,0.8666666666666667,33,25,8,0.7575757575757576,0.8084577114427861,medlm,mimiciii,progress_note,PROMPT1_ICL_entailment
141,225,10,9,1,0.9,37,24,13,0.6486486486486487,0.7539267015706806,medlm,mimiciii,progress_note,PROMPT1_ICL_entailment
142,226,17,16,1,0.9411764705882352,33,17,16,0.5151515151515151,0.6658506731946144,medlm,mimiciii,progress_note,PROMPT1_ICL_entailment
143,227,3,2,1,0.6666666666666666,15,3,12,0.2,0.3076923076923076,medlm,mimiciii,progress_note,PROMPT1_ICL_entailment
144,228,3,2,1,0.6666666666666666,15,3,12,0.2,0.3076923076923076,medlm,mimiciii,progress_note,PROMPT1_ICL_entailment
145,229,3,2,1,0.6666666666666666,15,3,12,0.2,0.3076923076923076,medlm,mimiciii,progress_note,PROMPT1_ICL_entailment
146,23,25,19,6,0.76,56,21,35,0.375,0.5022026431718062,medlm,mimiciii,progress_note,PROMPT1_ICL_entailment
147,230,15,11,4,0.7333333333333333,26,12,14,0.4615384615384615,0.5665236051502146,medlm,mimiciii,progress_note,PROMPT1_ICL_entailment
148,231,47,42,5,0.8936170212765957,102,77,25,0.7549019607843137,0.8184233835252436,medlm,mimiciii,progress_note,PROMPT1_ICL_entailment
149,232,39,28,11,0.717948717948718,72,45,27,0.625,0.6682577565632458,medlm,mimiciii,progress_note,PROMPT1_ICL_entailment
150,233,35,22,13,0.6285714285714286,82,53,29,0.6463414634146342,0.6373326045367587,medlm,mimiciii,progress_note,PROMPT1_ICL_entailment
151,234,22,16,6,0.7272727272727273,25,21,4,0.84,0.7795823665893271,medlm,mimiciii,progress_note,PROMPT1_ICL_entailment
152,24,15,8,7,0.5333333333333333,33,10,23,0.303030303030303,0.3864734299516908,medlm,mimiciii,progress_note,PROMPT1_ICL_entailment
153,25,14,11,3,0.7857142857142857,35,16,19,0.4571428571428571,0.5779967159277504,medlm,mimiciii,progress_note,PROMPT1_ICL_entailment
154,26,20,12,8,0.6,35,16,19,0.4571428571428571,0.5189189189189188,medlm,mimiciii,progress_note,PROMPT1_ICL_entailment
155,27,20,6,14,0.3,32,14,18,0.4375,0.3559322033898305,medlm,mimiciii,progress_note,PROMPT1_ICL_entailment
156,28,29,26,3,0.896551724137931,85,32,53,0.3764705882352941,0.5302740599107711,medlm,mimiciii,progress_note,PROMPT1_ICL_entailment
157,29,27,26,1,0.9629629629629628,76,37,39,0.4868421052631579,0.6467226890756302,medlm,mimiciii,progress_note,PROMPT1_ICL_entailment
158,3,17,10,7,0.5882352941176471,273,55,218,0.2014652014652014,0.3001364256480218,medlm,mimiciii,progress_note,PROMPT1_ICL_entailment
159,30,19,19,0,1.0,29,11,18,0.3793103448275862,0.5499999999999999,medlm,mimiciii,progress_note,PROMPT1_ICL_entailment
160,31,16,13,3,0.8125,26,13,13,0.5,0.6190476190476191,medlm,mimiciii,progress_note,PROMPT1_ICL_entailment
161,32,20,18,2,0.9,152,52,100,0.3421052631578947,0.4957627118644068,medlm,mimiciii,progress_note,PROMPT1_ICL_entailment
162,33,30,23,7,0.7666666666666667,106,41,65,0.3867924528301887,0.5141766630316249,medlm,mimiciii,progress_note,PROMPT1_ICL_entailment
163,34,41,28,13,0.6829268292682927,98,54,44,0.5510204081632653,0.6099233561920129,medlm,mimiciii,progress_note,PROMPT1_ICL_entailment
164,35,4,4,0,1.0,26,20,6,0.7692307692307693,0.8695652173913044,medlm,mimiciii,progress_note,PROMPT1_ICL_entailment
165,36,15,11,4,0.7333333333333333,60,18,42,0.3,0.4258064516129032,medlm,mimiciii,progress_note,PROMPT1_ICL_entailment
166,37,38,29,9,0.7631578947368421,344,73,271,0.2122093023255813,0.332078431372549,medlm,mimiciii,progress_note,PROMPT1_ICL_entailment
167,38,17,13,4,0.7647058823529411,278,51,227,0.1834532374100719,0.2959160901584468,medlm,mimiciii,progress_note,PROMPT1_ICL_entailment
168,39,30,27,3,0.9,117,58,59,0.4957264957264957,0.6393141457440294,medlm,mimiciii,progress_note,PROMPT1_ICL_entailment
169,4,36,24,12,0.6666666666666666,282,53,229,0.1879432624113475,0.293222683264177,medlm,mimiciii,progress_note,PROMPT1_ICL_entailment
170,40,26,26,0,1.0,117,56,61,0.4786324786324786,0.6473988439306358,medlm,mimiciii,progress_note,PROMPT1_ICL_entailment
171,41,8,6,2,0.75,119,67,52,0.5630252100840336,0.6432,medlm,mimiciii,progress_note,PROMPT1_ICL_entailment
172,42,8,7,1,0.875,119,37,82,0.3109243697478991,0.4588131089459699,medlm,mimiciii,progress_note,PROMPT1_ICL_entailment
173,43,39,28,11,0.717948717948718,117,51,66,0.4358974358974359,0.5424501424501426,medlm,mimiciii,progress_note,PROMPT1_ICL_entailment
174,44,34,30,4,0.8823529411764706,149,61,88,0.4093959731543624,0.5592909535452323,medlm,mimiciii,progress_note,PROMPT1_ICL_entailment
175,45,30,25,5,0.8333333333333334,125,52,73,0.416,0.5549626467449306,medlm,mimiciii,progress_note,PROMPT1_ICL_entailment
176,46,14,14,0,1.0,52,26,26,0.5,0.6666666666666666,medlm,mimiciii,progress_note,PROMPT1_ICL_entailment
177,47,10,8,2,0.8,12,8,4,0.6666666666666666,0.7272727272727272,medlm,mimiciii,progress_note,PROMPT1_ICL_entailment
178,48,16,16,0,1.0,49,25,24,0.5102040816326531,0.6756756756756758,medlm,mimiciii,progress_note,PROMPT1_ICL_entailment
179,49,28,22,6,0.7857142857142857,87,32,55,0.367816091954023,0.501067615658363,medlm,mimiciii,progress_note,PROMPT1_ICL_entailment
180,5,24,9,15,0.375,300,37,263,0.1233333333333333,0.1856187290969899,medlm,mimiciii,progress_note,PROMPT1_ICL_entailment
181,50,51,45,6,0.8823529411764706,176,128,48,0.7272727272727273,0.7973421926910299,medlm,mimiciii,progress_note,PROMPT1_ICL_entailment
182,51,19,8,11,0.4210526315789473,302,57,245,0.1887417218543046,0.2606458988282366,medlm,mimiciii,progress_note,PROMPT1_ICL_entailment
183,52,18,10,8,0.5555555555555556,302,55,247,0.1821192052980132,0.2743142144638404,medlm,mimiciii,progress_note,PROMPT1_ICL_entailment
184,53,19,17,2,0.8947368421052632,382,82,300,0.2146596858638743,0.3462493790362642,medlm,mimiciii,progress_note,PROMPT1_ICL_entailment
185,54,15,6,9,0.4,219,41,178,0.1872146118721461,0.255054432348367,medlm,mimiciii,progress_note,PROMPT1_ICL_entailment
186,55,60,45,15,0.75,286,66,220,0.2307692307692307,0.3529411764705882,medlm,mimiciii,progress_note,PROMPT1_ICL_entailment
187,56,7,7,0,1.0,48,24,24,0.5,0.6666666666666666,medlm,mimiciii,progress_note,PROMPT1_ICL_entailment
188,57,11,9,2,0.8181818181818182,46,22,24,0.4782608695652174,0.6036585365853658,medlm,mimiciii,progress_note,PROMPT1_ICL_entailment
189,58,19,13,6,0.6842105263157895,39,17,22,0.4358974358974359,0.5325301204819277,medlm,mimiciii,progress_note,PROMPT1_ICL_entailment
190,59,19,11,8,0.5789473684210527,39,20,19,0.5128205128205128,0.5438813349814585,medlm,mimiciii,progress_note,PROMPT1_ICL_entailment
191,6,13,9,4,0.6923076923076923,331,26,305,0.0785498489425981,0.1410913476032559,medlm,mimiciii,progress_note,PROMPT1_ICL_entailment
192,60,20,11,9,0.55,276,34,242,0.1231884057971014,0.201291711517761,medlm,mimiciii,progress_note,PROMPT1_ICL_entailment
193,61,25,19,6,0.76,56,22,34,0.3928571428571428,0.5179677819083023,medlm,mimiciii,progress_note,PROMPT1_ICL_entailment
194,62,18,9,9,0.5,56,24,32,0.4285714285714285,0.4615384615384615,medlm,mimiciii,progress_note,PROMPT1_ICL_entailment
195,63,32,18,14,0.5625,142,125,17,0.8802816901408451,0.6863941427699818,medlm,mimiciii,progress_note,PROMPT1_ICL_entailment
196,64,2,1,1,0.5,1,1,0,1.0,0.6666666666666666,medlm,mimiciii,progress_note,PROMPT1_ICL_entailment
197,65,8,8,0,1.0,12,12,0,1.0,1.0,medlm,mimiciii,progress_note,PROMPT1_ICL_entailment
198,66,28,25,3,0.8928571428571429,68,39,29,0.5735294117647058,0.6984240687679082,medlm,mimiciii,progress_note,PROMPT1_ICL_entailment
199,67,32,14,18,0.4375,490,97,393,0.1979591836734693,0.2725812926535528,medlm,mimiciii,progress_note,PROMPT1_ICL_entailment
200,68,17,15,2,0.8823529411764706,348,77,271,0.2212643678160919,0.3538060958799203,medlm,mimiciii,progress_note,PROMPT1_ICL_entailment
201,69,26,21,5,0.8076923076923077,373,90,283,0.2412868632707774,0.3715718077263344,medlm,mimiciii,progress_note,PROMPT1_ICL_entailment
202,7,40,17,23,0.425,331,217,114,0.6555891238670695,0.5156916194869644,medlm,mimiciii,progress_note,PROMPT1_ICL_entailment
203,70,32,28,4,0.875,374,103,271,0.2754010695187165,0.4189424753050552,medlm,mimiciii,progress_note,PROMPT1_ICL_entailment
204,71,8,7,1,0.875,372,32,340,0.086021505376344,0.1566433566433566,medlm,mimiciii,progress_note,PROMPT1_ICL_entailment
205,72,5,4,1,0.8,20,13,7,0.65,0.7172413793103448,medlm,mimiciii,progress_note,PROMPT1_ICL_entailment
206,73,36,27,9,0.75,460,105,355,0.2282608695652173,0.35,medlm,mimiciii,progress_note,PROMPT1_ICL_entailment
207,74,20,16,4,0.8,319,71,248,0.2225705329153605,0.3482526057633354,medlm,mimiciii,progress_note,PROMPT1_ICL_entailment
208,75,45,41,4,0.9111111111111112,62,29,33,0.4677419354838709,0.61814400831817,medlm,mimiciii,progress_note,PROMPT1_ICL_entailment
209,76,32,29,3,0.90625,86,45,41,0.5232558139534884,0.6634468734112863,medlm,mimiciii,progress_note,PROMPT1_ICL_entailment
210,77,4,3,1,0.75,38,32,6,0.8421052631578947,0.7933884297520661,medlm,mimiciii,progress_note,PROMPT1_ICL_entailment
211,78,21,19,2,0.9047619047619048,30,13,17,0.4333333333333333,0.5860023724792407,medlm,mimiciii,progress_note,PROMPT1_ICL_entailment
212,79,19,16,3,0.8421052631578947,67,28,39,0.417910447761194,0.5586034912718204,medlm,mimiciii,progress_note,PROMPT1_ICL_entailment
213,8,48,39,9,0.8125,118,106,12,0.8983050847457628,0.853250773993808,medlm,mimiciii,progress_note,PROMPT1_ICL_entailment
214,80,19,16,3,0.8421052631578947,32,19,13,0.59375,0.6964490263459335,medlm,mimiciii,progress_note,PROMPT1_ICL_entailment
215,81,17,14,3,0.8235294117647058,46,24,22,0.5217391304347826,0.6387832699619772,medlm,mimiciii,progress_note,PROMPT1_ICL_entailment
216,82,3,2,1,0.6666666666666666,18,3,15,0.1666666666666666,0.2666666666666666,medlm,mimiciii,progress_note,PROMPT1_ICL_entailment
217,83,21,15,6,0.7142857142857143,66,32,34,0.4848484848484848,0.5776173285198556,medlm,mimiciii,progress_note,PROMPT1_ICL_entailment
218,84,21,17,4,0.8095238095238095,48,28,20,0.5833333333333334,0.6780626780626782,medlm,mimiciii,progress_note,PROMPT1_ICL_entailment
219,85,21,16,5,0.7619047619047619,77,34,43,0.4415584415584415,0.5590955806783146,medlm,mimiciii,progress_note,PROMPT1_ICL_entailment
220,86,13,12,1,0.9230769230769232,52,25,27,0.4807692307692308,0.6322444678609063,medlm,mimiciii,progress_note,PROMPT1_ICL_entailment
221,87,3,2,1,0.6666666666666666,15,4,11,0.2666666666666666,0.3809523809523809,medlm,mimiciii,progress_note,PROMPT1_ICL_entailment
222,88,28,23,5,0.8214285714285714,105,51,54,0.4857142857142857,0.6104605776736923,medlm,mimiciii,progress_note,PROMPT1_ICL_entailment
223,89,38,16,22,0.4210526315789473,339,82,257,0.2418879056047197,0.3072599531615925,medlm,mimiciii,progress_note,PROMPT1_ICL_entailment
224,9,32,32,0,1.0,61,32,29,0.5245901639344263,0.6881720430107526,medlm,mimiciii,progress_note,PROMPT1_ICL_entailment
225,90,5,4,1,0.8,4,4,0,1.0,0.888888888888889,medlm,mimiciii,progress_note,PROMPT1_ICL_entailment
226,91,28,25,3,0.8928571428571429,112,56,56,0.5,0.6410256410256411,medlm,mimiciii,progress_note,PROMPT1_ICL_entailment
227,92,9,8,1,0.8888888888888888,208,29,179,0.1394230769230769,0.241038961038961,medlm,mimiciii,progress_note,PROMPT1_ICL_entailment
228,93,8,7,1,0.875,38,18,20,0.4736842105263157,0.6146341463414634,medlm,mimiciii,progress_note,PROMPT1_ICL_entailment
229,94,43,33,10,0.7674418604651163,112,50,62,0.4464285714285714,0.5644885391720835,medlm,mimiciii,progress_note,PROMPT1_ICL_entailment
230,95,18,12,6,0.6666666666666666,49,24,25,0.4897959183673469,0.5647058823529412,medlm,mimiciii,progress_note,PROMPT1_ICL_entailment
231,96,2,2,0,1.0,14,3,11,0.2142857142857142,0.3529411764705882,medlm,mimiciii,progress_note,PROMPT1_ICL_entailment
232,97,4,4,0,1.0,20,18,2,0.9,0.9473684210526316,medlm,mimiciii,progress_note,PROMPT1_ICL_entailment
233,98,11,10,1,0.9090909090909092,35,26,9,0.7428571428571429,0.8176100628930817,medlm,mimiciii,progress_note,PROMPT1_ICL_entailment
234,99,13,12,1,0.9230769230769232,104,31,73,0.2980769230769231,0.4506359781950333,medlm,mimiciii,progress_note,PROMPT1_ICL_entailment
0,0,37,30,7,0.8108108108108109,118,69,49,0.5847457627118644,0.6794682422451995,medlm,mimiciii,progress_note,PROMPT2_ICL_entailment
1,1,14,9,5,0.6428571428571429,320,196,124,0.6125,0.6273115220483642,medlm,mimiciii,progress_note,PROMPT2_ICL_entailment
2,10,33,21,12,0.6363636363636364,230,38,192,0.1652173913043478,0.2623274161735699,medlm,mimiciii,progress_note,PROMPT2_ICL_entailment
3,100,30,22,8,0.7333333333333333,115,54,61,0.4695652173913043,0.5725301204819278,medlm,mimiciii,progress_note,PROMPT2_ICL_entailment
4,101,19,17,2,0.8947368421052632,49,24,25,0.4897959183673469,0.6330488750969744,medlm,mimiciii,progress_note,PROMPT2_ICL_entailment
5,102,18,12,6,0.6666666666666666,67,29,38,0.4328358208955223,0.5248868778280542,medlm,mimiciii,progress_note,PROMPT2_ICL_entailment
6,103,41,31,10,0.7560975609756098,347,81,266,0.2334293948126801,0.3567268077851968,medlm,mimiciii,progress_note,PROMPT2_ICL_entailment
7,104,17,13,4,0.7647058823529411,57,26,31,0.4561403508771929,0.5714285714285713,medlm,mimiciii,progress_note,PROMPT2_ICL_entailment
8,105,16,15,1,0.9375,28,12,16,0.4285714285714285,0.588235294117647,medlm,mimiciii,progress_note,PROMPT2_ICL_entailment
9,106,11,9,2,0.8181818181818182,58,23,35,0.396551724137931,0.5341935483870968,medlm,mimiciii,progress_note,PROMPT2_ICL_entailment
10,107,23,21,2,0.9130434782608696,53,27,26,0.5094339622641509,0.6539792387543253,medlm,mimiciii,progress_note,PROMPT2_ICL_entailment
11,108,36,30,6,0.8333333333333334,94,45,49,0.4787234042553192,0.6081081081081082,medlm,mimiciii,progress_note,PROMPT2_ICL_entailment
12,109,19,16,3,0.8421052631578947,311,44,267,0.1414790996784566,0.2422573984858912,medlm,mimiciii,progress_note,PROMPT2_ICL_entailment
13,11,19,13,6,0.6842105263157895,233,27,206,0.1158798283261802,0.1981931112365895,medlm,mimiciii,progress_note,PROMPT2_ICL_entailment
14,110,15,12,3,0.8,358,72,286,0.2011173184357542,0.3214285714285714,medlm,mimiciii,progress_note,PROMPT2_ICL_entailment
15,111,19,12,7,0.631578947368421,389,77,312,0.1979434447300771,0.3014190181047137,medlm,mimiciii,progress_note,PROMPT2_ICL_entailment
16,112,16,13,3,0.8125,400,78,322,0.195,0.314516129032258,medlm,mimiciii,progress_note,PROMPT2_ICL_entailment
17,113,12,8,4,0.6666666666666666,340,51,289,0.15,0.2448979591836734,medlm,mimiciii,progress_note,PROMPT2_ICL_entailment
18,114,19,12,7,0.631578947368421,401,78,323,0.1945137157107231,0.2974261201143946,medlm,mimiciii,progress_note,PROMPT2_ICL_entailment
19,115,20,14,6,0.7,479,70,409,0.1461377870563674,0.2417962003454231,medlm,mimiciii,progress_note,PROMPT2_ICL_entailment
20,116,14,12,2,0.8571428571428571,53,31,22,0.5849056603773585,0.6953271028037383,medlm,mimiciii,progress_note,PROMPT2_ICL_entailment
21,117,14,12,2,0.8571428571428571,33,31,2,0.9393939393939394,0.8963855421686747,medlm,mimiciii,progress_note,PROMPT2_ICL_entailment
22,118,16,16,0,1.0,41,20,21,0.4878048780487805,0.6557377049180327,medlm,mimiciii,progress_note,PROMPT2_ICL_entailment
23,119,13,11,2,0.8461538461538461,21,10,11,0.4761904761904761,0.6094182825484764,medlm,mimiciii,progress_note,PROMPT2_ICL_entailment
24,12,15,15,0,1.0,388,61,327,0.1572164948453608,0.2717149220489978,medlm,mimiciii,progress_note,PROMPT2_ICL_entailment
25,120,29,26,3,0.896551724137931,95,42,53,0.4421052631578947,0.5921908893709328,medlm,mimiciii,progress_note,PROMPT2_ICL_entailment
26,121,19,17,2,0.8947368421052632,23,10,13,0.4347826086956521,0.5851979345955249,medlm,mimiciii,progress_note,PROMPT2_ICL_entailment
27,122,24,17,7,0.7083333333333334,71,38,33,0.5352112676056338,0.6097215667767816,medlm,mimiciii,progress_note,PROMPT2_ICL_entailment
28,123,16,15,1,0.9375,72,34,38,0.4722222222222222,0.6280788177339901,medlm,mimiciii,progress_note,PROMPT2_ICL_entailment
29,124,46,44,2,0.9565217391304348,96,30,66,0.3125,0.4710920770877944,medlm,mimiciii,progress_note,PROMPT2_ICL_entailment
30,125,23,17,6,0.7391304347826086,72,36,36,0.5,0.5964912280701754,medlm,mimiciii,progress_note,PROMPT2_ICL_entailment
31,126,18,13,5,0.7222222222222222,41,12,29,0.2926829268292683,0.4165554072096128,medlm,mimiciii,progress_note,PROMPT2_ICL_entailment
32,127,14,10,4,0.7142857142857143,41,18,23,0.4390243902439024,0.5438066465256798,medlm,mimiciii,progress_note,PROMPT2_ICL_entailment
33,128,22,18,4,0.8181818181818182,56,32,24,0.5714285714285714,0.6728971962616823,medlm,mimiciii,progress_note,PROMPT2_ICL_entailment
34,129,22,16,6,0.7272727272727273,100,46,54,0.46,0.5635528330781011,medlm,mimiciii,progress_note,PROMPT2_ICL_entailment
35,13,21,14,7,0.6666666666666666,106,42,64,0.3962264150943396,0.4970414201183432,medlm,mimiciii,progress_note,PROMPT2_ICL_entailment
36,130,22,14,8,0.6363636363636364,64,34,30,0.53125,0.5790754257907543,medlm,mimiciii,progress_note,PROMPT2_ICL_entailment
37,131,50,8,42,0.16,343,105,238,0.3061224489795918,0.2101576182136602,medlm,mimiciii,progress_note,PROMPT2_ICL_entailment
38,132,52,30,22,0.5769230769230769,333,106,227,0.3183183183183183,0.4102696426267578,medlm,mimiciii,progress_note,PROMPT2_ICL_entailment
39,133,9,9,0,1.0,271,158,113,0.5830258302583026,0.7365967365967365,medlm,mimiciii,progress_note,PROMPT2_ICL_entailment
40,134,11,10,1,0.9090909090909092,24,8,16,0.3333333333333333,0.4878048780487804,medlm,mimiciii,progress_note,PROMPT2_ICL_entailment
41,135,24,18,6,0.75,50,26,24,0.52,0.6141732283464567,medlm,mimiciii,progress_note,PROMPT2_ICL_entailment
42,136,9,8,1,0.8888888888888888,58,25,33,0.4310344827586206,0.5805515239477503,medlm,mimiciii,progress_note,PROMPT2_ICL_entailment
43,137,13,9,4,0.6923076923076923,36,23,13,0.6388888888888888,0.6645264847512038,medlm,mimiciii,progress_note,PROMPT2_ICL_entailment
44,138,16,16,0,1.0,66,24,42,0.3636363636363636,0.5333333333333333,medlm,mimiciii,progress_note,PROMPT2_ICL_entailment
45,139,14,11,3,0.7857142857142857,70,17,53,0.2428571428571428,0.371031746031746,medlm,mimiciii,progress_note,PROMPT2_ICL_entailment
46,14,17,1,16,0.0588235294117647,63,13,50,0.2063492063492063,0.0915492957746478,medlm,mimiciii,progress_note,PROMPT2_ICL_entailment
47,140,19,11,8,0.5789473684210527,39,18,21,0.4615384615384615,0.5136186770428015,medlm,mimiciii,progress_note,PROMPT2_ICL_entailment
48,141,14,13,1,0.9285714285714286,70,16,54,0.2285714285714285,0.3668430335097001,medlm,mimiciii,progress_note,PROMPT2_ICL_entailment
49,142,41,35,6,0.8536585365853658,72,41,31,0.5694444444444444,0.6831706736491311,medlm,mimiciii,progress_note,PROMPT2_ICL_entailment
50,143,8,7,1,0.875,16,2,14,0.125,0.21875,medlm,mimiciii,progress_note,PROMPT2_ICL_entailment
51,144,39,35,4,0.8974358974358975,72,32,40,0.4444444444444444,0.5944798301486199,medlm,mimiciii,progress_note,PROMPT2_ICL_entailment
52,145,20,17,3,0.85,63,33,30,0.5238095238095238,0.6481802426343155,medlm,mimiciii,progress_note,PROMPT2_ICL_entailment
53,146,7,4,3,0.5714285714285714,50,22,28,0.44,0.4971751412429378,medlm,mimiciii,progress_note,PROMPT2_ICL_entailment
54,147,27,22,5,0.8148148148148148,80,40,40,0.5,0.6197183098591549,medlm,mimiciii,progress_note,PROMPT2_ICL_entailment
55,148,7,7,0,1.0,6,3,3,0.5,0.6666666666666666,medlm,mimiciii,progress_note,PROMPT2_ICL_entailment
56,149,8,8,0,1.0,46,21,25,0.4565217391304347,0.626865671641791,medlm,mimiciii,progress_note,PROMPT2_ICL_entailment
57,15,41,36,5,0.8780487804878049,275,70,205,0.2545454545454545,0.3946750195771338,medlm,mimiciii,progress_note,PROMPT2_ICL_entailment
58,150,35,26,9,0.7428571428571429,121,55,66,0.4545454545454545,0.5639913232104121,medlm,mimiciii,progress_note,PROMPT2_ICL_entailment
59,151,8,7,1,0.875,340,45,295,0.1323529411764706,0.2299270072992701,medlm,mimiciii,progress_note,PROMPT2_ICL_entailment
60,152,15,1,14,0.0666666666666666,65,14,51,0.2153846153846154,0.1018181818181818,medlm,mimiciii,progress_note,PROMPT2_ICL_entailment
61,153,34,32,2,0.9411764705882352,368,101,267,0.2744565217391304,0.4249835634451019,medlm,mimiciii,progress_note,PROMPT2_ICL_entailment
62,154,10,10,0,1.0,23,15,8,0.6521739130434783,0.7894736842105263,medlm,mimiciii,progress_note,PROMPT2_ICL_entailment
63,155,21,15,6,0.7142857142857143,49,24,25,0.4897959183673469,0.5811138014527845,medlm,mimiciii,progress_note,PROMPT2_ICL_entailment
64,156,21,16,5,0.7619047619047619,49,26,23,0.5306122448979592,0.625563909774436,medlm,mimiciii,progress_note,PROMPT2_ICL_entailment
65,157,16,15,1,0.9375,41,22,19,0.5365853658536586,0.6825232678386763,medlm,mimiciii,progress_note,PROMPT2_ICL_entailment
66,158,39,35,4,0.8974358974358975,411,128,283,0.3114355231143552,0.4624038808897147,medlm,mimiciii,progress_note,PROMPT2_ICL_entailment
67,159,16,15,1,0.9375,35,12,23,0.3428571428571428,0.502092050209205,medlm,mimiciii,progress_note,PROMPT2_ICL_entailment
68,16,10,8,2,0.8,41,16,25,0.3902439024390244,0.5245901639344263,medlm,mimiciii,progress_note,PROMPT2_ICL_entailment
69,160,24,20,4,0.8333333333333334,96,47,49,0.4895833333333333,0.6167979002624672,medlm,mimiciii,progress_note,PROMPT2_ICL_entailment
70,161,9,8,1,0.8888888888888888,343,32,311,0.0932944606413994,0.1688654353562005,medlm,mimiciii,progress_note,PROMPT2_ICL_entailment
71,162,17,7,10,0.4117647058823529,300,180,120,0.6,0.4883720930232558,medlm,mimiciii,progress_note,PROMPT2_ICL_entailment
72,163,9,9,0,1.0,39,17,22,0.4358974358974359,0.6071428571428571,medlm,mimiciii,progress_note,PROMPT2_ICL_entailment
73,164,17,12,5,0.7058823529411765,82,48,34,0.5853658536585366,0.64,medlm,mimiciii,progress_note,PROMPT2_ICL_entailment
74,165,4,4,0,1.0,32,30,2,0.9375,0.967741935483871,medlm,mimiciii,progress_note,PROMPT2_ICL_entailment
75,166,17,12,5,0.7058823529411765,59,31,28,0.5254237288135594,0.6024291497975709,medlm,mimiciii,progress_note,PROMPT2_ICL_entailment
76,167,27,26,1,0.9629629629629628,85,39,46,0.4588235294117647,0.6215139442231075,medlm,mimiciii,progress_note,PROMPT2_ICL_entailment
77,168,17,12,5,0.7058823529411765,312,64,248,0.2051282051282051,0.3178807947019867,medlm,mimiciii,progress_note,PROMPT2_ICL_entailment
78,169,28,26,2,0.9285714285714286,377,82,295,0.2175066312997347,0.3524549512316085,medlm,mimiciii,progress_note,PROMPT2_ICL_entailment
79,17,5,5,0,1.0,20,14,6,0.7,0.8235294117647058,medlm,mimiciii,progress_note,PROMPT2_ICL_entailment
80,170,9,4,5,0.4444444444444444,318,160,158,0.5031446540880503,0.4719764011799409,medlm,mimiciii,progress_note,PROMPT2_ICL_entailment
81,171,24,21,3,0.875,387,65,322,0.1679586563307493,0.2818209972127594,medlm,mimiciii,progress_note,PROMPT2_ICL_entailment
82,172,15,13,2,0.8666666666666667,342,52,290,0.1520467836257309,0.2587064676616915,medlm,mimiciii,progress_note,PROMPT2_ICL_entailment
83,173,12,8,4,0.6666666666666666,299,67,232,0.2240802675585284,0.3354192740926158,medlm,mimiciii,progress_note,PROMPT2_ICL_entailment
84,174,25,19,6,0.76,351,56,295,0.1595441595441595,0.2637253686950055,medlm,mimiciii,progress_note,PROMPT2_ICL_entailment
85,175,17,14,3,0.8235294117647058,354,63,291,0.1779661016949152,0.2926829268292683,medlm,mimiciii,progress_note,PROMPT2_ICL_entailment
86,176,26,14,12,0.5384615384615384,330,66,264,0.2,0.2916666666666667,medlm,mimiciii,progress_note,PROMPT2_ICL_entailment
87,177,20,18,2,0.9,330,59,271,0.1787878787878788,0.298314606741573,medlm,mimiciii,progress_note,PROMPT2_ICL_entailment
88,178,14,14,0,1.0,23,14,9,0.6086956521739131,0.7567567567567568,medlm,mimiciii,progress_note,PROMPT2_ICL_entailment
89,179,33,19,14,0.5757575757575758,341,68,273,0.1994134897360703,0.2962283618021323,medlm,mimiciii,progress_note,PROMPT2_ICL_entailment
90,18,12,5,7,0.4166666666666667,29,26,3,0.896551724137931,0.5689277899343546,medlm,mimiciii,progress_note,PROMPT2_ICL_entailment
91,180,382,17,365,0.0445026178010471,343,24,319,0.0699708454810495,0.0544036269084605,medlm,mimiciii,progress_note,PROMPT2_ICL_entailment
92,181,19,17,2,0.8947368421052632,366,105,261,0.2868852459016393,0.4344651332603139,medlm,mimiciii,progress_note,PROMPT2_ICL_entailment
93,182,17,13,4,0.7647058823529411,367,57,310,0.1553133514986376,0.2581881533101045,medlm,mimiciii,progress_note,PROMPT2_ICL_entailment
94,183,13,8,5,0.6153846153846154,389,54,335,0.1388174807197943,0.226533822758259,medlm,mimiciii,progress_note,PROMPT2_ICL_entailment
95,184,10,8,2,0.8,330,34,296,0.103030303030303,0.1825503355704698,medlm,mimiciii,progress_note,PROMPT2_ICL_entailment
96,185,28,25,3,0.8928571428571429,69,27,42,0.391304347826087,0.5441354292623942,medlm,mimiciii,progress_note,PROMPT2_ICL_entailment
97,186,18,17,1,0.9444444444444444,352,51,301,0.1448863636363636,0.2512315270935961,medlm,mimiciii,progress_note,PROMPT2_ICL_entailment
98,187,13,9,4,0.6923076923076923,295,40,255,0.135593220338983,0.2267716535433071,medlm,mimiciii,progress_note,PROMPT2_ICL_entailment
99,188,24,17,7,0.7083333333333334,357,63,294,0.1764705882352941,0.2825484764542936,medlm,mimiciii,progress_note,PROMPT2_ICL_entailment
100,189,38,31,7,0.8157894736842105,394,83,311,0.2106598984771573,0.3348516397709525,medlm,mimiciii,progress_note,PROMPT2_ICL_entailment
101,19,6,6,0,1.0,54,29,25,0.5370370370370371,0.6987951807228916,medlm,mimiciii,progress_note,PROMPT2_ICL_entailment
102,190,30,22,8,0.7333333333333333,390,78,312,0.2,0.3142857142857143,medlm,mimiciii,progress_note,PROMPT2_ICL_entailment
103,191,21,21,0,1.0,359,81,278,0.2256267409470752,0.3681818181818182,medlm,mimiciii,progress_note,PROMPT2_ICL_entailment
104,192,25,25,0,1.0,360,86,274,0.2388888888888889,0.3856502242152466,medlm,mimiciii,progress_note,PROMPT2_ICL_entailment
105,193,12,9,3,0.75,415,43,372,0.1036144578313253,0.1820748059280169,medlm,mimiciii,progress_note,PROMPT2_ICL_entailment
106,194,13,13,0,1.0,155,82,73,0.5290322580645161,0.6919831223628692,medlm,mimiciii,progress_note,PROMPT2_ICL_entailment
107,195,9,8,1,0.8888888888888888,44,24,20,0.5454545454545454,0.676056338028169,medlm,mimiciii,progress_note,PROMPT2_ICL_entailment
108,196,22,16,6,0.7272727272727273,42,24,18,0.5714285714285714,0.64,medlm,mimiciii,progress_note,PROMPT2_ICL_entailment
109,197,34,29,5,0.8529411764705882,90,66,24,0.7333333333333333,0.7886279357231148,medlm,mimiciii,progress_note,PROMPT2_ICL_entailment
110,198,16,15,1,0.9375,34,30,4,0.8823529411764706,0.9090909090909092,medlm,mimiciii,progress_note,PROMPT2_ICL_entailment
111,199,24,23,1,0.9583333333333334,52,31,21,0.5961538461538461,0.7350515463917525,medlm,mimiciii,progress_note,PROMPT2_ICL_entailment
112,2,10,7,3,0.7,242,26,216,0.1074380165289256,0.1862845445240532,medlm,mimiciii,progress_note,PROMPT2_ICL_entailment
113,20,8,7,1,0.875,47,35,12,0.7446808510638298,0.8045977011494252,medlm,mimiciii,progress_note,PROMPT2_ICL_entailment
114,200,7,5,2,0.7142857142857143,164,44,120,0.2682926829268293,0.3900709219858156,medlm,mimiciii,progress_note,PROMPT2_ICL_entailment
115,201,26,22,4,0.8461538461538461,200,41,159,0.205,0.3300402488108305,medlm,mimiciii,progress_note,PROMPT2_ICL_entailment
116,202,16,13,3,0.8125,176,44,132,0.25,0.3823529411764705,medlm,mimiciii,progress_note,PROMPT2_ICL_entailment
117,203,18,16,2,0.8888888888888888,211,74,137,0.3507109004739336,0.5029736618521665,medlm,mimiciii,progress_note,PROMPT2_ICL_entailment
118,204,31,20,11,0.6451612903225806,201,76,125,0.3781094527363184,0.4767879548306148,medlm,mimiciii,progress_note,PROMPT2_ICL_entailment
119,205,11,8,3,0.7272727272727273,195,58,137,0.2974358974358974,0.4222020018198362,medlm,mimiciii,progress_note,PROMPT2_ICL_entailment
120,206,11,10,1,0.9090909090909092,239,90,149,0.3765690376569037,0.5325443786982248,medlm,mimiciii,progress_note,PROMPT2_ICL_entailment
121,207,41,34,7,0.8292682926829268,233,89,144,0.3819742489270386,0.5230317172240947,medlm,mimiciii,progress_note,PROMPT2_ICL_entailment
122,208,39,18,21,0.4615384615384615,229,71,158,0.3100436681222707,0.3709185894645189,medlm,mimiciii,progress_note,PROMPT2_ICL_entailment
123,209,46,32,14,0.6956521739130435,205,62,143,0.3024390243902439,0.4215894602634933,medlm,mimiciii,progress_note,PROMPT2_ICL_entailment
124,21,16,16,0,1.0,373,76,297,0.2037533512064343,0.3385300668151448,medlm,mimiciii,progress_note,PROMPT2_ICL_entailment
125,210,10,10,0,1.0,28,19,9,0.6785714285714286,0.8085106382978724,medlm,mimiciii,progress_note,PROMPT2_ICL_entailment
126,211,22,21,1,0.9545454545454546,54,40,14,0.7407407407407407,0.8341608738828202,medlm,mimiciii,progress_note,PROMPT2_ICL_entailment
127,212,15,11,4,0.7333333333333333,14,10,4,0.7142857142857143,0.7236842105263158,medlm,mimiciii,progress_note,PROMPT2_ICL_entailment
128,213,20,19,1,0.95,41,30,11,0.7317073170731707,0.8266860043509789,medlm,mimiciii,progress_note,PROMPT2_ICL_entailment
129,214,8,6,2,0.75,27,23,4,0.8518518518518519,0.7976878612716762,medlm,mimiciii,progress_note,PROMPT2_ICL_entailment
130,215,43,23,20,0.5348837209302325,66,42,24,0.6363636363636364,0.5812274368231046,medlm,mimiciii,progress_note,PROMPT2_ICL_entailment
131,216,21,12,9,0.5714285714285714,67,36,31,0.5373134328358209,0.5538461538461538,medlm,mimiciii,progress_note,PROMPT2_ICL_entailment
132,217,22,15,7,0.6818181818181818,73,39,34,0.5342465753424658,0.599078341013825,medlm,mimiciii,progress_note,PROMPT2_ICL_entailment
133,218,11,9,2,0.8181818181818182,27,15,12,0.5555555555555556,0.661764705882353,medlm,mimiciii,progress_note,PROMPT2_ICL_entailment
134,219,7,6,1,0.8571428571428571,17,14,3,0.8235294117647058,0.84,medlm,mimiciii,progress_note,PROMPT2_ICL_entailment
135,22,13,11,2,0.8461538461538461,56,24,32,0.4285714285714285,0.5689655172413793,medlm,mimiciii,progress_note,PROMPT2_ICL_entailment
136,220,25,23,2,0.92,34,28,6,0.8235294117647058,0.8690958164642375,medlm,mimiciii,progress_note,PROMPT2_ICL_entailment
137,221,30,12,18,0.4,188,73,115,0.3882978723404255,0.3940620782726046,medlm,mimiciii,progress_note,PROMPT2_ICL_entailment
138,222,15,11,4,0.7333333333333333,263,104,159,0.3954372623574144,0.5138109139905681,medlm,mimiciii,progress_note,PROMPT2_ICL_entailment
139,223,10,8,2,0.8,30,14,16,0.4666666666666667,0.5894736842105264,medlm,mimiciii,progress_note,PROMPT2_ICL_entailment
140,224,14,13,1,0.9285714285714286,33,26,7,0.7878787878787878,0.8524590163934426,medlm,mimiciii,progress_note,PROMPT2_ICL_entailment
141,225,8,7,1,0.875,37,21,16,0.5675675675675675,0.6885245901639344,medlm,mimiciii,progress_note,PROMPT2_ICL_entailment
142,226,16,16,0,1.0,33,16,17,0.4848484848484848,0.653061224489796,medlm,mimiciii,progress_note,PROMPT2_ICL_entailment
143,227,5,5,0,1.0,15,6,9,0.4,0.5714285714285715,medlm,mimiciii,progress_note,PROMPT2_ICL_entailment
144,228,5,5,0,1.0,15,9,6,0.6,0.7499999999999999,medlm,mimiciii,progress_note,PROMPT2_ICL_entailment
145,229,5,5,0,1.0,15,6,9,0.4,0.5714285714285715,medlm,mimiciii,progress_note,PROMPT2_ICL_entailment
146,23,24,20,4,0.8333333333333334,56,34,22,0.6071428571428571,0.7024793388429752,medlm,mimiciii,progress_note,PROMPT2_ICL_entailment
147,230,14,11,3,0.7857142857142857,26,21,5,0.8076923076923077,0.796551724137931,medlm,mimiciii,progress_note,PROMPT2_ICL_entailment
148,231,42,39,3,0.9285714285714286,102,80,22,0.7843137254901961,0.8503679476696646,medlm,mimiciii,progress_note,PROMPT2_ICL_entailment
149,232,20,18,2,0.9,72,32,40,0.4444444444444444,0.5950413223140495,medlm,mimiciii,progress_note,PROMPT2_ICL_entailment
150,233,32,19,13,0.59375,82,51,31,0.6219512195121951,0.6075235109717867,medlm,mimiciii,progress_note,PROMPT2_ICL_entailment
151,234,17,11,6,0.6470588235294118,42,30,12,0.7142857142857143,0.6790123456790124,medlm,mimiciii,progress_note,PROMPT2_ICL_entailment
152,24,13,11,2,0.8461538461538461,33,12,21,0.3636363636363636,0.508670520231214,medlm,mimiciii,progress_note,PROMPT2_ICL_entailment
153,25,12,9,3,0.75,35,15,20,0.4285714285714285,0.5454545454545454,medlm,mimiciii,progress_note,PROMPT2_ICL_entailment
154,26,12,7,5,0.5833333333333334,35,29,6,0.8285714285714286,0.6846543001686342,medlm,mimiciii,progress_note,PROMPT2_ICL_entailment
155,27,19,14,5,0.7368421052631579,32,29,3,0.90625,0.8128128128128128,medlm,mimiciii,progress_note,PROMPT2_ICL_entailment
156,28,30,29,1,0.9666666666666668,85,33,52,0.388235294117647,0.5539797395079594,medlm,mimiciii,progress_note,PROMPT2_ICL_entailment
157,29,28,28,0,1.0,76,40,36,0.5263157894736842,0.6896551724137931,medlm,mimiciii,progress_note,PROMPT2_ICL_entailment
158,3,417,19,398,0.0455635491606714,273,27,246,0.0989010989010989,0.0623859905144107,medlm,mimiciii,progress_note,PROMPT2_ICL_entailment
159,30,17,14,3,0.8235294117647058,29,11,18,0.3793103448275862,0.5193929173693086,medlm,mimiciii,progress_note,PROMPT2_ICL_entailment
160,31,16,14,2,0.875,26,15,11,0.5769230769230769,0.695364238410596,medlm,mimiciii,progress_note,PROMPT2_ICL_entailment
161,32,33,29,4,0.8787878787878788,152,78,74,0.5131578947368421,0.6479518762532226,medlm,mimiciii,progress_note,PROMPT2_ICL_entailment
162,33,27,24,3,0.8888888888888888,106,43,63,0.4056603773584906,0.5570850202429151,medlm,mimiciii,progress_note,PROMPT2_ICL_entailment
163,34,19,15,4,0.7894736842105263,98,43,55,0.4387755102040816,0.5640577175338872,medlm,mimiciii,progress_note,PROMPT2_ICL_entailment
164,35,5,4,1,0.8,26,15,11,0.5769230769230769,0.6703910614525139,medlm,mimiciii,progress_note,PROMPT2_ICL_entailment
165,36,19,14,5,0.7368421052631579,60,19,41,0.3166666666666666,0.4429641965029142,medlm,mimiciii,progress_note,PROMPT2_ICL_entailment
166,37,442,29,413,0.0656108597285067,344,220,124,0.6395348837209303,0.1190120877480973,medlm,mimiciii,progress_note,PROMPT2_ICL_entailment
167,38,22,19,3,0.8636363636363636,278,59,219,0.2122302158273381,0.3407294832826747,medlm,mimiciii,progress_note,PROMPT2_ICL_entailment
168,39,25,24,1,0.96,117,56,61,0.4786324786324786,0.6387832699619772,medlm,mimiciii,progress_note,PROMPT2_ICL_entailment
169,4,19,16,3,0.8421052631578947,282,50,232,0.1773049645390071,0.2929329915781765,medlm,mimiciii,progress_note,PROMPT2_ICL_entailment
170,40,25,24,1,0.96,117,49,68,0.4188034188034188,0.5831886932804363,medlm,mimiciii,progress_note,PROMPT2_ICL_entailment
171,41,23,19,4,0.8260869565217391,119,58,61,0.4873949579831932,0.6130737134909597,medlm,mimiciii,progress_note,PROMPT2_ICL_entailment
172,42,23,19,4,0.8260869565217391,119,53,66,0.4453781512605042,0.5787356321839081,medlm,mimiciii,progress_note,PROMPT2_ICL_entailment
173,43,40,26,14,0.65,117,53,64,0.452991452991453,0.5339015885315769,medlm,mimiciii,progress_note,PROMPT2_ICL_entailment
174,44,34,32,2,0.9411764705882352,149,123,26,0.825503355704698,0.8795530726256983,medlm,mimiciii,progress_note,PROMPT2_ICL_entailment
175,45,19,17,2,0.8947368421052632,125,49,76,0.392,0.5451570680628273,medlm,mimiciii,progress_note,PROMPT2_ICL_entailment
176,46,14,12,2,0.8571428571428571,52,24,28,0.4615384615384615,0.6,medlm,mimiciii,progress_note,PROMPT2_ICL_entailment
177,47,3,3,0,1.0,12,7,5,0.5833333333333334,0.7368421052631579,medlm,mimiciii,progress_note,PROMPT2_ICL_entailment
178,48,18,17,1,0.9444444444444444,49,25,24,0.5102040816326531,0.6625097427903351,medlm,mimiciii,progress_note,PROMPT2_ICL_entailment
179,49,27,19,8,0.7037037037037037,87,29,58,0.3333333333333333,0.4523809523809524,medlm,mimiciii,progress_note,PROMPT2_ICL_entailment
180,5,10,7,3,0.7,300,60,240,0.2,0.3111111111111111,medlm,mimiciii,progress_note,PROMPT2_ICL_entailment
181,50,69,64,5,0.927536231884058,176,71,105,0.4034090909090909,0.5622718554723751,medlm,mimiciii,progress_note,PROMPT2_ICL_entailment
182,51,15,8,7,0.5333333333333333,302,31,271,0.1026490066225165,0.1721624435959736,medlm,mimiciii,progress_note,PROMPT2_ICL_entailment
183,52,36,26,10,0.7222222222222222,302,86,216,0.2847682119205298,0.4084764340518816,medlm,mimiciii,progress_note,PROMPT2_ICL_entailment
184,53,19,17,2,0.8947368421052632,382,72,310,0.1884816753926701,0.3113711523785296,medlm,mimiciii,progress_note,PROMPT2_ICL_entailment
185,54,16,4,12,0.25,219,33,186,0.1506849315068493,0.188034188034188,medlm,mimiciii,progress_note,PROMPT2_ICL_entailment
186,55,27,18,9,0.6666666666666666,286,55,231,0.1923076923076923,0.2985074626865671,medlm,mimiciii,progress_note,PROMPT2_ICL_entailment
187,56,7,7,0,1.0,48,24,24,0.5,0.6666666666666666,medlm,mimiciii,progress_note,PROMPT2_ICL_entailment
188,57,10,7,3,0.7,46,22,24,0.4782608695652174,0.5682656826568265,medlm,mimiciii,progress_note,PROMPT2_ICL_entailment
189,58,19,12,7,0.631578947368421,39,17,22,0.4358974358974359,0.515802781289507,medlm,mimiciii,progress_note,PROMPT2_ICL_entailment
190,59,10,7,3,0.7,39,18,21,0.4615384615384615,0.5562913907284769,medlm,mimiciii,progress_note,PROMPT2_ICL_entailment
191,6,13,11,2,0.8461538461538461,331,40,291,0.120845921450151,0.2114876231675078,medlm,mimiciii,progress_note,PROMPT2_ICL_entailment
192,60,30,27,3,0.9,276,77,199,0.2789855072463768,0.4259373079287032,medlm,mimiciii,progress_note,PROMPT2_ICL_entailment
193,61,24,18,6,0.75,56,20,36,0.3571428571428571,0.4838709677419354,medlm,mimiciii,progress_note,PROMPT2_ICL_entailment
194,62,25,18,7,0.72,56,20,36,0.3571428571428571,0.4774535809018567,medlm,mimiciii,progress_note,PROMPT2_ICL_entailment
195,63,27,25,2,0.925925925925926,142,63,79,0.4436619718309859,0.5998857360502762,medlm,mimiciii,progress_note,PROMPT2_ICL_entailment
196,64,42,1,41,0.0238095238095238,1,1,0,1.0,0.0465116279069767,medlm,mimiciii,progress_note,PROMPT2_ICL_entailment
197,65,11,11,0,1.0,12,8,4,0.6666666666666666,0.8,medlm,mimiciii,progress_note,PROMPT2_ICL_entailment
198,66,25,24,1,0.96,68,38,30,0.5588235294117647,0.7064291247095276,medlm,mimiciii,progress_note,PROMPT2_ICL_entailment
199,67,20,16,4,0.8,490,125,365,0.2551020408163265,0.3868471953578337,medlm,mimiciii,progress_note,PROMPT2_ICL_entailment
200,68,16,14,2,0.875,348,70,278,0.2011494252873563,0.3271028037383178,medlm,mimiciii,progress_note,PROMPT2_ICL_entailment
201,69,47,39,8,0.8297872340425532,373,89,284,0.2386058981233244,0.3706353443673251,medlm,mimiciii,progress_note,PROMPT2_ICL_entailment
202,7,21,19,2,0.9047619047619048,331,40,291,0.120845921450151,0.2132136344508346,medlm,mimiciii,progress_note,PROMPT2_ICL_entailment
203,70,39,35,4,0.8974358974358975,374,103,271,0.2754010695187165,0.4214648974104168,medlm,mimiciii,progress_note,PROMPT2_ICL_entailment
204,71,14,14,0,1.0,372,65,307,0.1747311827956989,0.2974828375286041,medlm,mimiciii,progress_note,PROMPT2_ICL_entailment
205,72,5,4,1,0.8,20,12,8,0.6,0.6857142857142857,medlm,mimiciii,progress_note,PROMPT2_ICL_entailment
206,73,18,8,10,0.4444444444444444,460,113,347,0.2456521739130434,0.3164158207910395,medlm,mimiciii,progress_note,PROMPT2_ICL_entailment
207,74,21,11,10,0.5238095238095238,319,58,261,0.1818181818181818,0.2699386503067485,medlm,mimiciii,progress_note,PROMPT2_ICL_entailment
208,75,33,30,3,0.9090909090909092,62,31,31,0.5,0.6451612903225806,medlm,mimiciii,progress_note,PROMPT2_ICL_entailment
209,76,35,30,5,0.8571428571428571,86,45,41,0.5232558139534884,0.6498194945848375,medlm,mimiciii,progress_note,PROMPT2_ICL_entailment
210,77,7,7,0,1.0,38,17,21,0.4473684210526316,0.6181818181818182,medlm,mimiciii,progress_note,PROMPT2_ICL_entailment
211,78,22,19,3,0.8636363636363636,30,17,13,0.5666666666666667,0.6843220338983051,medlm,mimiciii,progress_note,PROMPT2_ICL_entailment
212,79,14,9,5,0.6428571428571429,67,24,43,0.3582089552238806,0.4600638977635782,medlm,mimiciii,progress_note,PROMPT2_ICL_entailment
213,8,39,28,11,0.717948717948718,118,103,15,0.8728813559322034,0.7878705094932387,medlm,mimiciii,progress_note,PROMPT2_ICL_entailment
214,80,21,21,0,1.0,32,15,17,0.46875,0.6382978723404256,medlm,mimiciii,progress_note,PROMPT2_ICL_entailment
215,81,23,21,2,0.9130434782608696,46,24,22,0.5217391304347826,0.6640316205533596,medlm,mimiciii,progress_note,PROMPT2_ICL_entailment
216,82,3,3,0,1.0,18,3,15,0.1666666666666666,0.2857142857142857,medlm,mimiciii,progress_note,PROMPT2_ICL_entailment
217,83,21,19,2,0.9047619047619048,66,34,32,0.5151515151515151,0.6565040650406504,medlm,mimiciii,progress_note,PROMPT2_ICL_entailment
218,84,10,9,1,0.9,48,14,34,0.2916666666666667,0.4405594405594406,medlm,mimiciii,progress_note,PROMPT2_ICL_entailment
219,85,18,14,4,0.7777777777777778,77,30,47,0.3896103896103896,0.519159456118665,medlm,mimiciii,progress_note,PROMPT2_ICL_entailment
220,86,31,29,2,0.935483870967742,52,27,25,0.5192307692307693,0.6678038379530917,medlm,mimiciii,progress_note,PROMPT2_ICL_entailment
221,87,3,2,1,0.6666666666666666,15,1,14,0.0666666666666666,0.1212121212121212,medlm,mimiciii,progress_note,PROMPT2_ICL_entailment
222,88,27,24,3,0.8888888888888888,105,49,56,0.4666666666666667,0.6120218579234972,medlm,mimiciii,progress_note,PROMPT2_ICL_entailment
223,89,20,5,15,0.25,339,65,274,0.191740412979351,0.2170283806343906,medlm,mimiciii,progress_note,PROMPT2_ICL_entailment
224,9,13,12,1,0.9230769230769232,61,34,27,0.5573770491803278,0.6950596252129472,medlm,mimiciii,progress_note,PROMPT2_ICL_entailment
225,90,3,3,0,1.0,4,4,0,1.0,1.0,medlm,mimiciii,progress_note,PROMPT2_ICL_entailment
226,91,28,24,4,0.8571428571428571,112,51,61,0.4553571428571428,0.5947521865889213,medlm,mimiciii,progress_note,PROMPT2_ICL_entailment
227,92,12,8,4,0.6666666666666666,208,45,163,0.2163461538461538,0.3266787658802177,medlm,mimiciii,progress_note,PROMPT2_ICL_entailment
228,93,8,7,1,0.875,38,14,24,0.3684210526315789,0.5185185185185185,medlm,mimiciii,progress_note,PROMPT2_ICL_entailment
229,94,35,29,6,0.8285714285714286,112,51,61,0.4553571428571428,0.5877210411285515,medlm,mimiciii,progress_note,PROMPT2_ICL_entailment
230,95,17,13,4,0.7647058823529411,49,14,35,0.2857142857142857,0.416,medlm,mimiciii,progress_note,PROMPT2_ICL_entailment
231,96,7,7,0,1.0,14,6,8,0.4285714285714285,0.6,medlm,mimiciii,progress_note,PROMPT2_ICL_entailment
232,97,5,5,0,1.0,20,10,10,0.5,0.6666666666666666,medlm,mimiciii,progress_note,PROMPT2_ICL_entailment
233,98,10,9,1,0.9,35,14,21,0.4,0.5538461538461539,medlm,mimiciii,progress_note,PROMPT2_ICL_entailment
234,99,15,14,1,0.9333333333333332,104,26,78,0.25,0.3943661971830985,medlm,mimiciii,progress_note,PROMPT2_ICL_entailment
0,0,38,34,4,0.8947368421052632,118,100,18,0.847457627118644,0.8704557091653865,medlm,mimiciii,progress_note,PROMPT2_entailment
1,1,43,41,2,0.9534883720930232,320,67,253,0.209375,0.3433535404037248,medlm,mimiciii,progress_note,PROMPT2_entailment
2,10,48,38,10,0.7916666666666666,230,32,198,0.1391304347826087,0.2366679641884001,medlm,mimiciii,progress_note,PROMPT2_entailment
3,100,41,32,9,0.7804878048780488,115,33,82,0.2869565217391304,0.4196304391019273,medlm,mimiciii,progress_note,PROMPT2_entailment
4,101,19,15,4,0.7894736842105263,49,23,26,0.4693877551020408,0.5887372013651877,medlm,mimiciii,progress_note,PROMPT2_entailment
5,102,7,4,3,0.5714285714285714,67,30,37,0.4477611940298507,0.5020920502092051,medlm,mimiciii,progress_note,PROMPT2_entailment
6,103,51,35,16,0.6862745098039216,347,83,264,0.239193083573487,0.3547441690072048,medlm,mimiciii,progress_note,PROMPT2_entailment
7,104,13,10,3,0.7692307692307693,57,16,41,0.2807017543859649,0.4113110539845759,medlm,mimiciii,progress_note,PROMPT2_entailment
8,105,13,12,1,0.9230769230769232,28,23,5,0.8214285714285714,0.8692913385826772,medlm,mimiciii,progress_note,PROMPT2_entailment
9,106,15,14,1,0.9333333333333332,58,42,16,0.7241379310344828,0.8155339805825242,medlm,mimiciii,progress_note,PROMPT2_entailment
10,107,23,21,2,0.9130434782608696,53,26,27,0.490566037735849,0.6382232612507305,medlm,mimiciii,progress_note,PROMPT2_entailment
11,109,9,8,1,0.8888888888888888,311,178,133,0.572347266881029,0.6963325183374083,medlm,mimiciii,progress_note,PROMPT2_entailment
12,11,24,16,8,0.6666666666666666,233,51,182,0.2188841201716738,0.3295638126009693,medlm,mimiciii,progress_note,PROMPT2_entailment
13,110,14,13,1,0.9285714285714286,358,84,274,0.2346368715083799,0.3746140651801029,medlm,mimiciii,progress_note,PROMPT2_entailment
14,111,14,9,5,0.6428571428571429,389,90,299,0.2313624678663239,0.3402646502835539,medlm,mimiciii,progress_note,PROMPT2_entailment
15,112,19,16,3,0.8421052631578947,400,76,324,0.19,0.3100458949515554,medlm,mimiciii,progress_note,PROMPT2_entailment
16,113,61,9,52,0.1475409836065573,340,81,259,0.238235294117647,0.1822272215973003,medlm,mimiciii,progress_note,PROMPT2_entailment
17,114,50,37,13,0.74,401,118,283,0.2942643391521197,0.4210830881998361,medlm,mimiciii,progress_note,PROMPT2_entailment
18,115,28,24,4,0.8571428571428571,479,88,391,0.1837160751565762,0.3025787965616046,medlm,mimiciii,progress_note,PROMPT2_entailment
19,116,14,13,1,0.9285714285714286,53,29,24,0.5471698113207547,0.6885844748858448,medlm,mimiciii,progress_note,PROMPT2_entailment
20,117,7,5,2,0.7142857142857143,33,14,19,0.4242424242424242,0.532319391634981,medlm,mimiciii,progress_note,PROMPT2_entailment
21,118,12,10,2,0.8333333333333334,41,18,23,0.4390243902439024,0.5750798722044728,medlm,mimiciii,progress_note,PROMPT2_entailment
22,119,14,11,3,0.7857142857142857,21,19,2,0.9047619047619048,0.841046277665996,medlm,mimiciii,progress_note,PROMPT2_entailment
23,12,13,10,3,0.7692307692307693,388,44,344,0.1134020618556701,0.1976639712488769,medlm,mimiciii,progress_note,PROMPT2_entailment
24,120,28,26,2,0.9285714285714286,95,41,54,0.431578947368421,0.5892758430071863,medlm,mimiciii,progress_note,PROMPT2_entailment
25,121,10,8,2,0.8,23,8,15,0.3478260869565217,0.4848484848484848,medlm,mimiciii,progress_note,PROMPT2_entailment
26,122,20,15,5,0.75,71,21,50,0.2957746478873239,0.4242424242424242,medlm,mimiciii,progress_note,PROMPT2_entailment
27,123,24,18,6,0.75,72,27,45,0.375,0.5,medlm,mimiciii,progress_note,PROMPT2_entailment
28,124,24,22,2,0.9166666666666666,96,40,56,0.4166666666666667,0.5729166666666666,medlm,mimiciii,progress_note,PROMPT2_entailment
29,125,29,26,3,0.896551724137931,72,35,37,0.4861111111111111,0.6304121925874611,medlm,mimiciii,progress_note,PROMPT2_entailment
30,126,10,8,2,0.8,41,32,9,0.7804878048780488,0.7901234567901235,medlm,mimiciii,progress_note,PROMPT2_entailment
31,127,10,8,2,0.8,41,18,23,0.4390243902439024,0.5669291338582678,medlm,mimiciii,progress_note,PROMPT2_entailment
32,128,22,19,3,0.8636363636363636,56,29,27,0.5178571428571429,0.6474735605170387,medlm,mimiciii,progress_note,PROMPT2_entailment
33,129,23,15,8,0.6521739130434783,100,48,52,0.48,0.5529953917050691,medlm,mimiciii,progress_note,PROMPT2_entailment
34,13,17,13,4,0.7647058823529411,106,47,59,0.4433962264150943,0.5613229214515388,medlm,mimiciii,progress_note,PROMPT2_entailment
35,130,24,13,11,0.5416666666666666,64,34,30,0.53125,0.5364077669902912,medlm,mimiciii,progress_note,PROMPT2_entailment
36,131,18,6,12,0.3333333333333333,343,65,278,0.1895043731778425,0.2416356877323419,medlm,mimiciii,progress_note,PROMPT2_entailment
37,132,27,18,9,0.6666666666666666,333,49,284,0.1471471471471471,0.2410824108241082,medlm,mimiciii,progress_note,PROMPT2_entailment
38,133,10,7,3,0.7,271,50,221,0.1845018450184501,0.2920317062995411,medlm,mimiciii,progress_note,PROMPT2_entailment
39,134,8,7,1,0.875,24,16,8,0.6666666666666666,0.7567567567567567,medlm,mimiciii,progress_note,PROMPT2_entailment
40,135,24,15,9,0.625,50,24,26,0.48,0.5429864253393665,medlm,mimiciii,progress_note,PROMPT2_entailment
41,136,9,8,1,0.8888888888888888,58,23,35,0.396551724137931,0.5484351713859911,medlm,mimiciii,progress_note,PROMPT2_entailment
42,137,11,10,1,0.9090909090909092,36,20,16,0.5555555555555556,0.6896551724137931,medlm,mimiciii,progress_note,PROMPT2_entailment
43,138,12,12,0,1.0,66,17,49,0.2575757575757575,0.4096385542168674,medlm,mimiciii,progress_note,PROMPT2_entailment
44,139,5,5,0,1.0,70,30,40,0.4285714285714285,0.6,medlm,mimiciii,progress_note,PROMPT2_entailment
45,14,9,2,7,0.2222222222222222,63,30,33,0.4761904761904761,0.303030303030303,medlm,mimiciii,progress_note,PROMPT2_entailment
46,140,16,8,8,0.5,39,18,21,0.4615384615384615,0.48,medlm,mimiciii,progress_note,PROMPT2_entailment
47,141,27,24,3,0.8888888888888888,70,31,39,0.4428571428571428,0.5911799761620977,medlm,mimiciii,progress_note,PROMPT2_entailment
48,142,36,31,5,0.8611111111111112,72,39,33,0.5416666666666666,0.665016501650165,medlm,mimiciii,progress_note,PROMPT2_entailment
49,143,7,7,0,1.0,16,4,12,0.25,0.4,medlm,mimiciii,progress_note,PROMPT2_entailment
50,144,34,32,2,0.9411764705882352,72,41,31,0.5694444444444444,0.709572742022715,medlm,mimiciii,progress_note,PROMPT2_entailment
51,145,15,12,3,0.8,63,20,43,0.3174603174603174,0.4545454545454545,medlm,mimiciii,progress_note,PROMPT2_entailment
52,146,13,8,5,0.6153846153846154,50,18,32,0.36,0.4542586750788643,medlm,mimiciii,progress_note,PROMPT2_entailment
53,147,26,23,3,0.8846153846153846,80,42,38,0.525,0.6589358799454298,medlm,mimiciii,progress_note,PROMPT2_entailment
54,148,8,7,1,0.875,6,5,1,0.8333333333333334,0.8536585365853658,medlm,mimiciii,progress_note,PROMPT2_entailment
55,15,31,23,8,0.7419354838709677,275,41,234,0.149090909090909,0.2482885729331227,medlm,mimiciii,progress_note,PROMPT2_entailment
56,150,13,12,1,0.9230769230769232,121,46,75,0.3801652892561983,0.5385365853658537,medlm,mimiciii,progress_note,PROMPT2_entailment
57,151,12,8,4,0.6666666666666666,340,55,285,0.1617647058823529,0.2603550295857988,medlm,mimiciii,progress_note,PROMPT2_entailment
58,152,15,4,11,0.2666666666666666,65,40,25,0.6153846153846154,0.3720930232558139,medlm,mimiciii,progress_note,PROMPT2_entailment
59,153,34,30,4,0.8823529411764706,368,103,265,0.2798913043478261,0.4249759317837986,medlm,mimiciii,progress_note,PROMPT2_entailment
60,154,11,11,0,1.0,23,22,1,0.9565217391304348,0.9777777777777776,medlm,mimiciii,progress_note,PROMPT2_entailment
61,155,20,15,5,0.75,49,25,24,0.5102040816326531,0.6072874493927126,medlm,mimiciii,progress_note,PROMPT2_entailment
62,156,20,14,6,0.7,49,25,24,0.5102040816326531,0.5902192242833052,medlm,mimiciii,progress_note,PROMPT2_entailment
63,157,10,8,2,0.8,41,25,16,0.6097560975609756,0.6920415224913495,medlm,mimiciii,progress_note,PROMPT2_entailment
64,158,46,40,6,0.8695652173913043,411,74,337,0.1800486618004866,0.2983269502116509,medlm,mimiciii,progress_note,PROMPT2_entailment
65,159,7,6,1,0.8571428571428571,35,26,9,0.7428571428571429,0.7959183673469387,medlm,mimiciii,progress_note,PROMPT2_entailment
66,16,16,12,4,0.75,41,20,21,0.4878048780487805,0.5911330049261083,medlm,mimiciii,progress_note,PROMPT2_entailment
67,160,23,22,1,0.9565217391304348,96,42,54,0.4375,0.6003898635477584,medlm,mimiciii,progress_note,PROMPT2_entailment
68,161,10,10,0,1.0,343,28,315,0.0816326530612244,0.150943396226415,medlm,mimiciii,progress_note,PROMPT2_entailment
69,162,18,16,2,0.8888888888888888,300,34,266,0.1133333333333333,0.2010347376201034,medlm,mimiciii,progress_note,PROMPT2_entailment
70,163,14,12,2,0.8571428571428571,39,15,24,0.3846153846153846,0.5309734513274336,medlm,mimiciii,progress_note,PROMPT2_entailment
71,164,18,15,3,0.8333333333333334,82,40,42,0.4878048780487805,0.6153846153846153,medlm,mimiciii,progress_note,PROMPT2_entailment
72,165,5,5,0,1.0,32,26,6,0.8125,0.896551724137931,medlm,mimiciii,progress_note,PROMPT2_entailment
73,166,17,11,6,0.6470588235294118,59,33,26,0.559322033898305,0.6,medlm,mimiciii,progress_note,PROMPT2_entailment
74,167,17,17,0,1.0,85,36,49,0.4235294117647059,0.5950413223140496,medlm,mimiciii,progress_note,PROMPT2_entailment
75,168,16,11,5,0.6875,312,50,262,0.1602564102564102,0.2599243856332703,medlm,mimiciii,progress_note,PROMPT2_entailment
76,169,60,47,13,0.7833333333333333,377,100,277,0.2652519893899204,0.3963067582950377,medlm,mimiciii,progress_note,PROMPT2_entailment
77,17,5,4,1,0.8,20,16,4,0.8,0.8000000000000002,medlm,mimiciii,progress_note,PROMPT2_entailment
78,170,20,18,2,0.9,318,84,234,0.2641509433962264,0.4084278768233387,medlm,mimiciii,progress_note,PROMPT2_entailment
79,171,71,59,12,0.8309859154929577,387,84,303,0.2170542635658914,0.3442025210959475,medlm,mimiciii,progress_note,PROMPT2_entailment
80,172,36,32,4,0.8888888888888888,342,89,253,0.260233918128655,0.4026010743567995,medlm,mimiciii,progress_note,PROMPT2_entailment
81,173,25,10,15,0.4,299,35,264,0.1170568561872909,0.1811125485122897,medlm,mimiciii,progress_note,PROMPT2_entailment
82,174,68,58,10,0.8529411764705882,351,78,273,0.2222222222222222,0.3525835866261398,medlm,mimiciii,progress_note,PROMPT2_entailment
83,175,27,23,4,0.8518518518518519,354,84,270,0.2372881355932203,0.3711815561959654,medlm,mimiciii,progress_note,PROMPT2_entailment
84,176,20,14,6,0.7,330,66,264,0.2,0.3111111111111111,medlm,mimiciii,progress_note,PROMPT2_entailment
85,177,20,16,4,0.8,330,67,263,0.203030303030303,0.3238670694864048,medlm,mimiciii,progress_note,PROMPT2_entailment
86,179,12,7,5,0.5833333333333334,341,52,289,0.1524926686217008,0.241780139488542,medlm,mimiciii,progress_note,PROMPT2_entailment
87,180,14,11,3,0.7857142857142857,343,42,301,0.1224489795918367,0.2118780096308186,medlm,mimiciii,progress_note,PROMPT2_entailment
88,181,27,21,6,0.7777777777777778,366,58,308,0.1584699453551912,0.2632944228274967,medlm,mimiciii,progress_note,PROMPT2_entailment
89,182,14,13,1,0.9285714285714286,367,50,317,0.1362397820163488,0.2376165234874794,medlm,mimiciii,progress_note,PROMPT2_entailment
90,183,49,35,14,0.7142857142857143,389,75,314,0.1928020565552699,0.3036437246963562,medlm,mimiciii,progress_note,PROMPT2_entailment
91,184,30,29,1,0.9666666666666668,330,67,263,0.203030303030303,0.3355785837651123,medlm,mimiciii,progress_note,PROMPT2_entailment
92,185,19,17,2,0.8947368421052632,69,28,41,0.4057971014492754,0.5583577712609971,medlm,mimiciii,progress_note,PROMPT2_entailment
93,186,41,30,11,0.7317073170731707,352,57,295,0.1619318181818181,0.2651779483600837,medlm,mimiciii,progress_note,PROMPT2_entailment
94,187,9,9,0,1.0,295,32,263,0.1084745762711864,0.1957186544342507,medlm,mimiciii,progress_note,PROMPT2_entailment
95,188,18,13,5,0.7222222222222222,357,46,311,0.1288515406162464,0.2186871457304808,medlm,mimiciii,progress_note,PROMPT2_entailment
96,189,89,81,8,0.9101123595505618,394,98,296,0.248730964467005,0.3906880598484103,medlm,mimiciii,progress_note,PROMPT2_entailment
97,190,126,92,34,0.7301587301587301,390,83,307,0.2128205128205128,0.3295783158530795,medlm,mimiciii,progress_note,PROMPT2_entailment
98,191,68,65,3,0.9558823529411764,359,106,253,0.2952646239554317,0.4511672068886487,medlm,mimiciii,progress_note,PROMPT2_entailment
99,192,26,25,1,0.9615384615384616,360,71,289,0.1972222222222222,0.3273096072284713,medlm,mimiciii,progress_note,PROMPT2_entailment
100,193,25,20,5,0.8,415,65,350,0.1566265060240964,0.2619647355163728,medlm,mimiciii,progress_note,PROMPT2_entailment
101,194,12,11,1,0.9166666666666666,365,41,324,0.1123287671232876,0.2001331262480585,medlm,mimiciii,progress_note,PROMPT2_entailment
102,195,9,8,1,0.8888888888888888,60,37,23,0.6166666666666667,0.7281672816728167,medlm,mimiciii,progress_note,PROMPT2_entailment
103,196,19,14,5,0.7368421052631579,61,29,32,0.4754098360655737,0.5779359430604982,medlm,mimiciii,progress_note,PROMPT2_entailment
104,197,32,30,2,0.9375,137,61,76,0.4452554744525547,0.603761134938964,medlm,mimiciii,progress_note,PROMPT2_entailment
105,198,16,13,3,0.8125,47,23,24,0.4893617021276595,0.6108273748723188,medlm,mimiciii,progress_note,PROMPT2_entailment
106,199,19,18,1,0.9473684210526316,76,29,47,0.3815789473684211,0.5440333507034913,medlm,mimiciii,progress_note,PROMPT2_entailment
107,2,12,8,4,0.6666666666666666,242,21,221,0.0867768595041322,0.1535648994515539,medlm,mimiciii,progress_note,PROMPT2_entailment
108,200,52,20,32,0.3846153846153846,276,32,244,0.1159420289855072,0.1781737193763919,medlm,mimiciii,progress_note,PROMPT2_entailment
109,201,23,20,3,0.8695652173913043,343,41,302,0.119533527696793,0.2101755734973728,medlm,mimiciii,progress_note,PROMPT2_entailment
110,202,42,31,11,0.7380952380952381,295,21,274,0.0711864406779661,0.1298494066021741,medlm,mimiciii,progress_note,PROMPT2_entailment
111,203,25,22,3,0.88,367,61,306,0.1662125340599455,0.2796124596312116,medlm,mimiciii,progress_note,PROMPT2_entailment
112,204,10,9,1,0.9,349,51,298,0.1461318051575931,0.2514379622021364,medlm,mimiciii,progress_note,PROMPT2_entailment
113,205,88,75,13,0.8522727272727273,329,81,248,0.2462006079027355,0.38203943024243,medlm,mimiciii,progress_note,PROMPT2_entailment
114,206,8,7,1,0.875,421,62,359,0.1472684085510688,0.252105721754284,medlm,mimiciii,progress_note,PROMPT2_entailment
115,207,19,16,3,0.8421052631578947,403,83,320,0.205955334987593,0.3309657320872274,medlm,mimiciii,progress_note,PROMPT2_entailment
116,208,10,8,2,0.8,395,33,362,0.0835443037974683,0.1512893982808023,medlm,mimiciii,progress_note,PROMPT2_entailment
117,209,10,8,2,0.8,351,43,308,0.1225071225071225,0.2124768375540457,medlm,mimiciii,progress_note,PROMPT2_entailment
118,21,11,9,2,0.8181818181818182,373,66,307,0.1769436997319035,0.2909625275532697,medlm,mimiciii,progress_note,PROMPT2_entailment
119,211,20,17,3,0.85,89,40,49,0.449438202247191,0.5879809770860355,medlm,mimiciii,progress_note,PROMPT2_entailment
120,213,17,16,1,0.9411764705882352,62,29,33,0.4677419354838709,0.6249158249158249,medlm,mimiciii,progress_note,PROMPT2_entailment
121,214,8,7,1,0.875,39,34,5,0.8717948717948718,0.873394495412844,medlm,mimiciii,progress_note,PROMPT2_entailment
122,215,35,18,17,0.5142857142857142,101,44,57,0.4356435643564356,0.47170935080405,medlm,mimiciii,progress_note,PROMPT2_entailment
123,216,20,10,10,0.5,103,39,64,0.3786407766990291,0.4309392265193369,medlm,mimiciii,progress_note,PROMPT2_entailment
124,217,23,17,6,0.7391304347826086,114,45,69,0.3947368421052631,0.5146316851664986,medlm,mimiciii,progress_note,PROMPT2_entailment
125,218,14,13,1,0.9285714285714286,41,21,20,0.5121951219512195,0.660217654171705,medlm,mimiciii,progress_note,PROMPT2_entailment
126,219,8,7,1,0.875,22,17,5,0.7727272727272727,0.8206896551724138,medlm,mimiciii,progress_note,PROMPT2_entailment
127,220,21,17,4,0.8095238095238095,50,31,19,0.62,0.7021985343104596,medlm,mimiciii,progress_note,PROMPT2_entailment
128,221,16,6,10,0.375,333,39,294,0.1171171171171171,0.1784897025171624,medlm,mimiciii,progress_note,PROMPT2_entailment
129,222,7,6,1,0.8571428571428571,458,81,377,0.1768558951965065,0.2932126696832579,medlm,mimiciii,progress_note,PROMPT2_entailment
130,223,13,10,3,0.7692307692307693,45,24,21,0.5333333333333333,0.6299212598425197,medlm,mimiciii,progress_note,PROMPT2_entailment
131,224,15,12,3,0.8,50,29,21,0.58,0.672463768115942,medlm,mimiciii,progress_note,PROMPT2_entailment
132,225,8,7,1,0.875,56,16,40,0.2857142857142857,0.4307692307692308,medlm,mimiciii,progress_note,PROMPT2_entailment
133,227,3,3,0,1.0,18,6,12,0.3333333333333333,0.5,medlm,mimiciii,progress_note,PROMPT2_entailment
134,228,2,2,0,1.0,18,4,14,0.2222222222222222,0.3636363636363636,medlm,mimiciii,progress_note,PROMPT2_entailment
135,229,2,2,0,1.0,18,5,13,0.2777777777777778,0.4347826086956522,medlm,mimiciii,progress_note,PROMPT2_entailment
136,23,25,18,7,0.72,56,21,35,0.375,0.4931506849315069,medlm,mimiciii,progress_note,PROMPT2_entailment
137,230,13,9,4,0.6923076923076923,40,32,8,0.8,0.7422680412371134,medlm,mimiciii,progress_note,PROMPT2_entailment
138,231,45,43,2,0.9555555555555556,152,128,24,0.8421052631578947,0.8952504879635653,medlm,mimiciii,progress_note,PROMPT2_entailment
139,232,32,21,11,0.65625,108,43,65,0.3981481481481481,0.4956092206366629,medlm,mimiciii,progress_note,PROMPT2_entailment
140,233,41,25,16,0.6097560975609756,116,47,69,0.4051724137931034,0.4868448311580692,medlm,mimiciii,progress_note,PROMPT2_entailment
141,234,19,13,6,0.6842105263157895,59,30,29,0.5084745762711864,0.5833956619296934,medlm,mimiciii,progress_note,PROMPT2_entailment
142,24,5,3,2,0.6,33,15,18,0.4545454545454545,0.5172413793103449,medlm,mimiciii,progress_note,PROMPT2_entailment
143,25,6,3,3,0.5,35,32,3,0.9142857142857144,0.6464646464646465,medlm,mimiciii,progress_note,PROMPT2_entailment
144,26,10,7,3,0.7,35,25,10,0.7142857142857143,0.7070707070707072,medlm,mimiciii,progress_note,PROMPT2_entailment
145,27,7,3,4,0.4285714285714285,32,11,21,0.34375,0.3815028901734104,medlm,mimiciii,progress_note,PROMPT2_entailment
146,28,29,28,1,0.9655172413793104,85,34,51,0.4,0.5656565656565657,medlm,mimiciii,progress_note,PROMPT2_entailment
147,29,25,25,0,1.0,76,36,40,0.4736842105263157,0.6428571428571429,medlm,mimiciii,progress_note,PROMPT2_entailment
148,3,22,14,8,0.6363636363636364,273,45,228,0.1648351648351648,0.2618453865336658,medlm,mimiciii,progress_note,PROMPT2_entailment
149,30,18,18,0,1.0,29,11,18,0.3793103448275862,0.5499999999999999,medlm,mimiciii,progress_note,PROMPT2_entailment
150,31,14,13,1,0.9285714285714286,26,9,17,0.3461538461538461,0.5043103448275863,medlm,mimiciii,progress_note,PROMPT2_entailment
151,32,27,20,7,0.7407407407407407,152,58,94,0.3815789473684211,0.5036908380373426,medlm,mimiciii,progress_note,PROMPT2_entailment
152,33,27,22,5,0.8148148148148148,106,48,58,0.4528301886792453,0.5821389195148843,medlm,mimiciii,progress_note,PROMPT2_entailment
153,34,10,8,2,0.8,98,38,60,0.3877551020408163,0.5223367697594502,medlm,mimiciii,progress_note,PROMPT2_entailment
154,35,5,4,1,0.8,26,23,3,0.8846153846153846,0.8401826484018265,medlm,mimiciii,progress_note,PROMPT2_entailment
155,36,8,6,2,0.75,60,20,40,0.3333333333333333,0.4615384615384615,medlm,mimiciii,progress_note,PROMPT2_entailment
156,37,20,17,3,0.85,344,77,267,0.2238372093023256,0.3543584190579318,medlm,mimiciii,progress_note,PROMPT2_entailment
157,38,32,23,9,0.71875,278,150,128,0.539568345323741,0.6164016437377167,medlm,mimiciii,progress_note,PROMPT2_entailment
158,39,24,24,0,1.0,117,48,69,0.4102564102564102,0.5818181818181819,medlm,mimiciii,progress_note,PROMPT2_entailment
159,4,18,16,2,0.8888888888888888,282,45,237,0.1595744680851064,0.2705749718151071,medlm,mimiciii,progress_note,PROMPT2_entailment
160,40,24,23,1,0.9583333333333334,117,52,65,0.4444444444444444,0.6072607260726073,medlm,mimiciii,progress_note,PROMPT2_entailment
161,41,25,22,3,0.88,119,52,67,0.4369747899159664,0.5839714139867278,medlm,mimiciii,progress_note,PROMPT2_entailment
162,42,19,16,3,0.8421052631578947,119,43,76,0.361344537815126,0.5056964351341419,medlm,mimiciii,progress_note,PROMPT2_entailment
163,43,16,11,5,0.6875,117,33,84,0.282051282051282,0.4,medlm,mimiciii,progress_note,PROMPT2_entailment
164,44,32,31,1,0.96875,149,116,33,0.7785234899328859,0.8632817188812867,medlm,mimiciii,progress_note,PROMPT2_entailment
165,45,21,19,2,0.9047619047619048,125,46,79,0.368,0.5231966477102664,medlm,mimiciii,progress_note,PROMPT2_entailment
166,46,13,10,3,0.7692307692307693,52,21,31,0.4038461538461538,0.5296343001261035,medlm,mimiciii,progress_note,PROMPT2_entailment
167,47,4,3,1,0.75,12,6,6,0.5,0.6,medlm,mimiciii,progress_note,PROMPT2_entailment
168,49,27,17,10,0.6296296296296297,87,27,60,0.3103448275862069,0.4157608695652173,medlm,mimiciii,progress_note,PROMPT2_entailment
169,5,55,49,6,0.8909090909090909,300,78,222,0.26,0.4025276461295419,medlm,mimiciii,progress_note,PROMPT2_entailment
170,50,52,48,4,0.9230769230769232,176,66,110,0.375,0.5333333333333333,medlm,mimiciii,progress_note,PROMPT2_entailment
171,51,27,11,16,0.4074074074074074,302,39,263,0.1291390728476821,0.1961142857142857,medlm,mimiciii,progress_note,PROMPT2_entailment
172,52,18,14,4,0.7777777777777778,302,52,250,0.1721854304635761,0.2819519752130132,medlm,mimiciii,progress_note,PROMPT2_entailment
173,53,17,13,4,0.7647058823529411,382,74,308,0.193717277486911,0.3091259640102827,medlm,mimiciii,progress_note,PROMPT2_entailment
174,54,11,5,6,0.4545454545454545,219,23,196,0.1050228310502283,0.1706231454005934,medlm,mimiciii,progress_note,PROMPT2_entailment
175,55,26,15,11,0.5769230769230769,286,54,232,0.1888111888111888,0.2845100105374078,medlm,mimiciii,progress_note,PROMPT2_entailment
176,56,8,8,0,1.0,48,22,26,0.4583333333333333,0.6285714285714286,medlm,mimiciii,progress_note,PROMPT2_entailment
177,57,9,7,2,0.7777777777777778,46,17,29,0.3695652173913043,0.5010526315789474,medlm,mimiciii,progress_note,PROMPT2_entailment
178,58,13,10,3,0.7692307692307693,39,13,26,0.3333333333333333,0.4651162790697674,medlm,mimiciii,progress_note,PROMPT2_entailment
179,59,14,7,7,0.5,39,14,25,0.358974358974359,0.417910447761194,medlm,mimiciii,progress_note,PROMPT2_entailment
180,6,11,8,3,0.7272727272727273,331,23,308,0.0694864048338368,0.1268528093760772,medlm,mimiciii,progress_note,PROMPT2_entailment
181,60,58,35,23,0.603448275862069,276,54,222,0.1956521739130435,0.2954971857410882,medlm,mimiciii,progress_note,PROMPT2_entailment
182,61,22,19,3,0.8636363636363636,56,16,40,0.2857142857142857,0.4293785310734463,medlm,mimiciii,progress_note,PROMPT2_entailment
183,62,22,18,4,0.8181818181818182,56,16,40,0.2857142857142857,0.4235294117647059,medlm,mimiciii,progress_note,PROMPT2_entailment
184,63,21,19,2,0.9047619047619048,142,61,81,0.4295774647887324,0.5825584317667756,medlm,mimiciii,progress_note,PROMPT2_entailment
185,64,3,2,1,0.6666666666666666,1,1,0,1.0,0.8,medlm,mimiciii,progress_note,PROMPT2_entailment
186,65,4,4,0,1.0,12,12,0,1.0,1.0,medlm,mimiciii,progress_note,PROMPT2_entailment
187,66,25,25,0,1.0,68,38,30,0.5588235294117647,0.7169811320754718,medlm,mimiciii,progress_note,PROMPT2_entailment
188,67,12,8,4,0.6666666666666666,490,99,391,0.2020408163265306,0.3101018010963195,medlm,mimiciii,progress_note,PROMPT2_entailment
189,68,47,34,13,0.723404255319149,348,102,246,0.293103448275862,0.4171779141104294,medlm,mimiciii,progress_note,PROMPT2_entailment
190,69,70,61,9,0.8714285714285714,373,84,289,0.225201072386059,0.3579087067369819,medlm,mimiciii,progress_note,PROMPT2_entailment
191,7,14,13,1,0.9285714285714286,331,41,290,0.1238670694864048,0.2185769940537215,medlm,mimiciii,progress_note,PROMPT2_entailment
192,70,22,19,3,0.8636363636363636,374,85,289,0.2272727272727272,0.3598484848484848,medlm,mimiciii,progress_note,PROMPT2_entailment
193,71,8,7,1,0.875,372,51,321,0.1370967741935483,0.2370517928286852,medlm,mimiciii,progress_note,PROMPT2_entailment
194,72,5,5,0,1.0,20,9,11,0.45,0.6206896551724138,medlm,mimiciii,progress_note,PROMPT2_entailment
195,73,32,27,5,0.84375,460,82,378,0.1782608695652174,0.294336612603031,medlm,mimiciii,progress_note,PROMPT2_entailment
196,74,15,11,4,0.7333333333333333,319,77,242,0.2413793103448276,0.3632075471698113,medlm,mimiciii,progress_note,PROMPT2_entailment
197,75,35,31,4,0.8857142857142857,62,27,35,0.4354838709677419,0.5838855946982908,medlm,mimiciii,progress_note,PROMPT2_entailment
198,76,20,13,7,0.65,86,60,26,0.6976744186046512,0.6729939603106126,medlm,mimiciii,progress_note,PROMPT2_entailment
199,77,7,7,0,1.0,38,15,23,0.3947368421052631,0.5660377358490566,medlm,mimiciii,progress_note,PROMPT2_entailment
200,78,20,18,2,0.9,30,15,15,0.5,0.6428571428571429,medlm,mimiciii,progress_note,PROMPT2_entailment
201,79,15,13,2,0.8666666666666667,67,25,42,0.373134328358209,0.521669341894061,medlm,mimiciii,progress_note,PROMPT2_entailment
202,8,37,27,10,0.7297297297297297,118,39,79,0.3305084745762712,0.4549578742709008,medlm,mimiciii,progress_note,PROMPT2_entailment
203,80,21,19,2,0.9047619047619048,32,15,17,0.46875,0.6175514626218852,medlm,mimiciii,progress_note,PROMPT2_entailment
204,81,18,17,1,0.9444444444444444,46,28,18,0.6086956521739131,0.7402799377916018,medlm,mimiciii,progress_note,PROMPT2_entailment
205,82,2,2,0,1.0,18,5,13,0.2777777777777778,0.4347826086956522,medlm,mimiciii,progress_note,PROMPT2_entailment
206,83,18,15,3,0.8333333333333334,66,26,40,0.3939393939393939,0.5349794238683128,medlm,mimiciii,progress_note,PROMPT2_entailment
207,84,8,8,0,1.0,48,20,28,0.4166666666666667,0.5882352941176471,medlm,mimiciii,progress_note,PROMPT2_entailment
208,85,5,2,3,0.4,77,46,31,0.5974025974025974,0.4791666666666667,medlm,mimiciii,progress_note,PROMPT2_entailment
209,87,3,2,1,0.6666666666666666,15,1,14,0.0666666666666666,0.1212121212121212,medlm,mimiciii,progress_note,PROMPT2_entailment
210,88,33,27,6,0.8181818181818182,105,38,67,0.3619047619047619,0.5018341892883346,medlm,mimiciii,progress_note,PROMPT2_entailment
211,89,16,12,4,0.75,339,38,301,0.1120943952802359,0.195038494439692,medlm,mimiciii,progress_note,PROMPT2_entailment
212,9,15,13,2,0.8666666666666667,61,34,27,0.5573770491803278,0.6784343821949347,medlm,mimiciii,progress_note,PROMPT2_entailment
213,90,3,3,0,1.0,4,4,0,1.0,1.0,medlm,mimiciii,progress_note,PROMPT2_entailment
214,91,23,18,5,0.782608695652174,112,51,61,0.4553571428571428,0.5757290686735653,medlm,mimiciii,progress_note,PROMPT2_entailment
215,92,8,6,2,0.75,208,40,168,0.1923076923076923,0.3061224489795919,medlm,mimiciii,progress_note,PROMPT2_entailment
216,93,8,7,1,0.875,38,14,24,0.3684210526315789,0.5185185185185185,medlm,mimiciii,progress_note,PROMPT2_entailment
217,94,37,32,5,0.8648648648648649,112,47,65,0.4196428571428571,0.5650948713131693,medlm,mimiciii,progress_note,PROMPT2_entailment
218,95,14,4,10,0.2857142857142857,49,15,34,0.3061224489795918,0.2955665024630541,medlm,mimiciii,progress_note,PROMPT2_entailment
219,96,3,2,1,0.6666666666666666,14,5,9,0.3571428571428571,0.4651162790697674,medlm,mimiciii,progress_note,PROMPT2_entailment
220,97,4,4,0,1.0,20,15,5,0.75,0.8571428571428571,medlm,mimiciii,progress_note,PROMPT2_entailment
221,98,11,10,1,0.9090909090909092,35,18,17,0.5142857142857142,0.6569343065693429,medlm,mimiciii,progress_note,PROMPT2_entailment
222,99,11,10,1,0.9090909090909092,104,34,70,0.3269230769230769,0.4809052333804808,medlm,mimiciii,progress_note,PROMPT2_entailment
0,0,6,6,0,1.0,6,6,0,1.0,1.0,medlm,medalign,nursing_note,PROMPT1_entailment
1,1,3,3,0,1.0,1,1,0,1.0,1.0,medlm,medalign,nursing_note,PROMPT1_entailment
2,10,6,5,1,0.8333333333333334,5,3,2,0.6,0.6976744186046512,medlm,medalign,nursing_note,PROMPT1_entailment
3,100,11,10,1,0.9090909090909092,10,6,4,0.6,0.7228915662650602,medlm,medalign,nursing_note,PROMPT1_entailment
4,101,5,5,0,1.0,1,1,0,1.0,1.0,medlm,medalign,nursing_note,PROMPT1_entailment
5,102,5,5,0,1.0,4,4,0,1.0,1.0,medlm,medalign,nursing_note,PROMPT1_entailment
6,103,1,1,0,1.0,2,2,0,1.0,1.0,medlm,medalign,nursing_note,PROMPT1_entailment
7,104,11,10,1,0.9090909090909092,15,11,4,0.7333333333333333,0.8118081180811808,medlm,medalign,nursing_note,PROMPT1_entailment
8,105,1,1,0,1.0,1,1,0,1.0,1.0,medlm,medalign,nursing_note,PROMPT1_entailment
9,106,2,2,0,1.0,1,1,0,1.0,1.0,medlm,medalign,nursing_note,PROMPT1_entailment
10,107,5,4,1,0.8,4,3,1,0.75,0.7741935483870969,medlm,medalign,nursing_note,PROMPT1_entailment
11,108,2,2,0,1.0,2,2,0,1.0,1.0,medlm,medalign,nursing_note,PROMPT1_entailment
12,109,5,5,0,1.0,5,5,0,1.0,1.0,medlm,medalign,nursing_note,PROMPT1_entailment
13,11,1,1,0,1.0,1,1,0,1.0,1.0,medlm,medalign,nursing_note,PROMPT1_entailment
14,111,1,1,0,1.0,1,1,0,1.0,1.0,medlm,medalign,nursing_note,PROMPT1_entailment
15,112,3,2,1,0.6666666666666666,2,2,0,1.0,0.8,medlm,medalign,nursing_note,PROMPT1_entailment
16,113,1,1,0,1.0,1,1,0,1.0,1.0,medlm,medalign,nursing_note,PROMPT1_entailment
17,114,1,1,0,1.0,1,1,0,1.0,1.0,medlm,medalign,nursing_note,PROMPT1_entailment
18,115,12,12,0,1.0,7,5,2,0.7142857142857143,0.8333333333333333,medlm,medalign,nursing_note,PROMPT1_entailment
19,117,13,9,4,0.6923076923076923,13,8,5,0.6153846153846154,0.6515837104072398,medlm,medalign,nursing_note,PROMPT1_entailment
20,118,1,1,0,1.0,2,1,1,0.5,0.6666666666666666,medlm,medalign,nursing_note,PROMPT1_entailment
21,119,2,2,0,1.0,2,2,0,1.0,1.0,medlm,medalign,nursing_note,PROMPT1_entailment
22,12,1,1,0,1.0,1,1,0,1.0,1.0,medlm,medalign,nursing_note,PROMPT1_entailment
23,120,6,6,0,1.0,7,5,2,0.7142857142857143,0.8333333333333333,medlm,medalign,nursing_note,PROMPT1_entailment
24,121,1,1,0,1.0,1,1,0,1.0,1.0,medlm,medalign,nursing_note,PROMPT1_entailment
25,122,6,2,4,0.3333333333333333,1,1,0,1.0,0.5,medlm,medalign,nursing_note,PROMPT1_entailment
26,123,2,2,0,1.0,4,2,2,0.5,0.6666666666666666,medlm,medalign,nursing_note,PROMPT1_entailment
27,124,11,11,0,1.0,14,12,2,0.8571428571428571,0.923076923076923,medlm,medalign,nursing_note,PROMPT1_entailment
28,125,5,5,0,1.0,9,5,4,0.5555555555555556,0.7142857142857143,medlm,medalign,nursing_note,PROMPT1_entailment
29,126,1,1,0,1.0,2,1,1,0.5,0.6666666666666666,medlm,medalign,nursing_note,PROMPT1_entailment
30,127,1,0,1,0.0,1,0,1,0.0,,medlm,medalign,nursing_note,PROMPT1_entailment
31,128,3,3,0,1.0,2,2,0,1.0,1.0,medlm,medalign,nursing_note,PROMPT1_entailment
32,129,10,10,0,1.0,20,10,10,0.5,0.6666666666666666,medlm,medalign,nursing_note,PROMPT1_entailment
33,13,7,7,0,1.0,5,5,0,1.0,1.0,medlm,medalign,nursing_note,PROMPT1_entailment
34,130,5,5,0,1.0,2,2,0,1.0,1.0,medlm,medalign,nursing_note,PROMPT1_entailment
35,131,2,2,0,1.0,1,1,0,1.0,1.0,medlm,medalign,nursing_note,PROMPT1_entailment
36,132,5,4,1,0.8,2,2,0,1.0,0.888888888888889,medlm,medalign,nursing_note,PROMPT1_entailment
37,133,10,8,2,0.8,14,7,7,0.5,0.6153846153846154,medlm,medalign,nursing_note,PROMPT1_entailment
38,134,5,5,0,1.0,3,3,0,1.0,1.0,medlm,medalign,nursing_note,PROMPT1_entailment
39,135,4,4,0,1.0,2,2,0,1.0,1.0,medlm,medalign,nursing_note,PROMPT1_entailment
40,136,8,7,1,0.875,51,17,34,0.3333333333333333,0.4827586206896551,medlm,medalign,nursing_note,PROMPT1_entailment
41,137,6,6,0,1.0,6,6,0,1.0,1.0,medlm,medalign,nursing_note,PROMPT1_entailment
42,138,1,1,0,1.0,1,1,0,1.0,1.0,medlm,medalign,nursing_note,PROMPT1_entailment
43,139,3,3,0,1.0,1,1,0,1.0,1.0,medlm,medalign,nursing_note,PROMPT1_entailment
44,14,1,1,0,1.0,1,1,0,1.0,1.0,medlm,medalign,nursing_note,PROMPT1_entailment
45,140,4,4,0,1.0,3,3,0,1.0,1.0,medlm,medalign,nursing_note,PROMPT1_entailment
46,141,1,1,0,1.0,1,1,0,1.0,1.0,medlm,medalign,nursing_note,PROMPT1_entailment
47,142,2,2,0,1.0,1,1,0,1.0,1.0,medlm,medalign,nursing_note,PROMPT1_entailment
48,143,1,1,0,1.0,1,1,0,1.0,1.0,medlm,medalign,nursing_note,PROMPT1_entailment
49,144,1,1,0,1.0,1,1,0,1.0,1.0,medlm,medalign,nursing_note,PROMPT1_entailment
50,145,4,4,0,1.0,4,4,0,1.0,1.0,medlm,medalign,nursing_note,PROMPT1_entailment
51,146,6,6,0,1.0,3,2,1,0.6666666666666666,0.8,medlm,medalign,nursing_note,PROMPT1_entailment
52,147,9,9,0,1.0,6,5,1,0.8333333333333334,0.9090909090909092,medlm,medalign,nursing_note,PROMPT1_entailment
53,148,7,7,0,1.0,7,7,0,1.0,1.0,medlm,medalign,nursing_note,PROMPT1_entailment
54,149,3,3,0,1.0,1,0,1,0.0,0.0,medlm,medalign,nursing_note,PROMPT1_entailment
55,15,2,2,0,1.0,1,0,1,0.0,0.0,medlm,medalign,nursing_note,PROMPT1_entailment
56,150,3,3,0,1.0,1,1,0,1.0,1.0,medlm,medalign,nursing_note,PROMPT1_entailment
57,151,5,5,0,1.0,8,7,1,0.875,0.9333333333333332,medlm,medalign,nursing_note,PROMPT1_entailment
58,152,4,4,0,1.0,4,4,0,1.0,1.0,medlm,medalign,nursing_note,PROMPT1_entailment
59,153,13,11,2,0.8461538461538461,14,12,2,0.8571428571428571,0.8516129032258064,medlm,medalign,nursing_note,PROMPT1_entailment
60,154,2,2,0,1.0,1,1,0,1.0,1.0,medlm,medalign,nursing_note,PROMPT1_entailment
61,155,9,8,1,0.8888888888888888,14,8,6,0.5714285714285714,0.6956521739130435,medlm,medalign,nursing_note,PROMPT1_entailment
62,156,3,3,0,1.0,1,0,1,0.0,0.0,medlm,medalign,nursing_note,PROMPT1_entailment
63,157,4,4,0,1.0,3,3,0,1.0,1.0,medlm,medalign,nursing_note,PROMPT1_entailment
64,158,3,3,0,1.0,1,1,0,1.0,1.0,medlm,medalign,nursing_note,PROMPT1_entailment
65,159,6,6,0,1.0,3,3,0,1.0,1.0,medlm,medalign,nursing_note,PROMPT1_entailment
66,16,5,5,0,1.0,3,2,1,0.6666666666666666,0.8,medlm,medalign,nursing_note,PROMPT1_entailment
67,160,2,2,0,1.0,1,1,0,1.0,1.0,medlm,medalign,nursing_note,PROMPT1_entailment
68,161,5,5,0,1.0,1,1,0,1.0,1.0,medlm,medalign,nursing_note,PROMPT1_entailment
69,162,11,7,4,0.6363636363636364,8,6,2,0.75,0.6885245901639345,medlm,medalign,nursing_note,PROMPT1_entailment
70,163,5,5,0,1.0,3,3,0,1.0,1.0,medlm,medalign,nursing_note,PROMPT1_entailment
71,164,3,3,0,1.0,2,2,0,1.0,1.0,medlm,medalign,nursing_note,PROMPT1_entailment
72,165,4,4,0,1.0,4,2,2,0.5,0.6666666666666666,medlm,medalign,nursing_note,PROMPT1_entailment
73,166,8,6,2,0.75,5,4,1,0.8,0.7741935483870969,medlm,medalign,nursing_note,PROMPT1_entailment
74,167,4,4,0,1.0,2,1,1,0.5,0.6666666666666666,medlm,medalign,nursing_note,PROMPT1_entailment
75,168,2,2,0,1.0,3,2,1,0.6666666666666666,0.8,medlm,medalign,nursing_note,PROMPT1_entailment
76,169,11,11,0,1.0,9,9,0,1.0,1.0,medlm,medalign,nursing_note,PROMPT1_entailment
77,17,2,2,0,1.0,1,1,0,1.0,1.0,medlm,medalign,nursing_note,PROMPT1_entailment
78,170,1,1,0,1.0,1,1,0,1.0,1.0,medlm,medalign,nursing_note,PROMPT1_entailment
79,172,9,6,3,0.6666666666666666,12,5,7,0.4166666666666667,0.5128205128205129,medlm,medalign,nursing_note,PROMPT1_entailment
80,173,6,6,0,1.0,1,1,0,1.0,1.0,medlm,medalign,nursing_note,PROMPT1_entailment
81,174,3,3,0,1.0,1,1,0,1.0,1.0,medlm,medalign,nursing_note,PROMPT1_entailment
82,175,2,2,0,1.0,2,2,0,1.0,1.0,medlm,medalign,nursing_note,PROMPT1_entailment
83,177,6,6,0,1.0,8,4,4,0.5,0.6666666666666666,medlm,medalign,nursing_note,PROMPT1_entailment
84,178,7,7,0,1.0,10,4,6,0.4,0.5714285714285715,medlm,medalign,nursing_note,PROMPT1_entailment
85,179,6,4,2,0.6666666666666666,2,1,1,0.5,0.5714285714285715,medlm,medalign,nursing_note,PROMPT1_entailment
86,18,7,7,0,1.0,3,2,1,0.6666666666666666,0.8,medlm,medalign,nursing_note,PROMPT1_entailment
87,181,5,5,0,1.0,7,7,0,1.0,1.0,medlm,medalign,nursing_note,PROMPT1_entailment
88,182,3,3,0,1.0,2,1,1,0.5,0.6666666666666666,medlm,medalign,nursing_note,PROMPT1_entailment
89,183,5,5,0,1.0,6,5,1,0.8333333333333334,0.9090909090909092,medlm,medalign,nursing_note,PROMPT1_entailment
90,184,9,7,2,0.7777777777777778,11,6,5,0.5454545454545454,0.6412213740458015,medlm,medalign,nursing_note,PROMPT1_entailment
91,185,3,3,0,1.0,3,3,0,1.0,1.0,medlm,medalign,nursing_note,PROMPT1_entailment
92,186,3,3,0,1.0,3,2,1,0.6666666666666666,0.8,medlm,medalign,nursing_note,PROMPT1_entailment
93,187,1,1,0,1.0,1,1,0,1.0,1.0,medlm,medalign,nursing_note,PROMPT1_entailment
94,188,2,2,0,1.0,3,3,0,1.0,1.0,medlm,medalign,nursing_note,PROMPT1_entailment
95,189,5,4,1,0.8,10,6,4,0.6,0.6857142857142857,medlm,medalign,nursing_note,PROMPT1_entailment
96,19,5,5,0,1.0,7,5,2,0.7142857142857143,0.8333333333333333,medlm,medalign,nursing_note,PROMPT1_entailment
97,190,3,3,0,1.0,2,2,0,1.0,1.0,medlm,medalign,nursing_note,PROMPT1_entailment
98,191,8,8,0,1.0,5,3,2,0.6,0.7499999999999999,medlm,medalign,nursing_note,PROMPT1_entailment
99,192,3,3,0,1.0,1,1,0,1.0,1.0,medlm,medalign,nursing_note,PROMPT1_entailment
100,193,3,3,0,1.0,3,3,0,1.0,1.0,medlm,medalign,nursing_note,PROMPT1_entailment
101,194,1,0,1,0.0,2,0,2,0.0,,medlm,medalign,nursing_note,PROMPT1_entailment
102,195,10,8,2,0.8,10,4,6,0.4,0.5333333333333333,medlm,medalign,nursing_note,PROMPT1_entailment
103,196,3,2,1,0.6666666666666666,1,1,0,1.0,0.8,medlm,medalign,nursing_note,PROMPT1_entailment
104,197,2,2,0,1.0,1,1,0,1.0,1.0,medlm,medalign,nursing_note,PROMPT1_entailment
105,198,14,10,4,0.7142857142857143,8,6,2,0.75,0.7317073170731706,medlm,medalign,nursing_note,PROMPT1_entailment
106,199,9,8,1,0.8888888888888888,7,7,0,1.0,0.9411764705882352,medlm,medalign,nursing_note,PROMPT1_entailment
107,20,5,4,1,0.8,2,2,0,1.0,0.888888888888889,medlm,medalign,nursing_note,PROMPT1_entailment
108,200,3,3,0,1.0,3,3,0,1.0,1.0,medlm,medalign,nursing_note,PROMPT1_entailment
109,201,2,2,0,1.0,1,1,0,1.0,1.0,medlm,medalign,nursing_note,PROMPT1_entailment
110,202,2,2,0,1.0,1,0,1,0.0,0.0,medlm,medalign,nursing_note,PROMPT1_entailment
111,203,1,1,0,1.0,1,1,0,1.0,1.0,medlm,medalign,nursing_note,PROMPT1_entailment
112,204,9,7,2,0.7777777777777778,9,3,6,0.3333333333333333,0.4666666666666666,medlm,medalign,nursing_note,PROMPT1_entailment
113,205,21,9,12,0.4285714285714285,8,3,5,0.375,0.3999999999999999,medlm,medalign,nursing_note,PROMPT1_entailment
114,206,4,3,1,0.75,4,4,0,1.0,0.8571428571428571,medlm,medalign,nursing_note,PROMPT1_entailment
115,207,6,6,0,1.0,6,5,1,0.8333333333333334,0.9090909090909092,medlm,medalign,nursing_note,PROMPT1_entailment
116,208,12,8,4,0.6666666666666666,10,7,3,0.7,0.6829268292682926,medlm,medalign,nursing_note,PROMPT1_entailment
117,209,2,2,0,1.0,1,1,0,1.0,1.0,medlm,medalign,nursing_note,PROMPT1_entailment
118,21,4,4,0,1.0,1,1,0,1.0,1.0,medlm,medalign,nursing_note,PROMPT1_entailment
119,210,3,2,1,0.6666666666666666,2,1,1,0.5,0.5714285714285715,medlm,medalign,nursing_note,PROMPT1_entailment
120,211,1,1,0,1.0,2,0,2,0.0,0.0,medlm,medalign,nursing_note,PROMPT1_entailment
121,212,5,5,0,1.0,3,3,0,1.0,1.0,medlm,medalign,nursing_note,PROMPT1_entailment
122,213,11,10,1,0.9090909090909092,8,8,0,1.0,0.9523809523809524,medlm,medalign,nursing_note,PROMPT1_entailment
123,214,2,2,0,1.0,2,1,1,0.5,0.6666666666666666,medlm,medalign,nursing_note,PROMPT1_entailment
124,215,2,2,0,1.0,1,1,0,1.0,1.0,medlm,medalign,nursing_note,PROMPT1_entailment
125,216,3,3,0,1.0,3,3,0,1.0,1.0,medlm,medalign,nursing_note,PROMPT1_entailment
126,217,9,7,2,0.7777777777777778,11,5,6,0.4545454545454545,0.5737704918032788,medlm,medalign,nursing_note,PROMPT1_entailment
127,218,8,7,1,0.875,3,2,1,0.6666666666666666,0.7567567567567567,medlm,medalign,nursing_note,PROMPT1_entailment
128,219,3,2,1,0.6666666666666666,2,1,1,0.5,0.5714285714285715,medlm,medalign,nursing_note,PROMPT1_entailment
129,22,1,0,1,0.0,1,0,1,0.0,,medlm,medalign,nursing_note,PROMPT1_entailment
130,220,9,7,2,0.7777777777777778,7,3,4,0.4285714285714285,0.5526315789473685,medlm,medalign,nursing_note,PROMPT1_entailment
131,221,12,11,1,0.9166666666666666,23,10,13,0.4347826086956521,0.5898123324396782,medlm,medalign,nursing_note,PROMPT1_entailment
132,222,4,4,0,1.0,4,4,0,1.0,1.0,medlm,medalign,nursing_note,PROMPT1_entailment
133,223,2,2,0,1.0,2,1,1,0.5,0.6666666666666666,medlm,medalign,nursing_note,PROMPT1_entailment
134,225,3,3,0,1.0,2,1,1,0.5,0.6666666666666666,medlm,medalign,nursing_note,PROMPT1_entailment
135,227,1,1,0,1.0,1,1,0,1.0,1.0,medlm,medalign,nursing_note,PROMPT1_entailment
136,228,17,13,4,0.7647058823529411,18,17,1,0.9444444444444444,0.8451242829827915,medlm,medalign,nursing_note,PROMPT1_entailment
137,229,11,9,2,0.8181818181818182,7,4,3,0.5714285714285714,0.6728971962616823,medlm,medalign,nursing_note,PROMPT1_entailment
138,23,13,8,5,0.6153846153846154,21,6,15,0.2857142857142857,0.3902439024390244,medlm,medalign,nursing_note,PROMPT1_entailment
139,230,1,1,0,1.0,1,1,0,1.0,1.0,medlm,medalign,nursing_note,PROMPT1_entailment
140,231,9,7,2,0.7777777777777778,13,8,5,0.6153846153846154,0.6871165644171779,medlm,medalign,nursing_note,PROMPT1_entailment
141,232,9,8,1,0.8888888888888888,6,5,1,0.8333333333333334,0.8602150537634408,medlm,medalign,nursing_note,PROMPT1_entailment
142,233,4,3,1,0.75,4,4,0,1.0,0.8571428571428571,medlm,medalign,nursing_note,PROMPT1_entailment
143,234,4,4,0,1.0,2,1,1,0.5,0.6666666666666666,medlm,medalign,nursing_note,PROMPT1_entailment
144,235,1,0,1,0.0,1,0,1,0.0,,medlm,medalign,nursing_note,PROMPT1_entailment
145,236,9,9,0,1.0,14,8,6,0.5714285714285714,0.7272727272727273,medlm,medalign,nursing_note,PROMPT1_entailment
146,238,7,7,0,1.0,4,4,0,1.0,1.0,medlm,medalign,nursing_note,PROMPT1_entailment
147,239,7,6,1,0.8571428571428571,4,3,1,0.75,0.7999999999999999,medlm,medalign,nursing_note,PROMPT1_entailment
148,24,1,0,1,0.0,1,0,1,0.0,,medlm,medalign,nursing_note,PROMPT1_entailment
149,240,1,1,0,1.0,2,1,1,0.5,0.6666666666666666,medlm,medalign,nursing_note,PROMPT1_entailment
150,241,4,4,0,1.0,2,2,0,1.0,1.0,medlm,medalign,nursing_note,PROMPT1_entailment
151,242,7,7,0,1.0,2,1,1,0.5,0.6666666666666666,medlm,medalign,nursing_note,PROMPT1_entailment
152,243,5,4,1,0.8,10,9,1,0.9,0.8470588235294118,medlm,medalign,nursing_note,PROMPT1_entailment
153,244,1,1,0,1.0,1,1,0,1.0,1.0,medlm,medalign,nursing_note,PROMPT1_entailment
154,245,3,3,0,1.0,1,0,1,0.0,0.0,medlm,medalign,nursing_note,PROMPT1_entailment
155,246,1,1,0,1.0,1,1,0,1.0,1.0,medlm,medalign,nursing_note,PROMPT1_entailment
156,247,5,5,0,1.0,5,5,0,1.0,1.0,medlm,medalign,nursing_note,PROMPT1_entailment
157,248,1,1,0,1.0,1,1,0,1.0,1.0,medlm,medalign,nursing_note,PROMPT1_entailment
158,249,5,5,0,1.0,2,1,1,0.5,0.6666666666666666,medlm,medalign,nursing_note,PROMPT1_entailment
159,25,12,11,1,0.9166666666666666,33,16,17,0.4848484848484848,0.6342342342342343,medlm,medalign,nursing_note,PROMPT1_entailment
160,26,2,2,0,1.0,1,1,0,1.0,1.0,medlm,medalign,nursing_note,PROMPT1_entailment
161,27,7,7,0,1.0,2,2,0,1.0,1.0,medlm,medalign,nursing_note,PROMPT1_entailment
162,29,4,4,0,1.0,3,1,2,0.3333333333333333,0.5,medlm,medalign,nursing_note,PROMPT1_entailment
163,3,3,3,0,1.0,2,1,1,0.5,0.6666666666666666,medlm,medalign,nursing_note,PROMPT1_entailment
164,30,2,2,0,1.0,1,1,0,1.0,1.0,medlm,medalign,nursing_note,PROMPT1_entailment
165,31,1,1,0,1.0,1,1,0,1.0,1.0,medlm,medalign,nursing_note,PROMPT1_entailment
166,32,3,3,0,1.0,2,2,0,1.0,1.0,medlm,medalign,nursing_note,PROMPT1_entailment
167,33,7,6,1,0.8571428571428571,5,4,1,0.8,0.8275862068965518,medlm,medalign,nursing_note,PROMPT1_entailment
168,34,8,7,1,0.875,4,1,3,0.25,0.3888888888888889,medlm,medalign,nursing_note,PROMPT1_entailment
169,35,5,5,0,1.0,4,1,3,0.25,0.4,medlm,medalign,nursing_note,PROMPT1_entailment
170,36,18,11,7,0.6111111111111112,5,3,2,0.6,0.6055045871559633,medlm,medalign,nursing_note,PROMPT1_entailment
171,37,4,4,0,1.0,3,2,1,0.6666666666666666,0.8,medlm,medalign,nursing_note,PROMPT1_entailment
172,39,3,3,0,1.0,1,1,0,1.0,1.0,medlm,medalign,nursing_note,PROMPT1_entailment
173,4,3,2,1,0.6666666666666666,3,3,0,1.0,0.8,medlm,medalign,nursing_note,PROMPT1_entailment
174,40,11,10,1,0.9090909090909092,8,2,6,0.25,0.392156862745098,medlm,medalign,nursing_note,PROMPT1_entailment
175,41,2,2,0,1.0,1,1,0,1.0,1.0,medlm,medalign,nursing_note,PROMPT1_entailment
176,42,10,9,1,0.9,8,2,6,0.25,0.391304347826087,medlm,medalign,nursing_note,PROMPT1_entailment
177,43,3,2,1,0.6666666666666666,2,2,0,1.0,0.8,medlm,medalign,nursing_note,PROMPT1_entailment
178,44,2,2,0,1.0,1,1,0,1.0,1.0,medlm,medalign,nursing_note,PROMPT1_entailment
179,45,1,1,0,1.0,1,1,0,1.0,1.0,medlm,medalign,nursing_note,PROMPT1_entailment
180,46,5,5,0,1.0,5,5,0,1.0,1.0,medlm,medalign,nursing_note,PROMPT1_entailment
181,47,18,18,0,1.0,20,18,2,0.9,0.9473684210526316,medlm,medalign,nursing_note,PROMPT1_entailment
182,48,2,2,0,1.0,2,2,0,1.0,1.0,medlm,medalign,nursing_note,PROMPT1_entailment
183,49,2,2,0,1.0,2,1,1,0.5,0.6666666666666666,medlm,medalign,nursing_note,PROMPT1_entailment
184,5,3,3,0,1.0,5,3,2,0.6,0.7499999999999999,medlm,medalign,nursing_note,PROMPT1_entailment
185,50,1,1,0,1.0,1,1,0,1.0,1.0,medlm,medalign,nursing_note,PROMPT1_entailment
186,51,2,2,0,1.0,2,2,0,1.0,1.0,medlm,medalign,nursing_note,PROMPT1_entailment
187,52,4,3,1,0.75,4,4,0,1.0,0.8571428571428571,medlm,medalign,nursing_note,PROMPT1_entailment
188,53,1,1,0,1.0,1,1,0,1.0,1.0,medlm,medalign,nursing_note,PROMPT1_entailment
189,54,11,8,3,0.7272727272727273,7,6,1,0.8571428571428571,0.7868852459016394,medlm,medalign,nursing_note,PROMPT1_entailment
190,55,3,3,0,1.0,2,1,1,0.5,0.6666666666666666,medlm,medalign,nursing_note,PROMPT1_entailment
191,56,6,6,0,1.0,3,3,0,1.0,1.0,medlm,medalign,nursing_note,PROMPT1_entailment
192,58,2,2,0,1.0,1,1,0,1.0,1.0,medlm,medalign,nursing_note,PROMPT1_entailment
193,59,2,2,0,1.0,1,1,0,1.0,1.0,medlm,medalign,nursing_note,PROMPT1_entailment
194,6,2,2,0,1.0,3,3,0,1.0,1.0,medlm,medalign,nursing_note,PROMPT1_entailment
195,60,8,8,0,1.0,9,9,0,1.0,1.0,medlm,medalign,nursing_note,PROMPT1_entailment
196,61,1,1,0,1.0,1,1,0,1.0,1.0,medlm,medalign,nursing_note,PROMPT1_entailment
197,62,9,9,0,1.0,5,2,3,0.4,0.5714285714285715,medlm,medalign,nursing_note,PROMPT1_entailment
198,63,8,8,0,1.0,7,3,4,0.4285714285714285,0.6,medlm,medalign,nursing_note,PROMPT1_entailment
199,64,4,2,2,0.5,1,0,1,0.0,0.0,medlm,medalign,nursing_note,PROMPT1_entailment
200,65,3,3,0,1.0,2,1,1,0.5,0.6666666666666666,medlm,medalign,nursing_note,PROMPT1_entailment
201,66,4,4,0,1.0,4,4,0,1.0,1.0,medlm,medalign,nursing_note,PROMPT1_entailment
202,67,3,3,0,1.0,4,4,0,1.0,1.0,medlm,medalign,nursing_note,PROMPT1_entailment
203,68,4,4,0,1.0,1,1,0,1.0,1.0,medlm,medalign,nursing_note,PROMPT1_entailment
204,69,5,4,1,0.8,2,2,0,1.0,0.888888888888889,medlm,medalign,nursing_note,PROMPT1_entailment
205,7,3,3,0,1.0,1,1,0,1.0,1.0,medlm,medalign,nursing_note,PROMPT1_entailment
206,70,4,4,0,1.0,1,1,0,1.0,1.0,medlm,medalign,nursing_note,PROMPT1_entailment
207,71,6,5,1,0.8333333333333334,1,0,1,0.0,0.0,medlm,medalign,nursing_note,PROMPT1_entailment
208,72,1,1,0,1.0,1,1,0,1.0,1.0,medlm,medalign,nursing_note,PROMPT1_entailment
209,73,6,6,0,1.0,2,2,0,1.0,1.0,medlm,medalign,nursing_note,PROMPT1_entailment
210,75,1,1,0,1.0,1,1,0,1.0,1.0,medlm,medalign,nursing_note,PROMPT1_entailment
211,76,9,9,0,1.0,5,3,2,0.6,0.7499999999999999,medlm,medalign,nursing_note,PROMPT1_entailment
212,77,5,5,0,1.0,3,3,0,1.0,1.0,medlm,medalign,nursing_note,PROMPT1_entailment
213,78,3,3,0,1.0,3,2,1,0.6666666666666666,0.8,medlm,medalign,nursing_note,PROMPT1_entailment
214,79,7,7,0,1.0,8,4,4,0.5,0.6666666666666666,medlm,medalign,nursing_note,PROMPT1_entailment
215,8,5,5,0,1.0,8,4,4,0.5,0.6666666666666666,medlm,medalign,nursing_note,PROMPT1_entailment
216,80,11,10,1,0.9090909090909092,10,10,0,1.0,0.9523809523809524,medlm,medalign,nursing_note,PROMPT1_entailment
217,81,1,1,0,1.0,1,1,0,1.0,1.0,medlm,medalign,nursing_note,PROMPT1_entailment
218,82,3,3,0,1.0,3,3,0,1.0,1.0,medlm,medalign,nursing_note,PROMPT1_entailment
219,83,2,2,0,1.0,3,1,2,0.3333333333333333,0.5,medlm,medalign,nursing_note,PROMPT1_entailment
220,84,8,6,2,0.75,2,1,1,0.5,0.6,medlm,medalign,nursing_note,PROMPT1_entailment
221,85,6,6,0,1.0,8,6,2,0.75,0.8571428571428571,medlm,medalign,nursing_note,PROMPT1_entailment
222,86,3,2,1,0.6666666666666666,3,3,0,1.0,0.8,medlm,medalign,nursing_note,PROMPT1_entailment
223,87,3,3,0,1.0,2,2,0,1.0,1.0,medlm,medalign,nursing_note,PROMPT1_entailment
224,88,8,8,0,1.0,7,6,1,0.8571428571428571,0.923076923076923,medlm,medalign,nursing_note,PROMPT1_entailment
225,89,5,5,0,1.0,6,5,1,0.8333333333333334,0.9090909090909092,medlm,medalign,nursing_note,PROMPT1_entailment
226,9,3,3,0,1.0,2,2,0,1.0,1.0,medlm,medalign,nursing_note,PROMPT1_entailment
227,90,5,5,0,1.0,1,1,0,1.0,1.0,medlm,medalign,nursing_note,PROMPT1_entailment
228,91,2,2,0,1.0,1,1,0,1.0,1.0,medlm,medalign,nursing_note,PROMPT1_entailment
229,92,4,4,0,1.0,4,2,2,0.5,0.6666666666666666,medlm,medalign,nursing_note,PROMPT1_entailment
230,93,3,3,0,1.0,1,1,0,1.0,1.0,medlm,medalign,nursing_note,PROMPT1_entailment
231,94,3,3,0,1.0,2,2,0,1.0,1.0,medlm,medalign,nursing_note,PROMPT1_entailment
232,95,1,1,0,1.0,1,1,0,1.0,1.0,medlm,medalign,nursing_note,PROMPT1_entailment
233,96,1,1,0,1.0,1,1,0,1.0,1.0,medlm,medalign,nursing_note,PROMPT1_entailment
234,97,6,6,0,1.0,2,2,0,1.0,1.0,medlm,medalign,nursing_note,PROMPT1_entailment
235,98,4,3,1,0.75,5,4,1,0.8,0.7741935483870969,medlm,medalign,nursing_note,PROMPT1_entailment
236,99,12,11,1,0.9166666666666666,7,4,3,0.5714285714285714,0.7039999999999998,medlm,medalign,nursing_note,PROMPT1_entailment
0,0,7,7,0,1.0,6,6,0,1.0,1.0,medlm,medalign,nursing_note,PROMPT1_ICL_entailment
1,1,4,3,1,0.75,1,1,0,1.0,0.8571428571428571,medlm,medalign,nursing_note,PROMPT1_ICL_entailment
2,10,5,5,0,1.0,5,3,2,0.6,0.7499999999999999,medlm,medalign,nursing_note,PROMPT1_ICL_entailment
3,100,11,11,0,1.0,10,7,3,0.7,0.8235294117647058,medlm,medalign,nursing_note,PROMPT1_ICL_entailment
4,101,6,6,0,1.0,1,1,0,1.0,1.0,medlm,medalign,nursing_note,PROMPT1_ICL_entailment
5,102,7,7,0,1.0,4,4,0,1.0,1.0,medlm,medalign,nursing_note,PROMPT1_ICL_entailment
6,103,2,2,0,1.0,2,1,1,0.5,0.6666666666666666,medlm,medalign,nursing_note,PROMPT1_ICL_entailment
7,104,15,13,2,0.8666666666666667,15,10,5,0.6666666666666666,0.7536231884057971,medlm,medalign,nursing_note,PROMPT1_ICL_entailment
8,105,2,1,1,0.5,1,1,0,1.0,0.6666666666666666,medlm,medalign,nursing_note,PROMPT1_ICL_entailment
9,106,9,1,8,0.1111111111111111,1,1,0,1.0,0.1999999999999999,medlm,medalign,nursing_note,PROMPT1_ICL_entailment
10,107,5,3,2,0.6,4,2,2,0.5,0.5454545454545454,medlm,medalign,nursing_note,PROMPT1_ICL_entailment
11,108,2,2,0,1.0,2,2,0,1.0,1.0,medlm,medalign,nursing_note,PROMPT1_ICL_entailment
12,109,13,5,8,0.3846153846153846,5,2,3,0.4,0.392156862745098,medlm,medalign,nursing_note,PROMPT1_ICL_entailment
13,11,1,1,0,1.0,1,1,0,1.0,1.0,medlm,medalign,nursing_note,PROMPT1_ICL_entailment
14,110,16,11,5,0.6875,6,3,3,0.5,0.5789473684210527,medlm,medalign,nursing_note,PROMPT1_ICL_entailment
15,111,1,0,1,0.0,1,0,1,0.0,,medlm,medalign,nursing_note,PROMPT1_ICL_entailment
16,112,4,4,0,1.0,2,2,0,1.0,1.0,medlm,medalign,nursing_note,PROMPT1_ICL_entailment
17,113,1,0,1,0.0,1,1,0,1.0,0.0,medlm,medalign,nursing_note,PROMPT1_ICL_entailment
18,114,4,2,2,0.5,1,1,0,1.0,0.6666666666666666,medlm,medalign,nursing_note,PROMPT1_ICL_entailment
19,115,21,12,9,0.5714285714285714,7,4,3,0.5714285714285714,0.5714285714285714,medlm,medalign,nursing_note,PROMPT1_ICL_entailment
20,116,12,8,4,0.6666666666666666,5,3,2,0.6,0.631578947368421,medlm,medalign,nursing_note,PROMPT1_ICL_entailment
21,117,12,9,3,0.75,13,8,5,0.6153846153846154,0.676056338028169,medlm,medalign,nursing_note,PROMPT1_ICL_entailment
22,118,2,1,1,0.5,2,1,1,0.5,0.5,medlm,medalign,nursing_note,PROMPT1_ICL_entailment
23,119,2,2,0,1.0,2,2,0,1.0,1.0,medlm,medalign,nursing_note,PROMPT1_ICL_entailment
24,12,3,3,0,1.0,1,1,0,1.0,1.0,medlm,medalign,nursing_note,PROMPT1_ICL_entailment
25,120,7,7,0,1.0,7,6,1,0.8571428571428571,0.923076923076923,medlm,medalign,nursing_note,PROMPT1_ICL_entailment
26,121,2,1,1,0.5,1,1,0,1.0,0.6666666666666666,medlm,medalign,nursing_note,PROMPT1_ICL_entailment
27,122,3,2,1,0.6666666666666666,1,1,0,1.0,0.8,medlm,medalign,nursing_note,PROMPT1_ICL_entailment
28,123,4,3,1,0.75,4,3,1,0.75,0.75,medlm,medalign,nursing_note,PROMPT1_ICL_entailment
29,124,111,0,111,0.0,14,1,13,0.0714285714285714,0.0,medlm,medalign,nursing_note,PROMPT1_ICL_entailment
30,125,8,8,0,1.0,9,6,3,0.6666666666666666,0.8,medlm,medalign,nursing_note,PROMPT1_ICL_entailment
31,126,3,2,1,0.6666666666666666,2,2,0,1.0,0.8,medlm,medalign,nursing_note,PROMPT1_ICL_entailment
32,127,2,1,1,0.5,1,1,0,1.0,0.6666666666666666,medlm,medalign,nursing_note,PROMPT1_ICL_entailment
33,128,5,5,0,1.0,2,2,0,1.0,1.0,medlm,medalign,nursing_note,PROMPT1_ICL_entailment
34,129,13,12,1,0.9230769230769232,20,14,6,0.7,0.7962085308056872,medlm,medalign,nursing_note,PROMPT1_ICL_entailment
35,13,4,4,0,1.0,5,4,1,0.8,0.888888888888889,medlm,medalign,nursing_note,PROMPT1_ICL_entailment
36,130,3,3,0,1.0,2,1,1,0.5,0.6666666666666666,medlm,medalign,nursing_note,PROMPT1_ICL_entailment
37,131,4,3,1,0.75,1,1,0,1.0,0.8571428571428571,medlm,medalign,nursing_note,PROMPT1_ICL_entailment
38,132,5,4,1,0.8,2,2,0,1.0,0.888888888888889,medlm,medalign,nursing_note,PROMPT1_ICL_entailment
39,133,10,8,2,0.8,14,8,6,0.5714285714285714,0.6666666666666666,medlm,medalign,nursing_note,PROMPT1_ICL_entailment
40,134,6,6,0,1.0,3,3,0,1.0,1.0,medlm,medalign,nursing_note,PROMPT1_ICL_entailment
41,135,4,3,1,0.75,2,2,0,1.0,0.8571428571428571,medlm,medalign,nursing_note,PROMPT1_ICL_entailment
42,136,38,27,11,0.7105263157894737,51,30,21,0.5882352941176471,0.6436233611442194,medlm,medalign,nursing_note,PROMPT1_ICL_entailment
43,137,6,6,0,1.0,6,6,0,1.0,1.0,medlm,medalign,nursing_note,PROMPT1_ICL_entailment
44,138,1,0,1,0.0,1,0,1,0.0,,medlm,medalign,nursing_note,PROMPT1_ICL_entailment
45,139,2,2,0,1.0,1,1,0,1.0,1.0,medlm,medalign,nursing_note,PROMPT1_ICL_entailment
46,14,1,0,1,0.0,1,0,1,0.0,,medlm,medalign,nursing_note,PROMPT1_ICL_entailment
47,140,5,4,1,0.8,3,3,0,1.0,0.888888888888889,medlm,medalign,nursing_note,PROMPT1_ICL_entailment
48,141,3,3,0,1.0,1,1,0,1.0,1.0,medlm,medalign,nursing_note,PROMPT1_ICL_entailment
49,142,3,3,0,1.0,1,1,0,1.0,1.0,medlm,medalign,nursing_note,PROMPT1_ICL_entailment
50,143,1,0,1,0.0,1,0,1,0.0,,medlm,medalign,nursing_note,PROMPT1_ICL_entailment
51,144,1,0,1,0.0,1,0,1,0.0,,medlm,medalign,nursing_note,PROMPT1_ICL_entailment
52,145,4,4,0,1.0,4,4,0,1.0,1.0,medlm,medalign,nursing_note,PROMPT1_ICL_entailment
53,146,7,7,0,1.0,3,2,1,0.6666666666666666,0.8,medlm,medalign,nursing_note,PROMPT1_ICL_entailment
54,147,8,8,0,1.0,6,2,4,0.3333333333333333,0.5,medlm,medalign,nursing_note,PROMPT1_ICL_entailment
55,148,7,7,0,1.0,7,7,0,1.0,1.0,medlm,medalign,nursing_note,PROMPT1_ICL_entailment
56,149,7,6,1,0.8571428571428571,1,1,0,1.0,0.923076923076923,medlm,medalign,nursing_note,PROMPT1_ICL_entailment
57,15,4,4,0,1.0,1,1,0,1.0,1.0,medlm,medalign,nursing_note,PROMPT1_ICL_entailment
58,150,1,0,1,0.0,1,0,1,0.0,,medlm,medalign,nursing_note,PROMPT1_ICL_entailment
59,151,7,7,0,1.0,8,6,2,0.75,0.8571428571428571,medlm,medalign,nursing_note,PROMPT1_ICL_entailment
60,152,5,5,0,1.0,4,4,0,1.0,1.0,medlm,medalign,nursing_note,PROMPT1_ICL_entailment
61,153,14,11,3,0.7857142857142857,14,6,8,0.4285714285714285,0.5546218487394958,medlm,medalign,nursing_note,PROMPT1_ICL_entailment
62,154,3,1,2,0.3333333333333333,1,1,0,1.0,0.5,medlm,medalign,nursing_note,PROMPT1_ICL_entailment
63,155,14,4,10,0.2857142857142857,14,4,10,0.2857142857142857,0.2857142857142857,medlm,medalign,nursing_note,PROMPT1_ICL_entailment
64,156,4,3,1,0.75,1,1,0,1.0,0.8571428571428571,medlm,medalign,nursing_note,PROMPT1_ICL_entailment
65,157,5,3,2,0.6,3,3,0,1.0,0.7499999999999999,medlm,medalign,nursing_note,PROMPT1_ICL_entailment
66,158,4,4,0,1.0,1,1,0,1.0,1.0,medlm,medalign,nursing_note,PROMPT1_ICL_entailment
67,159,6,6,0,1.0,3,3,0,1.0,1.0,medlm,medalign,nursing_note,PROMPT1_ICL_entailment
68,16,5,5,0,1.0,3,2,1,0.6666666666666666,0.8,medlm,medalign,nursing_note,PROMPT1_ICL_entailment
69,160,3,3,0,1.0,1,1,0,1.0,1.0,medlm,medalign,nursing_note,PROMPT1_ICL_entailment
70,161,3,3,0,1.0,1,1,0,1.0,1.0,medlm,medalign,nursing_note,PROMPT1_ICL_entailment
71,162,11,10,1,0.9090909090909092,8,5,3,0.625,0.7407407407407406,medlm,medalign,nursing_note,PROMPT1_ICL_entailment
72,163,7,6,1,0.8571428571428571,3,3,0,1.0,0.923076923076923,medlm,medalign,nursing_note,PROMPT1_ICL_entailment
73,164,4,3,1,0.75,2,2,0,1.0,0.8571428571428571,medlm,medalign,nursing_note,PROMPT1_ICL_entailment
74,165,5,5,0,1.0,4,2,2,0.5,0.6666666666666666,medlm,medalign,nursing_note,PROMPT1_ICL_entailment
75,166,9,7,2,0.7777777777777778,5,4,1,0.8,0.7887323943661971,medlm,medalign,nursing_note,PROMPT1_ICL_entailment
76,167,5,5,0,1.0,2,1,1,0.5,0.6666666666666666,medlm,medalign,nursing_note,PROMPT1_ICL_entailment
77,168,4,4,0,1.0,3,2,1,0.6666666666666666,0.8,medlm,medalign,nursing_note,PROMPT1_ICL_entailment
78,169,12,10,2,0.8333333333333334,9,6,3,0.6666666666666666,0.7407407407407408,medlm,medalign,nursing_note,PROMPT1_ICL_entailment
79,17,3,2,1,0.6666666666666666,1,1,0,1.0,0.8,medlm,medalign,nursing_note,PROMPT1_ICL_entailment
80,170,1,1,0,1.0,1,1,0,1.0,1.0,medlm,medalign,nursing_note,PROMPT1_ICL_entailment
81,171,13,12,1,0.9230769230769232,7,3,4,0.4285714285714285,0.5853658536585366,medlm,medalign,nursing_note,PROMPT1_ICL_entailment
82,172,14,8,6,0.5714285714285714,12,6,6,0.5,0.5333333333333333,medlm,medalign,nursing_note,PROMPT1_ICL_entailment
83,173,14,6,8,0.4285714285714285,1,1,0,1.0,0.6,medlm,medalign,nursing_note,PROMPT1_ICL_entailment
84,174,3,3,0,1.0,1,1,0,1.0,1.0,medlm,medalign,nursing_note,PROMPT1_ICL_entailment
85,175,9,1,8,0.1111111111111111,2,0,2,0.0,0.0,medlm,medalign,nursing_note,PROMPT1_ICL_entailment
86,176,10,5,5,0.5,3,1,2,0.3333333333333333,0.4,medlm,medalign,nursing_note,PROMPT1_ICL_entailment
87,177,8,0,8,0.0,8,1,7,0.125,0.0,medlm,medalign,nursing_note,PROMPT1_ICL_entailment
88,178,3,2,1,0.6666666666666666,10,2,8,0.2,0.3076923076923076,medlm,medalign,nursing_note,PROMPT1_ICL_entailment
89,179,15,4,11,0.2666666666666666,2,2,0,1.0,0.4210526315789474,medlm,medalign,nursing_note,PROMPT1_ICL_entailment
90,18,8,6,2,0.75,3,2,1,0.6666666666666666,0.7058823529411765,medlm,medalign,nursing_note,PROMPT1_ICL_entailment
91,180,6,3,3,0.5,4,2,2,0.5,0.5,medlm,medalign,nursing_note,PROMPT1_ICL_entailment
92,181,7,7,0,1.0,7,7,0,1.0,1.0,medlm,medalign,nursing_note,PROMPT1_ICL_entailment
93,182,4,3,1,0.75,2,2,0,1.0,0.8571428571428571,medlm,medalign,nursing_note,PROMPT1_ICL_entailment
94,183,6,6,0,1.0,6,6,0,1.0,1.0,medlm,medalign,nursing_note,PROMPT1_ICL_entailment
95,184,11,9,2,0.8181818181818182,11,9,2,0.8181818181818182,0.8181818181818182,medlm,medalign,nursing_note,PROMPT1_ICL_entailment
96,185,2,2,0,1.0,3,3,0,1.0,1.0,medlm,medalign,nursing_note,PROMPT1_ICL_entailment
97,186,4,2,2,0.5,3,3,0,1.0,0.6666666666666666,medlm,medalign,nursing_note,PROMPT1_ICL_entailment
98,187,2,0,2,0.0,1,1,0,1.0,0.0,medlm,medalign,nursing_note,PROMPT1_ICL_entailment
99,188,3,3,0,1.0,3,3,0,1.0,1.0,medlm,medalign,nursing_note,PROMPT1_ICL_entailment
100,189,7,7,0,1.0,10,6,4,0.6,0.7499999999999999,medlm,medalign,nursing_note,PROMPT1_ICL_entailment
101,19,8,8,0,1.0,7,5,2,0.7142857142857143,0.8333333333333333,medlm,medalign,nursing_note,PROMPT1_ICL_entailment
102,190,2,2,0,1.0,2,1,1,0.5,0.6666666666666666,medlm,medalign,nursing_note,PROMPT1_ICL_entailment
103,191,8,7,1,0.875,5,5,0,1.0,0.9333333333333332,medlm,medalign,nursing_note,PROMPT1_ICL_entailment
104,192,10,1,9,0.1,1,1,0,1.0,0.1818181818181818,medlm,medalign,nursing_note,PROMPT1_ICL_entailment
105,193,3,2,1,0.6666666666666666,3,3,0,1.0,0.8,medlm,medalign,nursing_note,PROMPT1_ICL_entailment
106,194,1,1,0,1.0,2,0,2,0.0,0.0,medlm,medalign,nursing_note,PROMPT1_ICL_entailment
107,195,11,10,1,0.9090909090909092,10,8,2,0.8,0.8510638297872342,medlm,medalign,nursing_note,PROMPT1_ICL_entailment
108,196,3,3,0,1.0,1,1,0,1.0,1.0,medlm,medalign,nursing_note,PROMPT1_ICL_entailment
109,197,3,2,1,0.6666666666666666,1,1,0,1.0,0.8,medlm,medalign,nursing_note,PROMPT1_ICL_entailment
110,198,18,17,1,0.9444444444444444,8,6,2,0.75,0.8360655737704917,medlm,medalign,nursing_note,PROMPT1_ICL_entailment
111,199,7,5,2,0.7142857142857143,7,4,3,0.5714285714285714,0.634920634920635,medlm,medalign,nursing_note,PROMPT1_ICL_entailment
112,2,100,0,100,0.0,5,1,4,0.2,0.0,medlm,medalign,nursing_note,PROMPT1_ICL_entailment
113,20,6,0,6,0.0,2,0,2,0.0,,medlm,medalign,nursing_note,PROMPT1_ICL_entailment
114,200,3,3,0,1.0,3,3,0,1.0,1.0,medlm,medalign,nursing_note,PROMPT1_ICL_entailment
115,201,11,2,9,0.1818181818181818,1,0,1,0.0,0.0,medlm,medalign,nursing_note,PROMPT1_ICL_entailment
116,202,3,2,1,0.6666666666666666,1,0,1,0.0,0.0,medlm,medalign,nursing_note,PROMPT1_ICL_entailment
117,203,3,3,0,1.0,1,1,0,1.0,1.0,medlm,medalign,nursing_note,PROMPT1_ICL_entailment
118,204,5,5,0,1.0,9,2,7,0.2222222222222222,0.3636363636363636,medlm,medalign,nursing_note,PROMPT1_ICL_entailment
119,205,12,10,2,0.8333333333333334,8,4,4,0.5,0.625,medlm,medalign,nursing_note,PROMPT1_ICL_entailment
120,206,5,5,0,1.0,4,4,0,1.0,1.0,medlm,medalign,nursing_note,PROMPT1_ICL_entailment
121,207,8,8,0,1.0,6,5,1,0.8333333333333334,0.9090909090909092,medlm,medalign,nursing_note,PROMPT1_ICL_entailment
122,208,9,8,1,0.8888888888888888,10,7,3,0.7,0.7832167832167831,medlm,medalign,nursing_note,PROMPT1_ICL_entailment
123,209,3,3,0,1.0,1,1,0,1.0,1.0,medlm,medalign,nursing_note,PROMPT1_ICL_entailment
124,21,6,6,0,1.0,1,1,0,1.0,1.0,medlm,medalign,nursing_note,PROMPT1_ICL_entailment
125,210,4,1,3,0.25,2,2,0,1.0,0.4,medlm,medalign,nursing_note,PROMPT1_ICL_entailment
126,211,4,4,0,1.0,2,2,0,1.0,1.0,medlm,medalign,nursing_note,PROMPT1_ICL_entailment
127,212,5,5,0,1.0,3,3,0,1.0,1.0,medlm,medalign,nursing_note,PROMPT1_ICL_entailment
128,213,11,11,0,1.0,8,8,0,1.0,1.0,medlm,medalign,nursing_note,PROMPT1_ICL_entailment
129,214,3,3,0,1.0,2,1,1,0.5,0.6666666666666666,medlm,medalign,nursing_note,PROMPT1_ICL_entailment
130,215,2,2,0,1.0,1,1,0,1.0,1.0,medlm,medalign,nursing_note,PROMPT1_ICL_entailment
131,216,4,4,0,1.0,3,3,0,1.0,1.0,medlm,medalign,nursing_note,PROMPT1_ICL_entailment
132,217,12,7,5,0.5833333333333334,11,5,6,0.4545454545454545,0.5109489051094891,medlm,medalign,nursing_note,PROMPT1_ICL_entailment
133,218,13,12,1,0.9230769230769232,3,1,2,0.3333333333333333,0.489795918367347,medlm,medalign,nursing_note,PROMPT1_ICL_entailment
134,219,5,4,1,0.8,2,2,0,1.0,0.888888888888889,medlm,medalign,nursing_note,PROMPT1_ICL_entailment
135,22,1,0,1,0.0,1,0,1,0.0,,medlm,medalign,nursing_note,PROMPT1_ICL_entailment
136,220,10,7,3,0.7,7,4,3,0.5714285714285714,0.6292134831460674,medlm,medalign,nursing_note,PROMPT1_ICL_entailment
137,221,21,21,0,1.0,23,10,13,0.4347826086956521,0.6060606060606061,medlm,medalign,nursing_note,PROMPT1_ICL_entailment
138,222,4,4,0,1.0,4,4,0,1.0,1.0,medlm,medalign,nursing_note,PROMPT1_ICL_entailment
139,223,4,3,1,0.75,2,2,0,1.0,0.8571428571428571,medlm,medalign,nursing_note,PROMPT1_ICL_entailment
140,224,10,6,4,0.6,4,1,3,0.25,0.3529411764705882,medlm,medalign,nursing_note,PROMPT1_ICL_entailment
141,225,3,3,0,1.0,2,1,1,0.5,0.6666666666666666,medlm,medalign,nursing_note,PROMPT1_ICL_entailment
142,226,10,8,2,0.8,5,3,2,0.6,0.6857142857142857,medlm,medalign,nursing_note,PROMPT1_ICL_entailment
143,227,1,0,1,0.0,1,0,1,0.0,,medlm,medalign,nursing_note,PROMPT1_ICL_entailment
144,228,18,14,4,0.7777777777777778,18,14,4,0.7777777777777778,0.7777777777777778,medlm,medalign,nursing_note,PROMPT1_ICL_entailment
145,229,6,5,1,0.8333333333333334,7,3,4,0.4285714285714285,0.5660377358490566,medlm,medalign,nursing_note,PROMPT1_ICL_entailment
146,23,14,11,3,0.7857142857142857,21,7,14,0.3333333333333333,0.4680851063829786,medlm,medalign,nursing_note,PROMPT1_ICL_entailment
147,230,1,0,1,0.0,1,0,1,0.0,,medlm,medalign,nursing_note,PROMPT1_ICL_entailment
148,231,12,9,3,0.75,13,12,1,0.9230769230769232,0.8275862068965517,medlm,medalign,nursing_note,PROMPT1_ICL_entailment
149,232,8,7,1,0.875,6,4,2,0.6666666666666666,0.7567567567567567,medlm,medalign,nursing_note,PROMPT1_ICL_entailment
150,233,5,3,2,0.6,4,4,0,1.0,0.7499999999999999,medlm,medalign,nursing_note,PROMPT1_ICL_entailment
151,234,4,4,0,1.0,2,2,0,1.0,1.0,medlm,medalign,nursing_note,PROMPT1_ICL_entailment
152,235,1,0,1,0.0,1,0,1,0.0,,medlm,medalign,nursing_note,PROMPT1_ICL_entailment
153,236,15,11,4,0.7333333333333333,14,11,3,0.7857142857142857,0.7586206896551724,medlm,medalign,nursing_note,PROMPT1_ICL_entailment
154,238,6,6,0,1.0,4,3,1,0.75,0.8571428571428571,medlm,medalign,nursing_note,PROMPT1_ICL_entailment
155,239,8,8,0,1.0,4,2,2,0.5,0.6666666666666666,medlm,medalign,nursing_note,PROMPT1_ICL_entailment
156,24,11,4,7,0.3636363636363636,1,1,0,1.0,0.5333333333333333,medlm,medalign,nursing_note,PROMPT1_ICL_entailment
157,240,3,2,1,0.6666666666666666,2,2,0,1.0,0.8,medlm,medalign,nursing_note,PROMPT1_ICL_entailment
158,241,4,3,1,0.75,2,2,0,1.0,0.8571428571428571,medlm,medalign,nursing_note,PROMPT1_ICL_entailment
159,242,7,7,0,1.0,2,0,2,0.0,0.0,medlm,medalign,nursing_note,PROMPT1_ICL_entailment
160,243,14,12,2,0.8571428571428571,10,8,2,0.8,0.8275862068965518,medlm,medalign,nursing_note,PROMPT1_ICL_entailment
161,244,4,4,0,1.0,1,1,0,1.0,1.0,medlm,medalign,nursing_note,PROMPT1_ICL_entailment
162,245,4,3,1,0.75,1,1,0,1.0,0.8571428571428571,medlm,medalign,nursing_note,PROMPT1_ICL_entailment
163,246,2,2,0,1.0,1,1,0,1.0,1.0,medlm,medalign,nursing_note,PROMPT1_ICL_entailment
164,247,5,5,0,1.0,5,5,0,1.0,1.0,medlm,medalign,nursing_note,PROMPT1_ICL_entailment
165,248,2,1,1,0.5,1,1,0,1.0,0.6666666666666666,medlm,medalign,nursing_note,PROMPT1_ICL_entailment
166,249,14,6,8,0.4285714285714285,2,1,1,0.5,0.4615384615384615,medlm,medalign,nursing_note,PROMPT1_ICL_entailment
167,25,15,13,2,0.8666666666666667,33,17,16,0.5151515151515151,0.6461988304093567,medlm,medalign,nursing_note,PROMPT1_ICL_entailment
168,26,3,2,1,0.6666666666666666,1,1,0,1.0,0.8,medlm,medalign,nursing_note,PROMPT1_ICL_entailment
169,27,7,3,4,0.4285714285714285,2,2,0,1.0,0.6,medlm,medalign,nursing_note,PROMPT1_ICL_entailment
170,28,9,7,2,0.7777777777777778,4,3,1,0.75,0.7636363636363638,medlm,medalign,nursing_note,PROMPT1_ICL_entailment
171,29,5,5,0,1.0,3,2,1,0.6666666666666666,0.8,medlm,medalign,nursing_note,PROMPT1_ICL_entailment
172,3,4,4,0,1.0,2,1,1,0.5,0.6666666666666666,medlm,medalign,nursing_note,PROMPT1_ICL_entailment
173,30,1,1,0,1.0,1,1,0,1.0,1.0,medlm,medalign,nursing_note,PROMPT1_ICL_entailment
174,31,2,1,1,0.5,1,1,0,1.0,0.6666666666666666,medlm,medalign,nursing_note,PROMPT1_ICL_entailment
175,32,1,1,0,1.0,2,1,1,0.5,0.6666666666666666,medlm,medalign,nursing_note,PROMPT1_ICL_entailment
176,33,8,6,2,0.75,5,4,1,0.8,0.7741935483870969,medlm,medalign,nursing_note,PROMPT1_ICL_entailment
177,34,9,7,2,0.7777777777777778,4,2,2,0.5,0.6086956521739131,medlm,medalign,nursing_note,PROMPT1_ICL_entailment
178,35,6,6,0,1.0,4,2,2,0.5,0.6666666666666666,medlm,medalign,nursing_note,PROMPT1_ICL_entailment
179,36,17,13,4,0.7647058823529411,5,3,2,0.6,0.6724137931034482,medlm,medalign,nursing_note,PROMPT1_ICL_entailment
180,37,5,4,1,0.8,3,3,0,1.0,0.888888888888889,medlm,medalign,nursing_note,PROMPT1_ICL_entailment
181,38,17,5,12,0.2941176470588235,5,3,2,0.6,0.3947368421052632,medlm,medalign,nursing_note,PROMPT1_ICL_entailment
182,39,3,3,0,1.0,1,1,0,1.0,1.0,medlm,medalign,nursing_note,PROMPT1_ICL_entailment
183,4,2,2,0,1.0,3,2,1,0.6666666666666666,0.8,medlm,medalign,nursing_note,PROMPT1_ICL_entailment
184,40,8,8,0,1.0,8,3,5,0.375,0.5454545454545454,medlm,medalign,nursing_note,PROMPT1_ICL_entailment
185,41,3,2,1,0.6666666666666666,1,1,0,1.0,0.8,medlm,medalign,nursing_note,PROMPT1_ICL_entailment
186,42,9,7,2,0.7777777777777778,8,3,5,0.375,0.5060240963855422,medlm,medalign,nursing_note,PROMPT1_ICL_entailment
187,43,2,2,0,1.0,2,2,0,1.0,1.0,medlm,medalign,nursing_note,PROMPT1_ICL_entailment
188,44,2,2,0,1.0,1,1,0,1.0,1.0,medlm,medalign,nursing_note,PROMPT1_ICL_entailment
189,45,2,1,1,0.5,1,1,0,1.0,0.6666666666666666,medlm,medalign,nursing_note,PROMPT1_ICL_entailment
190,46,5,5,0,1.0,5,5,0,1.0,1.0,medlm,medalign,nursing_note,PROMPT1_ICL_entailment
191,47,18,17,1,0.9444444444444444,20,19,1,0.95,0.9472140762463342,medlm,medalign,nursing_note,PROMPT1_ICL_entailment
192,48,1,1,0,1.0,2,1,1,0.5,0.6666666666666666,medlm,medalign,nursing_note,PROMPT1_ICL_entailment
193,49,3,2,1,0.6666666666666666,2,1,1,0.5,0.5714285714285715,medlm,medalign,nursing_note,PROMPT1_ICL_entailment
194,5,15,6,9,0.4,5,3,2,0.6,0.48,medlm,medalign,nursing_note,PROMPT1_ICL_entailment
195,50,1,1,0,1.0,1,1,0,1.0,1.0,medlm,medalign,nursing_note,PROMPT1_ICL_entailment
196,51,1,1,0,1.0,2,2,0,1.0,1.0,medlm,medalign,nursing_note,PROMPT1_ICL_entailment
197,52,5,5,0,1.0,4,4,0,1.0,1.0,medlm,medalign,nursing_note,PROMPT1_ICL_entailment
198,53,1,0,1,0.0,1,0,1,0.0,,medlm,medalign,nursing_note,PROMPT1_ICL_entailment
199,54,11,11,0,1.0,7,6,1,0.8571428571428571,0.923076923076923,medlm,medalign,nursing_note,PROMPT1_ICL_entailment
200,55,4,1,3,0.25,2,1,1,0.5,0.3333333333333333,medlm,medalign,nursing_note,PROMPT1_ICL_entailment
201,56,15,6,9,0.4,3,1,2,0.3333333333333333,0.3636363636363636,medlm,medalign,nursing_note,PROMPT1_ICL_entailment
202,57,16,5,11,0.3125,4,4,0,1.0,0.4761904761904761,medlm,medalign,nursing_note,PROMPT1_ICL_entailment
203,58,4,3,1,0.75,1,1,0,1.0,0.8571428571428571,medlm,medalign,nursing_note,PROMPT1_ICL_entailment
204,59,3,2,1,0.6666666666666666,1,1,0,1.0,0.8,medlm,medalign,nursing_note,PROMPT1_ICL_entailment
205,6,2,2,0,1.0,3,3,0,1.0,1.0,medlm,medalign,nursing_note,PROMPT1_ICL_entailment
206,60,10,9,1,0.9,9,8,1,0.8888888888888888,0.8944099378881988,medlm,medalign,nursing_note,PROMPT1_ICL_entailment
207,61,3,3,0,1.0,1,1,0,1.0,1.0,medlm,medalign,nursing_note,PROMPT1_ICL_entailment
208,62,12,12,0,1.0,5,3,2,0.6,0.7499999999999999,medlm,medalign,nursing_note,PROMPT1_ICL_entailment
209,63,8,8,0,1.0,7,3,4,0.4285714285714285,0.6,medlm,medalign,nursing_note,PROMPT1_ICL_entailment
210,64,4,4,0,1.0,1,1,0,1.0,1.0,medlm,medalign,nursing_note,PROMPT1_ICL_entailment
211,65,3,3,0,1.0,2,1,1,0.5,0.6666666666666666,medlm,medalign,nursing_note,PROMPT1_ICL_entailment
212,66,5,5,0,1.0,4,4,0,1.0,1.0,medlm,medalign,nursing_note,PROMPT1_ICL_entailment
213,67,3,3,0,1.0,4,4,0,1.0,1.0,medlm,medalign,nursing_note,PROMPT1_ICL_entailment
214,68,6,5,1,0.8333333333333334,1,1,0,1.0,0.9090909090909092,medlm,medalign,nursing_note,PROMPT1_ICL_entailment
215,69,7,7,0,1.0,2,2,0,1.0,1.0,medlm,medalign,nursing_note,PROMPT1_ICL_entailment
216,7,4,4,0,1.0,1,1,0,1.0,1.0,medlm,medalign,nursing_note,PROMPT1_ICL_entailment
217,70,10,10,0,1.0,1,1,0,1.0,1.0,medlm,medalign,nursing_note,PROMPT1_ICL_entailment
218,71,7,6,1,0.8571428571428571,1,1,0,1.0,0.923076923076923,medlm,medalign,nursing_note,PROMPT1_ICL_entailment
219,72,1,0,1,0.0,1,0,1,0.0,,medlm,medalign,nursing_note,PROMPT1_ICL_entailment
220,73,14,1,13,0.0714285714285714,2,0,2,0.0,0.0,medlm,medalign,nursing_note,PROMPT1_ICL_entailment
221,74,3,2,1,0.6666666666666666,6,3,3,0.5,0.5714285714285715,medlm,medalign,nursing_note,PROMPT1_ICL_entailment
222,75,2,1,1,0.5,1,1,0,1.0,0.6666666666666666,medlm,medalign,nursing_note,PROMPT1_ICL_entailment
223,76,9,9,0,1.0,5,3,2,0.6,0.7499999999999999,medlm,medalign,nursing_note,PROMPT1_ICL_entailment
224,77,5,5,0,1.0,3,3,0,1.0,1.0,medlm,medalign,nursing_note,PROMPT1_ICL_entailment
225,78,5,4,1,0.8,3,3,0,1.0,0.888888888888889,medlm,medalign,nursing_note,PROMPT1_ICL_entailment
226,79,8,4,4,0.5,8,3,5,0.375,0.4285714285714285,medlm,medalign,nursing_note,PROMPT1_ICL_entailment
227,8,7,5,2,0.7142857142857143,8,7,1,0.875,0.7865168539325842,medlm,medalign,nursing_note,PROMPT1_ICL_entailment
228,80,11,9,2,0.8181818181818182,10,7,3,0.7,0.7544910179640719,medlm,medalign,nursing_note,PROMPT1_ICL_entailment
229,81,2,1,1,0.5,1,1,0,1.0,0.6666666666666666,medlm,medalign,nursing_note,PROMPT1_ICL_entailment
230,82,3,3,0,1.0,3,3,0,1.0,1.0,medlm,medalign,nursing_note,PROMPT1_ICL_entailment
231,83,11,0,11,0.0,3,0,3,0.0,,medlm,medalign,nursing_note,PROMPT1_ICL_entailment
232,84,4,3,1,0.75,2,1,1,0.5,0.6,medlm,medalign,nursing_note,PROMPT1_ICL_entailment
233,85,6,5,1,0.8333333333333334,8,6,2,0.75,0.7894736842105262,medlm,medalign,nursing_note,PROMPT1_ICL_entailment
234,86,4,3,1,0.75,3,3,0,1.0,0.8571428571428571,medlm,medalign,nursing_note,PROMPT1_ICL_entailment
235,87,3,3,0,1.0,2,2,0,1.0,1.0,medlm,medalign,nursing_note,PROMPT1_ICL_entailment
236,88,8,8,0,1.0,7,7,0,1.0,1.0,medlm,medalign,nursing_note,PROMPT1_ICL_entailment
237,89,5,5,0,1.0,6,5,1,0.8333333333333334,0.9090909090909092,medlm,medalign,nursing_note,PROMPT1_ICL_entailment
238,9,5,5,0,1.0,2,2,0,1.0,1.0,medlm,medalign,nursing_note,PROMPT1_ICL_entailment
239,90,5,5,0,1.0,1,1,0,1.0,1.0,medlm,medalign,nursing_note,PROMPT1_ICL_entailment
240,91,3,3,0,1.0,1,1,0,1.0,1.0,medlm,medalign,nursing_note,PROMPT1_ICL_entailment
241,92,5,3,2,0.6,4,2,2,0.5,0.5454545454545454,medlm,medalign,nursing_note,PROMPT1_ICL_entailment
242,93,3,3,0,1.0,1,1,0,1.0,1.0,medlm,medalign,nursing_note,PROMPT1_ICL_entailment
243,94,3,3,0,1.0,2,2,0,1.0,1.0,medlm,medalign,nursing_note,PROMPT1_ICL_entailment
244,95,1,1,0,1.0,1,1,0,1.0,1.0,medlm,medalign,nursing_note,PROMPT1_ICL_entailment
245,96,2,1,1,0.5,1,1,0,1.0,0.6666666666666666,medlm,medalign,nursing_note,PROMPT1_ICL_entailment
246,97,2,2,0,1.0,2,2,0,1.0,1.0,medlm,medalign,nursing_note,PROMPT1_ICL_entailment
247,98,4,4,0,1.0,5,3,2,0.6,0.7499999999999999,medlm,medalign,nursing_note,PROMPT1_ICL_entailment
248,99,19,9,10,0.4736842105263157,7,1,6,0.1428571428571428,0.2195121951219512,medlm,medalign,nursing_note,PROMPT1_ICL_entailment
0,0,7,7,0,1.0,6,5,1,0.8333333333333334,0.9090909090909092,medlm,medalign,nursing_note,PROMPT2_ICL_entailment
1,1,50,3,47,0.06,1,1,0,1.0,0.1132075471698113,medlm,medalign,nursing_note,PROMPT2_ICL_entailment
2,10,6,6,0,1.0,5,2,3,0.4,0.5714285714285715,medlm,medalign,nursing_note,PROMPT2_ICL_entailment
3,100,2,2,0,1.0,10,2,8,0.2,0.3333333333333333,medlm,medalign,nursing_note,PROMPT2_ICL_entailment
4,101,6,6,0,1.0,1,1,0,1.0,1.0,medlm,medalign,nursing_note,PROMPT2_ICL_entailment
5,102,7,7,0,1.0,4,3,1,0.75,0.8571428571428571,medlm,medalign,nursing_note,PROMPT2_ICL_entailment
6,103,1,1,0,1.0,2,1,1,0.5,0.6666666666666666,medlm,medalign,nursing_note,PROMPT2_ICL_entailment
7,104,11,10,1,0.9090909090909092,15,10,5,0.6666666666666666,0.7692307692307692,medlm,medalign,nursing_note,PROMPT2_ICL_entailment
8,105,2,2,0,1.0,1,1,0,1.0,1.0,medlm,medalign,nursing_note,PROMPT2_ICL_entailment
9,106,50,2,48,0.04,1,1,0,1.0,0.0769230769230769,medlm,medalign,nursing_note,PROMPT2_ICL_entailment
10,107,5,4,1,0.8,4,3,1,0.75,0.7741935483870969,medlm,medalign,nursing_note,PROMPT2_ICL_entailment
11,108,2,2,0,1.0,2,2,0,1.0,1.0,medlm,medalign,nursing_note,PROMPT2_ICL_entailment
12,109,20,0,20,0.0,5,0,5,0.0,,medlm,medalign,nursing_note,PROMPT2_ICL_entailment
13,11,1,0,1,0.0,1,1,0,1.0,0.0,medlm,medalign,nursing_note,PROMPT2_ICL_entailment
14,110,15,1,14,0.0666666666666666,6,3,3,0.5,0.1176470588235294,medlm,medalign,nursing_note,PROMPT2_ICL_entailment
15,111,1,0,1,0.0,1,1,0,1.0,0.0,medlm,medalign,nursing_note,PROMPT2_ICL_entailment
16,112,4,4,0,1.0,2,2,0,1.0,1.0,medlm,medalign,nursing_note,PROMPT2_ICL_entailment
17,113,1,0,1,0.0,1,1,0,1.0,0.0,medlm,medalign,nursing_note,PROMPT2_ICL_entailment
18,114,11,0,11,0.0,1,0,1,0.0,,medlm,medalign,nursing_note,PROMPT2_ICL_entailment
19,115,10,10,0,1.0,7,4,3,0.5714285714285714,0.7272727272727273,medlm,medalign,nursing_note,PROMPT2_ICL_entailment
20,116,8,8,0,1.0,5,4,1,0.8,0.888888888888889,medlm,medalign,nursing_note,PROMPT2_ICL_entailment
21,117,7,7,0,1.0,13,6,7,0.4615384615384615,0.631578947368421,medlm,medalign,nursing_note,PROMPT2_ICL_entailment
22,118,1,1,0,1.0,2,1,1,0.5,0.6666666666666666,medlm,medalign,nursing_note,PROMPT2_ICL_entailment
23,119,2,0,2,0.0,2,2,0,1.0,0.0,medlm,medalign,nursing_note,PROMPT2_ICL_entailment
24,12,2,2,0,1.0,1,1,0,1.0,1.0,medlm,medalign,nursing_note,PROMPT2_ICL_entailment
25,120,7,7,0,1.0,7,6,1,0.8571428571428571,0.923076923076923,medlm,medalign,nursing_note,PROMPT2_ICL_entailment
26,121,50,1,49,0.02,1,0,1,0.0,0.0,medlm,medalign,nursing_note,PROMPT2_ICL_entailment
27,122,2,2,0,1.0,1,1,0,1.0,1.0,medlm,medalign,nursing_note,PROMPT2_ICL_entailment
28,123,1,1,0,1.0,4,0,4,0.0,0.0,medlm,medalign,nursing_note,PROMPT2_ICL_entailment
29,124,5,4,1,0.8,14,6,8,0.4285714285714285,0.5581395348837209,medlm,medalign,nursing_note,PROMPT2_ICL_entailment
30,125,6,5,1,0.8333333333333334,9,6,3,0.6666666666666666,0.7407407407407408,medlm,medalign,nursing_note,PROMPT2_ICL_entailment
31,126,2,2,0,1.0,2,2,0,1.0,1.0,medlm,medalign,nursing_note,PROMPT2_ICL_entailment
32,127,1,1,0,1.0,1,1,0,1.0,1.0,medlm,medalign,nursing_note,PROMPT2_ICL_entailment
33,128,11,0,11,0.0,2,0,2,0.0,,medlm,medalign,nursing_note,PROMPT2_ICL_entailment
34,129,7,6,1,0.8571428571428571,20,10,10,0.5,0.631578947368421,medlm,medalign,nursing_note,PROMPT2_ICL_entailment
35,13,3,3,0,1.0,5,3,2,0.6,0.7499999999999999,medlm,medalign,nursing_note,PROMPT2_ICL_entailment
36,130,3,3,0,1.0,2,1,1,0.5,0.6666666666666666,medlm,medalign,nursing_note,PROMPT2_ICL_entailment
37,131,2,2,0,1.0,1,1,0,1.0,1.0,medlm,medalign,nursing_note,PROMPT2_ICL_entailment
38,132,6,4,2,0.6666666666666666,2,2,0,1.0,0.8,medlm,medalign,nursing_note,PROMPT2_ICL_entailment
39,133,10,8,2,0.8,14,8,6,0.5714285714285714,0.6666666666666666,medlm,medalign,nursing_note,PROMPT2_ICL_entailment
40,134,3,3,0,1.0,3,1,2,0.3333333333333333,0.5,medlm,medalign,nursing_note,PROMPT2_ICL_entailment
41,135,4,4,0,1.0,2,2,0,1.0,1.0,medlm,medalign,nursing_note,PROMPT2_ICL_entailment
42,136,38,25,13,0.6578947368421053,51,27,24,0.5294117647058824,0.5867014341590614,medlm,medalign,nursing_note,PROMPT2_ICL_entailment
43,137,6,6,0,1.0,6,6,0,1.0,1.0,medlm,medalign,nursing_note,PROMPT2_ICL_entailment
44,138,1,0,1,0.0,1,1,0,1.0,0.0,medlm,medalign,nursing_note,PROMPT2_ICL_entailment
45,139,1,1,0,1.0,1,1,0,1.0,1.0,medlm,medalign,nursing_note,PROMPT2_ICL_entailment
46,14,1,0,1,0.0,1,1,0,1.0,0.0,medlm,medalign,nursing_note,PROMPT2_ICL_entailment
47,140,1,1,0,1.0,3,1,2,0.3333333333333333,0.5,medlm,medalign,nursing_note,PROMPT2_ICL_entailment
48,141,1,1,0,1.0,1,1,0,1.0,1.0,medlm,medalign,nursing_note,PROMPT2_ICL_entailment
49,142,2,2,0,1.0,1,1,0,1.0,1.0,medlm,medalign,nursing_note,PROMPT2_ICL_entailment
50,143,1,0,1,0.0,1,1,0,1.0,0.0,medlm,medalign,nursing_note,PROMPT2_ICL_entailment
51,144,2,0,2,0.0,1,0,1,0.0,,medlm,medalign,nursing_note,PROMPT2_ICL_entailment
52,145,4,4,0,1.0,4,4,0,1.0,1.0,medlm,medalign,nursing_note,PROMPT2_ICL_entailment
53,146,8,8,0,1.0,3,2,1,0.6666666666666666,0.8,medlm,medalign,nursing_note,PROMPT2_ICL_entailment
54,147,4,2,2,0.5,6,5,1,0.8333333333333334,0.625,medlm,medalign,nursing_note,PROMPT2_ICL_entailment
55,148,7,7,0,1.0,7,7,0,1.0,1.0,medlm,medalign,nursing_note,PROMPT2_ICL_entailment
56,149,3,3,0,1.0,1,0,1,0.0,0.0,medlm,medalign,nursing_note,PROMPT2_ICL_entailment
57,15,4,4,0,1.0,1,1,0,1.0,1.0,medlm,medalign,nursing_note,PROMPT2_ICL_entailment
58,150,11,4,7,0.3636363636363636,1,1,0,1.0,0.5333333333333333,medlm,medalign,nursing_note,PROMPT2_ICL_entailment
59,151,8,8,0,1.0,8,4,4,0.5,0.6666666666666666,medlm,medalign,nursing_note,PROMPT2_ICL_entailment
60,152,4,4,0,1.0,4,4,0,1.0,1.0,medlm,medalign,nursing_note,PROMPT2_ICL_entailment
61,153,13,11,2,0.8461538461538461,14,7,7,0.5,0.6285714285714286,medlm,medalign,nursing_note,PROMPT2_ICL_entailment
62,154,1,1,0,1.0,1,1,0,1.0,1.0,medlm,medalign,nursing_note,PROMPT2_ICL_entailment
63,155,13,6,7,0.4615384615384615,14,2,12,0.1428571428571428,0.2181818181818181,medlm,medalign,nursing_note,PROMPT2_ICL_entailment
64,156,3,3,0,1.0,1,1,0,1.0,1.0,medlm,medalign,nursing_note,PROMPT2_ICL_entailment
65,157,4,3,1,0.75,3,2,1,0.6666666666666666,0.7058823529411765,medlm,medalign,nursing_note,PROMPT2_ICL_entailment
66,158,2,2,0,1.0,1,1,0,1.0,1.0,medlm,medalign,nursing_note,PROMPT2_ICL_entailment
67,159,2,2,0,1.0,3,2,1,0.6666666666666666,0.8,medlm,medalign,nursing_note,PROMPT2_ICL_entailment
68,16,5,5,0,1.0,3,1,2,0.3333333333333333,0.5,medlm,medalign,nursing_note,PROMPT2_ICL_entailment
69,160,2,2,0,1.0,1,1,0,1.0,1.0,medlm,medalign,nursing_note,PROMPT2_ICL_entailment
70,161,4,4,0,1.0,1,1,0,1.0,1.0,medlm,medalign,nursing_note,PROMPT2_ICL_entailment
71,162,15,5,10,0.3333333333333333,8,1,7,0.125,0.1818181818181818,medlm,medalign,nursing_note,PROMPT2_ICL_entailment
72,163,6,6,0,1.0,3,3,0,1.0,1.0,medlm,medalign,nursing_note,PROMPT2_ICL_entailment
73,164,3,3,0,1.0,2,2,0,1.0,1.0,medlm,medalign,nursing_note,PROMPT2_ICL_entailment
74,165,4,4,0,1.0,4,2,2,0.5,0.6666666666666666,medlm,medalign,nursing_note,PROMPT2_ICL_entailment
75,166,5,4,1,0.8,5,2,3,0.4,0.5333333333333333,medlm,medalign,nursing_note,PROMPT2_ICL_entailment
76,167,9,7,2,0.7777777777777778,2,1,1,0.5,0.6086956521739131,medlm,medalign,nursing_note,PROMPT2_ICL_entailment
77,168,4,4,0,1.0,3,2,1,0.6666666666666666,0.8,medlm,medalign,nursing_note,PROMPT2_ICL_entailment
78,169,10,3,7,0.3,9,3,6,0.3333333333333333,0.3157894736842105,medlm,medalign,nursing_note,PROMPT2_ICL_entailment
79,17,2,1,1,0.5,1,1,0,1.0,0.6666666666666666,medlm,medalign,nursing_note,PROMPT2_ICL_entailment
80,170,1,1,0,1.0,1,1,0,1.0,1.0,medlm,medalign,nursing_note,PROMPT2_ICL_entailment
81,171,12,1,11,0.0833333333333333,7,2,5,0.2857142857142857,0.1290322580645161,medlm,medalign,nursing_note,PROMPT2_ICL_entailment
82,172,9,6,3,0.6666666666666666,12,8,4,0.6666666666666666,0.6666666666666666,medlm,medalign,nursing_note,PROMPT2_ICL_entailment
83,173,7,7,0,1.0,1,1,0,1.0,1.0,medlm,medalign,nursing_note,PROMPT2_ICL_entailment
84,174,3,3,0,1.0,1,1,0,1.0,1.0,medlm,medalign,nursing_note,PROMPT2_ICL_entailment
85,175,17,0,17,0.0,2,0,2,0.0,,medlm,medalign,nursing_note,PROMPT2_ICL_entailment
86,176,10,5,5,0.5,3,2,1,0.6666666666666666,0.5714285714285715,medlm,medalign,nursing_note,PROMPT2_ICL_entailment
87,177,12,1,11,0.0833333333333333,8,1,7,0.125,0.1,medlm,medalign,nursing_note,PROMPT2_ICL_entailment
88,178,33,1,32,0.0303030303030303,10,3,7,0.3,0.055045871559633,medlm,medalign,nursing_note,PROMPT2_ICL_entailment
89,179,10,1,9,0.1,2,1,1,0.5,0.1666666666666666,medlm,medalign,nursing_note,PROMPT2_ICL_entailment
90,18,4,2,2,0.5,3,1,2,0.3333333333333333,0.4,medlm,medalign,nursing_note,PROMPT2_ICL_entailment
91,180,3,2,1,0.6666666666666666,4,0,4,0.0,0.0,medlm,medalign,nursing_note,PROMPT2_ICL_entailment
92,181,7,7,0,1.0,7,7,0,1.0,1.0,medlm,medalign,nursing_note,PROMPT2_ICL_entailment
93,182,3,3,0,1.0,2,1,1,0.5,0.6666666666666666,medlm,medalign,nursing_note,PROMPT2_ICL_entailment
94,183,5,5,0,1.0,6,5,1,0.8333333333333334,0.9090909090909092,medlm,medalign,nursing_note,PROMPT2_ICL_entailment
95,184,9,7,2,0.7777777777777778,11,8,3,0.7272727272727273,0.7516778523489932,medlm,medalign,nursing_note,PROMPT2_ICL_entailment
96,185,2,2,0,1.0,3,3,0,1.0,1.0,medlm,medalign,nursing_note,PROMPT2_ICL_entailment
97,186,3,1,2,0.3333333333333333,3,0,3,0.0,0.0,medlm,medalign,nursing_note,PROMPT2_ICL_entailment
98,187,1,1,0,1.0,1,1,0,1.0,1.0,medlm,medalign,nursing_note,PROMPT2_ICL_entailment
99,188,2,2,0,1.0,3,3,0,1.0,1.0,medlm,medalign,nursing_note,PROMPT2_ICL_entailment
100,189,9,9,0,1.0,10,4,6,0.4,0.5714285714285715,medlm,medalign,nursing_note,PROMPT2_ICL_entailment
101,19,4,4,0,1.0,7,4,3,0.5714285714285714,0.7272727272727273,medlm,medalign,nursing_note,PROMPT2_ICL_entailment
102,190,1,1,0,1.0,2,1,1,0.5,0.6666666666666666,medlm,medalign,nursing_note,PROMPT2_ICL_entailment
103,191,6,6,0,1.0,5,5,0,1.0,1.0,medlm,medalign,nursing_note,PROMPT2_ICL_entailment
104,192,3,3,0,1.0,1,1,0,1.0,1.0,medlm,medalign,nursing_note,PROMPT2_ICL_entailment
105,193,3,3,0,1.0,3,3,0,1.0,1.0,medlm,medalign,nursing_note,PROMPT2_ICL_entailment
106,194,1,1,0,1.0,2,0,2,0.0,0.0,medlm,medalign,nursing_note,PROMPT2_ICL_entailment
107,195,9,8,1,0.8888888888888888,10,7,3,0.7,0.7832167832167831,medlm,medalign,nursing_note,PROMPT2_ICL_entailment
108,196,2,2,0,1.0,1,1,0,1.0,1.0,medlm,medalign,nursing_note,PROMPT2_ICL_entailment
109,197,1,1,0,1.0,1,1,0,1.0,1.0,medlm,medalign,nursing_note,PROMPT2_ICL_entailment
110,198,17,16,1,0.9411764705882352,8,6,2,0.75,0.8347826086956521,medlm,medalign,nursing_note,PROMPT2_ICL_entailment
111,199,8,6,2,0.75,7,2,5,0.2857142857142857,0.4137931034482759,medlm,medalign,nursing_note,PROMPT2_ICL_entailment
112,2,3,1,2,0.3333333333333333,5,2,3,0.4,0.3636363636363636,medlm,medalign,nursing_note,PROMPT2_ICL_entailment
113,20,1,1,0,1.0,2,1,1,0.5,0.6666666666666666,medlm,medalign,nursing_note,PROMPT2_ICL_entailment
114,200,3,3,0,1.0,3,3,0,1.0,1.0,medlm,medalign,nursing_note,PROMPT2_ICL_entailment
115,201,1,1,0,1.0,1,1,0,1.0,1.0,medlm,medalign,nursing_note,PROMPT2_ICL_entailment
116,202,2,2,0,1.0,1,0,1,0.0,0.0,medlm,medalign,nursing_note,PROMPT2_ICL_entailment
117,203,3,3,0,1.0,1,1,0,1.0,1.0,medlm,medalign,nursing_note,PROMPT2_ICL_entailment
118,204,4,4,0,1.0,9,3,6,0.3333333333333333,0.5,medlm,medalign,nursing_note,PROMPT2_ICL_entailment
119,205,10,8,2,0.8,8,4,4,0.5,0.6153846153846154,medlm,medalign,nursing_note,PROMPT2_ICL_entailment
120,206,3,3,0,1.0,4,4,0,1.0,1.0,medlm,medalign,nursing_note,PROMPT2_ICL_entailment
121,207,7,6,1,0.8571428571428571,6,4,2,0.6666666666666666,0.75,medlm,medalign,nursing_note,PROMPT2_ICL_entailment
122,208,9,2,7,0.2222222222222222,10,1,9,0.1,0.1379310344827586,medlm,medalign,nursing_note,PROMPT2_ICL_entailment
123,209,2,2,0,1.0,1,1,0,1.0,1.0,medlm,medalign,nursing_note,PROMPT2_ICL_entailment
124,21,4,4,0,1.0,1,1,0,1.0,1.0,medlm,medalign,nursing_note,PROMPT2_ICL_entailment
125,210,2,2,0,1.0,2,1,1,0.5,0.6666666666666666,medlm,medalign,nursing_note,PROMPT2_ICL_entailment
126,211,1,1,0,1.0,2,1,1,0.5,0.6666666666666666,medlm,medalign,nursing_note,PROMPT2_ICL_entailment
127,212,5,5,0,1.0,3,3,0,1.0,1.0,medlm,medalign,nursing_note,PROMPT2_ICL_entailment
128,213,9,8,1,0.8888888888888888,8,8,0,1.0,0.9411764705882352,medlm,medalign,nursing_note,PROMPT2_ICL_entailment
129,214,2,2,0,1.0,2,1,1,0.5,0.6666666666666666,medlm,medalign,nursing_note,PROMPT2_ICL_entailment
130,215,2,2,0,1.0,1,1,0,1.0,1.0,medlm,medalign,nursing_note,PROMPT2_ICL_entailment
131,216,3,3,0,1.0,3,3,0,1.0,1.0,medlm,medalign,nursing_note,PROMPT2_ICL_entailment
132,217,4,2,2,0.5,11,2,9,0.1818181818181818,0.2666666666666666,medlm,medalign,nursing_note,PROMPT2_ICL_entailment
133,218,13,13,0,1.0,3,1,2,0.3333333333333333,0.5,medlm,medalign,nursing_note,PROMPT2_ICL_entailment
134,219,2,2,0,1.0,2,1,1,0.5,0.6666666666666666,medlm,medalign,nursing_note,PROMPT2_ICL_entailment
135,22,1,0,1,0.0,1,0,1,0.0,,medlm,medalign,nursing_note,PROMPT2_ICL_entailment
136,220,16,1,15,0.0625,7,5,2,0.7142857142857143,0.1149425287356321,medlm,medalign,nursing_note,PROMPT2_ICL_entailment
137,221,2,2,0,1.0,23,3,20,0.1304347826086956,0.2307692307692307,medlm,medalign,nursing_note,PROMPT2_ICL_entailment
138,222,4,4,0,1.0,4,4,0,1.0,1.0,medlm,medalign,nursing_note,PROMPT2_ICL_entailment
139,223,2,2,0,1.0,2,2,0,1.0,1.0,medlm,medalign,nursing_note,PROMPT2_ICL_entailment
140,224,7,5,2,0.7142857142857143,4,2,2,0.5,0.588235294117647,medlm,medalign,nursing_note,PROMPT2_ICL_entailment
141,225,3,3,0,1.0,2,1,1,0.5,0.6666666666666666,medlm,medalign,nursing_note,PROMPT2_ICL_entailment
142,226,6,4,2,0.6666666666666666,5,3,2,0.6,0.631578947368421,medlm,medalign,nursing_note,PROMPT2_ICL_entailment
143,227,1,0,1,0.0,1,1,0,1.0,0.0,medlm,medalign,nursing_note,PROMPT2_ICL_entailment
144,228,18,17,1,0.9444444444444444,18,14,4,0.7777777777777778,0.8530465949820788,medlm,medalign,nursing_note,PROMPT2_ICL_entailment
145,229,6,4,2,0.6666666666666666,7,4,3,0.5714285714285714,0.6153846153846153,medlm,medalign,nursing_note,PROMPT2_ICL_entailment
146,23,9,5,4,0.5555555555555556,21,7,14,0.3333333333333333,0.4166666666666667,medlm,medalign,nursing_note,PROMPT2_ICL_entailment
147,230,1,1,0,1.0,1,1,0,1.0,1.0,medlm,medalign,nursing_note,PROMPT2_ICL_entailment
148,231,11,3,8,0.2727272727272727,13,3,10,0.2307692307692307,0.2499999999999999,medlm,medalign,nursing_note,PROMPT2_ICL_entailment
149,232,6,5,1,0.8333333333333334,6,4,2,0.6666666666666666,0.7407407407407408,medlm,medalign,nursing_note,PROMPT2_ICL_entailment
150,233,4,3,1,0.75,4,3,1,0.75,0.75,medlm,medalign,nursing_note,PROMPT2_ICL_entailment
151,234,4,4,0,1.0,2,2,0,1.0,1.0,medlm,medalign,nursing_note,PROMPT2_ICL_entailment
152,235,1,0,1,0.0,1,0,1,0.0,,medlm,medalign,nursing_note,PROMPT2_ICL_entailment
153,236,10,10,0,1.0,14,8,6,0.5714285714285714,0.7272727272727273,medlm,medalign,nursing_note,PROMPT2_ICL_entailment
154,237,6,5,1,0.8333333333333334,6,3,3,0.5,0.625,medlm,medalign,nursing_note,PROMPT2_ICL_entailment
155,238,5,5,0,1.0,4,3,1,0.75,0.8571428571428571,medlm,medalign,nursing_note,PROMPT2_ICL_entailment
156,239,3,3,0,1.0,4,2,2,0.5,0.6666666666666666,medlm,medalign,nursing_note,PROMPT2_ICL_entailment
157,24,21,9,12,0.4285714285714285,1,1,0,1.0,0.6,medlm,medalign,nursing_note,PROMPT2_ICL_entailment
158,240,2,2,0,1.0,2,2,0,1.0,1.0,medlm,medalign,nursing_note,PROMPT2_ICL_entailment
159,241,10,0,10,0.0,2,1,1,0.5,0.0,medlm,medalign,nursing_note,PROMPT2_ICL_entailment
160,242,7,7,0,1.0,2,0,2,0.0,0.0,medlm,medalign,nursing_note,PROMPT2_ICL_entailment
161,243,5,4,1,0.8,10,9,1,0.9,0.8470588235294118,medlm,medalign,nursing_note,PROMPT2_ICL_entailment
162,244,61,5,56,0.081967213114754,1,0,1,0.0,0.0,medlm,medalign,nursing_note,PROMPT2_ICL_entailment
163,245,3,3,0,1.0,1,1,0,1.0,1.0,medlm,medalign,nursing_note,PROMPT2_ICL_entailment
164,246,2,2,0,1.0,1,1,0,1.0,1.0,medlm,medalign,nursing_note,PROMPT2_ICL_entailment
165,247,5,5,0,1.0,5,5,0,1.0,1.0,medlm,medalign,nursing_note,PROMPT2_ICL_entailment
166,248,1,1,0,1.0,1,1,0,1.0,1.0,medlm,medalign,nursing_note,PROMPT2_ICL_entailment
167,249,5,5,0,1.0,2,1,1,0.5,0.6666666666666666,medlm,medalign,nursing_note,PROMPT2_ICL_entailment
168,25,13,12,1,0.9230769230769232,33,15,18,0.4545454545454545,0.6091370558375634,medlm,medalign,nursing_note,PROMPT2_ICL_entailment
169,26,1,1,0,1.0,1,1,0,1.0,1.0,medlm,medalign,nursing_note,PROMPT2_ICL_entailment
170,27,7,3,4,0.4285714285714285,2,2,0,1.0,0.6,medlm,medalign,nursing_note,PROMPT2_ICL_entailment
171,28,10,0,10,0.0,4,3,1,0.75,0.0,medlm,medalign,nursing_note,PROMPT2_ICL_entailment
172,29,2,2,0,1.0,3,2,1,0.6666666666666666,0.8,medlm,medalign,nursing_note,PROMPT2_ICL_entailment
173,3,1,1,0,1.0,2,1,1,0.5,0.6666666666666666,medlm,medalign,nursing_note,PROMPT2_ICL_entailment
174,30,2,2,0,1.0,1,1,0,1.0,1.0,medlm,medalign,nursing_note,PROMPT2_ICL_entailment
175,31,10,3,7,0.3,1,0,1,0.0,0.0,medlm,medalign,nursing_note,PROMPT2_ICL_entailment
176,32,11,0,11,0.0,2,0,2,0.0,,medlm,medalign,nursing_note,PROMPT2_ICL_entailment
177,33,16,1,15,0.0625,5,2,3,0.4,0.1081081081081081,medlm,medalign,nursing_note,PROMPT2_ICL_entailment
178,34,5,5,0,1.0,4,1,3,0.25,0.4,medlm,medalign,nursing_note,PROMPT2_ICL_entailment
179,35,6,6,0,1.0,4,2,2,0.5,0.6666666666666666,medlm,medalign,nursing_note,PROMPT2_ICL_entailment
180,36,13,1,12,0.0769230769230769,5,2,3,0.4,0.1290322580645161,medlm,medalign,nursing_note,PROMPT2_ICL_entailment
181,37,3,3,0,1.0,3,3,0,1.0,1.0,medlm,medalign,nursing_note,PROMPT2_ICL_entailment
182,38,5,3,2,0.6,5,3,2,0.6,0.6,medlm,medalign,nursing_note,PROMPT2_ICL_entailment
183,39,3,3,0,1.0,1,1,0,1.0,1.0,medlm,medalign,nursing_note,PROMPT2_ICL_entailment
184,4,3,2,1,0.6666666666666666,3,2,1,0.6666666666666666,0.6666666666666666,medlm,medalign,nursing_note,PROMPT2_ICL_entailment
185,40,11,1,10,0.0909090909090909,8,2,6,0.25,0.1333333333333333,medlm,medalign,nursing_note,PROMPT2_ICL_entailment
186,41,1,0,1,0.0,1,0,1,0.0,,medlm,medalign,nursing_note,PROMPT2_ICL_entailment
187,42,15,1,14,0.0666666666666666,8,2,6,0.25,0.1052631578947368,medlm,medalign,nursing_note,PROMPT2_ICL_entailment
188,43,2,2,0,1.0,2,2,0,1.0,1.0,medlm,medalign,nursing_note,PROMPT2_ICL_entailment
189,44,4,4,0,1.0,1,1,0,1.0,1.0,medlm,medalign,nursing_note,PROMPT2_ICL_entailment
190,45,50,0,50,0.0,1,0,1,0.0,,medlm,medalign,nursing_note,PROMPT2_ICL_entailment
191,46,5,5,0,1.0,5,5,0,1.0,1.0,medlm,medalign,nursing_note,PROMPT2_ICL_entailment
192,47,21,20,1,0.9523809523809524,20,18,2,0.9,0.9254498714652956,medlm,medalign,nursing_note,PROMPT2_ICL_entailment
193,48,1,1,0,1.0,2,1,1,0.5,0.6666666666666666,medlm,medalign,nursing_note,PROMPT2_ICL_entailment
194,49,2,2,0,1.0,2,2,0,1.0,1.0,medlm,medalign,nursing_note,PROMPT2_ICL_entailment
195,5,3,3,0,1.0,5,3,2,0.6,0.7499999999999999,medlm,medalign,nursing_note,PROMPT2_ICL_entailment
196,50,1,1,0,1.0,1,1,0,1.0,1.0,medlm,medalign,nursing_note,PROMPT2_ICL_entailment
197,51,2,2,0,1.0,2,2,0,1.0,1.0,medlm,medalign,nursing_note,PROMPT2_ICL_entailment
198,52,3,3,0,1.0,4,3,1,0.75,0.8571428571428571,medlm,medalign,nursing_note,PROMPT2_ICL_entailment
199,53,1,0,1,0.0,1,0,1,0.0,,medlm,medalign,nursing_note,PROMPT2_ICL_entailment
200,54,14,5,9,0.3571428571428571,7,1,6,0.1428571428571428,0.2040816326530612,medlm,medalign,nursing_note,PROMPT2_ICL_entailment
201,55,2,2,0,1.0,2,1,1,0.5,0.6666666666666666,medlm,medalign,nursing_note,PROMPT2_ICL_entailment
202,56,6,6,0,1.0,3,3,0,1.0,1.0,medlm,medalign,nursing_note,PROMPT2_ICL_entailment
203,57,5,3,2,0.6,4,1,3,0.25,0.3529411764705882,medlm,medalign,nursing_note,PROMPT2_ICL_entailment
204,58,2,2,0,1.0,1,1,0,1.0,1.0,medlm,medalign,nursing_note,PROMPT2_ICL_entailment
205,59,2,2,0,1.0,1,1,0,1.0,1.0,medlm,medalign,nursing_note,PROMPT2_ICL_entailment
206,6,2,2,0,1.0,3,3,0,1.0,1.0,medlm,medalign,nursing_note,PROMPT2_ICL_entailment
207,60,44,7,37,0.1590909090909091,9,1,8,0.1111111111111111,0.1308411214953271,medlm,medalign,nursing_note,PROMPT2_ICL_entailment
208,61,1,1,0,1.0,1,1,0,1.0,1.0,medlm,medalign,nursing_note,PROMPT2_ICL_entailment
209,62,9,9,0,1.0,5,4,1,0.8,0.888888888888889,medlm,medalign,nursing_note,PROMPT2_ICL_entailment
210,63,1,1,0,1.0,7,4,3,0.5714285714285714,0.7272727272727273,medlm,medalign,nursing_note,PROMPT2_ICL_entailment
211,64,147,3,144,0.0204081632653061,1,1,0,1.0,0.0399999999999999,medlm,medalign,nursing_note,PROMPT2_ICL_entailment
212,65,3,3,0,1.0,2,1,1,0.5,0.6666666666666666,medlm,medalign,nursing_note,PROMPT2_ICL_entailment
213,66,4,4,0,1.0,4,4,0,1.0,1.0,medlm,medalign,nursing_note,PROMPT2_ICL_entailment
214,67,3,3,0,1.0,4,4,0,1.0,1.0,medlm,medalign,nursing_note,PROMPT2_ICL_entailment
215,68,5,5,0,1.0,1,0,1,0.0,0.0,medlm,medalign,nursing_note,PROMPT2_ICL_entailment
216,69,6,4,2,0.6666666666666666,2,1,1,0.5,0.5714285714285715,medlm,medalign,nursing_note,PROMPT2_ICL_entailment
217,7,3,3,0,1.0,1,1,0,1.0,1.0,medlm,medalign,nursing_note,PROMPT2_ICL_entailment
218,70,13,3,10,0.2307692307692307,1,1,0,1.0,0.375,medlm,medalign,nursing_note,PROMPT2_ICL_entailment
219,71,6,5,1,0.8333333333333334,1,1,0,1.0,0.9090909090909092,medlm,medalign,nursing_note,PROMPT2_ICL_entailment
220,72,1,0,1,0.0,1,1,0,1.0,0.0,medlm,medalign,nursing_note,PROMPT2_ICL_entailment
221,73,3,0,3,0.0,2,0,2,0.0,,medlm,medalign,nursing_note,PROMPT2_ICL_entailment
222,74,6,4,2,0.6666666666666666,6,5,1,0.8333333333333334,0.7407407407407408,medlm,medalign,nursing_note,PROMPT2_ICL_entailment
223,75,1,1,0,1.0,1,1,0,1.0,1.0,medlm,medalign,nursing_note,PROMPT2_ICL_entailment
224,76,6,5,1,0.8333333333333334,5,2,3,0.4,0.5405405405405406,medlm,medalign,nursing_note,PROMPT2_ICL_entailment
225,77,4,4,0,1.0,3,2,1,0.6666666666666666,0.8,medlm,medalign,nursing_note,PROMPT2_ICL_entailment
226,78,3,3,0,1.0,3,2,1,0.6666666666666666,0.8,medlm,medalign,nursing_note,PROMPT2_ICL_entailment
227,79,15,0,15,0.0,8,3,5,0.375,0.0,medlm,medalign,nursing_note,PROMPT2_ICL_entailment
228,8,2,1,1,0.5,8,3,5,0.375,0.4285714285714285,medlm,medalign,nursing_note,PROMPT2_ICL_entailment
229,80,7,7,0,1.0,10,6,4,0.6,0.7499999999999999,medlm,medalign,nursing_note,PROMPT2_ICL_entailment
230,81,1,0,1,0.0,1,1,0,1.0,0.0,medlm,medalign,nursing_note,PROMPT2_ICL_entailment
231,82,4,3,1,0.75,3,3,0,1.0,0.8571428571428571,medlm,medalign,nursing_note,PROMPT2_ICL_entailment
232,83,2,2,0,1.0,3,1,2,0.3333333333333333,0.5,medlm,medalign,nursing_note,PROMPT2_ICL_entailment
233,84,3,3,0,1.0,2,1,1,0.5,0.6666666666666666,medlm,medalign,nursing_note,PROMPT2_ICL_entailment
234,85,6,5,1,0.8333333333333334,8,6,2,0.75,0.7894736842105262,medlm,medalign,nursing_note,PROMPT2_ICL_entailment
235,86,3,2,1,0.6666666666666666,3,3,0,1.0,0.8,medlm,medalign,nursing_note,PROMPT2_ICL_entailment
236,87,2,2,0,1.0,2,2,0,1.0,1.0,medlm,medalign,nursing_note,PROMPT2_ICL_entailment
237,88,8,8,0,1.0,7,6,1,0.8571428571428571,0.923076923076923,medlm,medalign,nursing_note,PROMPT2_ICL_entailment
238,89,5,5,0,1.0,6,5,1,0.8333333333333334,0.9090909090909092,medlm,medalign,nursing_note,PROMPT2_ICL_entailment
239,9,2,2,0,1.0,2,2,0,1.0,1.0,medlm,medalign,nursing_note,PROMPT2_ICL_entailment
240,90,4,4,0,1.0,1,1,0,1.0,1.0,medlm,medalign,nursing_note,PROMPT2_ICL_entailment
241,91,1,1,0,1.0,1,1,0,1.0,1.0,medlm,medalign,nursing_note,PROMPT2_ICL_entailment
242,92,3,3,0,1.0,4,2,2,0.5,0.6666666666666666,medlm,medalign,nursing_note,PROMPT2_ICL_entailment
243,93,11,3,8,0.2727272727272727,1,0,1,0.0,0.0,medlm,medalign,nursing_note,PROMPT2_ICL_entailment
244,94,4,4,0,1.0,2,2,0,1.0,1.0,medlm,medalign,nursing_note,PROMPT2_ICL_entailment
245,95,10,0,10,0.0,1,0,1,0.0,,medlm,medalign,nursing_note,PROMPT2_ICL_entailment
246,96,1,1,0,1.0,1,1,0,1.0,1.0,medlm,medalign,nursing_note,PROMPT2_ICL_entailment
247,97,3,3,0,1.0,2,2,0,1.0,1.0,medlm,medalign,nursing_note,PROMPT2_ICL_entailment
248,98,8,7,1,0.875,5,4,1,0.8,0.8358208955223881,medlm,medalign,nursing_note,PROMPT2_ICL_entailment
249,99,5,5,0,1.0,7,3,4,0.4285714285714285,0.6,medlm,medalign,nursing_note,PROMPT2_ICL_entailment
0,0,11,11,0,1.0,6,5,1,0.8333333333333334,0.9090909090909092,medlm,medalign,nursing_note,PROMPT2_entailment
1,1,3,3,0,1.0,1,1,0,1.0,1.0,medlm,medalign,nursing_note,PROMPT2_entailment
2,10,7,6,1,0.8571428571428571,5,3,2,0.6,0.7058823529411764,medlm,medalign,nursing_note,PROMPT2_entailment
3,100,3,2,1,0.6666666666666666,10,2,8,0.2,0.3076923076923076,medlm,medalign,nursing_note,PROMPT2_entailment
4,101,7,7,0,1.0,1,1,0,1.0,1.0,medlm,medalign,nursing_note,PROMPT2_entailment
5,102,6,6,0,1.0,4,3,1,0.75,0.8571428571428571,medlm,medalign,nursing_note,PROMPT2_entailment
6,103,1,1,0,1.0,2,1,1,0.5,0.6666666666666666,medlm,medalign,nursing_note,PROMPT2_entailment
7,104,11,9,2,0.8181818181818182,15,10,5,0.6666666666666666,0.7346938775510203,medlm,medalign,nursing_note,PROMPT2_entailment
8,105,2,2,0,1.0,1,1,0,1.0,1.0,medlm,medalign,nursing_note,PROMPT2_entailment
9,106,9,0,9,0.0,1,1,0,1.0,0.0,medlm,medalign,nursing_note,PROMPT2_entailment
10,107,6,5,1,0.8333333333333334,4,3,1,0.75,0.7894736842105262,medlm,medalign,nursing_note,PROMPT2_entailment
11,108,3,3,0,1.0,2,2,0,1.0,1.0,medlm,medalign,nursing_note,PROMPT2_entailment
12,109,5,5,0,1.0,5,5,0,1.0,1.0,medlm,medalign,nursing_note,PROMPT2_entailment
13,11,13,0,13,0.0,1,1,0,1.0,0.0,medlm,medalign,nursing_note,PROMPT2_entailment
14,111,10,0,10,0.0,1,1,0,1.0,0.0,medlm,medalign,nursing_note,PROMPT2_entailment
15,112,2,2,0,1.0,2,2,0,1.0,1.0,medlm,medalign,nursing_note,PROMPT2_entailment
16,113,14,0,14,0.0,1,1,0,1.0,0.0,medlm,medalign,nursing_note,PROMPT2_entailment
17,114,6,0,6,0.0,1,1,0,1.0,0.0,medlm,medalign,nursing_note,PROMPT2_entailment
18,115,13,13,0,1.0,7,5,2,0.7142857142857143,0.8333333333333333,medlm,medalign,nursing_note,PROMPT2_entailment
19,117,10,7,3,0.7,13,7,6,0.5384615384615384,0.608695652173913,medlm,medalign,nursing_note,PROMPT2_entailment
20,118,1,1,0,1.0,2,1,1,0.5,0.6666666666666666,medlm,medalign,nursing_note,PROMPT2_entailment
21,119,3,1,2,0.3333333333333333,2,2,0,1.0,0.5,medlm,medalign,nursing_note,PROMPT2_entailment
22,12,2,2,0,1.0,1,1,0,1.0,1.0,medlm,medalign,nursing_note,PROMPT2_entailment
23,120,8,8,0,1.0,7,5,2,0.7142857142857143,0.8333333333333333,medlm,medalign,nursing_note,PROMPT2_entailment
24,121,50,1,49,0.02,1,1,0,1.0,0.0392156862745098,medlm,medalign,nursing_note,PROMPT2_entailment
25,122,2,1,1,0.5,1,1,0,1.0,0.6666666666666666,medlm,medalign,nursing_note,PROMPT2_entailment
26,123,2,1,1,0.5,4,1,3,0.25,0.3333333333333333,medlm,medalign,nursing_note,PROMPT2_entailment
27,124,5,5,0,1.0,14,6,8,0.4285714285714285,0.6,medlm,medalign,nursing_note,PROMPT2_entailment
28,125,6,5,1,0.8333333333333334,9,6,3,0.6666666666666666,0.7407407407407408,medlm,medalign,nursing_note,PROMPT2_entailment
29,126,13,1,12,0.0769230769230769,2,1,1,0.5,0.1333333333333333,medlm,medalign,nursing_note,PROMPT2_entailment
30,127,1,1,0,1.0,1,1,0,1.0,1.0,medlm,medalign,nursing_note,PROMPT2_entailment
31,128,4,3,1,0.75,2,2,0,1.0,0.8571428571428571,medlm,medalign,nursing_note,PROMPT2_entailment
32,129,12,11,1,0.9166666666666666,20,11,9,0.55,0.6874999999999999,medlm,medalign,nursing_note,PROMPT2_entailment
33,13,4,4,0,1.0,5,3,2,0.6,0.7499999999999999,medlm,medalign,nursing_note,PROMPT2_entailment
34,130,5,5,0,1.0,2,2,0,1.0,1.0,medlm,medalign,nursing_note,PROMPT2_entailment
35,131,2,2,0,1.0,1,1,0,1.0,1.0,medlm,medalign,nursing_note,PROMPT2_entailment
36,132,6,5,1,0.8333333333333334,2,2,0,1.0,0.9090909090909092,medlm,medalign,nursing_note,PROMPT2_entailment
37,133,10,9,1,0.9,14,7,7,0.5,0.6428571428571429,medlm,medalign,nursing_note,PROMPT2_entailment
38,134,6,6,0,1.0,3,3,0,1.0,1.0,medlm,medalign,nursing_note,PROMPT2_entailment
39,135,4,4,0,1.0,2,2,0,1.0,1.0,medlm,medalign,nursing_note,PROMPT2_entailment
40,136,8,7,1,0.875,51,19,32,0.3725490196078431,0.5225933202357564,medlm,medalign,nursing_note,PROMPT2_entailment
41,137,6,6,0,1.0,6,6,0,1.0,1.0,medlm,medalign,nursing_note,PROMPT2_entailment
42,138,16,0,16,0.0,1,1,0,1.0,0.0,medlm,medalign,nursing_note,PROMPT2_entailment
43,139,1,1,0,1.0,1,1,0,1.0,1.0,medlm,medalign,nursing_note,PROMPT2_entailment
44,14,11,0,11,0.0,1,1,0,1.0,0.0,medlm,medalign,nursing_note,PROMPT2_entailment
45,140,4,4,0,1.0,3,2,1,0.6666666666666666,0.8,medlm,medalign,nursing_note,PROMPT2_entailment
46,141,2,1,1,0.5,1,1,0,1.0,0.6666666666666666,medlm,medalign,nursing_note,PROMPT2_entailment
47,142,3,2,1,0.6666666666666666,1,1,0,1.0,0.8,medlm,medalign,nursing_note,PROMPT2_entailment
48,143,11,0,11,0.0,1,1,0,1.0,0.0,medlm,medalign,nursing_note,PROMPT2_entailment
49,144,10,2,8,0.2,1,0,1,0.0,0.0,medlm,medalign,nursing_note,PROMPT2_entailment
50,145,4,4,0,1.0,4,4,0,1.0,1.0,medlm,medalign,nursing_note,PROMPT2_entailment
51,146,9,9,0,1.0,3,2,1,0.6666666666666666,0.8,medlm,medalign,nursing_note,PROMPT2_entailment
52,147,6,6,0,1.0,6,4,2,0.6666666666666666,0.8,medlm,medalign,nursing_note,PROMPT2_entailment
53,148,9,9,0,1.0,7,7,0,1.0,1.0,medlm,medalign,nursing_note,PROMPT2_entailment
54,149,4,4,0,1.0,1,0,1,0.0,0.0,medlm,medalign,nursing_note,PROMPT2_entailment
55,15,2,2,0,1.0,1,0,1,0.0,0.0,medlm,medalign,nursing_note,PROMPT2_entailment
56,150,10,3,7,0.3,1,1,0,1.0,0.4615384615384615,medlm,medalign,nursing_note,PROMPT2_entailment
57,151,6,6,0,1.0,8,7,1,0.875,0.9333333333333332,medlm,medalign,nursing_note,PROMPT2_entailment
58,152,4,4,0,1.0,4,4,0,1.0,1.0,medlm,medalign,nursing_note,PROMPT2_entailment
59,153,13,11,2,0.8461538461538461,14,9,5,0.6428571428571429,0.7306273062730628,medlm,medalign,nursing_note,PROMPT2_entailment
60,154,3,2,1,0.6666666666666666,1,1,0,1.0,0.8,medlm,medalign,nursing_note,PROMPT2_entailment
61,155,8,8,0,1.0,14,7,7,0.5,0.6666666666666666,medlm,medalign,nursing_note,PROMPT2_entailment
62,156,3,3,0,1.0,1,1,0,1.0,1.0,medlm,medalign,nursing_note,PROMPT2_entailment
63,157,6,5,1,0.8333333333333334,3,3,0,1.0,0.9090909090909092,medlm,medalign,nursing_note,PROMPT2_entailment
64,158,2,2,0,1.0,1,1,0,1.0,1.0,medlm,medalign,nursing_note,PROMPT2_entailment
65,159,2,2,0,1.0,3,1,2,0.3333333333333333,0.5,medlm,medalign,nursing_note,PROMPT2_entailment
66,16,5,5,0,1.0,3,1,2,0.3333333333333333,0.5,medlm,medalign,nursing_note,PROMPT2_entailment
67,160,2,2,0,1.0,1,1,0,1.0,1.0,medlm,medalign,nursing_note,PROMPT2_entailment
68,161,2,2,0,1.0,1,1,0,1.0,1.0,medlm,medalign,nursing_note,PROMPT2_entailment
69,162,12,9,3,0.75,8,6,2,0.75,0.75,medlm,medalign,nursing_note,PROMPT2_entailment
70,163,5,5,0,1.0,3,3,0,1.0,1.0,medlm,medalign,nursing_note,PROMPT2_entailment
71,164,4,4,0,1.0,2,2,0,1.0,1.0,medlm,medalign,nursing_note,PROMPT2_entailment
72,165,4,4,0,1.0,4,2,2,0.5,0.6666666666666666,medlm,medalign,nursing_note,PROMPT2_entailment
73,166,5,4,1,0.8,5,3,2,0.6,0.6857142857142857,medlm,medalign,nursing_note,PROMPT2_entailment
74,167,8,7,1,0.875,2,1,1,0.5,0.6363636363636364,medlm,medalign,nursing_note,PROMPT2_entailment
75,168,2,2,0,1.0,3,2,1,0.6666666666666666,0.8,medlm,medalign,nursing_note,PROMPT2_entailment
76,169,6,4,2,0.6666666666666666,9,3,6,0.3333333333333333,0.4444444444444444,medlm,medalign,nursing_note,PROMPT2_entailment
77,17,12,1,11,0.0833333333333333,1,1,0,1.0,0.1538461538461538,medlm,medalign,nursing_note,PROMPT2_entailment
78,170,2,2,0,1.0,1,1,0,1.0,1.0,medlm,medalign,nursing_note,PROMPT2_entailment
79,172,9,7,2,0.7777777777777778,12,7,5,0.5833333333333334,0.6666666666666666,medlm,medalign,nursing_note,PROMPT2_entailment
80,173,9,9,0,1.0,1,1,0,1.0,1.0,medlm,medalign,nursing_note,PROMPT2_entailment
81,174,4,3,1,0.75,1,1,0,1.0,0.8571428571428571,medlm,medalign,nursing_note,PROMPT2_entailment
82,175,18,0,18,0.0,2,0,2,0.0,,medlm,medalign,nursing_note,PROMPT2_entailment
83,176,10,5,5,0.5,3,2,1,0.6666666666666666,0.5714285714285715,medlm,medalign,nursing_note,PROMPT2_entailment
84,177,8,4,4,0.5,8,4,4,0.5,0.5,medlm,medalign,nursing_note,PROMPT2_entailment
85,178,8,6,2,0.75,10,6,4,0.6,0.6666666666666665,medlm,medalign,nursing_note,PROMPT2_entailment
86,179,3,2,1,0.6666666666666666,2,1,1,0.5,0.5714285714285715,medlm,medalign,nursing_note,PROMPT2_entailment
87,18,8,6,2,0.75,3,1,2,0.3333333333333333,0.4615384615384615,medlm,medalign,nursing_note,PROMPT2_entailment
88,181,7,7,0,1.0,7,6,1,0.8571428571428571,0.923076923076923,medlm,medalign,nursing_note,PROMPT2_entailment
89,182,3,3,0,1.0,2,1,1,0.5,0.6666666666666666,medlm,medalign,nursing_note,PROMPT2_entailment
90,183,6,6,0,1.0,6,6,0,1.0,1.0,medlm,medalign,nursing_note,PROMPT2_entailment
91,184,9,7,2,0.7777777777777778,11,8,3,0.7272727272727273,0.7516778523489932,medlm,medalign,nursing_note,PROMPT2_entailment
92,185,2,2,0,1.0,3,3,0,1.0,1.0,medlm,medalign,nursing_note,PROMPT2_entailment
93,186,3,1,2,0.3333333333333333,3,0,3,0.0,0.0,medlm,medalign,nursing_note,PROMPT2_entailment
94,187,1,1,0,1.0,1,0,1,0.0,0.0,medlm,medalign,nursing_note,PROMPT2_entailment
95,188,4,3,1,0.75,3,3,0,1.0,0.8571428571428571,medlm,medalign,nursing_note,PROMPT2_entailment
96,189,10,10,0,1.0,10,6,4,0.6,0.7499999999999999,medlm,medalign,nursing_note,PROMPT2_entailment
97,19,4,4,0,1.0,7,4,3,0.5714285714285714,0.7272727272727273,medlm,medalign,nursing_note,PROMPT2_entailment
98,190,2,2,0,1.0,2,1,1,0.5,0.6666666666666666,medlm,medalign,nursing_note,PROMPT2_entailment
99,191,8,8,0,1.0,5,4,1,0.8,0.888888888888889,medlm,medalign,nursing_note,PROMPT2_entailment
100,192,4,4,0,1.0,1,1,0,1.0,1.0,medlm,medalign,nursing_note,PROMPT2_entailment
101,193,3,3,0,1.0,3,3,0,1.0,1.0,medlm,medalign,nursing_note,PROMPT2_entailment
102,194,1,1,0,1.0,2,1,1,0.5,0.6666666666666666,medlm,medalign,nursing_note,PROMPT2_entailment
103,195,10,9,1,0.9,10,7,3,0.7,0.7875,medlm,medalign,nursing_note,PROMPT2_entailment
104,196,2,2,0,1.0,1,1,0,1.0,1.0,medlm,medalign,nursing_note,PROMPT2_entailment
105,197,1,1,0,1.0,1,1,0,1.0,1.0,medlm,medalign,nursing_note,PROMPT2_entailment
106,198,16,12,4,0.75,8,5,3,0.625,0.6818181818181818,medlm,medalign,nursing_note,PROMPT2_entailment
107,199,9,7,2,0.7777777777777778,7,6,1,0.8571428571428571,0.8155339805825242,medlm,medalign,nursing_note,PROMPT2_entailment
108,20,5,4,1,0.8,2,1,1,0.5,0.6153846153846154,medlm,medalign,nursing_note,PROMPT2_entailment
109,200,3,3,0,1.0,3,3,0,1.0,1.0,medlm,medalign,nursing_note,PROMPT2_entailment
110,201,1,1,0,1.0,1,1,0,1.0,1.0,medlm,medalign,nursing_note,PROMPT2_entailment
111,202,2,2,0,1.0,1,0,1,0.0,0.0,medlm,medalign,nursing_note,PROMPT2_entailment
112,203,3,3,0,1.0,1,1,0,1.0,1.0,medlm,medalign,nursing_note,PROMPT2_entailment
113,204,4,4,0,1.0,9,1,8,0.1111111111111111,0.1999999999999999,medlm,medalign,nursing_note,PROMPT2_entailment
114,205,10,7,3,0.7,8,4,4,0.5,0.5833333333333334,medlm,medalign,nursing_note,PROMPT2_entailment
115,206,3,3,0,1.0,4,4,0,1.0,1.0,medlm,medalign,nursing_note,PROMPT2_entailment
116,207,5,5,0,1.0,6,3,3,0.5,0.6666666666666666,medlm,medalign,nursing_note,PROMPT2_entailment
117,208,13,9,4,0.6923076923076923,10,7,3,0.7,0.6961325966850829,medlm,medalign,nursing_note,PROMPT2_entailment
118,209,2,2,0,1.0,1,1,0,1.0,1.0,medlm,medalign,nursing_note,PROMPT2_entailment
119,21,4,4,0,1.0,1,1,0,1.0,1.0,medlm,medalign,nursing_note,PROMPT2_entailment
120,210,2,2,0,1.0,2,1,1,0.5,0.6666666666666666,medlm,medalign,nursing_note,PROMPT2_entailment
121,211,4,3,1,0.75,2,2,0,1.0,0.8571428571428571,medlm,medalign,nursing_note,PROMPT2_entailment
122,212,5,5,0,1.0,3,3,0,1.0,1.0,medlm,medalign,nursing_note,PROMPT2_entailment
123,213,11,11,0,1.0,8,8,0,1.0,1.0,medlm,medalign,nursing_note,PROMPT2_entailment
124,214,1,1,0,1.0,2,1,1,0.5,0.6666666666666666,medlm,medalign,nursing_note,PROMPT2_entailment
125,215,2,2,0,1.0,1,1,0,1.0,1.0,medlm,medalign,nursing_note,PROMPT2_entailment
126,216,4,4,0,1.0,3,3,0,1.0,1.0,medlm,medalign,nursing_note,PROMPT2_entailment
127,217,13,2,11,0.1538461538461538,11,1,10,0.0909090909090909,0.1142857142857143,medlm,medalign,nursing_note,PROMPT2_entailment
128,218,6,5,1,0.8333333333333334,3,1,2,0.3333333333333333,0.4761904761904761,medlm,medalign,nursing_note,PROMPT2_entailment
129,219,2,2,0,1.0,2,2,0,1.0,1.0,medlm,medalign,nursing_note,PROMPT2_entailment
130,22,2,2,0,1.0,1,1,0,1.0,1.0,medlm,medalign,nursing_note,PROMPT2_entailment
131,220,5,4,1,0.8,7,3,4,0.4285714285714285,0.5581395348837209,medlm,medalign,nursing_note,PROMPT2_entailment
132,221,4,4,0,1.0,23,3,20,0.1304347826086956,0.2307692307692307,medlm,medalign,nursing_note,PROMPT2_entailment
133,222,3,3,0,1.0,4,4,0,1.0,1.0,medlm,medalign,nursing_note,PROMPT2_entailment
134,223,2,2,0,1.0,2,2,0,1.0,1.0,medlm,medalign,nursing_note,PROMPT2_entailment
135,225,4,4,0,1.0,2,1,1,0.5,0.6666666666666666,medlm,medalign,nursing_note,PROMPT2_entailment
136,227,11,0,11,0.0,1,1,0,1.0,0.0,medlm,medalign,nursing_note,PROMPT2_entailment
137,228,10,9,1,0.9,18,10,8,0.5555555555555556,0.6870229007633587,medlm,medalign,nursing_note,PROMPT2_entailment
138,229,7,6,1,0.8571428571428571,7,3,4,0.4285714285714285,0.5714285714285714,medlm,medalign,nursing_note,PROMPT2_entailment
139,23,13,8,5,0.6153846153846154,21,6,15,0.2857142857142857,0.3902439024390244,medlm,medalign,nursing_note,PROMPT2_entailment
140,230,4,2,2,0.5,1,1,0,1.0,0.6666666666666666,medlm,medalign,nursing_note,PROMPT2_entailment
141,231,10,8,2,0.8,13,8,5,0.6153846153846154,0.6956521739130435,medlm,medalign,nursing_note,PROMPT2_entailment
142,232,6,3,3,0.5,6,4,2,0.6666666666666666,0.5714285714285715,medlm,medalign,nursing_note,PROMPT2_entailment
143,233,5,3,2,0.6,4,4,0,1.0,0.7499999999999999,medlm,medalign,nursing_note,PROMPT2_entailment
144,234,5,5,0,1.0,2,2,0,1.0,1.0,medlm,medalign,nursing_note,PROMPT2_entailment
145,235,14,0,14,0.0,1,0,1,0.0,,medlm,medalign,nursing_note,PROMPT2_entailment
146,236,12,11,1,0.9166666666666666,14,8,6,0.5714285714285714,0.7039999999999998,medlm,medalign,nursing_note,PROMPT2_entailment
147,238,7,7,0,1.0,4,4,0,1.0,1.0,medlm,medalign,nursing_note,PROMPT2_entailment
148,239,3,3,0,1.0,4,2,2,0.5,0.6666666666666666,medlm,medalign,nursing_note,PROMPT2_entailment
149,24,13,5,8,0.3846153846153846,1,0,1,0.0,0.0,medlm,medalign,nursing_note,PROMPT2_entailment
150,240,12,1,11,0.0833333333333333,2,1,1,0.5,0.1428571428571428,medlm,medalign,nursing_note,PROMPT2_entailment
151,241,61,2,59,0.0327868852459016,2,0,2,0.0,0.0,medlm,medalign,nursing_note,PROMPT2_entailment
152,242,7,7,0,1.0,2,0,2,0.0,0.0,medlm,medalign,nursing_note,PROMPT2_entailment
153,243,6,6,0,1.0,10,9,1,0.9,0.9473684210526316,medlm,medalign,nursing_note,PROMPT2_entailment
154,244,4,3,1,0.75,1,1,0,1.0,0.8571428571428571,medlm,medalign,nursing_note,PROMPT2_entailment
155,245,3,3,0,1.0,1,1,0,1.0,1.0,medlm,medalign,nursing_note,PROMPT2_entailment
156,246,2,2,0,1.0,1,1,0,1.0,1.0,medlm,medalign,nursing_note,PROMPT2_entailment
157,247,6,6,0,1.0,5,5,0,1.0,1.0,medlm,medalign,nursing_note,PROMPT2_entailment
158,248,1,1,0,1.0,1,1,0,1.0,1.0,medlm,medalign,nursing_note,PROMPT2_entailment
159,249,5,5,0,1.0,2,1,1,0.5,0.6666666666666666,medlm,medalign,nursing_note,PROMPT2_entailment
160,25,15,14,1,0.9333333333333332,33,23,10,0.696969696969697,0.7980173482032219,medlm,medalign,nursing_note,PROMPT2_entailment
161,26,5,5,0,1.0,1,1,0,1.0,1.0,medlm,medalign,nursing_note,PROMPT2_entailment
162,27,3,3,0,1.0,2,1,1,0.5,0.6666666666666666,medlm,medalign,nursing_note,PROMPT2_entailment
163,29,4,4,0,1.0,3,2,1,0.6666666666666666,0.8,medlm,medalign,nursing_note,PROMPT2_entailment
164,3,3,3,0,1.0,2,1,1,0.5,0.6666666666666666,medlm,medalign,nursing_note,PROMPT2_entailment
165,30,3,3,0,1.0,1,1,0,1.0,1.0,medlm,medalign,nursing_note,PROMPT2_entailment
166,31,11,2,9,0.1818181818181818,1,1,0,1.0,0.3076923076923077,medlm,medalign,nursing_note,PROMPT2_entailment
167,32,4,3,1,0.75,2,2,0,1.0,0.8571428571428571,medlm,medalign,nursing_note,PROMPT2_entailment
168,33,7,6,1,0.8571428571428571,5,3,2,0.6,0.7058823529411764,medlm,medalign,nursing_note,PROMPT2_entailment
169,34,4,4,0,1.0,4,1,3,0.25,0.4,medlm,medalign,nursing_note,PROMPT2_entailment
170,35,6,6,0,1.0,4,1,3,0.25,0.4,medlm,medalign,nursing_note,PROMPT2_entailment
171,36,7,6,1,0.8571428571428571,5,2,3,0.4,0.5454545454545455,medlm,medalign,nursing_note,PROMPT2_entailment
172,37,4,2,2,0.5,3,2,1,0.6666666666666666,0.5714285714285715,medlm,medalign,nursing_note,PROMPT2_entailment
173,39,3,3,0,1.0,1,1,0,1.0,1.0,medlm,medalign,nursing_note,PROMPT2_entailment
174,4,1,0,1,0.0,3,1,2,0.3333333333333333,0.0,medlm,medalign,nursing_note,PROMPT2_entailment
175,40,4,0,4,0.0,8,1,7,0.125,0.0,medlm,medalign,nursing_note,PROMPT2_entailment
176,41,1,1,0,1.0,1,1,0,1.0,1.0,medlm,medalign,nursing_note,PROMPT2_entailment
177,42,5,3,2,0.6,8,2,6,0.25,0.3529411764705882,medlm,medalign,nursing_note,PROMPT2_entailment
178,43,4,2,2,0.5,2,2,0,1.0,0.6666666666666666,medlm,medalign,nursing_note,PROMPT2_entailment
179,44,2,2,0,1.0,1,1,0,1.0,1.0,medlm,medalign,nursing_note,PROMPT2_entailment
180,45,15,1,14,0.0666666666666666,1,0,1,0.0,0.0,medlm,medalign,nursing_note,PROMPT2_entailment
181,46,5,5,0,1.0,5,5,0,1.0,1.0,medlm,medalign,nursing_note,PROMPT2_entailment
182,47,11,11,0,1.0,20,9,11,0.45,0.6206896551724138,medlm,medalign,nursing_note,PROMPT2_entailment
183,48,1,1,0,1.0,2,1,1,0.5,0.6666666666666666,medlm,medalign,nursing_note,PROMPT2_entailment
184,49,2,2,0,1.0,2,2,0,1.0,1.0,medlm,medalign,nursing_note,PROMPT2_entailment
185,5,3,3,0,1.0,5,3,2,0.6,0.7499999999999999,medlm,medalign,nursing_note,PROMPT2_entailment
186,50,2,1,1,0.5,1,0,1,0.0,0.0,medlm,medalign,nursing_note,PROMPT2_entailment
187,51,3,3,0,1.0,2,2,0,1.0,1.0,medlm,medalign,nursing_note,PROMPT2_entailment
188,52,4,4,0,1.0,4,4,0,1.0,1.0,medlm,medalign,nursing_note,PROMPT2_entailment
189,53,2,2,0,1.0,1,1,0,1.0,1.0,medlm,medalign,nursing_note,PROMPT2_entailment
190,54,11,9,2,0.8181818181818182,7,3,4,0.4285714285714285,0.5625,medlm,medalign,nursing_note,PROMPT2_entailment
191,55,2,2,0,1.0,2,1,1,0.5,0.6666666666666666,medlm,medalign,nursing_note,PROMPT2_entailment
192,56,7,6,1,0.8571428571428571,3,3,0,1.0,0.923076923076923,medlm,medalign,nursing_note,PROMPT2_entailment
193,58,2,2,0,1.0,1,1,0,1.0,1.0,medlm,medalign,nursing_note,PROMPT2_entailment
194,59,2,2,0,1.0,1,1,0,1.0,1.0,medlm,medalign,nursing_note,PROMPT2_entailment
195,6,2,2,0,1.0,3,3,0,1.0,1.0,medlm,medalign,nursing_note,PROMPT2_entailment
196,60,9,9,0,1.0,9,8,1,0.8888888888888888,0.9411764705882352,medlm,medalign,nursing_note,PROMPT2_entailment
197,61,2,2,0,1.0,1,1,0,1.0,1.0,medlm,medalign,nursing_note,PROMPT2_entailment
198,62,7,6,1,0.8571428571428571,5,4,1,0.8,0.8275862068965518,medlm,medalign,nursing_note,PROMPT2_entailment
199,63,6,6,0,1.0,7,2,5,0.2857142857142857,0.4444444444444445,medlm,medalign,nursing_note,PROMPT2_entailment
200,64,111,6,105,0.054054054054054,1,1,0,1.0,0.1025641025641025,medlm,medalign,nursing_note,PROMPT2_entailment
201,65,3,1,2,0.3333333333333333,2,1,1,0.5,0.4,medlm,medalign,nursing_note,PROMPT2_entailment
202,66,4,4,0,1.0,4,4,0,1.0,1.0,medlm,medalign,nursing_note,PROMPT2_entailment
203,67,5,5,0,1.0,4,4,0,1.0,1.0,medlm,medalign,nursing_note,PROMPT2_entailment
204,68,5,5,0,1.0,1,1,0,1.0,1.0,medlm,medalign,nursing_note,PROMPT2_entailment
205,69,6,5,1,0.8333333333333334,2,1,1,0.5,0.625,medlm,medalign,nursing_note,PROMPT2_entailment
206,7,3,3,0,1.0,1,1,0,1.0,1.0,medlm,medalign,nursing_note,PROMPT2_entailment
207,70,4,4,0,1.0,1,1,0,1.0,1.0,medlm,medalign,nursing_note,PROMPT2_entailment
208,71,6,5,1,0.8333333333333334,1,1,0,1.0,0.9090909090909092,medlm,medalign,nursing_note,PROMPT2_entailment
209,72,14,0,14,0.0,1,1,0,1.0,0.0,medlm,medalign,nursing_note,PROMPT2_entailment
210,73,5,5,0,1.0,2,2,0,1.0,1.0,medlm,medalign,nursing_note,PROMPT2_entailment
211,74,7,2,5,0.2857142857142857,6,2,4,0.3333333333333333,0.3076923076923076,medlm,medalign,nursing_note,PROMPT2_entailment
212,75,2,1,1,0.5,1,1,0,1.0,0.6666666666666666,medlm,medalign,nursing_note,PROMPT2_entailment
213,76,7,5,2,0.7142857142857143,5,2,3,0.4,0.5128205128205129,medlm,medalign,nursing_note,PROMPT2_entailment
214,77,4,3,1,0.75,3,3,0,1.0,0.8571428571428571,medlm,medalign,nursing_note,PROMPT2_entailment
215,78,3,3,0,1.0,3,2,1,0.6666666666666666,0.8,medlm,medalign,nursing_note,PROMPT2_entailment
216,79,1,1,0,1.0,8,2,6,0.25,0.4,medlm,medalign,nursing_note,PROMPT2_entailment
217,8,3,3,0,1.0,8,2,6,0.25,0.4,medlm,medalign,nursing_note,PROMPT2_entailment
218,80,6,6,0,1.0,10,5,5,0.5,0.6666666666666666,medlm,medalign,nursing_note,PROMPT2_entailment
219,81,11,0,11,0.0,1,1,0,1.0,0.0,medlm,medalign,nursing_note,PROMPT2_entailment
220,82,3,2,1,0.6666666666666666,3,2,1,0.6666666666666666,0.6666666666666666,medlm,medalign,nursing_note,PROMPT2_entailment
221,83,2,2,0,1.0,3,1,2,0.3333333333333333,0.5,medlm,medalign,nursing_note,PROMPT2_entailment
222,84,9,8,1,0.8888888888888888,2,1,1,0.5,0.64,medlm,medalign,nursing_note,PROMPT2_entailment
223,85,6,5,1,0.8333333333333334,8,6,2,0.75,0.7894736842105262,medlm,medalign,nursing_note,PROMPT2_entailment
224,86,4,2,2,0.5,3,3,0,1.0,0.6666666666666666,medlm,medalign,nursing_note,PROMPT2_entailment
225,87,2,2,0,1.0,2,2,0,1.0,1.0,medlm,medalign,nursing_note,PROMPT2_entailment
226,88,7,7,0,1.0,7,6,1,0.8571428571428571,0.923076923076923,medlm,medalign,nursing_note,PROMPT2_entailment
227,89,7,7,0,1.0,6,5,1,0.8333333333333334,0.9090909090909092,medlm,medalign,nursing_note,PROMPT2_entailment
228,9,3,3,0,1.0,2,2,0,1.0,1.0,medlm,medalign,nursing_note,PROMPT2_entailment
229,90,3,3,0,1.0,1,1,0,1.0,1.0,medlm,medalign,nursing_note,PROMPT2_entailment
230,91,1,1,0,1.0,1,1,0,1.0,1.0,medlm,medalign,nursing_note,PROMPT2_entailment
231,92,3,3,0,1.0,4,2,2,0.5,0.6666666666666666,medlm,medalign,nursing_note,PROMPT2_entailment
232,93,17,4,13,0.2352941176470588,1,0,1,0.0,0.0,medlm,medalign,nursing_note,PROMPT2_entailment
233,94,4,4,0,1.0,2,2,0,1.0,1.0,medlm,medalign,nursing_note,PROMPT2_entailment
234,95,101,0,101,0.0,1,1,0,1.0,0.0,medlm,medalign,nursing_note,PROMPT2_entailment
235,96,1,1,0,1.0,1,1,0,1.0,1.0,medlm,medalign,nursing_note,PROMPT2_entailment
236,97,6,6,0,1.0,2,2,0,1.0,1.0,medlm,medalign,nursing_note,PROMPT2_entailment
237,98,4,2,2,0.5,5,4,1,0.8,0.6153846153846154,medlm,medalign,nursing_note,PROMPT2_entailment
238,99,12,11,1,0.9166666666666666,7,3,4,0.4285714285714285,0.5840707964601769,medlm,medalign,nursing_note,PROMPT2_entailment
0,0,13,10,3,0.7692307692307693,71,33,38,0.4647887323943662,0.5794556628621598,medlm,medalign,progress_note,PROMPT1_entailment
1,1,31,31,0,1.0,47,29,18,0.6170212765957447,0.763157894736842,medlm,medalign,progress_note,PROMPT1_entailment
2,2,22,17,5,0.7727272727272727,54,33,21,0.6111111111111112,0.6824817518248175,medlm,medalign,progress_note,PROMPT1_entailment
3,3,22,22,0,1.0,56,29,27,0.5178571428571429,0.6823529411764707,medlm,medalign,progress_note,PROMPT1_entailment
4,4,4,4,0,1.0,65,35,30,0.5384615384615384,0.7000000000000001,medlm,medalign,progress_note,PROMPT1_entailment
0,0,68,63,5,0.9264705882352942,71,57,14,0.8028169014084507,0.8602227811713978,medlm,medalign,progress_note,PROMPT1_ICL_entailment
1,1,41,41,0,1.0,47,33,14,0.7021276595744681,0.825,medlm,medalign,progress_note,PROMPT1_ICL_entailment
2,10,39,32,7,0.8205128205128205,48,33,15,0.6875,0.7481402763018066,medlm,medalign,progress_note,PROMPT1_ICL_entailment
3,100,48,48,0,1.0,43,37,6,0.8604651162790697,0.925,medlm,medalign,progress_note,PROMPT1_ICL_entailment
4,101,57,52,5,0.912280701754386,73,53,20,0.726027397260274,0.8085668182484964,medlm,medalign,progress_note,PROMPT1_ICL_entailment
5,102,10,10,0,1.0,13,6,7,0.4615384615384615,0.631578947368421,medlm,medalign,progress_note,PROMPT1_ICL_entailment
6,11,29,28,1,0.9655172413793104,38,23,15,0.6052631578947368,0.7440785673021375,medlm,medalign,progress_note,PROMPT1_ICL_entailment
7,12,31,30,1,0.967741935483871,46,25,21,0.5434782608695652,0.6960556844547563,medlm,medalign,progress_note,PROMPT1_ICL_entailment
8,13,72,60,12,0.8333333333333334,68,59,9,0.8676470588235294,0.8501440922190202,medlm,medalign,progress_note,PROMPT1_ICL_entailment
9,14,8,7,1,0.875,13,7,6,0.5384615384615384,0.6666666666666667,medlm,medalign,progress_note,PROMPT1_ICL_entailment
10,15,15,15,0,1.0,19,12,7,0.631578947368421,0.7741935483870968,medlm,medalign,progress_note,PROMPT1_ICL_entailment
11,16,57,55,2,0.9649122807017544,78,60,18,0.7692307692307693,0.8560311284046692,medlm,medalign,progress_note,PROMPT1_ICL_entailment
12,17,29,23,6,0.7931034482758621,33,28,5,0.8484848484848485,0.8198599618077657,medlm,medalign,progress_note,PROMPT1_ICL_entailment
13,18,51,51,0,1.0,59,50,9,0.847457627118644,0.9174311926605504,medlm,medalign,progress_note,PROMPT1_ICL_entailment
14,19,86,81,5,0.9418604651162792,57,42,15,0.7368421052631579,0.8268319358366751,medlm,medalign,progress_note,PROMPT1_ICL_entailment
15,2,50,45,5,0.9,54,40,14,0.7407407407407407,0.8126410835214446,medlm,medalign,progress_note,PROMPT1_ICL_entailment
16,20,27,26,1,0.9629629629629628,31,28,3,0.9032258064516128,0.9321382842509603,medlm,medalign,progress_note,PROMPT1_ICL_entailment
17,21,28,23,5,0.8214285714285714,31,22,9,0.7096774193548387,0.7614747930775019,medlm,medalign,progress_note,PROMPT1_ICL_entailment
18,22,16,16,0,1.0,63,22,41,0.3492063492063492,0.5176470588235293,medlm,medalign,progress_note,PROMPT1_ICL_entailment
19,23,29,26,3,0.896551724137931,35,30,5,0.8571428571428571,0.8764044943820224,medlm,medalign,progress_note,PROMPT1_ICL_entailment
20,24,14,14,0,1.0,42,16,26,0.3809523809523809,0.5517241379310345,medlm,medalign,progress_note,PROMPT1_ICL_entailment
21,25,26,24,2,0.9230769230769232,26,22,4,0.8461538461538461,0.8829431438127091,medlm,medalign,progress_note,PROMPT1_ICL_entailment
22,26,26,24,2,0.9230769230769232,24,21,3,0.875,0.8983957219251337,medlm,medalign,progress_note,PROMPT1_ICL_entailment
23,27,51,50,1,0.9803921568627452,81,56,25,0.691358024691358,0.8108890819577179,medlm,medalign,progress_note,PROMPT1_ICL_entailment
24,28,38,38,0,1.0,38,31,7,0.8157894736842105,0.898550724637681,medlm,medalign,progress_note,PROMPT1_ICL_entailment
25,29,82,80,2,0.975609756097561,99,60,39,0.6060606060606061,0.7476635514018692,medlm,medalign,progress_note,PROMPT1_ICL_entailment
26,3,32,30,2,0.9375,56,33,23,0.5892857142857143,0.7236842105263158,medlm,medalign,progress_note,PROMPT1_ICL_entailment
27,30,44,43,1,0.9772727272727272,54,44,10,0.8148148148148148,0.8886801315171442,medlm,medalign,progress_note,PROMPT1_ICL_entailment
28,31,25,21,4,0.84,38,32,6,0.8421052631578947,0.8410513141426784,medlm,medalign,progress_note,PROMPT1_ICL_entailment
29,32,45,44,1,0.9777777777777776,45,40,5,0.8888888888888888,0.931216931216931,medlm,medalign,progress_note,PROMPT1_ICL_entailment
30,33,21,20,1,0.9523809523809524,33,22,11,0.6666666666666666,0.7843137254901961,medlm,medalign,progress_note,PROMPT1_ICL_entailment
31,34,27,27,0,1.0,30,24,6,0.8,0.888888888888889,medlm,medalign,progress_note,PROMPT1_ICL_entailment
32,35,8,8,0,1.0,57,28,29,0.4912280701754385,0.6588235294117647,medlm,medalign,progress_note,PROMPT1_ICL_entailment
33,36,15,15,0,1.0,29,17,12,0.5862068965517241,0.7391304347826086,medlm,medalign,progress_note,PROMPT1_ICL_entailment
34,37,5,4,1,0.8,19,4,15,0.2105263157894736,0.3333333333333333,medlm,medalign,progress_note,PROMPT1_ICL_entailment
35,38,20,17,3,0.85,63,27,36,0.4285714285714285,0.5698324022346369,medlm,medalign,progress_note,PROMPT1_ICL_entailment
36,39,42,29,13,0.6904761904761905,43,35,8,0.813953488372093,0.7471475892528525,medlm,medalign,progress_note,PROMPT1_ICL_entailment
37,4,48,48,0,1.0,65,40,25,0.6153846153846154,0.761904761904762,medlm,medalign,progress_note,PROMPT1_ICL_entailment
38,40,16,14,2,0.875,31,15,16,0.4838709677419355,0.6231454005934718,medlm,medalign,progress_note,PROMPT1_ICL_entailment
39,41,43,43,0,1.0,69,50,19,0.7246376811594203,0.8403361344537814,medlm,medalign,progress_note,PROMPT1_ICL_entailment
40,42,13,10,3,0.7692307692307693,32,18,14,0.5625,0.6498194945848376,medlm,medalign,progress_note,PROMPT1_ICL_entailment
41,43,19,17,2,0.8947368421052632,23,20,3,0.8695652173913043,0.8819714656290532,medlm,medalign,progress_note,PROMPT1_ICL_entailment
42,44,36,36,0,1.0,92,48,44,0.5217391304347826,0.6857142857142856,medlm,medalign,progress_note,PROMPT1_ICL_entailment
43,45,12,11,1,0.9166666666666666,15,9,6,0.6,0.7252747252747253,medlm,medalign,progress_note,PROMPT1_ICL_entailment
44,46,54,54,0,1.0,50,36,14,0.72,0.8372093023255813,medlm,medalign,progress_note,PROMPT1_ICL_entailment
45,47,22,18,4,0.8181818181818182,42,21,21,0.5,0.6206896551724137,medlm,medalign,progress_note,PROMPT1_ICL_entailment
46,48,43,40,3,0.9302325581395348,56,38,18,0.6785714285714286,0.7847186370676303,medlm,medalign,progress_note,PROMPT1_ICL_entailment
47,49,52,51,1,0.9807692307692308,58,39,19,0.6724137931034483,0.7978339350180506,medlm,medalign,progress_note,PROMPT1_ICL_entailment
48,5,70,69,1,0.9857142857142858,69,50,19,0.7246376811594203,0.8352499697373199,medlm,medalign,progress_note,PROMPT1_ICL_entailment
49,50,36,34,2,0.9444444444444444,68,45,23,0.6617647058823529,0.7782299084435401,medlm,medalign,progress_note,PROMPT1_ICL_entailment
50,51,34,30,4,0.8823529411764706,47,37,10,0.7872340425531915,0.8320839580209896,medlm,medalign,progress_note,PROMPT1_ICL_entailment
51,52,13,13,0,1.0,19,10,9,0.5263157894736842,0.6896551724137931,medlm,medalign,progress_note,PROMPT1_ICL_entailment
52,53,31,31,0,1.0,54,30,24,0.5555555555555556,0.7142857142857143,medlm,medalign,progress_note,PROMPT1_ICL_entailment
53,54,22,22,0,1.0,24,14,10,0.5833333333333334,0.7368421052631579,medlm,medalign,progress_note,PROMPT1_ICL_entailment
54,55,18,15,3,0.8333333333333334,23,16,7,0.6956521739130435,0.7582938388625592,medlm,medalign,progress_note,PROMPT1_ICL_entailment
55,56,18,18,0,1.0,25,12,13,0.48,0.6486486486486487,medlm,medalign,progress_note,PROMPT1_ICL_entailment
56,57,21,8,13,0.3809523809523809,4,2,2,0.5,0.4324324324324324,medlm,medalign,progress_note,PROMPT1_ICL_entailment
57,58,12,11,1,0.9166666666666666,13,6,7,0.4615384615384615,0.6139534883720931,medlm,medalign,progress_note,PROMPT1_ICL_entailment
58,59,49,45,4,0.9183673469387756,35,22,13,0.6285714285714286,0.7463249151903507,medlm,medalign,progress_note,PROMPT1_ICL_entailment
59,6,10,10,0,1.0,59,17,42,0.288135593220339,0.4473684210526315,medlm,medalign,progress_note,PROMPT1_ICL_entailment
60,60,23,23,0,1.0,56,29,27,0.5178571428571429,0.6823529411764707,medlm,medalign,progress_note,PROMPT1_ICL_entailment
61,61,27,25,2,0.925925925925926,25,20,5,0.8,0.8583690987124465,medlm,medalign,progress_note,PROMPT1_ICL_entailment
62,62,26,16,10,0.6153846153846154,32,21,11,0.65625,0.6351606805293005,medlm,medalign,progress_note,PROMPT1_ICL_entailment
63,63,8,7,1,0.875,10,6,4,0.6,0.711864406779661,medlm,medalign,progress_note,PROMPT1_ICL_entailment
64,64,43,41,2,0.9534883720930232,69,48,21,0.6956521739130435,0.8044144696505212,medlm,medalign,progress_note,PROMPT1_ICL_entailment
65,65,72,48,24,0.6666666666666666,104,60,44,0.5769230769230769,0.6185567010309277,medlm,medalign,progress_note,PROMPT1_ICL_entailment
66,66,64,55,9,0.859375,87,69,18,0.7931034482758621,0.8249103358330616,medlm,medalign,progress_note,PROMPT1_ICL_entailment
67,67,25,23,2,0.92,18,11,7,0.6111111111111112,0.7343976777939043,medlm,medalign,progress_note,PROMPT1_ICL_entailment
68,68,8,8,0,1.0,11,3,8,0.2727272727272727,0.4285714285714285,medlm,medalign,progress_note,PROMPT1_ICL_entailment
69,69,25,25,0,1.0,68,37,31,0.5441176470588235,0.7047619047619048,medlm,medalign,progress_note,PROMPT1_ICL_entailment
70,7,45,37,8,0.8222222222222222,37,32,5,0.8648648648648649,0.8430046279814881,medlm,medalign,progress_note,PROMPT1_ICL_entailment
71,70,69,67,2,0.9710144927536232,69,52,17,0.7536231884057971,0.8486177079527463,medlm,medalign,progress_note,PROMPT1_ICL_entailment
72,71,44,41,3,0.9318181818181818,48,41,7,0.8541666666666666,0.8913043478260869,medlm,medalign,progress_note,PROMPT1_ICL_entailment
73,72,7,7,0,1.0,69,26,43,0.3768115942028985,0.5473684210526316,medlm,medalign,progress_note,PROMPT1_ICL_entailment
74,73,79,63,16,0.7974683544303798,90,71,19,0.7888888888888889,0.7931554215799272,medlm,medalign,progress_note,PROMPT1_ICL_entailment
75,74,19,19,0,1.0,22,19,3,0.8636363636363636,0.9268292682926828,medlm,medalign,progress_note,PROMPT1_ICL_entailment
76,75,49,44,5,0.8979591836734694,49,42,7,0.8571428571428571,0.8770764119601329,medlm,medalign,progress_note,PROMPT1_ICL_entailment
77,76,69,67,2,0.9710144927536232,77,56,21,0.7272727272727273,0.8316524437548486,medlm,medalign,progress_note,PROMPT1_ICL_entailment
78,77,41,40,1,0.975609756097561,38,34,4,0.8947368421052632,0.9334248455730954,medlm,medalign,progress_note,PROMPT1_ICL_entailment
79,78,36,36,0,1.0,54,24,30,0.4444444444444444,0.6153846153846153,medlm,medalign,progress_note,PROMPT1_ICL_entailment
80,79,57,39,18,0.6842105263157895,64,57,7,0.890625,0.7738903394255875,medlm,medalign,progress_note,PROMPT1_ICL_entailment
81,8,16,15,1,0.9375,31,18,13,0.5806451612903226,0.7171314741035858,medlm,medalign,progress_note,PROMPT1_ICL_entailment
82,80,50,46,4,0.92,66,29,37,0.4393939393939394,0.5947391885867143,medlm,medalign,progress_note,PROMPT1_ICL_entailment
83,81,10,9,1,0.9,12,5,7,0.4166666666666667,0.569620253164557,medlm,medalign,progress_note,PROMPT1_ICL_entailment
84,82,8,8,0,1.0,13,6,7,0.4615384615384615,0.631578947368421,medlm,medalign,progress_note,PROMPT1_ICL_entailment
85,83,7,7,0,1.0,8,5,3,0.625,0.7692307692307693,medlm,medalign,progress_note,PROMPT1_ICL_entailment
86,84,16,16,0,1.0,23,15,8,0.6521739130434783,0.7894736842105263,medlm,medalign,progress_note,PROMPT1_ICL_entailment
87,85,51,47,4,0.9215686274509804,63,44,19,0.6984126984126984,0.7946205571565802,medlm,medalign,progress_note,PROMPT1_ICL_entailment
88,86,77,63,14,0.8181818181818182,75,56,19,0.7466666666666667,0.7807900852052673,medlm,medalign,progress_note,PROMPT1_ICL_entailment
89,87,42,37,5,0.8809523809523809,87,69,18,0.7931034482758621,0.8347229033840118,medlm,medalign,progress_note,PROMPT1_ICL_entailment
90,88,33,32,1,0.9696969696969696,84,39,45,0.4642857142857143,0.6279245283018867,medlm,medalign,progress_note,PROMPT1_ICL_entailment
91,89,43,40,3,0.9302325581395348,41,36,5,0.8780487804878049,0.903387703889586,medlm,medalign,progress_note,PROMPT1_ICL_entailment
92,9,56,50,6,0.8928571428571429,68,39,29,0.5735294117647058,0.6984240687679082,medlm,medalign,progress_note,PROMPT1_ICL_entailment
93,90,11,11,0,1.0,24,13,11,0.5416666666666666,0.7027027027027027,medlm,medalign,progress_note,PROMPT1_ICL_entailment
94,91,23,23,0,1.0,45,27,18,0.6,0.7499999999999999,medlm,medalign,progress_note,PROMPT1_ICL_entailment
95,92,16,11,5,0.6875,17,15,2,0.8823529411764706,0.7728337236533958,medlm,medalign,progress_note,PROMPT1_ICL_entailment
96,93,19,17,2,0.8947368421052632,25,14,11,0.56,0.6888567293777135,medlm,medalign,progress_note,PROMPT1_ICL_entailment
97,94,22,20,2,0.9090909090909092,33,21,12,0.6363636363636364,0.7486631016042781,medlm,medalign,progress_note,PROMPT1_ICL_entailment
98,95,26,26,0,1.0,41,25,16,0.6097560975609756,0.7575757575757575,medlm,medalign,progress_note,PROMPT1_ICL_entailment
99,96,56,52,4,0.9285714285714286,48,41,7,0.8541666666666666,0.8898163606010016,medlm,medalign,progress_note,PROMPT1_ICL_entailment
100,97,40,35,5,0.875,37,27,10,0.7297297297297297,0.7957894736842105,medlm,medalign,progress_note,PROMPT1_ICL_entailment
101,98,19,16,3,0.8421052631578947,55,30,25,0.5454545454545454,0.6620689655172414,medlm,medalign,progress_note,PROMPT1_ICL_entailment
102,99,74,72,2,0.972972972972973,73,58,15,0.7945205479452054,0.8747381650607458,medlm,medalign,progress_note,PROMPT1_ICL_entailment
0,0,44,40,4,0.9090909090909092,71,49,22,0.6901408450704225,0.7846277021617293,medlm,medalign,progress_note,PROMPT2_ICL_entailment
1,1,26,26,0,1.0,47,15,32,0.3191489361702128,0.4838709677419355,medlm,medalign,progress_note,PROMPT2_ICL_entailment
2,10,35,29,6,0.8285714285714286,48,32,16,0.6666666666666666,0.7388535031847134,medlm,medalign,progress_note,PROMPT2_ICL_entailment
3,100,10,10,0,1.0,43,18,25,0.4186046511627907,0.5901639344262295,medlm,medalign,progress_note,PROMPT2_ICL_entailment
4,101,50,46,4,0.92,73,49,24,0.6712328767123288,0.7761707988980717,medlm,medalign,progress_note,PROMPT2_ICL_entailment
5,102,6,5,1,0.8333333333333334,13,6,7,0.4615384615384615,0.594059405940594,medlm,medalign,progress_note,PROMPT2_ICL_entailment
6,11,27,27,0,1.0,38,26,12,0.6842105263157895,0.8125000000000001,medlm,medalign,progress_note,PROMPT2_ICL_entailment
7,12,22,21,1,0.9545454545454546,46,23,23,0.5,0.65625,medlm,medalign,progress_note,PROMPT2_ICL_entailment
8,13,71,60,11,0.8450704225352113,68,51,17,0.75,0.794701986754967,medlm,medalign,progress_note,PROMPT2_ICL_entailment
9,14,8,7,1,0.875,13,6,7,0.4615384615384615,0.6043165467625898,medlm,medalign,progress_note,PROMPT2_ICL_entailment
10,15,10,10,0,1.0,19,12,7,0.631578947368421,0.7741935483870968,medlm,medalign,progress_note,PROMPT2_ICL_entailment
11,16,83,79,4,0.9518072289156626,78,69,9,0.8846153846153846,0.9169820842795862,medlm,medalign,progress_note,PROMPT2_ICL_entailment
12,17,26,23,3,0.8846153846153846,33,28,5,0.8484848484848485,0.8661735036987223,medlm,medalign,progress_note,PROMPT2_ICL_entailment
13,18,28,28,0,1.0,59,48,11,0.8135593220338984,0.897196261682243,medlm,medalign,progress_note,PROMPT2_ICL_entailment
14,19,75,70,5,0.9333333333333332,57,40,17,0.7017543859649122,0.8011444921316165,medlm,medalign,progress_note,PROMPT2_ICL_entailment
15,2,21,16,5,0.7619047619047619,54,25,29,0.4629629629629629,0.5759539236861051,medlm,medalign,progress_note,PROMPT2_ICL_entailment
16,20,25,25,0,1.0,31,27,4,0.8709677419354839,0.9310344827586208,medlm,medalign,progress_note,PROMPT2_ICL_entailment
17,21,12,10,2,0.8333333333333334,31,16,15,0.5161290322580645,0.6374501992031872,medlm,medalign,progress_note,PROMPT2_ICL_entailment
18,22,18,18,0,1.0,63,22,41,0.3492063492063492,0.5176470588235293,medlm,medalign,progress_note,PROMPT2_ICL_entailment
19,23,21,18,3,0.8571428571428571,35,20,15,0.5714285714285714,0.6857142857142857,medlm,medalign,progress_note,PROMPT2_ICL_entailment
20,24,13,13,0,1.0,42,13,29,0.3095238095238095,0.4727272727272727,medlm,medalign,progress_note,PROMPT2_ICL_entailment
21,25,22,20,2,0.9090909090909092,26,19,7,0.7307692307692307,0.8102345415778252,medlm,medalign,progress_note,PROMPT2_ICL_entailment
22,26,21,20,1,0.9523809523809524,24,18,6,0.75,0.8391608391608391,medlm,medalign,progress_note,PROMPT2_ICL_entailment
23,27,50,49,1,0.98,81,54,27,0.6666666666666666,0.7935222672064778,medlm,medalign,progress_note,PROMPT2_ICL_entailment
24,28,33,33,0,1.0,38,24,14,0.631578947368421,0.7741935483870968,medlm,medalign,progress_note,PROMPT2_ICL_entailment
25,29,32,30,2,0.9375,99,59,40,0.5959595959595959,0.7286949361877315,medlm,medalign,progress_note,PROMPT2_ICL_entailment
26,3,22,22,0,1.0,56,29,27,0.5178571428571429,0.6823529411764707,medlm,medalign,progress_note,PROMPT2_ICL_entailment
27,30,46,42,4,0.9130434782608696,54,36,18,0.6666666666666666,0.7706422018348623,medlm,medalign,progress_note,PROMPT2_ICL_entailment
28,31,26,20,6,0.7692307692307693,38,27,11,0.7105263157894737,0.7387140902872777,medlm,medalign,progress_note,PROMPT2_ICL_entailment
29,32,34,33,1,0.9705882352941176,45,34,11,0.7555555555555555,0.8496781522150699,medlm,medalign,progress_note,PROMPT2_ICL_entailment
30,33,14,12,2,0.8571428571428571,33,18,15,0.5454545454545454,0.6666666666666665,medlm,medalign,progress_note,PROMPT2_ICL_entailment
31,34,21,21,0,1.0,30,19,11,0.6333333333333333,0.7755102040816326,medlm,medalign,progress_note,PROMPT2_ICL_entailment
32,35,31,29,2,0.935483870967742,57,33,24,0.5789473684210527,0.7152466367713004,medlm,medalign,progress_note,PROMPT2_ICL_entailment
33,36,16,16,0,1.0,29,19,10,0.6551724137931034,0.7916666666666666,medlm,medalign,progress_note,PROMPT2_ICL_entailment
34,37,15,10,5,0.6666666666666666,19,2,17,0.1052631578947368,0.1818181818181818,medlm,medalign,progress_note,PROMPT2_ICL_entailment
35,38,18,17,1,0.9444444444444444,63,30,33,0.4761904761904761,0.633147113594041,medlm,medalign,progress_note,PROMPT2_ICL_entailment
36,39,16,11,5,0.6875,43,18,25,0.4186046511627907,0.5203679369250985,medlm,medalign,progress_note,PROMPT2_ICL_entailment
37,4,52,52,0,1.0,65,50,15,0.7692307692307693,0.8695652173913044,medlm,medalign,progress_note,PROMPT2_ICL_entailment
38,40,14,13,1,0.9285714285714286,31,14,17,0.4516129032258064,0.6076794657762938,medlm,medalign,progress_note,PROMPT2_ICL_entailment
39,41,41,41,0,1.0,69,51,18,0.7391304347826086,0.85,medlm,medalign,progress_note,PROMPT2_ICL_entailment
40,42,25,21,4,0.84,32,27,5,0.84375,0.8418708240534521,medlm,medalign,progress_note,PROMPT2_ICL_entailment
41,43,19,16,3,0.8421052631578947,23,20,3,0.8695652173913043,0.8556149732620322,medlm,medalign,progress_note,PROMPT2_ICL_entailment
42,44,56,52,4,0.9285714285714286,92,57,35,0.6195652173913043,0.7432296890672015,medlm,medalign,progress_note,PROMPT2_ICL_entailment
43,45,16,15,1,0.9375,15,11,4,0.7333333333333333,0.8229426433915211,medlm,medalign,progress_note,PROMPT2_ICL_entailment
44,46,37,36,1,0.972972972972973,50,27,23,0.54,0.6945337620578779,medlm,medalign,progress_note,PROMPT2_ICL_entailment
45,47,18,16,2,0.8888888888888888,42,23,19,0.5476190476190477,0.6777163904235728,medlm,medalign,progress_note,PROMPT2_ICL_entailment
46,48,39,36,3,0.9230769230769232,56,35,21,0.625,0.7453416149068324,medlm,medalign,progress_note,PROMPT2_ICL_entailment
47,49,86,83,3,0.9651162790697676,58,34,24,0.5862068965517241,0.7293874386146291,medlm,medalign,progress_note,PROMPT2_ICL_entailment
48,5,27,25,2,0.925925925925926,69,36,33,0.5217391304347826,0.6674082313681868,medlm,medalign,progress_note,PROMPT2_ICL_entailment
49,50,46,45,1,0.9782608695652174,68,44,24,0.6470588235294118,0.7789142407553108,medlm,medalign,progress_note,PROMPT2_ICL_entailment
50,51,35,31,4,0.8857142857142857,47,27,20,0.574468085106383,0.6969192339716903,medlm,medalign,progress_note,PROMPT2_ICL_entailment
51,52,13,13,0,1.0,19,9,10,0.4736842105263157,0.6428571428571429,medlm,medalign,progress_note,PROMPT2_ICL_entailment
52,53,29,29,0,1.0,54,33,21,0.6111111111111112,0.7586206896551725,medlm,medalign,progress_note,PROMPT2_ICL_entailment
53,54,20,20,0,1.0,24,12,12,0.5,0.6666666666666666,medlm,medalign,progress_note,PROMPT2_ICL_entailment
54,55,17,14,3,0.8235294117647058,23,17,6,0.7391304347826086,0.779050736497545,medlm,medalign,progress_note,PROMPT2_ICL_entailment
55,56,14,14,0,1.0,25,14,11,0.56,0.717948717948718,medlm,medalign,progress_note,PROMPT2_ICL_entailment
56,57,20,0,20,0.0,4,0,4,0.0,,medlm,medalign,progress_note,PROMPT2_ICL_entailment
57,58,11,10,1,0.9090909090909092,13,6,7,0.4615384615384615,0.6122448979591837,medlm,medalign,progress_note,PROMPT2_ICL_entailment
58,59,21,20,1,0.9523809523809524,35,24,11,0.6857142857142857,0.7973421926910299,medlm,medalign,progress_note,PROMPT2_ICL_entailment
59,6,27,27,0,1.0,59,42,17,0.711864406779661,0.8316831683168318,medlm,medalign,progress_note,PROMPT2_ICL_entailment
60,60,21,21,0,1.0,56,21,35,0.375,0.5454545454545454,medlm,medalign,progress_note,PROMPT2_ICL_entailment
61,61,14,14,0,1.0,25,14,11,0.56,0.717948717948718,medlm,medalign,progress_note,PROMPT2_ICL_entailment
62,62,11,9,2,0.8181818181818182,32,16,16,0.5,0.6206896551724137,medlm,medalign,progress_note,PROMPT2_ICL_entailment
63,63,5,5,0,1.0,10,5,5,0.5,0.6666666666666666,medlm,medalign,progress_note,PROMPT2_ICL_entailment
64,64,12,11,1,0.9166666666666666,69,36,33,0.5217391304347826,0.6649874055415617,medlm,medalign,progress_note,PROMPT2_ICL_entailment
65,65,65,48,17,0.7384615384615385,104,61,43,0.5865384615384616,0.6537903315842358,medlm,medalign,progress_note,PROMPT2_ICL_entailment
66,66,59,55,4,0.9322033898305084,87,50,37,0.5747126436781609,0.7110536522301227,medlm,medalign,progress_note,PROMPT2_ICL_entailment
67,67,14,14,0,1.0,18,11,7,0.6111111111111112,0.7586206896551725,medlm,medalign,progress_note,PROMPT2_ICL_entailment
68,68,5,5,0,1.0,11,3,8,0.2727272727272727,0.4285714285714285,medlm,medalign,progress_note,PROMPT2_ICL_entailment
69,69,28,28,0,1.0,68,32,36,0.4705882352941176,0.6399999999999999,medlm,medalign,progress_note,PROMPT2_ICL_entailment
70,7,20,15,5,0.75,37,22,15,0.5945945945945946,0.6633165829145727,medlm,medalign,progress_note,PROMPT2_ICL_entailment
71,70,32,30,2,0.9375,69,34,35,0.4927536231884058,0.6459784673844206,medlm,medalign,progress_note,PROMPT2_ICL_entailment
72,71,47,44,3,0.9361702127659576,48,40,8,0.8333333333333334,0.8817635270541081,medlm,medalign,progress_note,PROMPT2_ICL_entailment
73,72,28,28,0,1.0,69,25,44,0.3623188405797101,0.5319148936170213,medlm,medalign,progress_note,PROMPT2_ICL_entailment
74,73,54,46,8,0.8518518518518519,90,69,21,0.7666666666666667,0.8070175438596491,medlm,medalign,progress_note,PROMPT2_ICL_entailment
75,74,19,18,1,0.9473684210526316,22,19,3,0.8636363636363636,0.903566710700132,medlm,medalign,progress_note,PROMPT2_ICL_entailment
76,75,40,35,5,0.875,49,27,22,0.5510204081632653,0.6762075134168157,medlm,medalign,progress_note,PROMPT2_ICL_entailment
77,76,60,57,3,0.95,77,36,41,0.4675324675324675,0.6266605588639487,medlm,medalign,progress_note,PROMPT2_ICL_entailment
78,77,34,32,2,0.9411764705882352,38,21,17,0.5526315789473685,0.6963730569948187,medlm,medalign,progress_note,PROMPT2_ICL_entailment
79,78,39,39,0,1.0,54,30,24,0.5555555555555556,0.7142857142857143,medlm,medalign,progress_note,PROMPT2_ICL_entailment
80,79,78,56,22,0.717948717948718,64,47,17,0.734375,0.7260689655172413,medlm,medalign,progress_note,PROMPT2_ICL_entailment
81,8,16,16,0,1.0,31,16,15,0.5161290322580645,0.6808510638297872,medlm,medalign,progress_note,PROMPT2_ICL_entailment
82,80,48,45,3,0.9375,66,47,19,0.7121212121212122,0.809414466130884,medlm,medalign,progress_note,PROMPT2_ICL_entailment
83,81,6,6,0,1.0,12,4,8,0.3333333333333333,0.5,medlm,medalign,progress_note,PROMPT2_ICL_entailment
84,82,8,8,0,1.0,13,7,6,0.5384615384615384,0.7000000000000001,medlm,medalign,progress_note,PROMPT2_ICL_entailment
85,83,12,10,2,0.8333333333333334,8,6,2,0.75,0.7894736842105262,medlm,medalign,progress_note,PROMPT2_ICL_entailment
86,84,18,18,0,1.0,23,16,7,0.6956521739130435,0.8205128205128205,medlm,medalign,progress_note,PROMPT2_ICL_entailment
87,85,44,42,2,0.9545454545454546,63,45,18,0.7142857142857143,0.8171206225680934,medlm,medalign,progress_note,PROMPT2_ICL_entailment
88,86,31,31,0,1.0,75,24,51,0.32,0.4848484848484848,medlm,medalign,progress_note,PROMPT2_ICL_entailment
89,87,61,61,0,1.0,87,49,38,0.5632183908045977,0.7205882352941176,medlm,medalign,progress_note,PROMPT2_ICL_entailment
90,88,58,55,3,0.9482758620689656,84,56,28,0.6666666666666666,0.7829181494661921,medlm,medalign,progress_note,PROMPT2_ICL_entailment
91,89,40,40,0,1.0,41,36,5,0.8780487804878049,0.9350649350649352,medlm,medalign,progress_note,PROMPT2_ICL_entailment
92,9,37,35,2,0.945945945945946,68,37,31,0.5441176470588235,0.690850893571619,medlm,medalign,progress_note,PROMPT2_ICL_entailment
93,90,10,10,0,1.0,24,9,15,0.375,0.5454545454545454,medlm,medalign,progress_note,PROMPT2_ICL_entailment
94,91,21,19,2,0.9047619047619048,45,27,18,0.6,0.7215189873417721,medlm,medalign,progress_note,PROMPT2_ICL_entailment
95,92,13,12,1,0.9230769230769232,17,13,4,0.7647058823529411,0.8364611260053619,medlm,medalign,progress_note,PROMPT2_ICL_entailment
96,93,9,9,0,1.0,25,8,17,0.32,0.4848484848484848,medlm,medalign,progress_note,PROMPT2_ICL_entailment
97,94,24,20,4,0.8333333333333334,33,23,10,0.696969696969697,0.7590759075907592,medlm,medalign,progress_note,PROMPT2_ICL_entailment
98,95,21,21,0,1.0,41,25,16,0.6097560975609756,0.7575757575757575,medlm,medalign,progress_note,PROMPT2_ICL_entailment
99,96,50,46,4,0.92,48,39,9,0.8125,0.862914862914863,medlm,medalign,progress_note,PROMPT2_ICL_entailment
100,97,36,35,1,0.9722222222222222,37,26,11,0.7027027027027027,0.8157776781712236,medlm,medalign,progress_note,PROMPT2_ICL_entailment
101,98,22,16,6,0.7272727272727273,55,33,22,0.6,0.6575342465753425,medlm,medalign,progress_note,PROMPT2_ICL_entailment
102,99,41,39,2,0.951219512195122,73,48,25,0.6575342465753424,0.7775700934579439,medlm,medalign,progress_note,PROMPT2_ICL_entailment
0,0,20,14,6,0.7,71,30,41,0.4225352112676056,0.5269761606022584,medlm,medalign,progress_note,PROMPT2_entailment
1,1,25,25,0,1.0,47,19,28,0.4042553191489361,0.5757575757575757,medlm,medalign,progress_note,PROMPT2_entailment
2,10,38,33,5,0.868421052631579,48,31,17,0.6458333333333334,0.7407675597393194,medlm,medalign,progress_note,PROMPT2_entailment
3,100,30,28,2,0.9333333333333332,43,30,13,0.6976744186046512,0.7984790874524714,medlm,medalign,progress_note,PROMPT2_entailment
4,101,43,41,2,0.9534883720930232,73,49,24,0.6712328767123288,0.7878431372549021,medlm,medalign,progress_note,PROMPT2_entailment
5,102,5,5,0,1.0,13,6,7,0.4615384615384615,0.631578947368421,medlm,medalign,progress_note,PROMPT2_entailment
6,11,23,22,1,0.9565217391304348,38,28,10,0.7368421052631579,0.8324324324324325,medlm,medalign,progress_note,PROMPT2_entailment
7,12,24,24,0,1.0,46,27,19,0.5869565217391305,0.7397260273972603,medlm,medalign,progress_note,PROMPT2_entailment
8,13,42,35,7,0.8333333333333334,68,45,23,0.6617647058823529,0.7377049180327869,medlm,medalign,progress_note,PROMPT2_entailment
9,14,8,8,0,1.0,13,7,6,0.5384615384615384,0.7000000000000001,medlm,medalign,progress_note,PROMPT2_entailment
10,15,8,7,1,0.875,19,10,9,0.5263157894736842,0.6572769953051644,medlm,medalign,progress_note,PROMPT2_entailment
11,16,26,23,3,0.8846153846153846,78,38,40,0.4871794871794871,0.6283249460819554,medlm,medalign,progress_note,PROMPT2_entailment
12,17,13,11,2,0.8461538461538461,33,14,19,0.4242424242424242,0.5651376146788991,medlm,medalign,progress_note,PROMPT2_entailment
13,18,24,24,0,1.0,59,35,24,0.5932203389830508,0.7446808510638298,medlm,medalign,progress_note,PROMPT2_entailment
14,19,47,44,3,0.9361702127659576,57,34,23,0.5964912280701754,0.7286897223575255,medlm,medalign,progress_note,PROMPT2_entailment
15,2,16,12,4,0.75,54,25,29,0.4629629629629629,0.5725190839694656,medlm,medalign,progress_note,PROMPT2_entailment
16,20,24,24,0,1.0,31,28,3,0.9032258064516128,0.9491525423728812,medlm,medalign,progress_note,PROMPT2_entailment
17,21,10,7,3,0.7,31,20,11,0.6451612903225806,0.6714628297362109,medlm,medalign,progress_note,PROMPT2_entailment
18,22,10,10,0,1.0,63,26,37,0.4126984126984127,0.5842696629213483,medlm,medalign,progress_note,PROMPT2_entailment
19,23,8,8,0,1.0,35,13,22,0.3714285714285714,0.5416666666666666,medlm,medalign,progress_note,PROMPT2_entailment
20,24,20,18,2,0.9,42,28,14,0.6666666666666666,0.7659574468085106,medlm,medalign,progress_note,PROMPT2_entailment
21,25,8,8,0,1.0,26,20,6,0.7692307692307693,0.8695652173913044,medlm,medalign,progress_note,PROMPT2_entailment
22,26,23,18,5,0.782608695652174,24,20,4,0.8333333333333334,0.8071748878923767,medlm,medalign,progress_note,PROMPT2_entailment
23,27,83,71,12,0.8554216867469879,81,54,27,0.6666666666666666,0.7493403693931399,medlm,medalign,progress_note,PROMPT2_entailment
24,28,19,17,2,0.8947368421052632,38,18,20,0.4736842105263157,0.6194331983805668,medlm,medalign,progress_note,PROMPT2_entailment
25,29,51,48,3,0.9411764705882352,99,47,52,0.4747474747474747,0.6311372219890894,medlm,medalign,progress_note,PROMPT2_entailment
26,3,34,34,0,1.0,56,28,28,0.5,0.6666666666666666,medlm,medalign,progress_note,PROMPT2_entailment
27,30,37,36,1,0.972972972972973,54,31,23,0.5740740740740741,0.7220964089291492,medlm,medalign,progress_note,PROMPT2_entailment
28,31,19,15,4,0.7894736842105263,38,25,13,0.6578947368421053,0.7177033492822966,medlm,medalign,progress_note,PROMPT2_entailment
29,32,30,30,0,1.0,45,29,16,0.6444444444444445,0.7837837837837839,medlm,medalign,progress_note,PROMPT2_entailment
30,33,13,13,0,1.0,33,16,17,0.4848484848484848,0.653061224489796,medlm,medalign,progress_note,PROMPT2_entailment
31,34,24,24,0,1.0,30,23,7,0.7666666666666667,0.8679245283018869,medlm,medalign,progress_note,PROMPT2_entailment
32,35,12,11,1,0.9166666666666666,57,19,38,0.3333333333333333,0.4888888888888888,medlm,medalign,progress_note,PROMPT2_entailment
33,36,8,8,0,1.0,29,17,12,0.5862068965517241,0.7391304347826086,medlm,medalign,progress_note,PROMPT2_entailment
34,37,15,7,8,0.4666666666666667,19,4,15,0.2105263157894736,0.2901554404145077,medlm,medalign,progress_note,PROMPT2_entailment
35,38,14,14,0,1.0,63,25,38,0.3968253968253968,0.5681818181818182,medlm,medalign,progress_note,PROMPT2_entailment
36,39,43,33,10,0.7674418604651163,43,34,9,0.7906976744186046,0.7788962165914611,medlm,medalign,progress_note,PROMPT2_entailment
37,4,18,18,0,1.0,65,28,37,0.4307692307692308,0.6021505376344086,medlm,medalign,progress_note,PROMPT2_entailment
38,40,11,9,2,0.8181818181818182,31,13,18,0.4193548387096774,0.5545023696682465,medlm,medalign,progress_note,PROMPT2_entailment
39,41,33,33,0,1.0,69,44,25,0.6376811594202898,0.7787610619469026,medlm,medalign,progress_note,PROMPT2_entailment
40,42,22,20,2,0.9090909090909092,32,27,5,0.84375,0.8752025931928686,medlm,medalign,progress_note,PROMPT2_entailment
41,43,13,12,1,0.9230769230769232,23,14,9,0.6086956521739131,0.7336244541484717,medlm,medalign,progress_note,PROMPT2_entailment
42,44,21,21,0,1.0,92,34,58,0.3695652173913043,0.5396825396825397,medlm,medalign,progress_note,PROMPT2_entailment
43,45,11,9,2,0.8181818181818182,15,8,7,0.5333333333333333,0.6457399103139013,medlm,medalign,progress_note,PROMPT2_entailment
44,46,29,29,0,1.0,50,31,19,0.62,0.7654320987654321,medlm,medalign,progress_note,PROMPT2_entailment
45,47,22,18,4,0.8181818181818182,42,24,18,0.5714285714285714,0.6728971962616823,medlm,medalign,progress_note,PROMPT2_entailment
46,48,28,25,3,0.8928571428571429,56,34,22,0.6071428571428571,0.7227891156462585,medlm,medalign,progress_note,PROMPT2_entailment
47,49,29,28,1,0.9655172413793104,58,45,13,0.7758620689655172,0.8603618982587915,medlm,medalign,progress_note,PROMPT2_entailment
48,5,20,20,0,1.0,69,29,40,0.4202898550724637,0.5918367346938774,medlm,medalign,progress_note,PROMPT2_entailment
49,50,47,46,1,0.9787234042553192,68,50,18,0.7352941176470589,0.8397225264695145,medlm,medalign,progress_note,PROMPT2_entailment
50,51,38,36,2,0.9473684210526316,47,34,13,0.723404255319149,0.8203753351206434,medlm,medalign,progress_note,PROMPT2_entailment
51,52,11,11,0,1.0,19,7,12,0.3684210526315789,0.5384615384615384,medlm,medalign,progress_note,PROMPT2_entailment
52,53,28,27,1,0.9642857142857144,54,33,21,0.6111111111111112,0.7481108312342568,medlm,medalign,progress_note,PROMPT2_entailment
53,54,16,16,0,1.0,24,13,11,0.5416666666666666,0.7027027027027027,medlm,medalign,progress_note,PROMPT2_entailment
54,55,10,9,1,0.9,23,16,7,0.6956521739130435,0.7847411444141691,medlm,medalign,progress_note,PROMPT2_entailment
55,56,12,11,1,0.9166666666666666,25,12,13,0.48,0.630071599045346,medlm,medalign,progress_note,PROMPT2_entailment
56,57,11,1,10,0.0909090909090909,4,2,2,0.5,0.1538461538461538,medlm,medalign,progress_note,PROMPT2_entailment
57,58,5,4,1,0.8,13,6,7,0.4615384615384615,0.5853658536585367,medlm,medalign,progress_note,PROMPT2_entailment
58,59,16,15,1,0.9375,35,21,14,0.6,0.7317073170731707,medlm,medalign,progress_note,PROMPT2_entailment
59,6,22,22,0,1.0,59,33,26,0.559322033898305,0.717391304347826,medlm,medalign,progress_note,PROMPT2_entailment
60,60,23,19,4,0.8260869565217391,56,23,33,0.4107142857142857,0.5486503452605148,medlm,medalign,progress_note,PROMPT2_entailment
61,61,9,9,0,1.0,25,12,13,0.48,0.6486486486486487,medlm,medalign,progress_note,PROMPT2_entailment
62,62,14,9,5,0.6428571428571429,32,16,16,0.5,0.5625000000000001,medlm,medalign,progress_note,PROMPT2_entailment
63,63,6,6,0,1.0,10,7,3,0.7,0.8235294117647058,medlm,medalign,progress_note,PROMPT2_entailment
64,64,14,14,0,1.0,69,39,30,0.5652173913043478,0.7222222222222222,medlm,medalign,progress_note,PROMPT2_entailment
65,65,16,13,3,0.8125,104,52,52,0.5,0.6190476190476191,medlm,medalign,progress_note,PROMPT2_entailment
66,66,55,51,4,0.9272727272727272,87,55,32,0.632183908045977,0.7518091664433127,medlm,medalign,progress_note,PROMPT2_entailment
67,67,15,15,0,1.0,18,13,5,0.7222222222222222,0.8387096774193548,medlm,medalign,progress_note,PROMPT2_entailment
68,68,5,5,0,1.0,11,3,8,0.2727272727272727,0.4285714285714285,medlm,medalign,progress_note,PROMPT2_entailment
69,69,53,53,0,1.0,68,54,14,0.7941176470588235,0.8852459016393442,medlm,medalign,progress_note,PROMPT2_entailment
70,7,9,6,3,0.6666666666666666,37,18,19,0.4864864864864865,0.5625,medlm,medalign,progress_note,PROMPT2_entailment
71,70,40,35,5,0.875,69,34,35,0.4927536231884058,0.6304635761589404,medlm,medalign,progress_note,PROMPT2_entailment
72,71,34,30,4,0.8823529411764706,48,31,17,0.6458333333333334,0.7457898957497994,medlm,medalign,progress_note,PROMPT2_entailment
73,72,21,21,0,1.0,69,35,34,0.5072463768115942,0.6730769230769231,medlm,medalign,progress_note,PROMPT2_entailment
74,73,53,45,8,0.8490566037735849,90,63,27,0.7,0.7673568818514007,medlm,medalign,progress_note,PROMPT2_entailment
75,74,20,20,0,1.0,22,18,4,0.8181818181818182,0.9,medlm,medalign,progress_note,PROMPT2_entailment
76,75,6,6,0,1.0,49,16,33,0.3265306122448979,0.4923076923076923,medlm,medalign,progress_note,PROMPT2_entailment
77,76,23,22,1,0.9565217391304348,77,44,33,0.5714285714285714,0.7154471544715447,medlm,medalign,progress_note,PROMPT2_entailment
78,77,18,17,1,0.9444444444444444,38,24,14,0.631578947368421,0.7569573283858998,medlm,medalign,progress_note,PROMPT2_entailment
79,78,22,22,0,1.0,54,29,25,0.5370370370370371,0.6987951807228916,medlm,medalign,progress_note,PROMPT2_entailment
80,79,32,20,12,0.625,64,34,30,0.53125,0.5743243243243243,medlm,medalign,progress_note,PROMPT2_entailment
81,8,12,12,0,1.0,31,19,12,0.6129032258064516,0.76,medlm,medalign,progress_note,PROMPT2_entailment
82,80,51,46,5,0.9019607843137256,66,48,18,0.7272727272727273,0.8052516411378555,medlm,medalign,progress_note,PROMPT2_entailment
83,81,4,3,1,0.75,12,5,7,0.4166666666666667,0.5357142857142857,medlm,medalign,progress_note,PROMPT2_entailment
84,82,7,7,0,1.0,13,6,7,0.4615384615384615,0.631578947368421,medlm,medalign,progress_note,PROMPT2_entailment
85,83,8,8,0,1.0,8,3,5,0.375,0.5454545454545454,medlm,medalign,progress_note,PROMPT2_entailment
86,84,9,9,0,1.0,23,12,11,0.5217391304347826,0.6857142857142856,medlm,medalign,progress_note,PROMPT2_entailment
87,85,14,13,1,0.9285714285714286,63,32,31,0.5079365079365079,0.6566692975532754,medlm,medalign,progress_note,PROMPT2_entailment
88,86,19,17,2,0.8947368421052632,75,27,48,0.36,0.5134228187919463,medlm,medalign,progress_note,PROMPT2_entailment
89,87,65,59,6,0.9076923076923076,87,61,26,0.7011494252873564,0.7911628929435041,medlm,medalign,progress_note,PROMPT2_entailment
90,88,13,13,0,1.0,84,29,55,0.3452380952380952,0.5132743362831858,medlm,medalign,progress_note,PROMPT2_entailment
91,89,36,34,2,0.9444444444444444,41,32,9,0.7804878048780488,0.8546739984289081,medlm,medalign,progress_note,PROMPT2_entailment
92,9,30,28,2,0.9333333333333332,68,20,48,0.2941176470588235,0.4472843450479233,medlm,medalign,progress_note,PROMPT2_entailment
93,90,10,10,0,1.0,24,11,13,0.4583333333333333,0.6285714285714286,medlm,medalign,progress_note,PROMPT2_entailment
94,91,30,30,0,1.0,45,29,16,0.6444444444444445,0.7837837837837839,medlm,medalign,progress_note,PROMPT2_entailment
95,92,8,8,0,1.0,17,9,8,0.5294117647058824,0.6923076923076924,medlm,medalign,progress_note,PROMPT2_entailment
96,93,10,10,0,1.0,25,12,13,0.48,0.6486486486486487,medlm,medalign,progress_note,PROMPT2_entailment
97,94,9,8,1,0.8888888888888888,33,14,19,0.4242424242424242,0.5743589743589743,medlm,medalign,progress_note,PROMPT2_entailment
98,95,22,22,0,1.0,41,25,16,0.6097560975609756,0.7575757575757575,medlm,medalign,progress_note,PROMPT2_entailment
99,96,24,22,2,0.9166666666666666,48,29,19,0.6041666666666666,0.728310502283105,medlm,medalign,progress_note,PROMPT2_entailment
100,97,14,12,2,0.8571428571428571,37,14,23,0.3783783783783784,0.525,medlm,medalign,progress_note,PROMPT2_entailment
101,98,21,11,10,0.5238095238095238,55,25,30,0.4545454545454545,0.4867256637168142,medlm,medalign,progress_note,PROMPT2_entailment
102,99,20,19,1,0.95,73,29,44,0.3972602739726027,0.5602440264361972,medlm,medalign,progress_note,PROMPT2_entailment
0,0,13,12,1,0.9230769230769232,9,9,0,1.0,0.96,GPT4,coral,pdac,PROMPT1_entailment
1,1,13,13,0,1.0,9,9,0,1.0,1.0,GPT4,coral,pdac,PROMPT1_entailment
2,10,18,17,1,0.9444444444444444,11,7,4,0.6363636363636364,0.7603833865814696,GPT4,coral,pdac,PROMPT1_entailment
3,100,10,9,1,0.9,11,10,1,0.9090909090909092,0.9045226130653266,GPT4,coral,pdac,PROMPT1_entailment
4,101,21,19,2,0.9047619047619048,11,10,1,0.9090909090909092,0.9069212410501194,GPT4,coral,pdac,PROMPT1_entailment
5,102,27,27,0,1.0,27,14,13,0.5185185185185185,0.6829268292682926,GPT4,coral,pdac,PROMPT1_entailment
6,103,14,12,2,0.8571428571428571,15,12,3,0.8,0.8275862068965518,GPT4,coral,pdac,PROMPT1_entailment
7,104,19,18,1,0.9473684210526316,12,11,1,0.9166666666666666,0.9317647058823528,GPT4,coral,pdac,PROMPT1_entailment
8,105,26,17,9,0.6538461538461539,33,19,14,0.5757575757575758,0.6123222748815166,GPT4,coral,pdac,PROMPT1_entailment
9,106,12,12,0,1.0,10,10,0,1.0,1.0,GPT4,coral,pdac,PROMPT1_entailment
10,107,10,10,0,1.0,10,10,0,1.0,1.0,GPT4,coral,pdac,PROMPT1_entailment
11,108,15,15,0,1.0,10,10,0,1.0,1.0,GPT4,coral,pdac,PROMPT1_entailment
12,109,25,25,0,1.0,34,28,6,0.8235294117647058,0.9032258064516128,GPT4,coral,pdac,PROMPT1_entailment
13,11,19,19,0,1.0,10,10,0,1.0,1.0,GPT4,coral,pdac,PROMPT1_entailment
14,110,8,8,0,1.0,4,4,0,1.0,1.0,GPT4,coral,pdac,PROMPT1_entailment
15,111,10,9,1,0.9,3,3,0,1.0,0.9473684210526316,GPT4,coral,pdac,PROMPT1_entailment
16,112,12,12,0,1.0,9,9,0,1.0,1.0,GPT4,coral,pdac,PROMPT1_entailment
17,113,14,13,1,0.9285714285714286,6,6,0,1.0,0.962962962962963,GPT4,coral,pdac,PROMPT1_entailment
18,114,12,11,1,0.9166666666666666,9,9,0,1.0,0.9565217391304348,GPT4,coral,pdac,PROMPT1_entailment
19,115,12,12,0,1.0,7,7,0,1.0,1.0,GPT4,coral,pdac,PROMPT1_entailment
20,116,5,5,0,1.0,2,2,0,1.0,1.0,GPT4,coral,pdac,PROMPT1_entailment
21,117,11,11,0,1.0,8,7,1,0.875,0.9333333333333332,GPT4,coral,pdac,PROMPT1_entailment
22,118,14,14,0,1.0,9,9,0,1.0,1.0,GPT4,coral,pdac,PROMPT1_entailment
23,119,18,16,2,0.8888888888888888,12,11,1,0.9166666666666666,0.9025641025641026,GPT4,coral,pdac,PROMPT1_entailment
24,12,22,19,3,0.8636363636363636,10,9,1,0.9,0.8814432989690723,GPT4,coral,pdac,PROMPT1_entailment
25,120,16,14,2,0.875,13,12,1,0.9230769230769232,0.8983957219251337,GPT4,coral,pdac,PROMPT1_entailment
26,121,26,24,2,0.9230769230769232,12,12,0,1.0,0.96,GPT4,coral,pdac,PROMPT1_entailment
27,122,42,31,11,0.7380952380952381,45,33,12,0.7333333333333333,0.7357065803667744,GPT4,coral,pdac,PROMPT1_entailment
28,123,14,14,0,1.0,10,9,1,0.9,0.9473684210526316,GPT4,coral,pdac,PROMPT1_entailment
29,124,5,5,0,1.0,3,3,0,1.0,1.0,GPT4,coral,pdac,PROMPT1_entailment
30,125,10,9,1,0.9,8,7,1,0.875,0.8873239436619719,GPT4,coral,pdac,PROMPT1_entailment
31,126,14,14,0,1.0,10,10,0,1.0,1.0,GPT4,coral,pdac,PROMPT1_entailment
32,127,41,32,9,0.7804878048780488,30,23,7,0.7666666666666667,0.7735155018392011,GPT4,coral,pdac,PROMPT1_entailment
33,128,41,38,3,0.926829268292683,35,33,2,0.9428571428571428,0.9347745061498324,GPT4,coral,pdac,PROMPT1_entailment
34,129,14,13,1,0.9285714285714286,11,10,1,0.9090909090909092,0.9187279151943464,GPT4,coral,pdac,PROMPT1_entailment
35,13,30,25,5,0.8333333333333334,13,13,0,1.0,0.9090909090909092,GPT4,coral,pdac,PROMPT1_entailment
36,130,21,18,3,0.8571428571428571,12,9,3,0.75,0.7999999999999999,GPT4,coral,pdac,PROMPT1_entailment
37,131,13,12,1,0.9230769230769232,12,10,2,0.8333333333333334,0.8759124087591241,GPT4,coral,pdac,PROMPT1_entailment
38,132,13,11,2,0.8461538461538461,10,9,1,0.9,0.8722466960352422,GPT4,coral,pdac,PROMPT1_entailment
39,133,13,12,1,0.9230769230769232,7,7,0,1.0,0.96,GPT4,coral,pdac,PROMPT1_entailment
40,134,14,11,3,0.7857142857142857,15,9,6,0.6,0.6804123711340206,GPT4,coral,pdac,PROMPT1_entailment
41,135,14,14,0,1.0,9,9,0,1.0,1.0,GPT4,coral,pdac,PROMPT1_entailment
42,136,20,18,2,0.9,7,3,4,0.4285714285714285,0.5806451612903225,GPT4,coral,pdac,PROMPT1_entailment
43,137,13,12,1,0.9230769230769232,10,7,3,0.7,0.7962085308056872,GPT4,coral,pdac,PROMPT1_entailment
44,138,17,16,1,0.9411764705882352,25,21,4,0.84,0.8877146631439894,GPT4,coral,pdac,PROMPT1_entailment
45,139,28,24,4,0.8571428571428571,62,36,26,0.5806451612903226,0.6923076923076923,GPT4,coral,pdac,PROMPT1_entailment
46,14,13,12,1,0.9230769230769232,10,10,0,1.0,0.96,GPT4,coral,pdac,PROMPT1_entailment
47,140,12,12,0,1.0,8,8,0,1.0,1.0,GPT4,coral,pdac,PROMPT1_entailment
48,141,16,16,0,1.0,11,8,3,0.7272727272727273,0.8421052631578948,GPT4,coral,pdac,PROMPT1_entailment
49,142,15,9,6,0.6,11,10,1,0.9090909090909092,0.7228915662650602,GPT4,coral,pdac,PROMPT1_entailment
50,143,14,12,2,0.8571428571428571,9,8,1,0.8888888888888888,0.8727272727272727,GPT4,coral,pdac,PROMPT1_entailment
51,144,11,10,1,0.9090909090909092,12,11,1,0.9166666666666666,0.9128630705394192,GPT4,coral,pdac,PROMPT1_entailment
52,145,11,11,0,1.0,10,10,0,1.0,1.0,GPT4,coral,pdac,PROMPT1_entailment
53,146,11,11,0,1.0,7,6,1,0.8571428571428571,0.923076923076923,GPT4,coral,pdac,PROMPT1_entailment
54,147,12,11,1,0.9166666666666666,12,11,1,0.9166666666666666,0.9166666666666666,GPT4,coral,pdac,PROMPT1_entailment
55,148,26,23,3,0.8846153846153846,25,18,7,0.72,0.7938638542665388,GPT4,coral,pdac,PROMPT1_entailment
56,149,14,13,1,0.9285714285714286,7,6,1,0.8571428571428571,0.8914285714285715,GPT4,coral,pdac,PROMPT1_entailment
57,15,11,11,0,1.0,10,10,0,1.0,1.0,GPT4,coral,pdac,PROMPT1_entailment
58,150,11,11,0,1.0,8,8,0,1.0,1.0,GPT4,coral,pdac,PROMPT1_entailment
59,151,16,15,1,0.9375,10,10,0,1.0,0.967741935483871,GPT4,coral,pdac,PROMPT1_entailment
60,152,19,19,0,1.0,11,10,1,0.9090909090909092,0.9523809523809524,GPT4,coral,pdac,PROMPT1_entailment
61,153,44,31,13,0.7045454545454546,30,18,12,0.6,0.6480836236933797,GPT4,coral,pdac,PROMPT1_entailment
62,154,21,21,0,1.0,15,15,0,1.0,1.0,GPT4,coral,pdac,PROMPT1_entailment
63,155,45,42,3,0.9333333333333332,47,36,11,0.7659574468085106,0.8414023372287146,GPT4,coral,pdac,PROMPT1_entailment
64,156,13,12,1,0.9230769230769232,10,9,1,0.9,0.9113924050632912,GPT4,coral,pdac,PROMPT1_entailment
65,157,19,15,4,0.7894736842105263,14,12,2,0.8571428571428571,0.8219178082191781,GPT4,coral,pdac,PROMPT1_entailment
66,158,11,9,2,0.8181818181818182,10,9,1,0.9,0.8571428571428572,GPT4,coral,pdac,PROMPT1_entailment
67,159,12,12,0,1.0,4,4,0,1.0,1.0,GPT4,coral,pdac,PROMPT1_entailment
68,16,29,23,6,0.7931034482758621,31,29,2,0.935483870967742,0.8584298584298584,GPT4,coral,pdac,PROMPT1_entailment
69,160,10,10,0,1.0,9,9,0,1.0,1.0,GPT4,coral,pdac,PROMPT1_entailment
70,161,12,12,0,1.0,9,8,1,0.8888888888888888,0.9411764705882352,GPT4,coral,pdac,PROMPT1_entailment
71,162,13,13,0,1.0,10,10,0,1.0,1.0,GPT4,coral,pdac,PROMPT1_entailment
72,163,15,15,0,1.0,13,12,1,0.9230769230769232,0.96,GPT4,coral,pdac,PROMPT1_entailment
73,164,54,47,7,0.8703703703703703,36,32,4,0.8888888888888888,0.87953216374269,GPT4,coral,pdac,PROMPT1_entailment
74,165,16,14,2,0.875,10,6,4,0.6,0.711864406779661,GPT4,coral,pdac,PROMPT1_entailment
75,166,18,15,3,0.8333333333333334,11,11,0,1.0,0.9090909090909092,GPT4,coral,pdac,PROMPT1_entailment
76,167,12,11,1,0.9166666666666666,8,7,1,0.875,0.8953488372093024,GPT4,coral,pdac,PROMPT1_entailment
77,168,10,9,1,0.9,6,6,0,1.0,0.9473684210526316,GPT4,coral,pdac,PROMPT1_entailment
78,169,10,10,0,1.0,7,6,1,0.8571428571428571,0.923076923076923,GPT4,coral,pdac,PROMPT1_entailment
79,17,12,12,0,1.0,5,5,0,1.0,1.0,GPT4,coral,pdac,PROMPT1_entailment
80,170,18,14,4,0.7777777777777778,16,13,3,0.8125,0.7947598253275109,GPT4,coral,pdac,PROMPT1_entailment
81,171,23,19,4,0.8260869565217391,13,12,1,0.9230769230769232,0.8718929254302104,GPT4,coral,pdac,PROMPT1_entailment
82,172,21,17,4,0.8095238095238095,10,10,0,1.0,0.8947368421052632,GPT4,coral,pdac,PROMPT1_entailment
83,173,25,24,1,0.96,22,16,6,0.7272727272727273,0.8275862068965517,GPT4,coral,pdac,PROMPT1_entailment
84,174,14,9,5,0.6428571428571429,11,5,6,0.4545454545454545,0.5325443786982248,GPT4,coral,pdac,PROMPT1_entailment
85,175,45,12,33,0.2666666666666666,28,12,16,0.4285714285714285,0.3287671232876712,GPT4,coral,pdac,PROMPT1_entailment
86,176,14,14,0,1.0,10,10,0,1.0,1.0,GPT4,coral,pdac,PROMPT1_entailment
87,177,13,13,0,1.0,10,9,1,0.9,0.9473684210526316,GPT4,coral,pdac,PROMPT1_entailment
88,178,33,21,12,0.6363636363636364,36,27,9,0.75,0.6885245901639345,GPT4,coral,pdac,PROMPT1_entailment
89,179,9,9,0,1.0,9,8,1,0.8888888888888888,0.9411764705882352,GPT4,coral,pdac,PROMPT1_entailment
90,18,15,14,1,0.9333333333333332,15,12,3,0.8,0.8615384615384616,GPT4,coral,pdac,PROMPT1_entailment
91,180,8,7,1,0.875,5,5,0,1.0,0.9333333333333332,GPT4,coral,pdac,PROMPT1_entailment
92,181,17,17,0,1.0,10,8,2,0.8,0.888888888888889,GPT4,coral,pdac,PROMPT1_entailment
93,182,10,10,0,1.0,8,8,0,1.0,1.0,GPT4,coral,pdac,PROMPT1_entailment
94,183,15,15,0,1.0,10,6,4,0.6,0.7499999999999999,GPT4,coral,pdac,PROMPT1_entailment
95,184,14,6,8,0.4285714285714285,9,9,0,1.0,0.6,GPT4,coral,pdac,PROMPT1_entailment
96,185,20,16,4,0.8,22,17,5,0.7727272727272727,0.7861271676300577,GPT4,coral,pdac,PROMPT1_entailment
97,186,34,26,8,0.7647058823529411,32,15,17,0.46875,0.5812220566318926,GPT4,coral,pdac,PROMPT1_entailment
98,187,48,39,9,0.8125,34,24,10,0.7058823529411765,0.7554479418886199,GPT4,coral,pdac,PROMPT1_entailment
99,188,16,16,0,1.0,8,8,0,1.0,1.0,GPT4,coral,pdac,PROMPT1_entailment
100,189,12,11,1,0.9166666666666666,5,5,0,1.0,0.9565217391304348,GPT4,coral,pdac,PROMPT1_entailment
101,19,20,16,4,0.8,21,18,3,0.8571428571428571,0.8275862068965518,GPT4,coral,pdac,PROMPT1_entailment
102,190,11,10,1,0.9090909090909092,17,13,4,0.7647058823529411,0.8306709265175718,GPT4,coral,pdac,PROMPT1_entailment
103,191,30,24,6,0.8,15,13,2,0.8666666666666667,0.832,GPT4,coral,pdac,PROMPT1_entailment
104,192,14,11,3,0.7857142857142857,12,12,0,1.0,0.88,GPT4,coral,pdac,PROMPT1_entailment
105,193,10,8,2,0.8,10,10,0,1.0,0.888888888888889,GPT4,coral,pdac,PROMPT1_entailment
106,194,12,10,2,0.8333333333333334,11,10,1,0.9090909090909092,0.8695652173913043,GPT4,coral,pdac,PROMPT1_entailment
107,195,11,9,2,0.8181818181818182,7,7,0,1.0,0.9,GPT4,coral,pdac,PROMPT1_entailment
108,196,15,14,1,0.9333333333333332,8,8,0,1.0,0.9655172413793104,GPT4,coral,pdac,PROMPT1_entailment
109,197,9,9,0,1.0,9,8,1,0.8888888888888888,0.9411764705882352,GPT4,coral,pdac,PROMPT1_entailment
110,198,14,12,2,0.8571428571428571,12,11,1,0.9166666666666666,0.8859060402684563,GPT4,coral,pdac,PROMPT1_entailment
111,199,20,17,3,0.85,9,9,0,1.0,0.9189189189189187,GPT4,coral,pdac,PROMPT1_entailment
112,2,15,12,3,0.8,14,12,2,0.8571428571428571,0.8275862068965518,GPT4,coral,pdac,PROMPT1_entailment
113,20,27,15,12,0.5555555555555556,18,14,4,0.7777777777777778,0.6481481481481481,GPT4,coral,pdac,PROMPT1_entailment
114,200,24,18,6,0.75,16,15,1,0.9375,0.8333333333333334,GPT4,coral,pdac,PROMPT1_entailment
115,201,10,10,0,1.0,10,10,0,1.0,1.0,GPT4,coral,pdac,PROMPT1_entailment
116,202,10,10,0,1.0,10,10,0,1.0,1.0,GPT4,coral,pdac,PROMPT1_entailment
117,203,30,27,3,0.9,31,25,6,0.8064516129032258,0.8506616257088847,GPT4,coral,pdac,PROMPT1_entailment
118,204,17,11,6,0.6470588235294118,14,11,3,0.7857142857142857,0.7096774193548386,GPT4,coral,pdac,PROMPT1_entailment
119,205,11,7,4,0.6363636363636364,7,7,0,1.0,0.7777777777777778,GPT4,coral,pdac,PROMPT1_entailment
120,206,11,9,2,0.8181818181818182,9,9,0,1.0,0.9,GPT4,coral,pdac,PROMPT1_entailment
121,207,15,13,2,0.8666666666666667,8,7,1,0.875,0.8708133971291866,GPT4,coral,pdac,PROMPT1_entailment
122,208,8,7,1,0.875,8,8,0,1.0,0.9333333333333332,GPT4,coral,pdac,PROMPT1_entailment
123,209,16,16,0,1.0,9,9,0,1.0,1.0,GPT4,coral,pdac,PROMPT1_entailment
124,21,10,10,0,1.0,10,9,1,0.9,0.9473684210526316,GPT4,coral,pdac,PROMPT1_entailment
125,210,16,15,1,0.9375,9,9,0,1.0,0.967741935483871,GPT4,coral,pdac,PROMPT1_entailment
126,211,15,14,1,0.9333333333333332,8,8,0,1.0,0.9655172413793104,GPT4,coral,pdac,PROMPT1_entailment
127,212,21,19,2,0.9047619047619048,17,15,2,0.8823529411764706,0.8934169278996865,GPT4,coral,pdac,PROMPT1_entailment
128,213,13,13,0,1.0,11,11,0,1.0,1.0,GPT4,coral,pdac,PROMPT1_entailment
129,214,14,13,1,0.9285714285714286,18,11,7,0.6111111111111112,0.7371134020618557,GPT4,coral,pdac,PROMPT1_entailment
130,215,19,8,11,0.4210526315789473,12,8,4,0.6666666666666666,0.5161290322580646,GPT4,coral,pdac,PROMPT1_entailment
131,216,32,25,7,0.78125,33,28,5,0.8484848484848485,0.8134805345729226,GPT4,coral,pdac,PROMPT1_entailment
132,217,28,27,1,0.9642857142857144,19,16,3,0.8421052631578947,0.8990634755463058,GPT4,coral,pdac,PROMPT1_entailment
133,218,12,12,0,1.0,11,10,1,0.9090909090909092,0.9523809523809524,GPT4,coral,pdac,PROMPT1_entailment
134,219,11,8,3,0.7272727272727273,8,8,0,1.0,0.8421052631578948,GPT4,coral,pdac,PROMPT1_entailment
135,22,15,8,7,0.5333333333333333,17,15,2,0.8823529411764706,0.664819944598338,GPT4,coral,pdac,PROMPT1_entailment
136,220,14,13,1,0.9285714285714286,11,10,1,0.9090909090909092,0.9187279151943464,GPT4,coral,pdac,PROMPT1_entailment
137,221,13,13,0,1.0,12,11,1,0.9166666666666666,0.9565217391304348,GPT4,coral,pdac,PROMPT1_entailment
138,222,11,11,0,1.0,11,9,2,0.8181818181818182,0.9,GPT4,coral,pdac,PROMPT1_entailment
139,223,34,32,2,0.9411764705882352,37,33,4,0.8918918918918919,0.9158716392020816,GPT4,coral,pdac,PROMPT1_entailment
140,224,17,9,8,0.5294117647058824,8,8,0,1.0,0.6923076923076924,GPT4,coral,pdac,PROMPT1_entailment
141,225,14,12,2,0.8571428571428571,13,11,2,0.8461538461538461,0.8516129032258064,GPT4,coral,pdac,PROMPT1_entailment
142,226,12,12,0,1.0,11,10,1,0.9090909090909092,0.9523809523809524,GPT4,coral,pdac,PROMPT1_entailment
143,227,13,11,2,0.8461538461538461,10,10,0,1.0,0.9166666666666666,GPT4,coral,pdac,PROMPT1_entailment
144,228,12,11,1,0.9166666666666666,9,9,0,1.0,0.9565217391304348,GPT4,coral,pdac,PROMPT1_entailment
145,229,12,11,1,0.9166666666666666,9,7,2,0.7777777777777778,0.8415300546448087,GPT4,coral,pdac,PROMPT1_entailment
146,23,15,15,0,1.0,12,11,1,0.9166666666666666,0.9565217391304348,GPT4,coral,pdac,PROMPT1_entailment
147,230,11,11,0,1.0,8,8,0,1.0,1.0,GPT4,coral,pdac,PROMPT1_entailment
148,24,10,10,0,1.0,9,9,0,1.0,1.0,GPT4,coral,pdac,PROMPT1_entailment
149,25,12,11,1,0.9166666666666666,11,10,1,0.9090909090909092,0.9128630705394192,GPT4,coral,pdac,PROMPT1_entailment
150,26,13,12,1,0.9230769230769232,11,10,1,0.9090909090909092,0.9160305343511452,GPT4,coral,pdac,PROMPT1_entailment
151,27,13,12,1,0.9230769230769232,12,10,2,0.8333333333333334,0.8759124087591241,GPT4,coral,pdac,PROMPT1_entailment
152,28,15,15,0,1.0,13,12,1,0.9230769230769232,0.96,GPT4,coral,pdac,PROMPT1_entailment
153,29,8,7,1,0.875,9,7,2,0.7777777777777778,0.823529411764706,GPT4,coral,pdac,PROMPT1_entailment
154,3,10,10,0,1.0,8,8,0,1.0,1.0,GPT4,coral,pdac,PROMPT1_entailment
155,30,18,16,2,0.8888888888888888,11,11,0,1.0,0.9411764705882352,GPT4,coral,pdac,PROMPT1_entailment
156,31,18,18,0,1.0,11,11,0,1.0,1.0,GPT4,coral,pdac,PROMPT1_entailment
157,32,25,22,3,0.88,11,8,3,0.7272727272727273,0.7963800904977375,GPT4,coral,pdac,PROMPT1_entailment
158,33,21,10,11,0.4761904761904761,24,11,13,0.4583333333333333,0.4670912951167728,GPT4,coral,pdac,PROMPT1_entailment
159,34,10,10,0,1.0,10,10,0,1.0,1.0,GPT4,coral,pdac,PROMPT1_entailment
160,35,13,13,0,1.0,10,10,0,1.0,1.0,GPT4,coral,pdac,PROMPT1_entailment
161,36,39,38,1,0.9743589743589745,44,37,7,0.8409090909090909,0.9027287319422151,GPT4,coral,pdac,PROMPT1_entailment
162,37,18,14,4,0.7777777777777778,9,8,1,0.8888888888888888,0.8296296296296296,GPT4,coral,pdac,PROMPT1_entailment
163,38,22,19,3,0.8636363636363636,13,11,2,0.8461538461538461,0.8548057259713701,GPT4,coral,pdac,PROMPT1_entailment
164,39,15,14,1,0.9333333333333332,10,9,1,0.9,0.9163636363636364,GPT4,coral,pdac,PROMPT1_entailment
165,4,21,20,1,0.9523809523809524,15,11,4,0.7333333333333333,0.8286252354048965,GPT4,coral,pdac,PROMPT1_entailment
166,40,11,11,0,1.0,10,10,0,1.0,1.0,GPT4,coral,pdac,PROMPT1_entailment
167,41,14,14,0,1.0,8,8,0,1.0,1.0,GPT4,coral,pdac,PROMPT1_entailment
168,42,16,14,2,0.875,11,9,2,0.8181818181818182,0.8456375838926175,GPT4,coral,pdac,PROMPT1_entailment
169,43,20,20,0,1.0,13,9,4,0.6923076923076923,0.8181818181818181,GPT4,coral,pdac,PROMPT1_entailment
170,44,10,9,1,0.9,11,11,0,1.0,0.9473684210526316,GPT4,coral,pdac,PROMPT1_entailment
171,45,12,10,2,0.8333333333333334,10,10,0,1.0,0.9090909090909092,GPT4,coral,pdac,PROMPT1_entailment
172,46,16,16,0,1.0,11,10,1,0.9090909090909092,0.9523809523809524,GPT4,coral,pdac,PROMPT1_entailment
173,47,37,35,2,0.945945945945946,39,29,10,0.7435897435897436,0.8326497128794094,GPT4,coral,pdac,PROMPT1_entailment
174,48,11,10,1,0.9090909090909092,10,9,1,0.9,0.9045226130653266,GPT4,coral,pdac,PROMPT1_entailment
175,49,15,15,0,1.0,10,9,1,0.9,0.9473684210526316,GPT4,coral,pdac,PROMPT1_entailment
176,5,15,15,0,1.0,10,8,2,0.8,0.888888888888889,GPT4,coral,pdac,PROMPT1_entailment
177,50,9,8,1,0.8888888888888888,10,8,2,0.8,0.8421052631578948,GPT4,coral,pdac,PROMPT1_entailment
178,51,16,14,2,0.875,12,12,0,1.0,0.9333333333333332,GPT4,coral,pdac,PROMPT1_entailment
179,52,10,10,0,1.0,10,10,0,1.0,1.0,GPT4,coral,pdac,PROMPT1_entailment
180,53,13,12,1,0.9230769230769232,8,8,0,1.0,0.96,GPT4,coral,pdac,PROMPT1_entailment
181,54,5,5,0,1.0,2,2,0,1.0,1.0,GPT4,coral,pdac,PROMPT1_entailment
182,55,15,15,0,1.0,10,9,1,0.9,0.9473684210526316,GPT4,coral,pdac,PROMPT1_entailment
183,56,14,11,3,0.7857142857142857,8,7,1,0.875,0.8279569892473119,GPT4,coral,pdac,PROMPT1_entailment
184,57,36,26,10,0.7222222222222222,13,9,4,0.6923076923076923,0.7069486404833838,GPT4,coral,pdac,PROMPT1_entailment
185,58,22,19,3,0.8636363636363636,10,10,0,1.0,0.9268292682926828,GPT4,coral,pdac,PROMPT1_entailment
186,59,17,12,5,0.7058823529411765,21,16,5,0.7619047619047619,0.7328244274809159,GPT4,coral,pdac,PROMPT1_entailment
187,6,15,15,0,1.0,12,12,0,1.0,1.0,GPT4,coral,pdac,PROMPT1_entailment
188,60,28,26,2,0.9285714285714286,13,13,0,1.0,0.962962962962963,GPT4,coral,pdac,PROMPT1_entailment
189,61,11,10,1,0.9090909090909092,7,7,0,1.0,0.9523809523809524,GPT4,coral,pdac,PROMPT1_entailment
190,62,13,11,2,0.8461538461538461,11,10,1,0.9090909090909092,0.8764940239043824,GPT4,coral,pdac,PROMPT1_entailment
191,63,10,10,0,1.0,10,10,0,1.0,1.0,GPT4,coral,pdac,PROMPT1_entailment
192,64,12,11,1,0.9166666666666666,12,12,0,1.0,0.9565217391304348,GPT4,coral,pdac,PROMPT1_entailment
193,65,17,16,1,0.9411764705882352,9,9,0,1.0,0.9696969696969696,GPT4,coral,pdac,PROMPT1_entailment
194,66,18,18,0,1.0,12,10,2,0.8333333333333334,0.9090909090909092,GPT4,coral,pdac,PROMPT1_entailment
195,67,4,4,0,1.0,1,1,0,1.0,1.0,GPT4,coral,pdac,PROMPT1_entailment
196,68,15,12,3,0.8,11,10,1,0.9090909090909092,0.8510638297872342,GPT4,coral,pdac,PROMPT1_entailment
197,69,13,12,1,0.9230769230769232,10,9,1,0.9,0.9113924050632912,GPT4,coral,pdac,PROMPT1_entailment
198,7,13,11,2,0.8461538461538461,11,10,1,0.9090909090909092,0.8764940239043824,GPT4,coral,pdac,PROMPT1_entailment
199,70,16,16,0,1.0,15,13,2,0.8666666666666667,0.9285714285714286,GPT4,coral,pdac,PROMPT1_entailment
200,71,23,17,6,0.7391304347826086,9,9,0,1.0,0.85,GPT4,coral,pdac,PROMPT1_entailment
201,72,28,21,7,0.75,13,13,0,1.0,0.8571428571428571,GPT4,coral,pdac,PROMPT1_entailment
202,73,28,8,20,0.2857142857142857,154,30,124,0.1948051948051948,0.2316602316602316,GPT4,coral,pdac,PROMPT1_entailment
203,74,19,10,9,0.5263157894736842,8,7,1,0.875,0.6572769953051644,GPT4,coral,pdac,PROMPT1_entailment
204,75,12,11,1,0.9166666666666666,7,7,0,1.0,0.9565217391304348,GPT4,coral,pdac,PROMPT1_entailment
205,76,11,10,1,0.9090909090909092,7,7,0,1.0,0.9523809523809524,GPT4,coral,pdac,PROMPT1_entailment
206,77,15,9,6,0.6,8,8,0,1.0,0.7499999999999999,GPT4,coral,pdac,PROMPT1_entailment
207,78,9,9,0,1.0,8,8,0,1.0,1.0,GPT4,coral,pdac,PROMPT1_entailment
208,79,13,13,0,1.0,11,9,2,0.8181818181818182,0.9,GPT4,coral,pdac,PROMPT1_entailment
209,8,10,10,0,1.0,2,2,0,1.0,1.0,GPT4,coral,pdac,PROMPT1_entailment
210,80,11,9,2,0.8181818181818182,9,9,0,1.0,0.9,GPT4,coral,pdac,PROMPT1_entailment
211,81,10,9,1,0.9,6,5,1,0.8333333333333334,0.8653846153846153,GPT4,coral,pdac,PROMPT1_entailment
212,82,20,20,0,1.0,4,3,1,0.75,0.8571428571428571,GPT4,coral,pdac,PROMPT1_entailment
213,83,18,15,3,0.8333333333333334,11,9,2,0.8181818181818182,0.8256880733944955,GPT4,coral,pdac,PROMPT1_entailment
214,84,19,15,4,0.7894736842105263,11,8,3,0.7272727272727273,0.7570977917981072,GPT4,coral,pdac,PROMPT1_entailment
215,85,36,25,11,0.6944444444444444,35,26,9,0.7428571428571429,0.7178354500276092,GPT4,coral,pdac,PROMPT1_entailment
216,86,11,10,1,0.9090909090909092,10,9,1,0.9,0.9045226130653266,GPT4,coral,pdac,PROMPT1_entailment
217,87,17,13,4,0.7647058823529411,7,6,1,0.8571428571428571,0.8082901554404144,GPT4,coral,pdac,PROMPT1_entailment
218,88,13,11,2,0.8461538461538461,8,7,1,0.875,0.8603351955307262,GPT4,coral,pdac,PROMPT1_entailment
219,89,16,11,5,0.6875,10,10,0,1.0,0.8148148148148148,GPT4,coral,pdac,PROMPT1_entailment
220,9,13,11,2,0.8461538461538461,12,11,1,0.9166666666666666,0.8799999999999999,GPT4,coral,pdac,PROMPT1_entailment
221,90,16,10,6,0.625,9,9,0,1.0,0.7692307692307693,GPT4,coral,pdac,PROMPT1_entailment
222,91,14,13,1,0.9285714285714286,10,10,0,1.0,0.962962962962963,GPT4,coral,pdac,PROMPT1_entailment
223,92,12,9,3,0.75,10,9,1,0.9,0.8181818181818182,GPT4,coral,pdac,PROMPT1_entailment
224,93,10,7,3,0.7,9,9,0,1.0,0.8235294117647058,GPT4,coral,pdac,PROMPT1_entailment
225,94,12,10,2,0.8333333333333334,7,7,0,1.0,0.9090909090909092,GPT4,coral,pdac,PROMPT1_entailment
226,95,17,17,0,1.0,8,7,1,0.875,0.9333333333333332,GPT4,coral,pdac,PROMPT1_entailment
227,96,7,7,0,1.0,4,4,0,1.0,1.0,GPT4,coral,pdac,PROMPT1_entailment
228,97,13,13,0,1.0,8,8,0,1.0,1.0,GPT4,coral,pdac,PROMPT1_entailment
229,98,14,13,1,0.9285714285714286,9,9,0,1.0,0.962962962962963,GPT4,coral,pdac,PROMPT1_entailment
230,99,11,10,1,0.9090909090909092,9,9,0,1.0,0.9523809523809524,GPT4,coral,pdac,PROMPT1_entailment
0,0,16,15,1,0.9375,9,9,0,1.0,0.967741935483871,GPT4,coral,pdac,PROMPT1_ICL_entailment
1,1,15,15,0,1.0,9,9,0,1.0,1.0,GPT4,coral,pdac,PROMPT1_ICL_entailment
2,10,25,20,5,0.8,11,11,0,1.0,0.888888888888889,GPT4,coral,pdac,PROMPT1_ICL_entailment
3,100,20,19,1,0.95,11,11,0,1.0,0.9743589743589745,GPT4,coral,pdac,PROMPT1_ICL_entailment
4,101,20,19,1,0.95,11,9,2,0.8181818181818182,0.879177377892031,GPT4,coral,pdac,PROMPT1_ICL_entailment
5,102,28,28,0,1.0,27,21,6,0.7777777777777778,0.8750000000000001,GPT4,coral,pdac,PROMPT1_ICL_entailment
6,103,31,29,2,0.935483870967742,15,11,4,0.7333333333333333,0.8221649484536082,GPT4,coral,pdac,PROMPT1_ICL_entailment
7,104,22,21,1,0.9545454545454546,12,12,0,1.0,0.9767441860465116,GPT4,coral,pdac,PROMPT1_ICL_entailment
8,105,41,27,14,0.6585365853658537,33,14,19,0.4242424242424242,0.5160409556313994,GPT4,coral,pdac,PROMPT1_ICL_entailment
9,106,14,14,0,1.0,10,10,0,1.0,1.0,GPT4,coral,pdac,PROMPT1_ICL_entailment
10,107,10,10,0,1.0,10,10,0,1.0,1.0,GPT4,coral,pdac,PROMPT1_ICL_entailment
11,108,17,17,0,1.0,10,10,0,1.0,1.0,GPT4,coral,pdac,PROMPT1_ICL_entailment
12,109,29,27,2,0.9310344827586208,34,27,7,0.7941176470588235,0.8571428571428571,GPT4,coral,pdac,PROMPT1_ICL_entailment
13,11,21,21,0,1.0,10,10,0,1.0,1.0,GPT4,coral,pdac,PROMPT1_ICL_entailment
14,110,10,10,0,1.0,4,2,2,0.5,0.6666666666666666,GPT4,coral,pdac,PROMPT1_ICL_entailment
15,111,17,17,0,1.0,3,3,0,1.0,1.0,GPT4,coral,pdac,PROMPT1_ICL_entailment
16,112,14,14,0,1.0,9,9,0,1.0,1.0,GPT4,coral,pdac,PROMPT1_ICL_entailment
17,113,17,13,4,0.7647058823529411,6,6,0,1.0,0.8666666666666666,GPT4,coral,pdac,PROMPT1_ICL_entailment
18,114,13,13,0,1.0,9,9,0,1.0,1.0,GPT4,coral,pdac,PROMPT1_ICL_entailment
19,115,15,15,0,1.0,7,7,0,1.0,1.0,GPT4,coral,pdac,PROMPT1_ICL_entailment
20,116,8,8,0,1.0,2,2,0,1.0,1.0,GPT4,coral,pdac,PROMPT1_ICL_entailment
21,117,27,27,0,1.0,8,8,0,1.0,1.0,GPT4,coral,pdac,PROMPT1_ICL_entailment
22,118,25,25,0,1.0,9,9,0,1.0,1.0,GPT4,coral,pdac,PROMPT1_ICL_entailment
23,119,18,13,5,0.7222222222222222,12,11,1,0.9166666666666666,0.807909604519774,GPT4,coral,pdac,PROMPT1_ICL_entailment
24,12,22,21,1,0.9545454545454546,10,10,0,1.0,0.9767441860465116,GPT4,coral,pdac,PROMPT1_ICL_entailment
25,120,43,30,13,0.6976744186046512,13,10,3,0.7692307692307693,0.7317073170731708,GPT4,coral,pdac,PROMPT1_ICL_entailment
26,121,27,25,2,0.925925925925926,12,10,2,0.8333333333333334,0.8771929824561403,GPT4,coral,pdac,PROMPT1_ICL_entailment
27,122,59,43,16,0.7288135593220338,45,41,4,0.9111111111111112,0.8098300413412953,GPT4,coral,pdac,PROMPT1_ICL_entailment
28,123,19,19,0,1.0,10,9,1,0.9,0.9473684210526316,GPT4,coral,pdac,PROMPT1_ICL_entailment
29,124,6,6,0,1.0,3,3,0,1.0,1.0,GPT4,coral,pdac,PROMPT1_ICL_entailment
30,125,20,19,1,0.95,8,8,0,1.0,0.9743589743589745,GPT4,coral,pdac,PROMPT1_ICL_entailment
31,126,16,15,1,0.9375,10,10,0,1.0,0.967741935483871,GPT4,coral,pdac,PROMPT1_ICL_entailment
32,127,47,29,18,0.6170212765957447,30,19,11,0.6333333333333333,0.6250709018718094,GPT4,coral,pdac,PROMPT1_ICL_entailment
33,128,68,63,5,0.9264705882352942,35,33,2,0.9428571428571428,0.9345920431557654,GPT4,coral,pdac,PROMPT1_ICL_entailment
34,129,14,13,1,0.9285714285714286,11,10,1,0.9090909090909092,0.9187279151943464,GPT4,coral,pdac,PROMPT1_ICL_entailment
35,13,33,30,3,0.9090909090909092,13,12,1,0.9230769230769232,0.9160305343511452,GPT4,coral,pdac,PROMPT1_ICL_entailment
36,130,25,23,2,0.92,12,8,4,0.6666666666666666,0.7731092436974789,GPT4,coral,pdac,PROMPT1_ICL_entailment
37,131,24,22,2,0.9166666666666666,12,9,3,0.75,0.8250000000000001,GPT4,coral,pdac,PROMPT1_ICL_entailment
38,132,17,14,3,0.8235294117647058,10,10,0,1.0,0.9032258064516128,GPT4,coral,pdac,PROMPT1_ICL_entailment
39,133,24,24,0,1.0,7,7,0,1.0,1.0,GPT4,coral,pdac,PROMPT1_ICL_entailment
40,134,37,36,1,0.972972972972973,15,12,3,0.8,0.8780487804878049,GPT4,coral,pdac,PROMPT1_ICL_entailment
41,135,23,23,0,1.0,9,9,0,1.0,1.0,GPT4,coral,pdac,PROMPT1_ICL_entailment
42,136,24,21,3,0.875,7,6,1,0.8571428571428571,0.8659793814432989,GPT4,coral,pdac,PROMPT1_ICL_entailment
43,137,20,17,3,0.85,10,10,0,1.0,0.9189189189189187,GPT4,coral,pdac,PROMPT1_ICL_entailment
44,138,21,16,5,0.7619047619047619,25,21,4,0.84,0.7990487514863258,GPT4,coral,pdac,PROMPT1_ICL_entailment
45,139,55,37,18,0.6727272727272727,62,28,34,0.4516129032258064,0.5404277516953574,GPT4,coral,pdac,PROMPT1_ICL_entailment
46,14,13,13,0,1.0,10,10,0,1.0,1.0,GPT4,coral,pdac,PROMPT1_ICL_entailment
47,140,19,18,1,0.9473684210526316,8,8,0,1.0,0.972972972972973,GPT4,coral,pdac,PROMPT1_ICL_entailment
48,141,26,25,1,0.9615384615384616,11,8,3,0.7272727272727273,0.8281573498964805,GPT4,coral,pdac,PROMPT1_ICL_entailment
49,142,28,23,5,0.8214285714285714,11,11,0,1.0,0.9019607843137256,GPT4,coral,pdac,PROMPT1_ICL_entailment
50,143,17,15,2,0.8823529411764706,9,8,1,0.8888888888888888,0.8856088560885608,GPT4,coral,pdac,PROMPT1_ICL_entailment
51,144,27,19,8,0.7037037037037037,12,12,0,1.0,0.8260869565217391,GPT4,coral,pdac,PROMPT1_ICL_entailment
52,145,14,12,2,0.8571428571428571,10,9,1,0.9,0.8780487804878048,GPT4,coral,pdac,PROMPT1_ICL_entailment
53,146,15,10,5,0.6666666666666666,7,6,1,0.8571428571428571,0.75,GPT4,coral,pdac,PROMPT1_ICL_entailment
54,147,18,16,2,0.8888888888888888,12,12,0,1.0,0.9411764705882352,GPT4,coral,pdac,PROMPT1_ICL_entailment
55,148,45,41,4,0.9111111111111112,25,17,8,0.68,0.7787709497206705,GPT4,coral,pdac,PROMPT1_ICL_entailment
56,149,25,25,0,1.0,7,7,0,1.0,1.0,GPT4,coral,pdac,PROMPT1_ICL_entailment
57,15,11,11,0,1.0,10,10,0,1.0,1.0,GPT4,coral,pdac,PROMPT1_ICL_entailment
58,150,15,15,0,1.0,8,8,0,1.0,1.0,GPT4,coral,pdac,PROMPT1_ICL_entailment
59,151,21,20,1,0.9523809523809524,10,10,0,1.0,0.975609756097561,GPT4,coral,pdac,PROMPT1_ICL_entailment
60,152,20,20,0,1.0,11,10,1,0.9090909090909092,0.9523809523809524,GPT4,coral,pdac,PROMPT1_ICL_entailment
61,153,45,30,15,0.6666666666666666,30,17,13,0.5666666666666667,0.6126126126126126,GPT4,coral,pdac,PROMPT1_ICL_entailment
62,154,28,27,1,0.9642857142857144,15,15,0,1.0,0.9818181818181818,GPT4,coral,pdac,PROMPT1_ICL_entailment
63,155,43,42,1,0.9767441860465116,47,31,16,0.6595744680851063,0.7874206229210765,GPT4,coral,pdac,PROMPT1_ICL_entailment
64,156,15,11,4,0.7333333333333333,10,9,1,0.9,0.8081632653061224,GPT4,coral,pdac,PROMPT1_ICL_entailment
65,157,30,29,1,0.9666666666666668,14,11,3,0.7857142857142857,0.8668478260869565,GPT4,coral,pdac,PROMPT1_ICL_entailment
66,158,19,15,4,0.7894736842105263,10,9,1,0.9,0.8411214953271027,GPT4,coral,pdac,PROMPT1_ICL_entailment
67,159,16,16,0,1.0,4,3,1,0.75,0.8571428571428571,GPT4,coral,pdac,PROMPT1_ICL_entailment
68,16,14,14,0,1.0,31,23,8,0.7419354838709677,0.8518518518518519,GPT4,coral,pdac,PROMPT1_ICL_entailment
69,160,18,18,0,1.0,9,9,0,1.0,1.0,GPT4,coral,pdac,PROMPT1_ICL_entailment
70,161,16,16,0,1.0,9,8,1,0.8888888888888888,0.9411764705882352,GPT4,coral,pdac,PROMPT1_ICL_entailment
71,162,16,16,0,1.0,10,10,0,1.0,1.0,GPT4,coral,pdac,PROMPT1_ICL_entailment
72,163,21,18,3,0.8571428571428571,13,11,2,0.8461538461538461,0.8516129032258064,GPT4,coral,pdac,PROMPT1_ICL_entailment
73,164,52,47,5,0.903846153846154,36,28,8,0.7777777777777778,0.8360864040660737,GPT4,coral,pdac,PROMPT1_ICL_entailment
74,165,27,22,5,0.8148148148148148,10,7,3,0.7,0.7530562347188264,GPT4,coral,pdac,PROMPT1_ICL_entailment
75,166,24,24,0,1.0,11,10,1,0.9090909090909092,0.9523809523809524,GPT4,coral,pdac,PROMPT1_ICL_entailment
76,167,18,16,2,0.8888888888888888,8,8,0,1.0,0.9411764705882352,GPT4,coral,pdac,PROMPT1_ICL_entailment
77,168,13,12,1,0.9230769230769232,6,6,0,1.0,0.96,GPT4,coral,pdac,PROMPT1_ICL_entailment
78,169,14,14,0,1.0,7,6,1,0.8571428571428571,0.923076923076923,GPT4,coral,pdac,PROMPT1_ICL_entailment
79,17,14,14,0,1.0,5,5,0,1.0,1.0,GPT4,coral,pdac,PROMPT1_ICL_entailment
80,170,25,17,8,0.68,16,11,5,0.6875,0.6837294332723949,GPT4,coral,pdac,PROMPT1_ICL_entailment
81,171,24,20,4,0.8333333333333334,13,13,0,1.0,0.9090909090909092,GPT4,coral,pdac,PROMPT1_ICL_entailment
82,172,21,19,2,0.9047619047619048,10,10,0,1.0,0.95,GPT4,coral,pdac,PROMPT1_ICL_entailment
83,173,36,32,4,0.8888888888888888,22,17,5,0.7727272727272727,0.8267477203647416,GPT4,coral,pdac,PROMPT1_ICL_entailment
84,174,39,14,25,0.358974358974359,11,8,3,0.7272727272727273,0.4806866952789699,GPT4,coral,pdac,PROMPT1_ICL_entailment
85,175,63,31,32,0.492063492063492,28,18,10,0.6428571428571429,0.5574425574425574,GPT4,coral,pdac,PROMPT1_ICL_entailment
86,176,14,14,0,1.0,10,10,0,1.0,1.0,GPT4,coral,pdac,PROMPT1_ICL_entailment
87,177,15,15,0,1.0,10,10,0,1.0,1.0,GPT4,coral,pdac,PROMPT1_ICL_entailment
88,178,39,24,15,0.6153846153846154,36,28,8,0.7777777777777778,0.6871165644171779,GPT4,coral,pdac,PROMPT1_ICL_entailment
89,179,11,11,0,1.0,9,7,2,0.7777777777777778,0.8750000000000001,GPT4,coral,pdac,PROMPT1_ICL_entailment
90,18,37,37,0,1.0,15,13,2,0.8666666666666667,0.9285714285714286,GPT4,coral,pdac,PROMPT1_ICL_entailment
91,180,14,14,0,1.0,5,5,0,1.0,1.0,GPT4,coral,pdac,PROMPT1_ICL_entailment
92,181,21,20,1,0.9523809523809524,10,10,0,1.0,0.975609756097561,GPT4,coral,pdac,PROMPT1_ICL_entailment
93,182,16,14,2,0.875,8,8,0,1.0,0.9333333333333332,GPT4,coral,pdac,PROMPT1_ICL_entailment
94,183,20,20,0,1.0,10,9,1,0.9,0.9473684210526316,GPT4,coral,pdac,PROMPT1_ICL_entailment
95,184,14,9,5,0.6428571428571429,9,8,1,0.8888888888888888,0.7461139896373057,GPT4,coral,pdac,PROMPT1_ICL_entailment
96,185,29,22,7,0.7586206896551724,22,16,6,0.7272727272727273,0.7426160337552743,GPT4,coral,pdac,PROMPT1_ICL_entailment
97,186,54,40,14,0.7407407407407407,32,14,18,0.4375,0.550098231827112,GPT4,coral,pdac,PROMPT1_ICL_entailment
98,187,67,53,14,0.7910447761194029,34,17,17,0.5,0.6127167630057804,GPT4,coral,pdac,PROMPT1_ICL_entailment
99,188,22,19,3,0.8636363636363636,8,8,0,1.0,0.9268292682926828,GPT4,coral,pdac,PROMPT1_ICL_entailment
100,189,18,15,3,0.8333333333333334,5,5,0,1.0,0.9090909090909092,GPT4,coral,pdac,PROMPT1_ICL_entailment
101,19,40,32,8,0.8,21,16,5,0.7619047619047619,0.7804878048780488,GPT4,coral,pdac,PROMPT1_ICL_entailment
102,190,22,18,4,0.8181818181818182,17,13,4,0.7647058823529411,0.7905405405405405,GPT4,coral,pdac,PROMPT1_ICL_entailment
103,191,53,49,4,0.9245283018867924,15,13,2,0.8666666666666667,0.8946629213483146,GPT4,coral,pdac,PROMPT1_ICL_entailment
104,192,35,18,17,0.5142857142857142,12,10,2,0.8333333333333334,0.6360424028268551,GPT4,coral,pdac,PROMPT1_ICL_entailment
105,193,18,18,0,1.0,10,10,0,1.0,1.0,GPT4,coral,pdac,PROMPT1_ICL_entailment
106,194,14,13,1,0.9285714285714286,11,10,1,0.9090909090909092,0.9187279151943464,GPT4,coral,pdac,PROMPT1_ICL_entailment
107,195,15,14,1,0.9333333333333332,7,7,0,1.0,0.9655172413793104,GPT4,coral,pdac,PROMPT1_ICL_entailment
108,196,17,16,1,0.9411764705882352,8,8,0,1.0,0.9696969696969696,GPT4,coral,pdac,PROMPT1_ICL_entailment
109,197,33,31,2,0.9393939393939394,9,9,0,1.0,0.96875,GPT4,coral,pdac,PROMPT1_ICL_entailment
110,198,25,25,0,1.0,12,11,1,0.9166666666666666,0.9565217391304348,GPT4,coral,pdac,PROMPT1_ICL_entailment
111,199,30,29,1,0.9666666666666668,9,9,0,1.0,0.983050847457627,GPT4,coral,pdac,PROMPT1_ICL_entailment
112,2,30,26,4,0.8666666666666667,14,13,1,0.9285714285714286,0.896551724137931,GPT4,coral,pdac,PROMPT1_ICL_entailment
113,20,31,17,14,0.5483870967741935,18,14,4,0.7777777777777778,0.6432432432432432,GPT4,coral,pdac,PROMPT1_ICL_entailment
114,200,40,34,6,0.85,16,15,1,0.9375,0.8916083916083916,GPT4,coral,pdac,PROMPT1_ICL_entailment
115,201,11,11,0,1.0,10,10,0,1.0,1.0,GPT4,coral,pdac,PROMPT1_ICL_entailment
116,202,15,15,0,1.0,10,10,0,1.0,1.0,GPT4,coral,pdac,PROMPT1_ICL_entailment
117,203,36,29,7,0.8055555555555556,31,26,5,0.8387096774193549,0.8217983651226158,GPT4,coral,pdac,PROMPT1_ICL_entailment
118,204,29,22,7,0.7586206896551724,14,12,2,0.8571428571428571,0.8048780487804879,GPT4,coral,pdac,PROMPT1_ICL_entailment
119,205,21,18,3,0.8571428571428571,7,5,2,0.7142857142857143,0.7792207792207793,GPT4,coral,pdac,PROMPT1_ICL_entailment
120,206,18,14,4,0.7777777777777778,9,7,2,0.7777777777777778,0.7777777777777778,GPT4,coral,pdac,PROMPT1_ICL_entailment
121,207,18,16,2,0.8888888888888888,8,8,0,1.0,0.9411764705882352,GPT4,coral,pdac,PROMPT1_ICL_entailment
122,208,13,13,0,1.0,8,8,0,1.0,1.0,GPT4,coral,pdac,PROMPT1_ICL_entailment
123,209,29,29,0,1.0,9,9,0,1.0,1.0,GPT4,coral,pdac,PROMPT1_ICL_entailment
124,21,10,10,0,1.0,10,9,1,0.9,0.9473684210526316,GPT4,coral,pdac,PROMPT1_ICL_entailment
125,210,18,16,2,0.8888888888888888,9,8,1,0.8888888888888888,0.8888888888888888,GPT4,coral,pdac,PROMPT1_ICL_entailment
126,211,24,22,2,0.9166666666666666,8,6,2,0.75,0.8250000000000001,GPT4,coral,pdac,PROMPT1_ICL_entailment
127,212,25,23,2,0.92,17,16,1,0.9411764705882352,0.9304677623261696,GPT4,coral,pdac,PROMPT1_ICL_entailment
128,213,21,21,0,1.0,11,11,0,1.0,1.0,GPT4,coral,pdac,PROMPT1_ICL_entailment
129,214,28,24,4,0.8571428571428571,18,13,5,0.7222222222222222,0.7839195979899497,GPT4,coral,pdac,PROMPT1_ICL_entailment
130,215,35,20,15,0.5714285714285714,12,9,3,0.75,0.6486486486486486,GPT4,coral,pdac,PROMPT1_ICL_entailment
131,216,42,37,5,0.8809523809523809,33,27,6,0.8181818181818182,0.8484076433121019,GPT4,coral,pdac,PROMPT1_ICL_entailment
132,217,30,30,0,1.0,19,17,2,0.8947368421052632,0.9444444444444444,GPT4,coral,pdac,PROMPT1_ICL_entailment
133,218,30,30,0,1.0,11,10,1,0.9090909090909092,0.9523809523809524,GPT4,coral,pdac,PROMPT1_ICL_entailment
134,219,19,18,1,0.9473684210526316,8,8,0,1.0,0.972972972972973,GPT4,coral,pdac,PROMPT1_ICL_entailment
135,22,35,21,14,0.6,17,17,0,1.0,0.7499999999999999,GPT4,coral,pdac,PROMPT1_ICL_entailment
136,220,30,28,2,0.9333333333333332,11,10,1,0.9090909090909092,0.9210526315789476,GPT4,coral,pdac,PROMPT1_ICL_entailment
137,221,18,17,1,0.9444444444444444,12,10,2,0.8333333333333334,0.8854166666666667,GPT4,coral,pdac,PROMPT1_ICL_entailment
138,222,38,27,11,0.7105263157894737,11,9,2,0.8181818181818182,0.7605633802816901,GPT4,coral,pdac,PROMPT1_ICL_entailment
139,223,86,77,9,0.8953488372093024,37,33,4,0.8918918918918919,0.8936170212765958,GPT4,coral,pdac,PROMPT1_ICL_entailment
140,224,26,18,8,0.6923076923076923,8,8,0,1.0,0.8181818181818181,GPT4,coral,pdac,PROMPT1_ICL_entailment
141,225,24,24,0,1.0,13,12,1,0.9230769230769232,0.96,GPT4,coral,pdac,PROMPT1_ICL_entailment
142,226,21,20,1,0.9523809523809524,11,9,2,0.8181818181818182,0.880195599022005,GPT4,coral,pdac,PROMPT1_ICL_entailment
143,227,24,20,4,0.8333333333333334,10,10,0,1.0,0.9090909090909092,GPT4,coral,pdac,PROMPT1_ICL_entailment
144,228,18,17,1,0.9444444444444444,9,9,0,1.0,0.9714285714285714,GPT4,coral,pdac,PROMPT1_ICL_entailment
145,229,23,21,2,0.9130434782608696,9,8,1,0.8888888888888888,0.900804289544236,GPT4,coral,pdac,PROMPT1_ICL_entailment
146,23,24,24,0,1.0,12,9,3,0.75,0.8571428571428571,GPT4,coral,pdac,PROMPT1_ICL_entailment
147,230,17,17,0,1.0,8,8,0,1.0,1.0,GPT4,coral,pdac,PROMPT1_ICL_entailment
148,24,16,16,0,1.0,9,9,0,1.0,1.0,GPT4,coral,pdac,PROMPT1_ICL_entailment
149,25,22,21,1,0.9545454545454546,11,10,1,0.9090909090909092,0.9312638580931264,GPT4,coral,pdac,PROMPT1_ICL_entailment
150,26,15,14,1,0.9333333333333332,11,11,0,1.0,0.9655172413793104,GPT4,coral,pdac,PROMPT1_ICL_entailment
151,27,18,15,3,0.8333333333333334,12,10,2,0.8333333333333334,0.8333333333333334,GPT4,coral,pdac,PROMPT1_ICL_entailment
152,28,30,29,1,0.9666666666666668,13,11,2,0.8461538461538461,0.9024045261669024,GPT4,coral,pdac,PROMPT1_ICL_entailment
153,29,16,16,0,1.0,9,9,0,1.0,1.0,GPT4,coral,pdac,PROMPT1_ICL_entailment
154,3,19,15,4,0.7894736842105263,8,8,0,1.0,0.8823529411764706,GPT4,coral,pdac,PROMPT1_ICL_entailment
155,30,43,38,5,0.8837209302325582,11,10,1,0.9090909090909092,0.8962264150943396,GPT4,coral,pdac,PROMPT1_ICL_entailment
156,31,35,31,4,0.8857142857142857,11,11,0,1.0,0.9393939393939392,GPT4,coral,pdac,PROMPT1_ICL_entailment
157,32,52,41,11,0.7884615384615384,11,9,2,0.8181818181818182,0.8030467899891186,GPT4,coral,pdac,PROMPT1_ICL_entailment
158,33,31,12,19,0.3870967741935484,24,14,10,0.5833333333333334,0.4653739612188366,GPT4,coral,pdac,PROMPT1_ICL_entailment
159,34,10,10,0,1.0,10,10,0,1.0,1.0,GPT4,coral,pdac,PROMPT1_ICL_entailment
160,35,14,14,0,1.0,10,10,0,1.0,1.0,GPT4,coral,pdac,PROMPT1_ICL_entailment
161,36,34,33,1,0.9705882352941176,44,37,7,0.8409090909090909,0.9011070110701108,GPT4,coral,pdac,PROMPT1_ICL_entailment
162,37,26,23,3,0.8846153846153846,9,8,1,0.8888888888888888,0.8867469879518072,GPT4,coral,pdac,PROMPT1_ICL_entailment
163,38,27,24,3,0.8888888888888888,13,12,1,0.9230769230769232,0.9056603773584906,GPT4,coral,pdac,PROMPT1_ICL_entailment
164,39,23,20,3,0.8695652173913043,10,9,1,0.9,0.8845208845208845,GPT4,coral,pdac,PROMPT1_ICL_entailment
165,4,30,28,2,0.9333333333333332,15,12,3,0.8,0.8615384615384616,GPT4,coral,pdac,PROMPT1_ICL_entailment
166,40,16,11,5,0.6875,10,7,3,0.7,0.6936936936936936,GPT4,coral,pdac,PROMPT1_ICL_entailment
167,41,23,22,1,0.9565217391304348,8,8,0,1.0,0.9777777777777776,GPT4,coral,pdac,PROMPT1_ICL_entailment
168,42,29,28,1,0.9655172413793104,11,11,0,1.0,0.9824561403508772,GPT4,coral,pdac,PROMPT1_ICL_entailment
169,43,30,28,2,0.9333333333333332,13,9,4,0.6923076923076923,0.7949526813880127,GPT4,coral,pdac,PROMPT1_ICL_entailment
170,44,26,23,3,0.8846153846153846,11,11,0,1.0,0.9387755102040816,GPT4,coral,pdac,PROMPT1_ICL_entailment
171,45,22,22,0,1.0,10,10,0,1.0,1.0,GPT4,coral,pdac,PROMPT1_ICL_entailment
172,46,26,21,5,0.8076923076923077,11,8,3,0.7272727272727273,0.765375854214123,GPT4,coral,pdac,PROMPT1_ICL_entailment
173,47,41,39,2,0.951219512195122,39,28,11,0.717948717948718,0.8182840014986885,GPT4,coral,pdac,PROMPT1_ICL_entailment
174,48,19,13,6,0.6842105263157895,10,9,1,0.9,0.7774086378737541,GPT4,coral,pdac,PROMPT1_ICL_entailment
175,49,16,15,1,0.9375,10,8,2,0.8,0.8633093525179856,GPT4,coral,pdac,PROMPT1_ICL_entailment
176,5,18,15,3,0.8333333333333334,10,9,1,0.9,0.8653846153846153,GPT4,coral,pdac,PROMPT1_ICL_entailment
177,50,14,13,1,0.9285714285714286,10,10,0,1.0,0.962962962962963,GPT4,coral,pdac,PROMPT1_ICL_entailment
178,51,23,19,4,0.8260869565217391,12,12,0,1.0,0.9047619047619048,GPT4,coral,pdac,PROMPT1_ICL_entailment
179,52,17,16,1,0.9411764705882352,10,10,0,1.0,0.9696969696969696,GPT4,coral,pdac,PROMPT1_ICL_entailment
180,53,14,14,0,1.0,8,8,0,1.0,1.0,GPT4,coral,pdac,PROMPT1_ICL_entailment
181,54,7,6,1,0.8571428571428571,2,1,1,0.5,0.631578947368421,GPT4,coral,pdac,PROMPT1_ICL_entailment
182,55,25,24,1,0.96,10,8,2,0.8,0.8727272727272728,GPT4,coral,pdac,PROMPT1_ICL_entailment
183,56,30,26,4,0.8666666666666667,8,7,1,0.875,0.8708133971291866,GPT4,coral,pdac,PROMPT1_ICL_entailment
184,57,36,31,5,0.8611111111111112,13,10,3,0.7692307692307693,0.8125819134993448,GPT4,coral,pdac,PROMPT1_ICL_entailment
185,58,45,40,5,0.8888888888888888,10,10,0,1.0,0.9411764705882352,GPT4,coral,pdac,PROMPT1_ICL_entailment
186,59,41,30,11,0.7317073170731707,21,15,6,0.7142857142857143,0.7228915662650603,GPT4,coral,pdac,PROMPT1_ICL_entailment
187,6,21,17,4,0.8095238095238095,12,12,0,1.0,0.8947368421052632,GPT4,coral,pdac,PROMPT1_ICL_entailment
188,60,35,30,5,0.8571428571428571,13,11,2,0.8461538461538461,0.8516129032258064,GPT4,coral,pdac,PROMPT1_ICL_entailment
189,61,16,16,0,1.0,7,7,0,1.0,1.0,GPT4,coral,pdac,PROMPT1_ICL_entailment
190,62,22,15,7,0.6818181818181818,11,9,2,0.8181818181818182,0.7438016528925621,GPT4,coral,pdac,PROMPT1_ICL_entailment
191,63,12,12,0,1.0,10,10,0,1.0,1.0,GPT4,coral,pdac,PROMPT1_ICL_entailment
192,64,16,16,0,1.0,12,12,0,1.0,1.0,GPT4,coral,pdac,PROMPT1_ICL_entailment
193,65,37,33,4,0.8918918918918919,9,9,0,1.0,0.9428571428571428,GPT4,coral,pdac,PROMPT1_ICL_entailment
194,66,20,19,1,0.95,12,12,0,1.0,0.9743589743589745,GPT4,coral,pdac,PROMPT1_ICL_entailment
195,67,7,7,0,1.0,1,1,0,1.0,1.0,GPT4,coral,pdac,PROMPT1_ICL_entailment
196,68,24,22,2,0.9166666666666666,11,10,1,0.9090909090909092,0.9128630705394192,GPT4,coral,pdac,PROMPT1_ICL_entailment
197,69,24,24,0,1.0,10,10,0,1.0,1.0,GPT4,coral,pdac,PROMPT1_ICL_entailment
198,7,16,15,1,0.9375,11,10,1,0.9090909090909092,0.923076923076923,GPT4,coral,pdac,PROMPT1_ICL_entailment
199,70,29,28,1,0.9655172413793104,15,15,0,1.0,0.9824561403508772,GPT4,coral,pdac,PROMPT1_ICL_entailment
200,71,26,18,8,0.6923076923076923,9,8,1,0.8888888888888888,0.7783783783783783,GPT4,coral,pdac,PROMPT1_ICL_entailment
201,72,28,23,5,0.8214285714285714,13,12,1,0.9230769230769232,0.8692913385826772,GPT4,coral,pdac,PROMPT1_ICL_entailment
202,73,79,21,58,0.2658227848101265,154,98,56,0.6363636363636364,0.375,GPT4,coral,pdac,PROMPT1_ICL_entailment
203,74,27,22,5,0.8148148148148148,8,7,1,0.875,0.843835616438356,GPT4,coral,pdac,PROMPT1_ICL_entailment
204,75,22,19,3,0.8636363636363636,7,6,1,0.8571428571428571,0.860377358490566,GPT4,coral,pdac,PROMPT1_ICL_entailment
205,76,24,22,2,0.9166666666666666,7,6,1,0.8571428571428571,0.8859060402684563,GPT4,coral,pdac,PROMPT1_ICL_entailment
206,77,21,17,4,0.8095238095238095,8,8,0,1.0,0.8947368421052632,GPT4,coral,pdac,PROMPT1_ICL_entailment
207,78,15,13,2,0.8666666666666667,8,6,2,0.75,0.8041237113402062,GPT4,coral,pdac,PROMPT1_ICL_entailment
208,79,23,21,2,0.9130434782608696,11,11,0,1.0,0.9545454545454544,GPT4,coral,pdac,PROMPT1_ICL_entailment
209,8,12,12,0,1.0,2,2,0,1.0,1.0,GPT4,coral,pdac,PROMPT1_ICL_entailment
210,80,22,21,1,0.9545454545454546,9,9,0,1.0,0.9767441860465116,GPT4,coral,pdac,PROMPT1_ICL_entailment
211,81,19,18,1,0.9473684210526316,6,5,1,0.8333333333333334,0.8866995073891626,GPT4,coral,pdac,PROMPT1_ICL_entailment
212,82,33,33,0,1.0,4,4,0,1.0,1.0,GPT4,coral,pdac,PROMPT1_ICL_entailment
213,83,27,25,2,0.925925925925926,11,8,3,0.7272727272727273,0.814663951120163,GPT4,coral,pdac,PROMPT1_ICL_entailment
214,84,33,24,9,0.7272727272727273,11,8,3,0.7272727272727273,0.7272727272727273,GPT4,coral,pdac,PROMPT1_ICL_entailment
215,85,38,29,9,0.7631578947368421,35,31,4,0.8857142857142857,0.8198814409484725,GPT4,coral,pdac,PROMPT1_ICL_entailment
216,86,21,20,1,0.9523809523809524,10,9,1,0.9,0.9254498714652956,GPT4,coral,pdac,PROMPT1_ICL_entailment
217,87,27,20,7,0.7407407407407407,7,7,0,1.0,0.851063829787234,GPT4,coral,pdac,PROMPT1_ICL_entailment
218,88,23,21,2,0.9130434782608696,8,5,3,0.625,0.7420494699646643,GPT4,coral,pdac,PROMPT1_ICL_entailment
219,89,17,13,4,0.7647058823529411,10,10,0,1.0,0.8666666666666666,GPT4,coral,pdac,PROMPT1_ICL_entailment
220,9,15,12,3,0.8,12,10,2,0.8333333333333334,0.816326530612245,GPT4,coral,pdac,PROMPT1_ICL_entailment
221,90,24,17,7,0.7083333333333334,9,9,0,1.0,0.8292682926829268,GPT4,coral,pdac,PROMPT1_ICL_entailment
222,91,21,20,1,0.9523809523809524,10,10,0,1.0,0.975609756097561,GPT4,coral,pdac,PROMPT1_ICL_entailment
223,92,28,24,4,0.8571428571428571,10,10,0,1.0,0.923076923076923,GPT4,coral,pdac,PROMPT1_ICL_entailment
224,93,16,15,1,0.9375,9,8,1,0.8888888888888888,0.9125475285171102,GPT4,coral,pdac,PROMPT1_ICL_entailment
225,94,14,8,6,0.5714285714285714,7,7,0,1.0,0.7272727272727273,GPT4,coral,pdac,PROMPT1_ICL_entailment
226,95,26,24,2,0.9230769230769232,8,8,0,1.0,0.96,GPT4,coral,pdac,PROMPT1_ICL_entailment
227,96,13,13,0,1.0,4,4,0,1.0,1.0,GPT4,coral,pdac,PROMPT1_ICL_entailment
228,97,20,19,1,0.95,8,8,0,1.0,0.9743589743589745,GPT4,coral,pdac,PROMPT1_ICL_entailment
229,98,24,21,3,0.875,9,9,0,1.0,0.9333333333333332,GPT4,coral,pdac,PROMPT1_ICL_entailment
230,99,24,21,3,0.875,9,9,0,1.0,0.9333333333333332,GPT4,coral,pdac,PROMPT1_ICL_entailment
0,0,16,16,0,1.0,9,9,0,1.0,1.0,GPT4,coral,pdac,PROMPT2_ICL_entailment
1,1,17,17,0,1.0,9,9,0,1.0,1.0,GPT4,coral,pdac,PROMPT2_ICL_entailment
2,10,29,26,3,0.896551724137931,11,9,2,0.8181818181818182,0.8555758683729433,GPT4,coral,pdac,PROMPT2_ICL_entailment
3,100,19,18,1,0.9473684210526316,11,10,1,0.9090909090909092,0.9278350515463918,GPT4,coral,pdac,PROMPT2_ICL_entailment
4,101,21,20,1,0.9523809523809524,11,10,1,0.9090909090909092,0.9302325581395348,GPT4,coral,pdac,PROMPT2_ICL_entailment
5,102,28,28,0,1.0,27,15,12,0.5555555555555556,0.7142857142857143,GPT4,coral,pdac,PROMPT2_ICL_entailment
6,103,29,22,7,0.7586206896551724,15,12,3,0.8,0.7787610619469026,GPT4,coral,pdac,PROMPT2_ICL_entailment
7,104,29,25,4,0.8620689655172413,12,10,2,0.8333333333333334,0.847457627118644,GPT4,coral,pdac,PROMPT2_ICL_entailment
8,105,39,22,17,0.5641025641025641,33,15,18,0.4545454545454545,0.5034324942791761,GPT4,coral,pdac,PROMPT2_ICL_entailment
9,106,14,14,0,1.0,10,10,0,1.0,1.0,GPT4,coral,pdac,PROMPT2_ICL_entailment
10,107,10,10,0,1.0,10,10,0,1.0,1.0,GPT4,coral,pdac,PROMPT2_ICL_entailment
11,108,17,17,0,1.0,10,10,0,1.0,1.0,GPT4,coral,pdac,PROMPT2_ICL_entailment
12,109,27,26,1,0.9629629629629628,34,28,6,0.8235294117647058,0.8878048780487804,GPT4,coral,pdac,PROMPT2_ICL_entailment
13,11,28,26,2,0.9285714285714286,10,10,0,1.0,0.962962962962963,GPT4,coral,pdac,PROMPT2_ICL_entailment
14,110,18,18,0,1.0,4,4,0,1.0,1.0,GPT4,coral,pdac,PROMPT2_ICL_entailment
15,111,14,13,1,0.9285714285714286,3,2,1,0.6666666666666666,0.7761194029850746,GPT4,coral,pdac,PROMPT2_ICL_entailment
16,112,15,15,0,1.0,9,9,0,1.0,1.0,GPT4,coral,pdac,PROMPT2_ICL_entailment
17,113,16,13,3,0.8125,6,6,0,1.0,0.896551724137931,GPT4,coral,pdac,PROMPT2_ICL_entailment
18,114,17,17,0,1.0,9,9,0,1.0,1.0,GPT4,coral,pdac,PROMPT2_ICL_entailment
19,115,15,15,0,1.0,7,7,0,1.0,1.0,GPT4,coral,pdac,PROMPT2_ICL_entailment
20,116,7,7,0,1.0,2,2,0,1.0,1.0,GPT4,coral,pdac,PROMPT2_ICL_entailment
21,117,25,25,0,1.0,8,7,1,0.875,0.9333333333333332,GPT4,coral,pdac,PROMPT2_ICL_entailment
22,118,24,24,0,1.0,9,9,0,1.0,1.0,GPT4,coral,pdac,PROMPT2_ICL_entailment
23,119,18,15,3,0.8333333333333334,12,10,2,0.8333333333333334,0.8333333333333334,GPT4,coral,pdac,PROMPT2_ICL_entailment
24,12,26,23,3,0.8846153846153846,10,10,0,1.0,0.9387755102040816,GPT4,coral,pdac,PROMPT2_ICL_entailment
25,120,36,30,6,0.8333333333333334,13,10,3,0.7692307692307693,0.8,GPT4,coral,pdac,PROMPT2_ICL_entailment
26,121,27,25,2,0.925925925925926,12,10,2,0.8333333333333334,0.8771929824561403,GPT4,coral,pdac,PROMPT2_ICL_entailment
27,122,89,68,21,0.7640449438202247,45,36,9,0.8,0.7816091954022989,GPT4,coral,pdac,PROMPT2_ICL_entailment
28,123,25,23,2,0.92,10,9,1,0.9,0.90989010989011,GPT4,coral,pdac,PROMPT2_ICL_entailment
29,124,5,5,0,1.0,3,3,0,1.0,1.0,GPT4,coral,pdac,PROMPT2_ICL_entailment
30,125,20,19,1,0.95,8,8,0,1.0,0.9743589743589745,GPT4,coral,pdac,PROMPT2_ICL_entailment
31,126,18,18,0,1.0,10,10,0,1.0,1.0,GPT4,coral,pdac,PROMPT2_ICL_entailment
32,127,44,33,11,0.75,30,20,10,0.6666666666666666,0.7058823529411765,GPT4,coral,pdac,PROMPT2_ICL_entailment
33,128,71,65,6,0.9154929577464788,35,31,4,0.8857142857142857,0.9003574620196604,GPT4,coral,pdac,PROMPT2_ICL_entailment
34,129,16,15,1,0.9375,11,10,1,0.9090909090909092,0.923076923076923,GPT4,coral,pdac,PROMPT2_ICL_entailment
35,13,19,16,3,0.8421052631578947,13,12,1,0.9230769230769232,0.8807339449541285,GPT4,coral,pdac,PROMPT2_ICL_entailment
36,130,26,22,4,0.8461538461538461,12,8,4,0.6666666666666666,0.7457627118644068,GPT4,coral,pdac,PROMPT2_ICL_entailment
37,131,26,23,3,0.8846153846153846,12,8,4,0.6666666666666666,0.7603305785123966,GPT4,coral,pdac,PROMPT2_ICL_entailment
38,132,15,15,0,1.0,10,9,1,0.9,0.9473684210526316,GPT4,coral,pdac,PROMPT2_ICL_entailment
39,133,18,18,0,1.0,7,7,0,1.0,1.0,GPT4,coral,pdac,PROMPT2_ICL_entailment
40,134,29,28,1,0.9655172413793104,15,9,6,0.6,0.7400881057268723,GPT4,coral,pdac,PROMPT2_ICL_entailment
41,135,25,25,0,1.0,9,8,1,0.8888888888888888,0.9411764705882352,GPT4,coral,pdac,PROMPT2_ICL_entailment
42,136,25,22,3,0.88,7,5,2,0.7142857142857143,0.7885304659498208,GPT4,coral,pdac,PROMPT2_ICL_entailment
43,137,21,19,2,0.9047619047619048,10,7,3,0.7,0.7893175074183976,GPT4,coral,pdac,PROMPT2_ICL_entailment
44,138,34,26,8,0.7647058823529411,25,20,5,0.8,0.7819548872180452,GPT4,coral,pdac,PROMPT2_ICL_entailment
45,139,74,67,7,0.9054054054054054,62,21,41,0.3387096774193548,0.4929922915206727,GPT4,coral,pdac,PROMPT2_ICL_entailment
46,14,13,12,1,0.9230769230769232,10,10,0,1.0,0.96,GPT4,coral,pdac,PROMPT2_ICL_entailment
47,140,20,18,2,0.9,8,7,1,0.875,0.8873239436619719,GPT4,coral,pdac,PROMPT2_ICL_entailment
48,141,28,27,1,0.9642857142857144,11,9,2,0.8181818181818182,0.8852459016393442,GPT4,coral,pdac,PROMPT2_ICL_entailment
49,142,29,22,7,0.7586206896551724,11,10,1,0.9090909090909092,0.8270676691729324,GPT4,coral,pdac,PROMPT2_ICL_entailment
50,143,20,19,1,0.95,9,9,0,1.0,0.9743589743589745,GPT4,coral,pdac,PROMPT2_ICL_entailment
51,144,20,15,5,0.75,12,11,1,0.9166666666666666,0.8250000000000001,GPT4,coral,pdac,PROMPT2_ICL_entailment
52,145,20,20,0,1.0,10,10,0,1.0,1.0,GPT4,coral,pdac,PROMPT2_ICL_entailment
53,146,15,11,4,0.7333333333333333,7,6,1,0.8571428571428571,0.7904191616766466,GPT4,coral,pdac,PROMPT2_ICL_entailment
54,147,18,16,2,0.8888888888888888,12,12,0,1.0,0.9411764705882352,GPT4,coral,pdac,PROMPT2_ICL_entailment
55,148,47,41,6,0.8723404255319149,25,18,7,0.72,0.7888829502939605,GPT4,coral,pdac,PROMPT2_ICL_entailment
56,149,20,18,2,0.9,7,7,0,1.0,0.9473684210526316,GPT4,coral,pdac,PROMPT2_ICL_entailment
57,15,11,11,0,1.0,10,10,0,1.0,1.0,GPT4,coral,pdac,PROMPT2_ICL_entailment
58,150,19,18,1,0.9473684210526316,8,8,0,1.0,0.972972972972973,GPT4,coral,pdac,PROMPT2_ICL_entailment
59,151,22,22,0,1.0,10,10,0,1.0,1.0,GPT4,coral,pdac,PROMPT2_ICL_entailment
60,152,20,20,0,1.0,11,10,1,0.9090909090909092,0.9523809523809524,GPT4,coral,pdac,PROMPT2_ICL_entailment
61,153,46,29,17,0.6304347826086957,30,19,11,0.6333333333333333,0.6318807339449541,GPT4,coral,pdac,PROMPT2_ICL_entailment
62,154,34,30,4,0.8823529411764706,15,12,3,0.8,0.8391608391608392,GPT4,coral,pdac,PROMPT2_ICL_entailment
63,155,46,42,4,0.9130434782608696,47,34,13,0.723404255319149,0.8072357263990955,GPT4,coral,pdac,PROMPT2_ICL_entailment
64,156,21,19,2,0.9047619047619048,10,9,1,0.9,0.9023746701846964,GPT4,coral,pdac,PROMPT2_ICL_entailment
65,157,31,27,4,0.8709677419354839,14,10,4,0.7142857142857143,0.7848837209302325,GPT4,coral,pdac,PROMPT2_ICL_entailment
66,158,16,15,1,0.9375,10,8,2,0.8,0.8633093525179856,GPT4,coral,pdac,PROMPT2_ICL_entailment
67,159,18,17,1,0.9444444444444444,4,3,1,0.75,0.8360655737704917,GPT4,coral,pdac,PROMPT2_ICL_entailment
68,16,41,31,10,0.7560975609756098,31,25,6,0.8064516129032258,0.7804632426988922,GPT4,coral,pdac,PROMPT2_ICL_entailment
69,160,20,19,1,0.95,9,9,0,1.0,0.9743589743589745,GPT4,coral,pdac,PROMPT2_ICL_entailment
70,161,18,16,2,0.8888888888888888,9,8,1,0.8888888888888888,0.8888888888888888,GPT4,coral,pdac,PROMPT2_ICL_entailment
71,162,16,16,0,1.0,10,9,1,0.9,0.9473684210526316,GPT4,coral,pdac,PROMPT2_ICL_entailment
72,163,21,18,3,0.8571428571428571,13,12,1,0.9230769230769232,0.888888888888889,GPT4,coral,pdac,PROMPT2_ICL_entailment
73,164,44,39,5,0.8863636363636364,36,24,12,0.6666666666666666,0.7609756097560975,GPT4,coral,pdac,PROMPT2_ICL_entailment
74,165,33,28,5,0.8484848484848485,10,9,1,0.9,0.8734835355285963,GPT4,coral,pdac,PROMPT2_ICL_entailment
75,166,28,28,0,1.0,11,10,1,0.9090909090909092,0.9523809523809524,GPT4,coral,pdac,PROMPT2_ICL_entailment
76,167,25,23,2,0.92,8,7,1,0.875,0.8969359331476324,GPT4,coral,pdac,PROMPT2_ICL_entailment
77,168,13,12,1,0.9230769230769232,6,6,0,1.0,0.96,GPT4,coral,pdac,PROMPT2_ICL_entailment
78,169,14,13,1,0.9285714285714286,7,7,0,1.0,0.962962962962963,GPT4,coral,pdac,PROMPT2_ICL_entailment
79,17,16,16,0,1.0,5,5,0,1.0,1.0,GPT4,coral,pdac,PROMPT2_ICL_entailment
80,170,29,18,11,0.6206896551724138,16,12,4,0.75,0.679245283018868,GPT4,coral,pdac,PROMPT2_ICL_entailment
81,171,29,21,8,0.7241379310344828,13,12,1,0.9230769230769232,0.8115942028985507,GPT4,coral,pdac,PROMPT2_ICL_entailment
82,172,21,16,5,0.7619047619047619,10,10,0,1.0,0.8648648648648648,GPT4,coral,pdac,PROMPT2_ICL_entailment
83,173,30,28,2,0.9333333333333332,22,15,7,0.6818181818181818,0.7879924953095684,GPT4,coral,pdac,PROMPT2_ICL_entailment
84,174,18,15,3,0.8333333333333334,11,10,1,0.9090909090909092,0.8695652173913043,GPT4,coral,pdac,PROMPT2_ICL_entailment
85,175,57,26,31,0.4561403508771929,28,19,9,0.6785714285714286,0.545554942020983,GPT4,coral,pdac,PROMPT2_ICL_entailment
86,176,14,14,0,1.0,10,10,0,1.0,1.0,GPT4,coral,pdac,PROMPT2_ICL_entailment
87,177,15,15,0,1.0,10,10,0,1.0,1.0,GPT4,coral,pdac,PROMPT2_ICL_entailment
88,178,38,21,17,0.5526315789473685,36,22,14,0.6111111111111112,0.5804020100502513,GPT4,coral,pdac,PROMPT2_ICL_entailment
89,179,14,12,2,0.8571428571428571,9,7,2,0.7777777777777778,0.8155339805825242,GPT4,coral,pdac,PROMPT2_ICL_entailment
90,18,29,26,3,0.896551724137931,15,11,4,0.7333333333333333,0.8067700987306065,GPT4,coral,pdac,PROMPT2_ICL_entailment
91,180,15,14,1,0.9333333333333332,5,5,0,1.0,0.9655172413793104,GPT4,coral,pdac,PROMPT2_ICL_entailment
92,181,20,18,2,0.9,10,9,1,0.9,0.9,GPT4,coral,pdac,PROMPT2_ICL_entailment
93,182,19,19,0,1.0,8,8,0,1.0,1.0,GPT4,coral,pdac,PROMPT2_ICL_entailment
94,183,19,15,4,0.7894736842105263,10,6,4,0.6,0.6818181818181819,GPT4,coral,pdac,PROMPT2_ICL_entailment
95,184,27,14,13,0.5185185185185185,9,9,0,1.0,0.6829268292682926,GPT4,coral,pdac,PROMPT2_ICL_entailment
96,185,30,23,7,0.7666666666666667,3,3,0,1.0,0.8679245283018869,GPT4,coral,pdac,PROMPT2_ICL_entailment
97,186,50,39,11,0.78,32,15,17,0.46875,0.5855855855855856,GPT4,coral,pdac,PROMPT2_ICL_entailment
98,187,68,53,15,0.7794117647058824,34,21,13,0.6176470588235294,0.6891640866873066,GPT4,coral,pdac,PROMPT2_ICL_entailment
99,188,25,25,0,1.0,8,8,0,1.0,1.0,GPT4,coral,pdac,PROMPT2_ICL_entailment
100,189,20,18,2,0.9,5,5,0,1.0,0.9473684210526316,GPT4,coral,pdac,PROMPT2_ICL_entailment
101,19,46,39,7,0.8478260869565217,21,14,7,0.6666666666666666,0.7464114832535884,GPT4,coral,pdac,PROMPT2_ICL_entailment
102,190,46,42,4,0.9130434782608696,17,10,7,0.5882352941176471,0.7155025553662692,GPT4,coral,pdac,PROMPT2_ICL_entailment
103,191,53,49,4,0.9245283018867924,15,15,0,1.0,0.9607843137254902,GPT4,coral,pdac,PROMPT2_ICL_entailment
104,192,36,30,6,0.8333333333333334,12,9,3,0.75,0.7894736842105262,GPT4,coral,pdac,PROMPT2_ICL_entailment
105,193,18,18,0,1.0,10,10,0,1.0,1.0,GPT4,coral,pdac,PROMPT2_ICL_entailment
106,194,20,18,2,0.9,11,10,1,0.9090909090909092,0.9045226130653266,GPT4,coral,pdac,PROMPT2_ICL_entailment
107,195,19,17,2,0.8947368421052632,7,7,0,1.0,0.9444444444444444,GPT4,coral,pdac,PROMPT2_ICL_entailment
108,196,18,16,2,0.8888888888888888,8,8,0,1.0,0.9411764705882352,GPT4,coral,pdac,PROMPT2_ICL_entailment
109,197,32,29,3,0.90625,9,6,3,0.6666666666666666,0.7682119205298014,GPT4,coral,pdac,PROMPT2_ICL_entailment
110,198,21,19,2,0.9047619047619048,12,10,2,0.8333333333333334,0.867579908675799,GPT4,coral,pdac,PROMPT2_ICL_entailment
111,199,30,29,1,0.9666666666666668,9,9,0,1.0,0.983050847457627,GPT4,coral,pdac,PROMPT2_ICL_entailment
112,2,17,14,3,0.8235294117647058,14,13,1,0.9285714285714286,0.8729016786570742,GPT4,coral,pdac,PROMPT2_ICL_entailment
113,20,30,20,10,0.6666666666666666,18,14,4,0.7777777777777778,0.717948717948718,GPT4,coral,pdac,PROMPT2_ICL_entailment
114,200,44,40,4,0.9090909090909092,16,15,1,0.9375,0.923076923076923,GPT4,coral,pdac,PROMPT2_ICL_entailment
115,201,11,11,0,1.0,10,10,0,1.0,1.0,GPT4,coral,pdac,PROMPT2_ICL_entailment
116,202,15,15,0,1.0,10,10,0,1.0,1.0,GPT4,coral,pdac,PROMPT2_ICL_entailment
117,203,34,28,6,0.8235294117647058,31,24,7,0.7741935483870968,0.7980997624703088,GPT4,coral,pdac,PROMPT2_ICL_entailment
118,204,30,28,2,0.9333333333333332,14,11,3,0.7857142857142857,0.8531855955678669,GPT4,coral,pdac,PROMPT2_ICL_entailment
119,205,21,20,1,0.9523809523809524,7,6,1,0.8571428571428571,0.9022556390977444,GPT4,coral,pdac,PROMPT2_ICL_entailment
120,206,19,18,1,0.9473684210526316,9,8,1,0.8888888888888888,0.9171974522292994,GPT4,coral,pdac,PROMPT2_ICL_entailment
121,207,19,16,3,0.8421052631578947,8,8,0,1.0,0.9142857142857144,GPT4,coral,pdac,PROMPT2_ICL_entailment
122,208,17,15,2,0.8823529411764706,8,8,0,1.0,0.9375,GPT4,coral,pdac,PROMPT2_ICL_entailment
123,209,38,36,2,0.9473684210526316,9,9,0,1.0,0.972972972972973,GPT4,coral,pdac,PROMPT2_ICL_entailment
124,21,10,10,0,1.0,10,9,1,0.9,0.9473684210526316,GPT4,coral,pdac,PROMPT2_ICL_entailment
125,210,16,14,2,0.875,9,9,0,1.0,0.9333333333333332,GPT4,coral,pdac,PROMPT2_ICL_entailment
126,211,23,21,2,0.9130434782608696,8,6,2,0.75,0.8235294117647057,GPT4,coral,pdac,PROMPT2_ICL_entailment
127,212,23,23,0,1.0,17,17,0,1.0,1.0,GPT4,coral,pdac,PROMPT2_ICL_entailment
128,213,21,21,0,1.0,11,11,0,1.0,1.0,GPT4,coral,pdac,PROMPT2_ICL_entailment
129,214,28,26,2,0.9285714285714286,18,14,4,0.7777777777777778,0.8465116279069766,GPT4,coral,pdac,PROMPT2_ICL_entailment
130,215,30,16,14,0.5333333333333333,12,5,7,0.4166666666666667,0.4678362573099415,GPT4,coral,pdac,PROMPT2_ICL_entailment
131,216,38,29,9,0.7631578947368421,33,32,1,0.9696969696969696,0.854118729866544,GPT4,coral,pdac,PROMPT2_ICL_entailment
132,217,49,47,2,0.9591836734693876,19,11,8,0.5789473684210527,0.7220670391061452,GPT4,coral,pdac,PROMPT2_ICL_entailment
133,218,29,29,0,1.0,11,9,2,0.8181818181818182,0.9,GPT4,coral,pdac,PROMPT2_ICL_entailment
134,219,19,18,1,0.9473684210526316,8,8,0,1.0,0.972972972972973,GPT4,coral,pdac,PROMPT2_ICL_entailment
135,22,35,24,11,0.6857142857142857,17,17,0,1.0,0.8135593220338984,GPT4,coral,pdac,PROMPT2_ICL_entailment
136,220,30,25,5,0.8333333333333334,11,9,2,0.8181818181818182,0.8256880733944955,GPT4,coral,pdac,PROMPT2_ICL_entailment
137,221,17,17,0,1.0,12,11,1,0.9166666666666666,0.9565217391304348,GPT4,coral,pdac,PROMPT2_ICL_entailment
138,222,42,30,12,0.7142857142857143,11,10,1,0.9090909090909092,0.8,GPT4,coral,pdac,PROMPT2_ICL_entailment
139,223,69,62,7,0.8985507246376812,37,35,2,0.945945945945946,0.921639413888299,GPT4,coral,pdac,PROMPT2_ICL_entailment
140,224,25,20,5,0.8,8,8,0,1.0,0.888888888888889,GPT4,coral,pdac,PROMPT2_ICL_entailment
141,225,23,21,2,0.9130434782608696,13,11,2,0.8461538461538461,0.8783269961977186,GPT4,coral,pdac,PROMPT2_ICL_entailment
142,226,28,27,1,0.9642857142857144,11,10,1,0.9090909090909092,0.9358752166377816,GPT4,coral,pdac,PROMPT2_ICL_entailment
143,227,20,17,3,0.85,10,9,1,0.9,0.8742857142857143,GPT4,coral,pdac,PROMPT2_ICL_entailment
144,228,24,24,0,1.0,9,9,0,1.0,1.0,GPT4,coral,pdac,PROMPT2_ICL_entailment
145,229,23,21,2,0.9130434782608696,9,8,1,0.8888888888888888,0.900804289544236,GPT4,coral,pdac,PROMPT2_ICL_entailment
146,23,27,26,1,0.9629629629629628,12,10,2,0.8333333333333334,0.8934707903780069,GPT4,coral,pdac,PROMPT2_ICL_entailment
147,230,18,17,1,0.9444444444444444,8,8,0,1.0,0.9714285714285714,GPT4,coral,pdac,PROMPT2_ICL_entailment
148,24,21,21,0,1.0,9,9,0,1.0,1.0,GPT4,coral,pdac,PROMPT2_ICL_entailment
149,25,26,21,5,0.8076923076923077,11,10,1,0.9090909090909092,0.8553971486761711,GPT4,coral,pdac,PROMPT2_ICL_entailment
150,26,15,15,0,1.0,11,11,0,1.0,1.0,GPT4,coral,pdac,PROMPT2_ICL_entailment
151,27,22,20,2,0.9090909090909092,12,10,2,0.8333333333333334,0.8695652173913043,GPT4,coral,pdac,PROMPT2_ICL_entailment
152,28,38,36,2,0.9473684210526316,13,12,1,0.9230769230769232,0.935064935064935,GPT4,coral,pdac,PROMPT2_ICL_entailment
153,29,44,40,4,0.9090909090909092,9,9,0,1.0,0.9523809523809524,GPT4,coral,pdac,PROMPT2_ICL_entailment
154,3,18,17,1,0.9444444444444444,8,8,0,1.0,0.9714285714285714,GPT4,coral,pdac,PROMPT2_ICL_entailment
155,30,40,35,5,0.875,11,11,0,1.0,0.9333333333333332,GPT4,coral,pdac,PROMPT2_ICL_entailment
156,31,36,32,4,0.8888888888888888,11,11,0,1.0,0.9411764705882352,GPT4,coral,pdac,PROMPT2_ICL_entailment
157,32,50,43,7,0.86,11,10,1,0.9090909090909092,0.8838643371017472,GPT4,coral,pdac,PROMPT2_ICL_entailment
158,33,53,21,32,0.3962264150943396,24,20,4,0.8333333333333334,0.5370843989769821,GPT4,coral,pdac,PROMPT2_ICL_entailment
159,34,10,10,0,1.0,10,10,0,1.0,1.0,GPT4,coral,pdac,PROMPT2_ICL_entailment
160,35,16,16,0,1.0,10,10,0,1.0,1.0,GPT4,coral,pdac,PROMPT2_ICL_entailment
161,36,68,67,1,0.9852941176470588,44,36,8,0.8181818181818182,0.8939955522609341,GPT4,coral,pdac,PROMPT2_ICL_entailment
162,37,29,26,3,0.896551724137931,9,8,1,0.8888888888888888,0.8927038626609441,GPT4,coral,pdac,PROMPT2_ICL_entailment
163,38,27,24,3,0.8888888888888888,13,10,3,0.7692307692307693,0.8247422680412372,GPT4,coral,pdac,PROMPT2_ICL_entailment
164,39,21,20,1,0.9523809523809524,10,9,1,0.9,0.9254498714652956,GPT4,coral,pdac,PROMPT2_ICL_entailment
165,4,31,27,4,0.8709677419354839,15,12,3,0.8,0.833976833976834,GPT4,coral,pdac,PROMPT2_ICL_entailment
166,40,15,13,2,0.8666666666666667,10,7,3,0.7,0.774468085106383,GPT4,coral,pdac,PROMPT2_ICL_entailment
167,41,21,20,1,0.9523809523809524,8,8,0,1.0,0.975609756097561,GPT4,coral,pdac,PROMPT2_ICL_entailment
168,42,27,27,0,1.0,11,10,1,0.9090909090909092,0.9523809523809524,GPT4,coral,pdac,PROMPT2_ICL_entailment
169,43,29,28,1,0.9655172413793104,13,10,3,0.7692307692307693,0.8562691131498472,GPT4,coral,pdac,PROMPT2_ICL_entailment
170,44,24,24,0,1.0,11,10,1,0.9090909090909092,0.9523809523809524,GPT4,coral,pdac,PROMPT2_ICL_entailment
171,45,22,22,0,1.0,10,10,0,1.0,1.0,GPT4,coral,pdac,PROMPT2_ICL_entailment
172,46,26,19,7,0.7307692307692307,11,11,0,1.0,0.8444444444444443,GPT4,coral,pdac,PROMPT2_ICL_entailment
173,47,72,62,10,0.8611111111111112,39,26,13,0.6666666666666666,0.7515151515151516,GPT4,coral,pdac,PROMPT2_ICL_entailment
174,48,15,10,5,0.6666666666666666,10,8,2,0.8,0.7272727272727272,GPT4,coral,pdac,PROMPT2_ICL_entailment
175,49,18,18,0,1.0,10,8,2,0.8,0.888888888888889,GPT4,coral,pdac,PROMPT2_ICL_entailment
176,5,21,20,1,0.9523809523809524,10,9,1,0.9,0.9254498714652956,GPT4,coral,pdac,PROMPT2_ICL_entailment
177,50,20,17,3,0.85,10,8,2,0.8,0.8242424242424243,GPT4,coral,pdac,PROMPT2_ICL_entailment
178,51,16,14,2,0.875,12,9,3,0.75,0.8076923076923077,GPT4,coral,pdac,PROMPT2_ICL_entailment
179,52,19,16,3,0.8421052631578947,10,10,0,1.0,0.9142857142857144,GPT4,coral,pdac,PROMPT2_ICL_entailment
180,53,15,14,1,0.9333333333333332,8,8,0,1.0,0.9655172413793104,GPT4,coral,pdac,PROMPT2_ICL_entailment
181,54,8,8,0,1.0,2,2,0,1.0,1.0,GPT4,coral,pdac,PROMPT2_ICL_entailment
182,55,28,27,1,0.9642857142857144,10,9,1,0.9,0.9310344827586208,GPT4,coral,pdac,PROMPT2_ICL_entailment
183,56,27,25,2,0.925925925925926,8,7,1,0.875,0.8997429305912596,GPT4,coral,pdac,PROMPT2_ICL_entailment
184,57,43,32,11,0.7441860465116279,13,9,4,0.6923076923076923,0.7173100871731007,GPT4,coral,pdac,PROMPT2_ICL_entailment
185,58,44,41,3,0.9318181818181818,10,10,0,1.0,0.9647058823529412,GPT4,coral,pdac,PROMPT2_ICL_entailment
186,59,48,39,9,0.8125,21,15,6,0.7142857142857143,0.7602339181286549,GPT4,coral,pdac,PROMPT2_ICL_entailment
187,6,20,19,1,0.95,12,8,4,0.6666666666666666,0.7835051546391752,GPT4,coral,pdac,PROMPT2_ICL_entailment
188,60,33,32,1,0.9696969696969696,13,10,3,0.7692307692307693,0.8579088471849867,GPT4,coral,pdac,PROMPT2_ICL_entailment
189,61,22,21,1,0.9545454545454546,7,7,0,1.0,0.9767441860465116,GPT4,coral,pdac,PROMPT2_ICL_entailment
190,62,24,17,7,0.7083333333333334,11,9,2,0.8181818181818182,0.7593052109181142,GPT4,coral,pdac,PROMPT2_ICL_entailment
191,63,12,12,0,1.0,10,10,0,1.0,1.0,GPT4,coral,pdac,PROMPT2_ICL_entailment
192,64,19,18,1,0.9473684210526316,12,12,0,1.0,0.972972972972973,GPT4,coral,pdac,PROMPT2_ICL_entailment
193,65,36,33,3,0.9166666666666666,9,9,0,1.0,0.9565217391304348,GPT4,coral,pdac,PROMPT2_ICL_entailment
194,66,26,25,1,0.9615384615384616,12,11,1,0.9166666666666666,0.938566552901024,GPT4,coral,pdac,PROMPT2_ICL_entailment
195,67,11,11,0,1.0,1,1,0,1.0,1.0,GPT4,coral,pdac,PROMPT2_ICL_entailment
196,68,24,21,3,0.875,11,10,1,0.9090909090909092,0.8917197452229298,GPT4,coral,pdac,PROMPT2_ICL_entailment
197,69,28,28,0,1.0,10,10,0,1.0,1.0,GPT4,coral,pdac,PROMPT2_ICL_entailment
198,7,17,15,2,0.8823529411764706,11,10,1,0.9090909090909092,0.8955223880597014,GPT4,coral,pdac,PROMPT2_ICL_entailment
199,70,36,34,2,0.9444444444444444,15,12,3,0.8,0.8662420382165604,GPT4,coral,pdac,PROMPT2_ICL_entailment
200,71,44,41,3,0.9318181818181818,9,8,1,0.8888888888888888,0.9098474341192788,GPT4,coral,pdac,PROMPT2_ICL_entailment
201,72,42,29,13,0.6904761904761905,13,12,1,0.9230769230769232,0.790011350737798,GPT4,coral,pdac,PROMPT2_ICL_entailment
202,73,88,29,59,0.3295454545454545,154,61,93,0.3961038961038961,0.3597722188326215,GPT4,coral,pdac,PROMPT2_ICL_entailment
203,74,30,20,10,0.6666666666666666,8,7,1,0.875,0.7567567567567567,GPT4,coral,pdac,PROMPT2_ICL_entailment
204,75,24,22,2,0.9166666666666666,7,7,0,1.0,0.9565217391304348,GPT4,coral,pdac,PROMPT2_ICL_entailment
205,76,15,12,3,0.8,7,7,0,1.0,0.888888888888889,GPT4,coral,pdac,PROMPT2_ICL_entailment
206,77,24,21,3,0.875,8,8,0,1.0,0.9333333333333332,GPT4,coral,pdac,PROMPT2_ICL_entailment
207,78,17,16,1,0.9411764705882352,8,8,0,1.0,0.9696969696969696,GPT4,coral,pdac,PROMPT2_ICL_entailment
208,79,27,24,3,0.8888888888888888,11,11,0,1.0,0.9411764705882352,GPT4,coral,pdac,PROMPT2_ICL_entailment
209,8,11,11,0,1.0,2,2,0,1.0,1.0,GPT4,coral,pdac,PROMPT2_ICL_entailment
210,80,29,24,5,0.8275862068965517,9,8,1,0.8888888888888888,0.8571428571428572,GPT4,coral,pdac,PROMPT2_ICL_entailment
211,81,19,19,0,1.0,6,5,1,0.8333333333333334,0.9090909090909092,GPT4,coral,pdac,PROMPT2_ICL_entailment
212,82,33,33,0,1.0,4,4,0,1.0,1.0,GPT4,coral,pdac,PROMPT2_ICL_entailment
213,83,33,26,7,0.7878787878787878,11,9,2,0.8181818181818182,0.8027444253859348,GPT4,coral,pdac,PROMPT2_ICL_entailment
214,84,25,20,5,0.8,11,9,2,0.8181818181818182,0.8089887640449439,GPT4,coral,pdac,PROMPT2_ICL_entailment
215,85,42,33,9,0.7857142857142857,35,26,9,0.7428571428571429,0.7636849132176236,GPT4,coral,pdac,PROMPT2_ICL_entailment
216,86,20,20,0,1.0,10,9,1,0.9,0.9473684210526316,GPT4,coral,pdac,PROMPT2_ICL_entailment
217,87,35,31,4,0.8857142857142857,7,6,1,0.8571428571428571,0.8711943793911006,GPT4,coral,pdac,PROMPT2_ICL_entailment
218,88,22,20,2,0.9090909090909092,8,7,1,0.875,0.8917197452229298,GPT4,coral,pdac,PROMPT2_ICL_entailment
219,89,20,16,4,0.8,10,10,0,1.0,0.888888888888889,GPT4,coral,pdac,PROMPT2_ICL_entailment
220,9,18,18,0,1.0,12,9,3,0.75,0.8571428571428571,GPT4,coral,pdac,PROMPT2_ICL_entailment
221,90,31,26,5,0.8387096774193549,9,9,0,1.0,0.912280701754386,GPT4,coral,pdac,PROMPT2_ICL_entailment
222,91,24,23,1,0.9583333333333334,10,10,0,1.0,0.9787234042553192,GPT4,coral,pdac,PROMPT2_ICL_entailment
223,92,27,24,3,0.8888888888888888,10,9,1,0.9,0.8944099378881988,GPT4,coral,pdac,PROMPT2_ICL_entailment
224,93,22,22,0,1.0,9,7,2,0.7777777777777778,0.8750000000000001,GPT4,coral,pdac,PROMPT2_ICL_entailment
225,94,18,15,3,0.8333333333333334,7,5,2,0.7142857142857143,0.7692307692307692,GPT4,coral,pdac,PROMPT2_ICL_entailment
226,95,24,23,1,0.9583333333333334,8,7,1,0.875,0.9147727272727272,GPT4,coral,pdac,PROMPT2_ICL_entailment
227,96,14,14,0,1.0,4,4,0,1.0,1.0,GPT4,coral,pdac,PROMPT2_ICL_entailment
228,97,20,19,1,0.95,8,8,0,1.0,0.9743589743589745,GPT4,coral,pdac,PROMPT2_ICL_entailment
229,98,24,22,2,0.9166666666666666,9,9,0,1.0,0.9565217391304348,GPT4,coral,pdac,PROMPT2_ICL_entailment
230,99,25,24,1,0.96,9,9,0,1.0,0.979591836734694,GPT4,coral,pdac,PROMPT2_ICL_entailment
0,0,18,18,0,1.0,9,9,0,1.0,1.0,GPT4,coral,pdac,PROMPT2_entailment
1,1,14,14,0,1.0,9,9,0,1.0,1.0,GPT4,coral,pdac,PROMPT2_entailment
2,10,18,18,0,1.0,11,11,0,1.0,1.0,GPT4,coral,pdac,PROMPT2_entailment
3,100,18,18,0,1.0,11,10,1,0.9090909090909092,0.9523809523809524,GPT4,coral,pdac,PROMPT2_entailment
4,101,22,19,3,0.8636363636363636,11,9,2,0.8181818181818182,0.8402948402948404,GPT4,coral,pdac,PROMPT2_entailment
5,102,25,25,0,1.0,27,20,7,0.7407407407407407,0.851063829787234,GPT4,coral,pdac,PROMPT2_entailment
6,103,19,10,9,0.5263157894736842,15,9,6,0.6,0.5607476635514018,GPT4,coral,pdac,PROMPT2_entailment
7,104,22,17,5,0.7727272727272727,12,11,1,0.9166666666666666,0.8385650224215245,GPT4,coral,pdac,PROMPT2_entailment
8,105,38,22,16,0.5789473684210527,33,13,20,0.3939393939393939,0.4688524590163934,GPT4,coral,pdac,PROMPT2_entailment
9,106,14,13,1,0.9285714285714286,10,10,0,1.0,0.962962962962963,GPT4,coral,pdac,PROMPT2_entailment
10,107,10,10,0,1.0,10,10,0,1.0,1.0,GPT4,coral,pdac,PROMPT2_entailment
11,108,17,17,0,1.0,10,10,0,1.0,1.0,GPT4,coral,pdac,PROMPT2_entailment
12,109,27,27,0,1.0,34,23,11,0.6764705882352942,0.8070175438596492,GPT4,coral,pdac,PROMPT2_entailment
13,11,19,15,4,0.7894736842105263,10,10,0,1.0,0.8823529411764706,GPT4,coral,pdac,PROMPT2_entailment
14,110,9,9,0,1.0,4,4,0,1.0,1.0,GPT4,coral,pdac,PROMPT2_entailment
15,111,12,12,0,1.0,3,3,0,1.0,1.0,GPT4,coral,pdac,PROMPT2_entailment
16,112,13,13,0,1.0,9,9,0,1.0,1.0,GPT4,coral,pdac,PROMPT2_entailment
17,113,14,11,3,0.7857142857142857,6,6,0,1.0,0.88,GPT4,coral,pdac,PROMPT2_entailment
18,114,12,12,0,1.0,9,9,0,1.0,1.0,GPT4,coral,pdac,PROMPT2_entailment
19,115,15,15,0,1.0,7,7,0,1.0,1.0,GPT4,coral,pdac,PROMPT2_entailment
20,116,5,5,0,1.0,2,2,0,1.0,1.0,GPT4,coral,pdac,PROMPT2_entailment
21,117,17,17,0,1.0,8,7,1,0.875,0.9333333333333332,GPT4,coral,pdac,PROMPT2_entailment
22,118,17,17,0,1.0,9,9,0,1.0,1.0,GPT4,coral,pdac,PROMPT2_entailment
23,119,18,14,4,0.7777777777777778,12,10,2,0.8333333333333334,0.8045977011494253,GPT4,coral,pdac,PROMPT2_entailment
24,12,22,18,4,0.8181818181818182,10,9,1,0.9,0.8571428571428572,GPT4,coral,pdac,PROMPT2_entailment
25,120,17,15,2,0.8823529411764706,13,11,2,0.8461538461538461,0.8638743455497382,GPT4,coral,pdac,PROMPT2_entailment
26,121,24,22,2,0.9166666666666666,12,10,2,0.8333333333333334,0.8730158730158729,GPT4,coral,pdac,PROMPT2_entailment
27,122,49,38,11,0.7755102040816326,45,35,10,0.7777777777777778,0.7766423357664234,GPT4,coral,pdac,PROMPT2_entailment
28,123,19,15,4,0.7894736842105263,10,10,0,1.0,0.8823529411764706,GPT4,coral,pdac,PROMPT2_entailment
29,124,4,4,0,1.0,3,3,0,1.0,1.0,GPT4,coral,pdac,PROMPT2_entailment
30,125,17,17,0,1.0,8,8,0,1.0,1.0,GPT4,coral,pdac,PROMPT2_entailment
31,126,13,13,0,1.0,10,9,1,0.9,0.9473684210526316,GPT4,coral,pdac,PROMPT2_entailment
32,127,42,33,9,0.7857142857142857,30,21,9,0.7,0.7403846153846153,GPT4,coral,pdac,PROMPT2_entailment
33,128,54,50,4,0.925925925925926,35,28,7,0.8,0.8583690987124465,GPT4,coral,pdac,PROMPT2_entailment
34,129,14,13,1,0.9285714285714286,11,10,1,0.9090909090909092,0.9187279151943464,GPT4,coral,pdac,PROMPT2_entailment
35,13,17,16,1,0.9411764705882352,13,10,3,0.7692307692307693,0.8465608465608465,GPT4,coral,pdac,PROMPT2_entailment
36,130,25,22,3,0.88,12,9,3,0.75,0.8098159509202455,GPT4,coral,pdac,PROMPT2_entailment
37,131,15,14,1,0.9333333333333332,12,9,3,0.75,0.8316831683168316,GPT4,coral,pdac,PROMPT2_entailment
38,132,14,13,1,0.9285714285714286,10,9,1,0.9,0.9140625,GPT4,coral,pdac,PROMPT2_entailment
39,133,17,16,1,0.9411764705882352,7,6,1,0.8571428571428571,0.897196261682243,GPT4,coral,pdac,PROMPT2_entailment
40,134,26,25,1,0.9615384615384616,15,10,5,0.6666666666666666,0.7874015748031495,GPT4,coral,pdac,PROMPT2_entailment
41,135,17,16,1,0.9411764705882352,9,9,0,1.0,0.9696969696969696,GPT4,coral,pdac,PROMPT2_entailment
42,136,26,23,3,0.8846153846153846,7,5,2,0.7142857142857143,0.7903780068728522,GPT4,coral,pdac,PROMPT2_entailment
43,137,14,12,2,0.8571428571428571,10,8,2,0.8,0.8275862068965518,GPT4,coral,pdac,PROMPT2_entailment
44,138,34,27,7,0.7941176470588235,25,19,6,0.76,0.7766843300529901,GPT4,coral,pdac,PROMPT2_entailment
45,139,52,31,21,0.5961538461538461,62,38,24,0.6129032258064516,0.6044125192406362,GPT4,coral,pdac,PROMPT2_entailment
46,14,13,12,1,0.9230769230769232,10,10,0,1.0,0.96,GPT4,coral,pdac,PROMPT2_entailment
47,140,16,15,1,0.9375,8,8,0,1.0,0.967741935483871,GPT4,coral,pdac,PROMPT2_entailment
48,141,23,23,0,1.0,11,8,3,0.7272727272727273,0.8421052631578948,GPT4,coral,pdac,PROMPT2_entailment
49,142,22,17,5,0.7727272727272727,11,11,0,1.0,0.8717948717948718,GPT4,coral,pdac,PROMPT2_entailment
50,143,15,14,1,0.9333333333333332,9,8,1,0.8888888888888888,0.9105691056910568,GPT4,coral,pdac,PROMPT2_entailment
51,144,20,14,6,0.7,12,12,0,1.0,0.8235294117647058,GPT4,coral,pdac,PROMPT2_entailment
52,145,14,14,0,1.0,10,10,0,1.0,1.0,GPT4,coral,pdac,PROMPT2_entailment
53,146,13,10,3,0.7692307692307693,7,6,1,0.8571428571428571,0.8108108108108107,GPT4,coral,pdac,PROMPT2_entailment
54,147,16,14,2,0.875,12,12,0,1.0,0.9333333333333332,GPT4,coral,pdac,PROMPT2_entailment
55,148,38,32,6,0.8421052631578947,25,16,9,0.64,0.7272727272727272,GPT4,coral,pdac,PROMPT2_entailment
56,149,20,19,1,0.95,7,7,0,1.0,0.9743589743589745,GPT4,coral,pdac,PROMPT2_entailment
57,15,11,11,0,1.0,10,10,0,1.0,1.0,GPT4,coral,pdac,PROMPT2_entailment
58,150,13,13,0,1.0,8,8,0,1.0,1.0,GPT4,coral,pdac,PROMPT2_entailment
59,151,22,20,2,0.9090909090909092,10,10,0,1.0,0.9523809523809524,GPT4,coral,pdac,PROMPT2_entailment
60,152,20,20,0,1.0,11,10,1,0.9090909090909092,0.9523809523809524,GPT4,coral,pdac,PROMPT2_entailment
61,153,44,28,16,0.6363636363636364,30,19,11,0.6333333333333333,0.6348448687350836,GPT4,coral,pdac,PROMPT2_entailment
62,154,30,27,3,0.9,15,15,0,1.0,0.9473684210526316,GPT4,coral,pdac,PROMPT2_entailment
63,155,47,44,3,0.9361702127659576,47,34,13,0.723404255319149,0.8161483906164759,GPT4,coral,pdac,PROMPT2_entailment
64,156,16,15,1,0.9375,10,8,2,0.8,0.8633093525179856,GPT4,coral,pdac,PROMPT2_entailment
65,157,21,21,0,1.0,14,11,3,0.7857142857142857,0.88,GPT4,coral,pdac,PROMPT2_entailment
66,158,13,12,1,0.9230769230769232,10,8,2,0.8,0.8571428571428571,GPT4,coral,pdac,PROMPT2_entailment
67,159,16,15,1,0.9375,4,4,0,1.0,0.967741935483871,GPT4,coral,pdac,PROMPT2_entailment
68,16,38,32,6,0.8421052631578947,31,25,6,0.8064516129032258,0.82389289392379,GPT4,coral,pdac,PROMPT2_entailment
69,160,12,11,1,0.9166666666666666,9,9,0,1.0,0.9565217391304348,GPT4,coral,pdac,PROMPT2_entailment
70,161,14,13,1,0.9285714285714286,9,8,1,0.8888888888888888,0.9082969432314412,GPT4,coral,pdac,PROMPT2_entailment
71,162,12,12,0,1.0,10,10,0,1.0,1.0,GPT4,coral,pdac,PROMPT2_entailment
72,163,21,16,5,0.7619047619047619,13,11,2,0.8461538461538461,0.8018223234624144,GPT4,coral,pdac,PROMPT2_entailment
73,164,47,42,5,0.8936170212765957,36,28,8,0.7777777777777778,0.8316831683168316,GPT4,coral,pdac,PROMPT2_entailment
74,165,25,21,4,0.84,10,8,2,0.8,0.8195121951219512,GPT4,coral,pdac,PROMPT2_entailment
75,166,18,18,0,1.0,11,9,2,0.8181818181818182,0.9,GPT4,coral,pdac,PROMPT2_entailment
76,167,17,16,1,0.9411764705882352,8,7,1,0.875,0.9068825910931174,GPT4,coral,pdac,PROMPT2_entailment
77,168,13,12,1,0.9230769230769232,6,6,0,1.0,0.96,GPT4,coral,pdac,PROMPT2_entailment
78,169,11,11,0,1.0,7,7,0,1.0,1.0,GPT4,coral,pdac,PROMPT2_entailment
79,17,11,11,0,1.0,5,5,0,1.0,1.0,GPT4,coral,pdac,PROMPT2_entailment
80,170,27,19,8,0.7037037037037037,16,12,4,0.75,0.7261146496815287,GPT4,coral,pdac,PROMPT2_entailment
81,171,17,14,3,0.8235294117647058,13,13,0,1.0,0.9032258064516128,GPT4,coral,pdac,PROMPT2_entailment
82,172,21,15,6,0.7142857142857143,10,10,0,1.0,0.8333333333333333,GPT4,coral,pdac,PROMPT2_entailment
83,173,26,24,2,0.9230769230769232,22,14,8,0.6363636363636364,0.7533632286995515,GPT4,coral,pdac,PROMPT2_entailment
84,174,16,13,3,0.8125,11,10,1,0.9090909090909092,0.858085808580858,GPT4,coral,pdac,PROMPT2_entailment
85,175,45,16,29,0.3555555555555555,28,15,13,0.5357142857142857,0.4274265360641139,GPT4,coral,pdac,PROMPT2_entailment
86,176,14,14,0,1.0,10,10,0,1.0,1.0,GPT4,coral,pdac,PROMPT2_entailment
87,177,12,12,0,1.0,10,9,1,0.9,0.9473684210526316,GPT4,coral,pdac,PROMPT2_entailment
88,178,37,23,14,0.6216216216216216,36,23,13,0.6388888888888888,0.6301369863013699,GPT4,coral,pdac,PROMPT2_entailment
89,179,12,11,1,0.9166666666666666,9,7,2,0.7777777777777778,0.8415300546448087,GPT4,coral,pdac,PROMPT2_entailment
90,18,29,27,2,0.9310344827586208,15,8,7,0.5333333333333333,0.6781789638932496,GPT4,coral,pdac,PROMPT2_entailment
91,180,10,9,1,0.9,5,5,0,1.0,0.9473684210526316,GPT4,coral,pdac,PROMPT2_entailment
92,181,19,18,1,0.9473684210526316,10,8,2,0.8,0.8674698795180723,GPT4,coral,pdac,PROMPT2_entailment
93,182,18,17,1,0.9444444444444444,8,8,0,1.0,0.9714285714285714,GPT4,coral,pdac,PROMPT2_entailment
94,183,19,18,1,0.9473684210526316,10,9,1,0.9,0.9230769230769232,GPT4,coral,pdac,PROMPT2_entailment
95,184,14,8,6,0.5714285714285714,9,9,0,1.0,0.7272727272727273,GPT4,coral,pdac,PROMPT2_entailment
96,185,24,22,2,0.9166666666666666,22,16,6,0.7272727272727273,0.8110599078341013,GPT4,coral,pdac,PROMPT2_entailment
97,186,53,38,15,0.7169811320754716,32,14,18,0.4375,0.54341164453524,GPT4,coral,pdac,PROMPT2_entailment
98,187,49,40,9,0.8163265306122449,34,26,8,0.7647058823529411,0.7896735003796507,GPT4,coral,pdac,PROMPT2_entailment
99,188,18,16,2,0.8888888888888888,8,8,0,1.0,0.9411764705882352,GPT4,coral,pdac,PROMPT2_entailment
100,189,19,16,3,0.8421052631578947,5,5,0,1.0,0.9142857142857144,GPT4,coral,pdac,PROMPT2_entailment
101,19,28,22,6,0.7857142857142857,21,17,4,0.8095238095238095,0.7974413646055437,GPT4,coral,pdac,PROMPT2_entailment
102,190,14,14,0,1.0,17,13,4,0.7647058823529411,0.8666666666666666,GPT4,coral,pdac,PROMPT2_entailment
103,191,41,38,3,0.926829268292683,15,14,1,0.9333333333333332,0.93006993006993,GPT4,coral,pdac,PROMPT2_entailment
104,192,38,30,8,0.7894736842105263,12,10,2,0.8333333333333334,0.8108108108108109,GPT4,coral,pdac,PROMPT2_entailment
105,193,17,16,1,0.9411764705882352,10,10,0,1.0,0.9696969696969696,GPT4,coral,pdac,PROMPT2_entailment
106,194,15,14,1,0.9333333333333332,11,10,1,0.9090909090909092,0.9210526315789476,GPT4,coral,pdac,PROMPT2_entailment
107,195,14,12,2,0.8571428571428571,7,7,0,1.0,0.923076923076923,GPT4,coral,pdac,PROMPT2_entailment
108,196,16,15,1,0.9375,8,8,0,1.0,0.967741935483871,GPT4,coral,pdac,PROMPT2_entailment
109,197,17,17,0,1.0,9,8,1,0.8888888888888888,0.9411764705882352,GPT4,coral,pdac,PROMPT2_entailment
110,198,19,19,0,1.0,12,11,1,0.9166666666666666,0.9565217391304348,GPT4,coral,pdac,PROMPT2_entailment
111,199,32,32,0,1.0,9,9,0,1.0,1.0,GPT4,coral,pdac,PROMPT2_entailment
112,2,15,13,2,0.8666666666666667,6,6,0,1.0,0.9285714285714286,GPT4,coral,pdac,PROMPT2_entailment
113,20,28,17,11,0.6071428571428571,18,13,5,0.7222222222222222,0.6597014925373134,GPT4,coral,pdac,PROMPT2_entailment
114,200,39,34,5,0.8717948717948718,16,15,1,0.9375,0.9034543844109832,GPT4,coral,pdac,PROMPT2_entailment
115,201,11,11,0,1.0,10,10,0,1.0,1.0,GPT4,coral,pdac,PROMPT2_entailment
116,202,15,15,0,1.0,10,10,0,1.0,1.0,GPT4,coral,pdac,PROMPT2_entailment
117,203,30,25,5,0.8333333333333334,31,20,11,0.6451612903225806,0.7272727272727272,GPT4,coral,pdac,PROMPT2_entailment
118,204,25,21,4,0.84,14,13,1,0.9285714285714286,0.8820678513731826,GPT4,coral,pdac,PROMPT2_entailment
119,205,20,20,0,1.0,7,6,1,0.8571428571428571,0.923076923076923,GPT4,coral,pdac,PROMPT2_entailment
120,206,19,16,3,0.8421052631578947,9,7,2,0.7777777777777778,0.8086642599277979,GPT4,coral,pdac,PROMPT2_entailment
121,207,16,14,2,0.875,8,8,0,1.0,0.9333333333333332,GPT4,coral,pdac,PROMPT2_entailment
122,208,12,11,1,0.9166666666666666,8,8,0,1.0,0.9565217391304348,GPT4,coral,pdac,PROMPT2_entailment
123,209,26,25,1,0.9615384615384616,9,9,0,1.0,0.9803921568627452,GPT4,coral,pdac,PROMPT2_entailment
124,21,10,10,0,1.0,10,9,1,0.9,0.9473684210526316,GPT4,coral,pdac,PROMPT2_entailment
125,210,17,15,2,0.8823529411764706,9,9,0,1.0,0.9375,GPT4,coral,pdac,PROMPT2_entailment
126,211,16,16,0,1.0,8,6,2,0.75,0.8571428571428571,GPT4,coral,pdac,PROMPT2_entailment
127,212,27,27,0,1.0,17,15,2,0.8823529411764706,0.9375,GPT4,coral,pdac,PROMPT2_entailment
128,213,19,19,0,1.0,11,11,0,1.0,1.0,GPT4,coral,pdac,PROMPT2_entailment
129,214,13,11,2,0.8461538461538461,18,10,8,0.5555555555555556,0.6707317073170732,GPT4,coral,pdac,PROMPT2_entailment
130,215,27,17,10,0.6296296296296297,12,8,4,0.6666666666666666,0.6476190476190475,GPT4,coral,pdac,PROMPT2_entailment
131,216,34,27,7,0.7941176470588235,33,31,2,0.9393939393939394,0.860668380462725,GPT4,coral,pdac,PROMPT2_entailment
132,217,25,25,0,1.0,19,15,4,0.7894736842105263,0.8823529411764706,GPT4,coral,pdac,PROMPT2_entailment
133,218,22,22,0,1.0,11,8,3,0.7272727272727273,0.8421052631578948,GPT4,coral,pdac,PROMPT2_entailment
134,219,17,14,3,0.8235294117647058,8,8,0,1.0,0.9032258064516128,GPT4,coral,pdac,PROMPT2_entailment
135,22,28,19,9,0.6785714285714286,17,14,3,0.8235294117647058,0.7440559440559441,GPT4,coral,pdac,PROMPT2_entailment
136,220,23,20,3,0.8695652173913043,11,11,0,1.0,0.9302325581395348,GPT4,coral,pdac,PROMPT2_entailment
137,221,15,15,0,1.0,12,11,1,0.9166666666666666,0.9565217391304348,GPT4,coral,pdac,PROMPT2_entailment
138,222,12,10,2,0.8333333333333334,11,11,0,1.0,0.9090909090909092,GPT4,coral,pdac,PROMPT2_entailment
139,223,46,37,9,0.8043478260869565,37,29,8,0.7837837837837838,0.7939326674065853,GPT4,coral,pdac,PROMPT2_entailment
140,224,25,17,8,0.68,8,8,0,1.0,0.8095238095238095,GPT4,coral,pdac,PROMPT2_entailment
141,225,21,20,1,0.9523809523809524,13,9,4,0.6923076923076923,0.8017817371937639,GPT4,coral,pdac,PROMPT2_entailment
142,226,19,18,1,0.9473684210526316,11,10,1,0.9090909090909092,0.9278350515463918,GPT4,coral,pdac,PROMPT2_entailment
143,227,17,14,3,0.8235294117647058,10,10,0,1.0,0.9032258064516128,GPT4,coral,pdac,PROMPT2_entailment
144,228,19,18,1,0.9473684210526316,9,9,0,1.0,0.972972972972973,GPT4,coral,pdac,PROMPT2_entailment
145,229,15,14,1,0.9333333333333332,9,8,1,0.8888888888888888,0.9105691056910568,GPT4,coral,pdac,PROMPT2_entailment
146,23,15,15,0,1.0,12,10,2,0.8333333333333334,0.9090909090909092,GPT4,coral,pdac,PROMPT2_entailment
147,230,12,12,0,1.0,8,8,0,1.0,1.0,GPT4,coral,pdac,PROMPT2_entailment
148,24,20,20,0,1.0,9,9,0,1.0,1.0,GPT4,coral,pdac,PROMPT2_entailment
149,25,20,19,1,0.95,11,10,1,0.9090909090909092,0.9290953545232272,GPT4,coral,pdac,PROMPT2_entailment
150,26,15,14,1,0.9333333333333332,11,11,0,1.0,0.9655172413793104,GPT4,coral,pdac,PROMPT2_entailment
151,27,16,14,2,0.875,12,10,2,0.8333333333333334,0.8536585365853658,GPT4,coral,pdac,PROMPT2_entailment
152,28,29,26,3,0.896551724137931,13,13,0,1.0,0.9454545454545454,GPT4,coral,pdac,PROMPT2_entailment
153,29,31,31,0,1.0,9,9,0,1.0,1.0,GPT4,coral,pdac,PROMPT2_entailment
154,3,18,18,0,1.0,8,8,0,1.0,1.0,GPT4,coral,pdac,PROMPT2_entailment
155,30,29,27,2,0.9310344827586208,11,10,1,0.9090909090909092,0.919931856899489,GPT4,coral,pdac,PROMPT2_entailment
156,31,19,19,0,1.0,11,11,0,1.0,1.0,GPT4,coral,pdac,PROMPT2_entailment
157,32,30,24,6,0.8,11,7,4,0.6363636363636364,0.7088607594936709,GPT4,coral,pdac,PROMPT2_entailment
158,33,20,5,15,0.25,24,16,8,0.6666666666666666,0.3636363636363636,GPT4,coral,pdac,PROMPT2_entailment
159,34,10,10,0,1.0,10,10,0,1.0,1.0,GPT4,coral,pdac,PROMPT2_entailment
160,35,16,16,0,1.0,10,10,0,1.0,1.0,GPT4,coral,pdac,PROMPT2_entailment
161,36,38,37,1,0.9736842105263158,44,31,13,0.7045454545454546,0.8175338560228083,GPT4,coral,pdac,PROMPT2_entailment
162,37,23,21,2,0.9130434782608696,9,8,1,0.8888888888888888,0.900804289544236,GPT4,coral,pdac,PROMPT2_entailment
163,38,22,20,2,0.9090909090909092,13,10,3,0.7692307692307693,0.8333333333333333,GPT4,coral,pdac,PROMPT2_entailment
164,39,15,15,0,1.0,10,9,1,0.9,0.9473684210526316,GPT4,coral,pdac,PROMPT2_entailment
165,4,24,23,1,0.9583333333333334,15,13,2,0.8666666666666667,0.9101978691019786,GPT4,coral,pdac,PROMPT2_entailment
166,40,13,12,1,0.9230769230769232,10,6,4,0.6,0.7272727272727274,GPT4,coral,pdac,PROMPT2_entailment
167,41,21,21,0,1.0,8,8,0,1.0,1.0,GPT4,coral,pdac,PROMPT2_entailment
168,42,25,25,0,1.0,11,11,0,1.0,1.0,GPT4,coral,pdac,PROMPT2_entailment
169,43,26,25,1,0.9615384615384616,13,8,5,0.6153846153846154,0.7504690431519699,GPT4,coral,pdac,PROMPT2_entailment
170,44,14,13,1,0.9285714285714286,11,10,1,0.9090909090909092,0.9187279151943464,GPT4,coral,pdac,PROMPT2_entailment
171,45,21,21,0,1.0,10,9,1,0.9,0.9473684210526316,GPT4,coral,pdac,PROMPT2_entailment
172,46,25,21,4,0.84,11,11,0,1.0,0.9130434782608696,GPT4,coral,pdac,PROMPT2_entailment
173,47,43,36,7,0.8372093023255814,39,14,25,0.358974358974359,0.5024925224327019,GPT4,coral,pdac,PROMPT2_entailment
174,48,11,6,5,0.5454545454545454,10,8,2,0.8,0.6486486486486486,GPT4,coral,pdac,PROMPT2_entailment
175,49,15,15,0,1.0,10,9,1,0.9,0.9473684210526316,GPT4,coral,pdac,PROMPT2_entailment
176,5,17,17,0,1.0,10,9,1,0.9,0.9473684210526316,GPT4,coral,pdac,PROMPT2_entailment
177,50,14,13,1,0.9285714285714286,10,9,1,0.9,0.9140625,GPT4,coral,pdac,PROMPT2_entailment
178,51,17,16,1,0.9411764705882352,12,10,2,0.8333333333333334,0.8839779005524863,GPT4,coral,pdac,PROMPT2_entailment
179,52,16,12,4,0.75,10,10,0,1.0,0.8571428571428571,GPT4,coral,pdac,PROMPT2_entailment
180,53,14,14,0,1.0,8,8,0,1.0,1.0,GPT4,coral,pdac,PROMPT2_entailment
181,54,5,5,0,1.0,2,2,0,1.0,1.0,GPT4,coral,pdac,PROMPT2_entailment
182,55,22,22,0,1.0,10,8,2,0.8,0.888888888888889,GPT4,coral,pdac,PROMPT2_entailment
183,56,20,16,4,0.8,8,7,1,0.875,0.8358208955223881,GPT4,coral,pdac,PROMPT2_entailment
184,57,34,27,7,0.7941176470588235,13,10,3,0.7692307692307693,0.7814761215629523,GPT4,coral,pdac,PROMPT2_entailment
185,58,39,35,4,0.8974358974358975,10,10,0,1.0,0.945945945945946,GPT4,coral,pdac,PROMPT2_entailment
186,59,31,25,6,0.8064516129032258,21,17,4,0.8095238095238095,0.8079847908745248,GPT4,coral,pdac,PROMPT2_entailment
187,6,18,16,2,0.8888888888888888,12,10,2,0.8333333333333334,0.8602150537634408,GPT4,coral,pdac,PROMPT2_entailment
188,60,29,26,3,0.896551724137931,13,10,3,0.7692307692307693,0.8280254777070064,GPT4,coral,pdac,PROMPT2_entailment
189,61,11,11,0,1.0,7,7,0,1.0,1.0,GPT4,coral,pdac,PROMPT2_entailment
190,62,22,15,7,0.6818181818181818,11,9,2,0.8181818181818182,0.7438016528925621,GPT4,coral,pdac,PROMPT2_entailment
191,63,12,12,0,1.0,10,10,0,1.0,1.0,GPT4,coral,pdac,PROMPT2_entailment
192,64,15,13,2,0.8666666666666667,12,12,0,1.0,0.9285714285714286,GPT4,coral,pdac,PROMPT2_entailment
193,65,27,25,2,0.925925925925926,9,9,0,1.0,0.9615384615384616,GPT4,coral,pdac,PROMPT2_entailment
194,66,16,16,0,1.0,12,12,0,1.0,1.0,GPT4,coral,pdac,PROMPT2_entailment
195,67,8,8,0,1.0,1,1,0,1.0,1.0,GPT4,coral,pdac,PROMPT2_entailment
196,68,16,13,3,0.8125,11,10,1,0.9090909090909092,0.858085808580858,GPT4,coral,pdac,PROMPT2_entailment
197,69,17,17,0,1.0,10,10,0,1.0,1.0,GPT4,coral,pdac,PROMPT2_entailment
198,7,15,14,1,0.9333333333333332,11,10,1,0.9090909090909092,0.9210526315789476,GPT4,coral,pdac,PROMPT2_entailment
199,70,24,23,1,0.9583333333333334,15,14,1,0.9333333333333332,0.945668135095448,GPT4,coral,pdac,PROMPT2_entailment
200,71,25,20,5,0.8,9,9,0,1.0,0.888888888888889,GPT4,coral,pdac,PROMPT2_entailment
201,72,38,29,9,0.7631578947368421,13,12,1,0.9230769230769232,0.8355342136854742,GPT4,coral,pdac,PROMPT2_entailment
202,73,70,23,47,0.3285714285714285,154,44,110,0.2857142857142857,0.3056478405315614,GPT4,coral,pdac,PROMPT2_entailment
203,74,26,19,7,0.7307692307692307,8,7,1,0.875,0.7964071856287425,GPT4,coral,pdac,PROMPT2_entailment
204,75,19,14,5,0.7368421052631579,7,7,0,1.0,0.8484848484848484,GPT4,coral,pdac,PROMPT2_entailment
205,76,11,11,0,1.0,7,7,0,1.0,1.0,GPT4,coral,pdac,PROMPT2_entailment
206,77,19,17,2,0.8947368421052632,8,8,0,1.0,0.9444444444444444,GPT4,coral,pdac,PROMPT2_entailment
207,78,10,8,2,0.8,8,8,0,1.0,0.888888888888889,GPT4,coral,pdac,PROMPT2_entailment
208,79,20,17,3,0.85,11,11,0,1.0,0.9189189189189187,GPT4,coral,pdac,PROMPT2_entailment
209,8,11,11,0,1.0,2,2,0,1.0,1.0,GPT4,coral,pdac,PROMPT2_entailment
210,80,22,20,2,0.9090909090909092,9,8,1,0.8888888888888888,0.8988764044943819,GPT4,coral,pdac,PROMPT2_entailment
211,81,18,18,0,1.0,6,5,1,0.8333333333333334,0.9090909090909092,GPT4,coral,pdac,PROMPT2_entailment
212,82,25,25,0,1.0,4,4,0,1.0,1.0,GPT4,coral,pdac,PROMPT2_entailment
213,83,28,21,7,0.75,11,7,4,0.6363636363636364,0.6885245901639345,GPT4,coral,pdac,PROMPT2_entailment
214,84,24,19,5,0.7916666666666666,11,8,3,0.7272727272727273,0.7581047381546134,GPT4,coral,pdac,PROMPT2_entailment
215,85,35,26,9,0.7428571428571429,35,26,9,0.7428571428571429,0.7428571428571429,GPT4,coral,pdac,PROMPT2_entailment
216,86,11,10,1,0.9090909090909092,10,8,2,0.8,0.8510638297872342,GPT4,coral,pdac,PROMPT2_entailment
217,87,20,14,6,0.7,7,6,1,0.8571428571428571,0.7706422018348624,GPT4,coral,pdac,PROMPT2_entailment
218,88,17,15,2,0.8823529411764706,8,7,1,0.875,0.8786610878661087,GPT4,coral,pdac,PROMPT2_entailment
219,89,19,18,1,0.9473684210526316,10,8,2,0.8,0.8674698795180723,GPT4,coral,pdac,PROMPT2_entailment
220,9,12,12,0,1.0,12,9,3,0.75,0.8571428571428571,GPT4,coral,pdac,PROMPT2_entailment
221,90,23,19,4,0.8260869565217391,9,9,0,1.0,0.9047619047619048,GPT4,coral,pdac,PROMPT2_entailment
222,91,18,17,1,0.9444444444444444,10,9,1,0.9,0.9216867469879516,GPT4,coral,pdac,PROMPT2_entailment
223,92,26,20,6,0.7692307692307693,10,8,2,0.8,0.7843137254901961,GPT4,coral,pdac,PROMPT2_entailment
224,93,16,13,3,0.8125,9,7,2,0.7777777777777778,0.7947598253275109,GPT4,coral,pdac,PROMPT2_entailment
225,94,19,16,3,0.8421052631578947,7,7,0,1.0,0.9142857142857144,GPT4,coral,pdac,PROMPT2_entailment
226,95,20,16,4,0.8,8,7,1,0.875,0.8358208955223881,GPT4,coral,pdac,PROMPT2_entailment
227,96,11,11,0,1.0,4,4,0,1.0,1.0,GPT4,coral,pdac,PROMPT2_entailment
228,97,19,16,3,0.8421052631578947,8,8,0,1.0,0.9142857142857144,GPT4,coral,pdac,PROMPT2_entailment
229,98,20,19,1,0.95,9,9,0,1.0,0.9743589743589745,GPT4,coral,pdac,PROMPT2_entailment
230,99,18,15,3,0.8333333333333334,9,8,1,0.8888888888888888,0.8602150537634408,GPT4,coral,pdac,PROMPT2_entailment
0,0,10,10,0,1.0,10,10,0,1.0,1.0,GPT4,coral,breastca,PROMPT1_entailment
1,1,17,16,1,0.9411764705882352,12,11,1,0.9166666666666666,0.9287598944591028,GPT4,coral,breastca,PROMPT1_entailment
2,10,11,10,1,0.9090909090909092,10,9,1,0.9,0.9045226130653266,GPT4,coral,breastca,PROMPT1_entailment
3,100,17,13,4,0.7647058823529411,26,16,10,0.6153846153846154,0.6819672131147541,GPT4,coral,breastca,PROMPT1_entailment
4,101,28,27,1,0.9642857142857144,18,15,3,0.8333333333333334,0.8940397350993378,GPT4,coral,breastca,PROMPT1_entailment
5,102,11,11,0,1.0,7,6,1,0.8571428571428571,0.923076923076923,GPT4,coral,breastca,PROMPT1_entailment
6,103,15,14,1,0.9333333333333332,10,8,2,0.8,0.8615384615384616,GPT4,coral,breastca,PROMPT1_entailment
7,104,41,31,10,0.7560975609756098,26,19,7,0.7307692307692307,0.7432176656151419,GPT4,coral,breastca,PROMPT1_entailment
8,105,16,16,0,1.0,15,15,0,1.0,1.0,GPT4,coral,breastca,PROMPT1_entailment
9,106,13,11,2,0.8461538461538461,9,8,1,0.8888888888888888,0.8669950738916256,GPT4,coral,breastca,PROMPT1_entailment
10,107,10,10,0,1.0,9,7,2,0.7777777777777778,0.8750000000000001,GPT4,coral,breastca,PROMPT1_entailment
11,108,12,12,0,1.0,11,10,1,0.9090909090909092,0.9523809523809524,GPT4,coral,breastca,PROMPT1_entailment
12,109,12,10,2,0.8333333333333334,11,10,1,0.9090909090909092,0.8695652173913043,GPT4,coral,breastca,PROMPT1_entailment
13,11,10,9,1,0.9,3,3,0,1.0,0.9473684210526316,GPT4,coral,breastca,PROMPT1_entailment
14,110,13,13,0,1.0,11,7,4,0.6363636363636364,0.7777777777777778,GPT4,coral,breastca,PROMPT1_entailment
15,111,17,13,4,0.7647058823529411,10,8,2,0.8,0.7819548872180452,GPT4,coral,breastca,PROMPT1_entailment
16,112,15,15,0,1.0,10,9,1,0.9,0.9473684210526316,GPT4,coral,breastca,PROMPT1_entailment
17,113,27,24,3,0.8888888888888888,49,25,24,0.5102040816326531,0.6482982171799028,GPT4,coral,breastca,PROMPT1_entailment
18,114,35,25,10,0.7142857142857143,21,11,10,0.5238095238095238,0.6043956043956045,GPT4,coral,breastca,PROMPT1_entailment
19,115,12,11,1,0.9166666666666666,9,8,1,0.8888888888888888,0.9025641025641026,GPT4,coral,breastca,PROMPT1_entailment
20,116,17,16,1,0.9411764705882352,14,10,4,0.7142857142857143,0.8121827411167514,GPT4,coral,breastca,PROMPT1_entailment
21,117,8,7,1,0.875,2,1,1,0.5,0.6363636363636364,GPT4,coral,breastca,PROMPT1_entailment
22,118,16,16,0,1.0,19,6,13,0.3157894736842105,0.4799999999999999,GPT4,coral,breastca,PROMPT1_entailment
23,119,11,10,1,0.9090909090909092,10,9,1,0.9,0.9045226130653266,GPT4,coral,breastca,PROMPT1_entailment
24,12,9,9,0,1.0,10,7,3,0.7,0.8235294117647058,GPT4,coral,breastca,PROMPT1_entailment
25,120,12,11,1,0.9166666666666666,9,6,3,0.6666666666666666,0.7719298245614035,GPT4,coral,breastca,PROMPT1_entailment
26,121,17,15,2,0.8823529411764706,10,10,0,1.0,0.9375,GPT4,coral,breastca,PROMPT1_entailment
27,122,14,14,0,1.0,9,9,0,1.0,1.0,GPT4,coral,breastca,PROMPT1_entailment
28,123,12,11,1,0.9166666666666666,8,7,1,0.875,0.8953488372093024,GPT4,coral,breastca,PROMPT1_entailment
29,124,16,16,0,1.0,10,10,0,1.0,1.0,GPT4,coral,breastca,PROMPT1_entailment
30,125,11,11,0,1.0,11,8,3,0.7272727272727273,0.8421052631578948,GPT4,coral,breastca,PROMPT1_entailment
31,126,11,10,1,0.9090909090909092,10,10,0,1.0,0.9523809523809524,GPT4,coral,breastca,PROMPT1_entailment
32,127,17,17,0,1.0,10,8,2,0.8,0.888888888888889,GPT4,coral,breastca,PROMPT1_entailment
33,128,19,19,0,1.0,11,10,1,0.9090909090909092,0.9523809523809524,GPT4,coral,breastca,PROMPT1_entailment
34,129,20,19,1,0.95,11,9,2,0.8181818181818182,0.879177377892031,GPT4,coral,breastca,PROMPT1_entailment
35,13,16,15,1,0.9375,10,9,1,0.9,0.9183673469387756,GPT4,coral,breastca,PROMPT1_entailment
36,130,13,11,2,0.8461538461538461,7,5,2,0.7142857142857143,0.7746478873239436,GPT4,coral,breastca,PROMPT1_entailment
37,131,17,16,1,0.9411764705882352,10,9,1,0.9,0.9201277955271564,GPT4,coral,breastca,PROMPT1_entailment
38,132,13,13,0,1.0,8,8,0,1.0,1.0,GPT4,coral,breastca,PROMPT1_entailment
39,133,31,21,10,0.6774193548387096,29,23,6,0.7931034482758621,0.73071104387292,GPT4,coral,breastca,PROMPT1_entailment
40,134,12,6,6,0.5,11,9,2,0.8181818181818182,0.6206896551724137,GPT4,coral,breastca,PROMPT1_entailment
41,135,15,9,6,0.6,16,14,2,0.875,0.711864406779661,GPT4,coral,breastca,PROMPT1_entailment
42,136,18,15,3,0.8333333333333334,10,8,2,0.8,0.816326530612245,GPT4,coral,breastca,PROMPT1_entailment
43,137,15,14,1,0.9333333333333332,10,10,0,1.0,0.9655172413793104,GPT4,coral,breastca,PROMPT1_entailment
44,138,12,12,0,1.0,10,10,0,1.0,1.0,GPT4,coral,breastca,PROMPT1_entailment
45,139,13,11,2,0.8461538461538461,11,10,1,0.9090909090909092,0.8764940239043824,GPT4,coral,breastca,PROMPT1_entailment
46,14,28,24,4,0.8571428571428571,59,14,45,0.2372881355932203,0.3716814159292035,GPT4,coral,breastca,PROMPT1_entailment
47,140,11,9,2,0.8181818181818182,9,9,0,1.0,0.9,GPT4,coral,breastca,PROMPT1_entailment
48,141,13,9,4,0.6923076923076923,11,11,0,1.0,0.8181818181818181,GPT4,coral,breastca,PROMPT1_entailment
49,142,12,12,0,1.0,10,10,0,1.0,1.0,GPT4,coral,breastca,PROMPT1_entailment
50,143,13,10,3,0.7692307692307693,10,7,3,0.7,0.7329842931937172,GPT4,coral,breastca,PROMPT1_entailment
51,144,13,13,0,1.0,5,4,1,0.8,0.888888888888889,GPT4,coral,breastca,PROMPT1_entailment
52,145,12,12,0,1.0,5,5,0,1.0,1.0,GPT4,coral,breastca,PROMPT1_entailment
53,146,12,11,1,0.9166666666666666,9,7,2,0.7777777777777778,0.8415300546448087,GPT4,coral,breastca,PROMPT1_entailment
54,147,21,19,2,0.9047619047619048,5,5,0,1.0,0.95,GPT4,coral,breastca,PROMPT1_entailment
55,148,15,13,2,0.8666666666666667,4,2,2,0.5,0.6341463414634146,GPT4,coral,breastca,PROMPT1_entailment
56,149,10,10,0,1.0,1,1,0,1.0,1.0,GPT4,coral,breastca,PROMPT1_entailment
57,15,30,23,7,0.7666666666666667,16,9,7,0.5625,0.6489028213166145,GPT4,coral,breastca,PROMPT1_entailment
58,150,12,9,3,0.75,2,2,0,1.0,0.8571428571428571,GPT4,coral,breastca,PROMPT1_entailment
59,151,13,12,1,0.9230769230769232,9,8,1,0.8888888888888888,0.9056603773584906,GPT4,coral,breastca,PROMPT1_entailment
60,152,15,12,3,0.8,16,13,3,0.8125,0.8062015503875969,GPT4,coral,breastca,PROMPT1_entailment
61,153,10,9,1,0.9,1,1,0,1.0,0.9473684210526316,GPT4,coral,breastca,PROMPT1_entailment
62,154,13,12,1,0.9230769230769232,10,10,0,1.0,0.96,GPT4,coral,breastca,PROMPT1_entailment
63,155,20,19,1,0.95,9,9,0,1.0,0.9743589743589745,GPT4,coral,breastca,PROMPT1_entailment
64,156,16,15,1,0.9375,8,7,1,0.875,0.9051724137931034,GPT4,coral,breastca,PROMPT1_entailment
65,157,13,13,0,1.0,9,9,0,1.0,1.0,GPT4,coral,breastca,PROMPT1_entailment
66,158,14,11,3,0.7857142857142857,16,12,4,0.75,0.7674418604651163,GPT4,coral,breastca,PROMPT1_entailment
67,159,28,21,7,0.75,29,16,13,0.5517241379310345,0.6357615894039735,GPT4,coral,breastca,PROMPT1_entailment
68,16,18,16,2,0.8888888888888888,10,10,0,1.0,0.9411764705882352,GPT4,coral,breastca,PROMPT1_entailment
69,160,31,25,6,0.8064516129032258,18,8,10,0.4444444444444444,0.5730659025787965,GPT4,coral,breastca,PROMPT1_entailment
70,161,21,21,0,1.0,11,10,1,0.9090909090909092,0.9523809523809524,GPT4,coral,breastca,PROMPT1_entailment
71,162,16,13,3,0.8125,16,15,1,0.9375,0.8705357142857143,GPT4,coral,breastca,PROMPT1_entailment
72,163,12,12,0,1.0,11,10,1,0.9090909090909092,0.9523809523809524,GPT4,coral,breastca,PROMPT1_entailment
73,164,12,12,0,1.0,8,6,2,0.75,0.8571428571428571,GPT4,coral,breastca,PROMPT1_entailment
74,165,18,17,1,0.9444444444444444,12,9,3,0.75,0.8360655737704917,GPT4,coral,breastca,PROMPT1_entailment
75,166,13,12,1,0.9230769230769232,10,7,3,0.7,0.7962085308056872,GPT4,coral,breastca,PROMPT1_entailment
76,167,14,13,1,0.9285714285714286,7,7,0,1.0,0.962962962962963,GPT4,coral,breastca,PROMPT1_entailment
77,168,9,7,2,0.7777777777777778,7,5,2,0.7142857142857143,0.7446808510638298,GPT4,coral,breastca,PROMPT1_entailment
78,169,12,12,0,1.0,11,10,1,0.9090909090909092,0.9523809523809524,GPT4,coral,breastca,PROMPT1_entailment
79,17,5,5,0,1.0,3,3,0,1.0,1.0,GPT4,coral,breastca,PROMPT1_entailment
80,170,11,11,0,1.0,10,10,0,1.0,1.0,GPT4,coral,breastca,PROMPT1_entailment
81,171,18,18,0,1.0,9,9,0,1.0,1.0,GPT4,coral,breastca,PROMPT1_entailment
82,172,22,20,2,0.9090909090909092,32,18,14,0.5625,0.6949806949806949,GPT4,coral,breastca,PROMPT1_entailment
83,173,11,10,1,0.9090909090909092,11,9,2,0.8181818181818182,0.861244019138756,GPT4,coral,breastca,PROMPT1_entailment
84,174,8,5,3,0.625,7,6,1,0.8571428571428571,0.7228915662650602,GPT4,coral,breastca,PROMPT1_entailment
85,175,8,8,0,1.0,10,10,0,1.0,1.0,GPT4,coral,breastca,PROMPT1_entailment
86,176,13,13,0,1.0,10,10,0,1.0,1.0,GPT4,coral,breastca,PROMPT1_entailment
87,177,14,14,0,1.0,9,8,1,0.8888888888888888,0.9411764705882352,GPT4,coral,breastca,PROMPT1_entailment
88,178,19,16,3,0.8421052631578947,10,10,0,1.0,0.9142857142857144,GPT4,coral,breastca,PROMPT1_entailment
89,179,12,12,0,1.0,9,8,1,0.8888888888888888,0.9411764705882352,GPT4,coral,breastca,PROMPT1_entailment
90,18,9,9,0,1.0,8,7,1,0.875,0.9333333333333332,GPT4,coral,breastca,PROMPT1_entailment
91,180,14,10,4,0.7142857142857143,10,9,1,0.9,0.7964601769911505,GPT4,coral,breastca,PROMPT1_entailment
92,181,11,7,4,0.6363636363636364,9,8,1,0.8888888888888888,0.7417218543046358,GPT4,coral,breastca,PROMPT1_entailment
93,182,12,12,0,1.0,9,7,2,0.7777777777777778,0.8750000000000001,GPT4,coral,breastca,PROMPT1_entailment
94,183,14,14,0,1.0,10,8,2,0.8,0.888888888888889,GPT4,coral,breastca,PROMPT1_entailment
95,184,13,13,0,1.0,9,8,1,0.8888888888888888,0.9411764705882352,GPT4,coral,breastca,PROMPT1_entailment
96,185,12,12,0,1.0,10,6,4,0.6,0.7499999999999999,GPT4,coral,breastca,PROMPT1_entailment
97,186,11,11,0,1.0,5,5,0,1.0,1.0,GPT4,coral,breastca,PROMPT1_entailment
98,187,30,29,1,0.9666666666666668,26,20,6,0.7692307692307693,0.8567208271787297,GPT4,coral,breastca,PROMPT1_entailment
99,188,13,13,0,1.0,9,9,0,1.0,1.0,GPT4,coral,breastca,PROMPT1_entailment
100,189,13,13,0,1.0,9,9,0,1.0,1.0,GPT4,coral,breastca,PROMPT1_entailment
101,19,12,12,0,1.0,8,8,0,1.0,1.0,GPT4,coral,breastca,PROMPT1_entailment
102,190,41,16,25,0.3902439024390244,34,16,18,0.4705882352941176,0.4266666666666667,GPT4,coral,breastca,PROMPT1_entailment
103,191,24,20,4,0.8333333333333334,14,8,6,0.5714285714285714,0.6779661016949152,GPT4,coral,breastca,PROMPT1_entailment
104,192,16,15,1,0.9375,12,11,1,0.9166666666666666,0.9269662921348316,GPT4,coral,breastca,PROMPT1_entailment
105,193,9,9,0,1.0,2,2,0,1.0,1.0,GPT4,coral,breastca,PROMPT1_entailment
106,194,15,14,1,0.9333333333333332,15,10,5,0.6666666666666666,0.7777777777777778,GPT4,coral,breastca,PROMPT1_entailment
107,195,15,14,1,0.9333333333333332,13,13,0,1.0,0.9655172413793104,GPT4,coral,breastca,PROMPT1_entailment
108,196,38,33,5,0.868421052631579,30,22,8,0.7333333333333333,0.7951807228915663,GPT4,coral,breastca,PROMPT1_entailment
109,197,25,23,2,0.92,14,10,4,0.7142857142857143,0.8041958041958042,GPT4,coral,breastca,PROMPT1_entailment
110,198,14,13,1,0.9285714285714286,11,11,0,1.0,0.962962962962963,GPT4,coral,breastca,PROMPT1_entailment
111,199,5,5,0,1.0,2,2,0,1.0,1.0,GPT4,coral,breastca,PROMPT1_entailment
112,2,13,12,1,0.9230769230769232,10,8,2,0.8,0.8571428571428571,GPT4,coral,breastca,PROMPT1_entailment
113,20,18,17,1,0.9444444444444444,17,8,9,0.4705882352941176,0.628175519630485,GPT4,coral,breastca,PROMPT1_entailment
114,200,21,20,1,0.9523809523809524,15,14,1,0.9333333333333332,0.9427609427609428,GPT4,coral,breastca,PROMPT1_entailment
115,201,23,16,7,0.6956521739130435,26,21,5,0.8076923076923077,0.7474972191323692,GPT4,coral,breastca,PROMPT1_entailment
116,202,23,19,4,0.8260869565217391,17,14,3,0.8235294117647058,0.8248062015503876,GPT4,coral,breastca,PROMPT1_entailment
117,203,29,25,4,0.8620689655172413,27,12,15,0.4444444444444444,0.5865102639296187,GPT4,coral,breastca,PROMPT1_entailment
118,204,14,13,1,0.9285714285714286,11,11,0,1.0,0.962962962962963,GPT4,coral,breastca,PROMPT1_entailment
119,205,12,12,0,1.0,11,11,0,1.0,1.0,GPT4,coral,breastca,PROMPT1_entailment
120,206,10,10,0,1.0,4,4,0,1.0,1.0,GPT4,coral,breastca,PROMPT1_entailment
121,207,12,10,2,0.8333333333333334,12,10,2,0.8333333333333334,0.8333333333333334,GPT4,coral,breastca,PROMPT1_entailment
122,208,13,13,0,1.0,9,9,0,1.0,1.0,GPT4,coral,breastca,PROMPT1_entailment
123,209,11,8,3,0.7272727272727273,11,6,5,0.5454545454545454,0.6233766233766234,GPT4,coral,breastca,PROMPT1_entailment
124,21,19,12,7,0.631578947368421,27,22,5,0.8148148148148148,0.711590296495957,GPT4,coral,breastca,PROMPT1_entailment
125,210,18,17,1,0.9444444444444444,13,10,3,0.7692307692307693,0.8478802992518703,GPT4,coral,breastca,PROMPT1_entailment
126,211,21,19,2,0.9047619047619048,11,10,1,0.9090909090909092,0.9069212410501194,GPT4,coral,breastca,PROMPT1_entailment
127,212,11,11,0,1.0,9,8,1,0.8888888888888888,0.9411764705882352,GPT4,coral,breastca,PROMPT1_entailment
128,213,10,10,0,1.0,11,9,2,0.8181818181818182,0.9,GPT4,coral,breastca,PROMPT1_entailment
129,214,16,9,7,0.5625,28,18,10,0.6428571428571429,0.6000000000000001,GPT4,coral,breastca,PROMPT1_entailment
130,215,19,12,7,0.631578947368421,37,24,13,0.6486486486486487,0.64,GPT4,coral,breastca,PROMPT1_entailment
131,216,21,17,4,0.8095238095238095,15,13,2,0.8666666666666667,0.8371212121212122,GPT4,coral,breastca,PROMPT1_entailment
132,22,11,7,4,0.6363636363636364,7,3,4,0.4285714285714285,0.5121951219512195,GPT4,coral,breastca,PROMPT1_entailment
133,23,12,10,2,0.8333333333333334,9,9,0,1.0,0.9090909090909092,GPT4,coral,breastca,PROMPT1_entailment
134,24,11,11,0,1.0,10,9,1,0.9,0.9473684210526316,GPT4,coral,breastca,PROMPT1_entailment
135,25,19,17,2,0.8947368421052632,8,8,0,1.0,0.9444444444444444,GPT4,coral,breastca,PROMPT1_entailment
136,26,19,18,1,0.9473684210526316,11,10,1,0.9090909090909092,0.9278350515463918,GPT4,coral,breastca,PROMPT1_entailment
137,27,8,8,0,1.0,12,11,1,0.9166666666666666,0.9565217391304348,GPT4,coral,breastca,PROMPT1_entailment
138,28,18,17,1,0.9444444444444444,18,16,2,0.8888888888888888,0.9158249158249158,GPT4,coral,breastca,PROMPT1_entailment
139,29,22,16,6,0.7272727272727273,9,4,5,0.4444444444444444,0.5517241379310345,GPT4,coral,breastca,PROMPT1_entailment
140,3,14,7,7,0.5,11,7,4,0.6363636363636364,0.56,GPT4,coral,breastca,PROMPT1_entailment
141,30,40,18,22,0.45,18,16,2,0.8888888888888888,0.5975103734439834,GPT4,coral,breastca,PROMPT1_entailment
142,31,13,10,3,0.7692307692307693,13,9,4,0.6923076923076923,0.728744939271255,GPT4,coral,breastca,PROMPT1_entailment
143,32,12,10,2,0.8333333333333334,9,9,0,1.0,0.9090909090909092,GPT4,coral,breastca,PROMPT1_entailment
144,33,10,8,2,0.8,8,7,1,0.875,0.8358208955223881,GPT4,coral,breastca,PROMPT1_entailment
145,34,9,8,1,0.8888888888888888,10,7,3,0.7,0.7832167832167831,GPT4,coral,breastca,PROMPT1_entailment
146,35,22,15,7,0.6818181818181818,12,11,1,0.9166666666666666,0.7819905213270141,GPT4,coral,breastca,PROMPT1_entailment
147,36,14,14,0,1.0,11,10,1,0.9090909090909092,0.9523809523809524,GPT4,coral,breastca,PROMPT1_entailment
148,37,15,11,4,0.7333333333333333,11,10,1,0.9090909090909092,0.8118081180811808,GPT4,coral,breastca,PROMPT1_entailment
149,38,13,12,1,0.9230769230769232,11,10,1,0.9090909090909092,0.9160305343511452,GPT4,coral,breastca,PROMPT1_entailment
150,39,14,14,0,1.0,11,11,0,1.0,1.0,GPT4,coral,breastca,PROMPT1_entailment
151,4,35,24,11,0.6857142857142857,59,28,31,0.4745762711864407,0.5609348914858097,GPT4,coral,breastca,PROMPT1_entailment
152,40,13,10,3,0.7692307692307693,9,7,2,0.7777777777777778,0.7734806629834255,GPT4,coral,breastca,PROMPT1_entailment
153,41,27,19,8,0.7037037037037037,14,10,4,0.7142857142857143,0.708955223880597,GPT4,coral,breastca,PROMPT1_entailment
154,42,18,16,2,0.8888888888888888,9,5,4,0.5555555555555556,0.6837606837606838,GPT4,coral,breastca,PROMPT1_entailment
155,43,15,14,1,0.9333333333333332,9,7,2,0.7777777777777778,0.8484848484848485,GPT4,coral,breastca,PROMPT1_entailment
156,44,13,12,1,0.9230769230769232,9,9,0,1.0,0.96,GPT4,coral,breastca,PROMPT1_entailment
157,45,6,6,0,1.0,2,2,0,1.0,1.0,GPT4,coral,breastca,PROMPT1_entailment
158,46,13,12,1,0.9230769230769232,5,5,0,1.0,0.96,GPT4,coral,breastca,PROMPT1_entailment
159,47,14,13,1,0.9285714285714286,2,2,0,1.0,0.962962962962963,GPT4,coral,breastca,PROMPT1_entailment
160,48,11,11,0,1.0,5,4,1,0.8,0.888888888888889,GPT4,coral,breastca,PROMPT1_entailment
161,49,24,14,10,0.5833333333333334,16,13,3,0.8125,0.6791044776119403,GPT4,coral,breastca,PROMPT1_entailment
162,5,39,36,3,0.9230769230769232,12,10,2,0.8333333333333334,0.8759124087591241,GPT4,coral,breastca,PROMPT1_entailment
163,50,22,18,4,0.8181818181818182,16,15,1,0.9375,0.8737864077669902,GPT4,coral,breastca,PROMPT1_entailment
164,51,39,34,5,0.8717948717948718,11,10,1,0.9090909090909092,0.8900523560209423,GPT4,coral,breastca,PROMPT1_entailment
165,52,16,13,3,0.8125,10,10,0,1.0,0.896551724137931,GPT4,coral,breastca,PROMPT1_entailment
166,53,18,17,1,0.9444444444444444,10,9,1,0.9,0.9216867469879516,GPT4,coral,breastca,PROMPT1_entailment
167,54,14,13,1,0.9285714285714286,9,9,0,1.0,0.962962962962963,GPT4,coral,breastca,PROMPT1_entailment
168,55,3,3,0,1.0,1,1,0,1.0,1.0,GPT4,coral,breastca,PROMPT1_entailment
169,56,10,10,0,1.0,18,8,10,0.4444444444444444,0.6153846153846153,GPT4,coral,breastca,PROMPT1_entailment
170,57,14,13,1,0.9285714285714286,10,10,0,1.0,0.962962962962963,GPT4,coral,breastca,PROMPT1_entailment
171,58,12,12,0,1.0,10,9,1,0.9,0.9473684210526316,GPT4,coral,breastca,PROMPT1_entailment
172,59,13,13,0,1.0,9,7,2,0.7777777777777778,0.8750000000000001,GPT4,coral,breastca,PROMPT1_entailment
173,6,11,11,0,1.0,8,8,0,1.0,1.0,GPT4,coral,breastca,PROMPT1_entailment
174,60,17,17,0,1.0,10,8,2,0.8,0.888888888888889,GPT4,coral,breastca,PROMPT1_entailment
175,61,16,15,1,0.9375,11,10,1,0.9090909090909092,0.923076923076923,GPT4,coral,breastca,PROMPT1_entailment
176,62,16,16,0,1.0,10,9,1,0.9,0.9473684210526316,GPT4,coral,breastca,PROMPT1_entailment
177,63,13,11,2,0.8461538461538461,11,11,0,1.0,0.9166666666666666,GPT4,coral,breastca,PROMPT1_entailment
178,64,11,8,3,0.7272727272727273,18,5,13,0.2777777777777778,0.4020100502512562,GPT4,coral,breastca,PROMPT1_entailment
179,65,14,14,0,1.0,6,6,0,1.0,1.0,GPT4,coral,breastca,PROMPT1_entailment
180,66,15,13,2,0.8666666666666667,10,10,0,1.0,0.9285714285714286,GPT4,coral,breastca,PROMPT1_entailment
181,67,46,27,19,0.5869565217391305,49,23,26,0.4693877551020408,0.5216295674086519,GPT4,coral,breastca,PROMPT1_entailment
182,68,13,13,0,1.0,8,8,0,1.0,1.0,GPT4,coral,breastca,PROMPT1_entailment
183,69,49,22,27,0.4489795918367347,12,5,7,0.4166666666666667,0.4322200392927308,GPT4,coral,breastca,PROMPT1_entailment
184,7,12,11,1,0.9166666666666666,11,8,3,0.7272727272727273,0.8110599078341013,GPT4,coral,breastca,PROMPT1_entailment
185,70,26,20,6,0.7692307692307693,51,23,28,0.4509803921568627,0.5686032138442522,GPT4,coral,breastca,PROMPT1_entailment
186,71,8,7,1,0.875,5,5,0,1.0,0.9333333333333332,GPT4,coral,breastca,PROMPT1_entailment
187,72,13,13,0,1.0,3,3,0,1.0,1.0,GPT4,coral,breastca,PROMPT1_entailment
188,73,10,10,0,1.0,1,1,0,1.0,1.0,GPT4,coral,breastca,PROMPT1_entailment
189,74,10,8,2,0.8,2,2,0,1.0,0.888888888888889,GPT4,coral,breastca,PROMPT1_entailment
190,75,11,9,2,0.8181818181818182,6,6,0,1.0,0.9,GPT4,coral,breastca,PROMPT1_entailment
191,76,15,15,0,1.0,7,6,1,0.8571428571428571,0.923076923076923,GPT4,coral,breastca,PROMPT1_entailment
192,77,13,11,2,0.8461538461538461,15,10,5,0.6666666666666666,0.7457627118644068,GPT4,coral,breastca,PROMPT1_entailment
193,78,17,17,0,1.0,8,8,0,1.0,1.0,GPT4,coral,breastca,PROMPT1_entailment
194,79,11,10,1,0.9090909090909092,8,7,1,0.875,0.8917197452229298,GPT4,coral,breastca,PROMPT1_entailment
195,8,9,7,2,0.7777777777777778,9,6,3,0.6666666666666666,0.717948717948718,GPT4,coral,breastca,PROMPT1_entailment
196,80,17,17,0,1.0,24,20,4,0.8333333333333334,0.9090909090909092,GPT4,coral,breastca,PROMPT1_entailment
197,81,10,9,1,0.9,11,10,1,0.9090909090909092,0.9045226130653266,GPT4,coral,breastca,PROMPT1_entailment
198,82,12,8,4,0.6666666666666666,6,5,1,0.8333333333333334,0.7407407407407408,GPT4,coral,breastca,PROMPT1_entailment
199,83,13,13,0,1.0,6,6,0,1.0,1.0,GPT4,coral,breastca,PROMPT1_entailment
200,84,17,13,4,0.7647058823529411,11,9,2,0.8181818181818182,0.7905405405405405,GPT4,coral,breastca,PROMPT1_entailment
201,85,13,12,1,0.9230769230769232,7,6,1,0.8571428571428571,0.888888888888889,GPT4,coral,breastca,PROMPT1_entailment
202,86,21,19,2,0.9047619047619048,16,15,1,0.9375,0.9208400646203556,GPT4,coral,breastca,PROMPT1_entailment
203,87,11,10,1,0.9090909090909092,8,8,0,1.0,0.9523809523809524,GPT4,coral,breastca,PROMPT1_entailment
204,88,8,8,0,1.0,8,8,0,1.0,1.0,GPT4,coral,breastca,PROMPT1_entailment
205,89,12,12,0,1.0,11,11,0,1.0,1.0,GPT4,coral,breastca,PROMPT1_entailment
206,9,10,9,1,0.9,6,5,1,0.8333333333333334,0.8653846153846153,GPT4,coral,breastca,PROMPT1_entailment
207,90,36,19,17,0.5277777777777778,18,15,3,0.8333333333333334,0.6462585034013605,GPT4,coral,breastca,PROMPT1_entailment
208,91,12,11,1,0.9166666666666666,7,6,1,0.8571428571428571,0.8859060402684563,GPT4,coral,breastca,PROMPT1_entailment
209,92,8,8,0,1.0,2,1,1,0.5,0.6666666666666666,GPT4,coral,breastca,PROMPT1_entailment
210,93,20,19,1,0.95,13,12,1,0.9230769230769232,0.9363449691991786,GPT4,coral,breastca,PROMPT1_entailment
211,94,25,15,10,0.6,25,20,5,0.8,0.6857142857142857,GPT4,coral,breastca,PROMPT1_entailment
212,95,23,21,2,0.9130434782608696,13,9,4,0.6923076923076923,0.7875,GPT4,coral,breastca,PROMPT1_entailment
213,96,16,14,2,0.875,10,10,0,1.0,0.9333333333333332,GPT4,coral,breastca,PROMPT1_entailment
214,97,11,9,2,0.8181818181818182,11,8,3,0.7272727272727273,0.770053475935829,GPT4,coral,breastca,PROMPT1_entailment
215,98,6,6,0,1.0,2,2,0,1.0,1.0,GPT4,coral,breastca,PROMPT1_entailment
216,99,16,14,2,0.875,15,11,4,0.7333333333333333,0.7979274611398963,GPT4,coral,breastca,PROMPT1_entailment
0,0,21,21,0,1.0,10,10,0,1.0,1.0,GPT4,coral,breastca,PROMPT1_ICL_entailment
1,1,55,48,7,0.8727272727272727,12,10,2,0.8333333333333334,0.852575488454707,GPT4,coral,breastca,PROMPT1_ICL_entailment
2,10,29,26,3,0.896551724137931,10,10,0,1.0,0.9454545454545454,GPT4,coral,breastca,PROMPT1_ICL_entailment
3,100,37,31,6,0.8378378378378378,26,10,16,0.3846153846153846,0.5272108843537415,GPT4,coral,breastca,PROMPT1_ICL_entailment
4,101,48,46,2,0.9583333333333334,18,15,3,0.8333333333333334,0.8914728682170543,GPT4,coral,breastca,PROMPT1_ICL_entailment
5,102,14,13,1,0.9285714285714286,7,6,1,0.8571428571428571,0.8914285714285715,GPT4,coral,breastca,PROMPT1_ICL_entailment
6,103,32,31,1,0.96875,10,6,4,0.6,0.7410358565737051,GPT4,coral,breastca,PROMPT1_ICL_entailment
7,104,51,44,7,0.8627450980392157,26,20,6,0.7692307692307693,0.8133086876155269,GPT4,coral,breastca,PROMPT1_ICL_entailment
8,105,19,18,1,0.9473684210526316,15,15,0,1.0,0.972972972972973,GPT4,coral,breastca,PROMPT1_ICL_entailment
9,106,18,18,0,1.0,9,9,0,1.0,1.0,GPT4,coral,breastca,PROMPT1_ICL_entailment
10,107,17,14,3,0.8235294117647058,9,8,1,0.8888888888888888,0.8549618320610687,GPT4,coral,breastca,PROMPT1_ICL_entailment
11,108,29,28,1,0.9655172413793104,11,11,0,1.0,0.9824561403508772,GPT4,coral,breastca,PROMPT1_ICL_entailment
12,109,27,25,2,0.925925925925926,11,11,0,1.0,0.9615384615384616,GPT4,coral,breastca,PROMPT1_ICL_entailment
13,11,13,12,1,0.9230769230769232,3,3,0,1.0,0.96,GPT4,coral,breastca,PROMPT1_ICL_entailment
14,110,15,14,1,0.9333333333333332,11,7,4,0.6363636363636364,0.7567567567567568,GPT4,coral,breastca,PROMPT1_ICL_entailment
15,111,20,14,6,0.7,10,8,2,0.8,0.7466666666666666,GPT4,coral,breastca,PROMPT1_ICL_entailment
16,112,17,17,0,1.0,10,8,2,0.8,0.888888888888889,GPT4,coral,breastca,PROMPT1_ICL_entailment
17,113,45,32,13,0.7111111111111111,49,26,23,0.5306122448979592,0.6077428780131483,GPT4,coral,breastca,PROMPT1_ICL_entailment
18,114,44,37,7,0.8409090909090909,21,12,9,0.5714285714285714,0.6804597701149425,GPT4,coral,breastca,PROMPT1_ICL_entailment
19,115,20,20,0,1.0,9,8,1,0.8888888888888888,0.9411764705882352,GPT4,coral,breastca,PROMPT1_ICL_entailment
20,116,31,28,3,0.9032258064516128,14,12,2,0.8571428571428571,0.8795811518324608,GPT4,coral,breastca,PROMPT1_ICL_entailment
21,117,8,8,0,1.0,2,1,1,0.5,0.6666666666666666,GPT4,coral,breastca,PROMPT1_ICL_entailment
22,118,16,16,0,1.0,19,6,13,0.3157894736842105,0.4799999999999999,GPT4,coral,breastca,PROMPT1_ICL_entailment
23,119,18,17,1,0.9444444444444444,10,10,0,1.0,0.9714285714285714,GPT4,coral,breastca,PROMPT1_ICL_entailment
24,12,18,18,0,1.0,10,9,1,0.9,0.9473684210526316,GPT4,coral,breastca,PROMPT1_ICL_entailment
25,120,23,23,0,1.0,9,9,0,1.0,1.0,GPT4,coral,breastca,PROMPT1_ICL_entailment
26,121,28,25,3,0.8928571428571429,10,9,1,0.9,0.896414342629482,GPT4,coral,breastca,PROMPT1_ICL_entailment
27,122,19,19,0,1.0,9,9,0,1.0,1.0,GPT4,coral,breastca,PROMPT1_ICL_entailment
28,123,21,21,0,1.0,8,8,0,1.0,1.0,GPT4,coral,breastca,PROMPT1_ICL_entailment
29,124,21,21,0,1.0,10,10,0,1.0,1.0,GPT4,coral,breastca,PROMPT1_ICL_entailment
30,125,28,24,4,0.8571428571428571,11,9,2,0.8181818181818182,0.8372093023255814,GPT4,coral,breastca,PROMPT1_ICL_entailment
31,126,20,20,0,1.0,10,10,0,1.0,1.0,GPT4,coral,breastca,PROMPT1_ICL_entailment
32,127,27,26,1,0.9629629629629628,10,10,0,1.0,0.981132075471698,GPT4,coral,breastca,PROMPT1_ICL_entailment
33,128,34,34,0,1.0,11,6,5,0.5454545454545454,0.7058823529411764,GPT4,coral,breastca,PROMPT1_ICL_entailment
34,129,25,23,2,0.92,11,7,4,0.6363636363636364,0.7523364485981309,GPT4,coral,breastca,PROMPT1_ICL_entailment
35,13,23,21,2,0.9130434782608696,10,8,2,0.8,0.852791878172589,GPT4,coral,breastca,PROMPT1_ICL_entailment
36,130,16,16,0,1.0,7,5,2,0.7142857142857143,0.8333333333333333,GPT4,coral,breastca,PROMPT1_ICL_entailment
37,131,44,43,1,0.9772727272727272,10,10,0,1.0,0.9885057471264368,GPT4,coral,breastca,PROMPT1_ICL_entailment
38,132,15,13,2,0.8666666666666667,8,6,2,0.75,0.8041237113402062,GPT4,coral,breastca,PROMPT1_ICL_entailment
39,133,35,33,2,0.9428571428571428,29,18,11,0.6206896551724138,0.7485822306238185,GPT4,coral,breastca,PROMPT1_ICL_entailment
40,134,33,13,20,0.3939393939393939,11,7,4,0.6363636363636364,0.4866310160427807,GPT4,coral,breastca,PROMPT1_ICL_entailment
41,135,27,20,7,0.7407407407407407,16,14,2,0.875,0.8022922636103152,GPT4,coral,breastca,PROMPT1_ICL_entailment
42,136,27,24,3,0.8888888888888888,10,8,2,0.8,0.8421052631578948,GPT4,coral,breastca,PROMPT1_ICL_entailment
43,137,15,15,0,1.0,10,10,0,1.0,1.0,GPT4,coral,breastca,PROMPT1_ICL_entailment
44,138,12,12,0,1.0,10,10,0,1.0,1.0,GPT4,coral,breastca,PROMPT1_ICL_entailment
45,139,22,19,3,0.8636363636363636,11,10,1,0.9090909090909092,0.8857808857808858,GPT4,coral,breastca,PROMPT1_ICL_entailment
46,14,61,44,17,0.7213114754098361,59,32,27,0.5423728813559322,0.6191732629727353,GPT4,coral,breastca,PROMPT1_ICL_entailment
47,140,22,17,5,0.7727272727272727,9,9,0,1.0,0.8717948717948718,GPT4,coral,breastca,PROMPT1_ICL_entailment
48,141,20,18,2,0.9,11,11,0,1.0,0.9473684210526316,GPT4,coral,breastca,PROMPT1_ICL_entailment
49,142,16,16,0,1.0,10,10,0,1.0,1.0,GPT4,coral,breastca,PROMPT1_ICL_entailment
50,143,14,13,1,0.9285714285714286,10,7,3,0.7,0.7982456140350878,GPT4,coral,breastca,PROMPT1_ICL_entailment
51,144,21,21,0,1.0,5,4,1,0.8,0.888888888888889,GPT4,coral,breastca,PROMPT1_ICL_entailment
52,145,15,15,0,1.0,5,4,1,0.8,0.888888888888889,GPT4,coral,breastca,PROMPT1_ICL_entailment
53,146,20,20,0,1.0,9,8,1,0.8888888888888888,0.9411764705882352,GPT4,coral,breastca,PROMPT1_ICL_entailment
54,147,28,28,0,1.0,5,5,0,1.0,1.0,GPT4,coral,breastca,PROMPT1_ICL_entailment
55,148,23,19,4,0.8260869565217391,4,3,1,0.75,0.786206896551724,GPT4,coral,breastca,PROMPT1_ICL_entailment
56,149,17,16,1,0.9411764705882352,1,1,0,1.0,0.9696969696969696,GPT4,coral,breastca,PROMPT1_ICL_entailment
57,15,85,62,23,0.7294117647058823,16,9,7,0.5625,0.6351735913488901,GPT4,coral,breastca,PROMPT1_ICL_entailment
58,150,21,17,4,0.8095238095238095,2,2,0,1.0,0.8947368421052632,GPT4,coral,breastca,PROMPT1_ICL_entailment
59,151,18,17,1,0.9444444444444444,9,9,0,1.0,0.9714285714285714,GPT4,coral,breastca,PROMPT1_ICL_entailment
60,152,18,17,1,0.9444444444444444,16,13,3,0.8125,0.8735177865612648,GPT4,coral,breastca,PROMPT1_ICL_entailment
61,153,16,15,1,0.9375,1,1,0,1.0,0.967741935483871,GPT4,coral,breastca,PROMPT1_ICL_entailment
62,154,14,14,0,1.0,10,6,4,0.6,0.7499999999999999,GPT4,coral,breastca,PROMPT1_ICL_entailment
63,155,29,27,2,0.9310344827586208,9,9,0,1.0,0.9642857142857144,GPT4,coral,breastca,PROMPT1_ICL_entailment
64,156,29,26,3,0.896551724137931,8,7,1,0.875,0.8856447688564477,GPT4,coral,breastca,PROMPT1_ICL_entailment
65,157,24,23,1,0.9583333333333334,9,9,0,1.0,0.9787234042553192,GPT4,coral,breastca,PROMPT1_ICL_entailment
66,158,56,45,11,0.8035714285714286,16,16,0,1.0,0.8910891089108911,GPT4,coral,breastca,PROMPT1_ICL_entailment
67,159,36,32,4,0.8888888888888888,29,20,9,0.6896551724137931,0.7766990291262136,GPT4,coral,breastca,PROMPT1_ICL_entailment
68,16,25,22,3,0.88,10,8,2,0.8,0.8380952380952381,GPT4,coral,breastca,PROMPT1_ICL_entailment
69,160,111,94,17,0.8468468468468469,18,12,6,0.6666666666666666,0.7460317460317459,GPT4,coral,breastca,PROMPT1_ICL_entailment
70,161,35,35,0,1.0,11,10,1,0.9090909090909092,0.9523809523809524,GPT4,coral,breastca,PROMPT1_ICL_entailment
71,162,25,21,4,0.84,16,13,3,0.8125,0.8260211800302573,GPT4,coral,breastca,PROMPT1_ICL_entailment
72,163,14,14,0,1.0,11,11,0,1.0,1.0,GPT4,coral,breastca,PROMPT1_ICL_entailment
73,164,28,26,2,0.9285714285714286,8,8,0,1.0,0.962962962962963,GPT4,coral,breastca,PROMPT1_ICL_entailment
74,165,27,27,0,1.0,12,11,1,0.9166666666666666,0.9565217391304348,GPT4,coral,breastca,PROMPT1_ICL_entailment
75,166,24,22,2,0.9166666666666666,10,5,5,0.5,0.6470588235294118,GPT4,coral,breastca,PROMPT1_ICL_entailment
76,167,25,23,2,0.92,7,7,0,1.0,0.9583333333333334,GPT4,coral,breastca,PROMPT1_ICL_entailment
77,168,15,12,3,0.8,7,6,1,0.8571428571428571,0.8275862068965518,GPT4,coral,breastca,PROMPT1_ICL_entailment
78,169,19,17,2,0.8947368421052632,11,9,2,0.8181818181818182,0.8547486033519553,GPT4,coral,breastca,PROMPT1_ICL_entailment
79,17,7,6,1,0.8571428571428571,3,3,0,1.0,0.923076923076923,GPT4,coral,breastca,PROMPT1_ICL_entailment
80,170,19,19,0,1.0,10,9,1,0.9,0.9473684210526316,GPT4,coral,breastca,PROMPT1_ICL_entailment
81,171,43,42,1,0.9767441860465116,9,7,2,0.7777777777777778,0.8659793814432991,GPT4,coral,breastca,PROMPT1_ICL_entailment
82,172,58,52,6,0.896551724137931,32,25,7,0.78125,0.8349389852280026,GPT4,coral,breastca,PROMPT1_ICL_entailment
83,173,21,20,1,0.9523809523809524,11,10,1,0.9090909090909092,0.9302325581395348,GPT4,coral,breastca,PROMPT1_ICL_entailment
84,174,23,15,8,0.6521739130434783,7,6,1,0.8571428571428571,0.7407407407407407,GPT4,coral,breastca,PROMPT1_ICL_entailment
85,175,14,12,2,0.8571428571428571,10,9,1,0.9,0.8780487804878048,GPT4,coral,breastca,PROMPT1_ICL_entailment
86,176,15,14,1,0.9333333333333332,10,10,0,1.0,0.9655172413793104,GPT4,coral,breastca,PROMPT1_ICL_entailment
87,177,18,18,0,1.0,9,9,0,1.0,1.0,GPT4,coral,breastca,PROMPT1_ICL_entailment
88,178,28,24,4,0.8571428571428571,10,9,1,0.9,0.8780487804878048,GPT4,coral,breastca,PROMPT1_ICL_entailment
89,179,26,26,0,1.0,9,9,0,1.0,1.0,GPT4,coral,breastca,PROMPT1_ICL_entailment
90,18,31,31,0,1.0,8,8,0,1.0,1.0,GPT4,coral,breastca,PROMPT1_ICL_entailment
91,180,19,18,1,0.9473684210526316,10,10,0,1.0,0.972972972972973,GPT4,coral,breastca,PROMPT1_ICL_entailment
92,181,18,15,3,0.8333333333333334,9,8,1,0.8888888888888888,0.8602150537634408,GPT4,coral,breastca,PROMPT1_ICL_entailment
93,182,19,19,0,1.0,9,9,0,1.0,1.0,GPT4,coral,breastca,PROMPT1_ICL_entailment
94,183,13,13,0,1.0,10,8,2,0.8,0.888888888888889,GPT4,coral,breastca,PROMPT1_ICL_entailment
95,184,30,27,3,0.9,9,9,0,1.0,0.9473684210526316,GPT4,coral,breastca,PROMPT1_ICL_entailment
96,185,30,30,0,1.0,10,10,0,1.0,1.0,GPT4,coral,breastca,PROMPT1_ICL_entailment
97,186,12,11,1,0.9166666666666666,5,5,0,1.0,0.9565217391304348,GPT4,coral,breastca,PROMPT1_ICL_entailment
98,187,41,37,4,0.902439024390244,26,19,7,0.7307692307692307,0.8075818495117748,GPT4,coral,breastca,PROMPT1_ICL_entailment
99,188,17,17,0,1.0,9,9,0,1.0,1.0,GPT4,coral,breastca,PROMPT1_ICL_entailment
100,189,18,18,0,1.0,9,6,3,0.6666666666666666,0.8,GPT4,coral,breastca,PROMPT1_ICL_entailment
101,19,21,19,2,0.9047619047619048,8,7,1,0.875,0.8896321070234113,GPT4,coral,breastca,PROMPT1_ICL_entailment
102,190,49,21,28,0.4285714285714285,34,18,16,0.5294117647058824,0.4736842105263158,GPT4,coral,breastca,PROMPT1_ICL_entailment
103,191,45,35,10,0.7777777777777778,14,8,6,0.5714285714285714,0.6588235294117646,GPT4,coral,breastca,PROMPT1_ICL_entailment
104,192,23,23,0,1.0,12,10,2,0.8333333333333334,0.9090909090909092,GPT4,coral,breastca,PROMPT1_ICL_entailment
105,193,15,15,0,1.0,2,2,0,1.0,1.0,GPT4,coral,breastca,PROMPT1_ICL_entailment
106,194,28,28,0,1.0,15,14,1,0.9333333333333332,0.9655172413793104,GPT4,coral,breastca,PROMPT1_ICL_entailment
107,195,23,20,3,0.8695652173913043,13,13,0,1.0,0.9302325581395348,GPT4,coral,breastca,PROMPT1_ICL_entailment
108,196,41,37,4,0.902439024390244,30,22,8,0.7333333333333333,0.8091451292246521,GPT4,coral,breastca,PROMPT1_ICL_entailment
109,197,36,34,2,0.9444444444444444,14,8,6,0.5714285714285714,0.7120418848167539,GPT4,coral,breastca,PROMPT1_ICL_entailment
110,198,26,22,4,0.8461538461538461,11,11,0,1.0,0.9166666666666666,GPT4,coral,breastca,PROMPT1_ICL_entailment
111,199,5,5,0,1.0,2,2,0,1.0,1.0,GPT4,coral,breastca,PROMPT1_ICL_entailment
112,2,43,35,8,0.813953488372093,10,8,2,0.8,0.8069164265129684,GPT4,coral,breastca,PROMPT1_ICL_entailment
113,20,29,23,6,0.7931034482758621,17,12,5,0.7058823529411765,0.7469553450608931,GPT4,coral,breastca,PROMPT1_ICL_entailment
114,200,49,44,5,0.8979591836734694,15,14,1,0.9333333333333332,0.9153046062407132,GPT4,coral,breastca,PROMPT1_ICL_entailment
115,201,32,19,13,0.59375,26,21,5,0.8076923076923077,0.6843910806174958,GPT4,coral,breastca,PROMPT1_ICL_entailment
116,202,26,24,2,0.9230769230769232,17,13,4,0.7647058823529411,0.8364611260053619,GPT4,coral,breastca,PROMPT1_ICL_entailment
117,203,44,40,4,0.9090909090909092,27,27,0,1.0,0.9523809523809524,GPT4,coral,breastca,PROMPT1_ICL_entailment
118,204,26,25,1,0.9615384615384616,11,9,2,0.8181818181818182,0.8840864440078586,GPT4,coral,breastca,PROMPT1_ICL_entailment
119,205,24,23,1,0.9583333333333334,11,11,0,1.0,0.9787234042553192,GPT4,coral,breastca,PROMPT1_ICL_entailment
120,206,22,22,0,1.0,4,4,0,1.0,1.0,GPT4,coral,breastca,PROMPT1_ICL_entailment
121,207,21,18,3,0.8571428571428571,12,10,2,0.8333333333333334,0.8450704225352113,GPT4,coral,breastca,PROMPT1_ICL_entailment
122,208,18,18,0,1.0,9,9,0,1.0,1.0,GPT4,coral,breastca,PROMPT1_ICL_entailment
123,209,52,46,6,0.8846153846153846,11,10,1,0.9090909090909092,0.8966861598440545,GPT4,coral,breastca,PROMPT1_ICL_entailment
124,21,102,67,35,0.6568627450980392,27,16,11,0.5925925925925926,0.6230746875908166,GPT4,coral,breastca,PROMPT1_ICL_entailment
125,210,50,44,6,0.88,13,11,2,0.8461538461538461,0.8627450980392156,GPT4,coral,breastca,PROMPT1_ICL_entailment
126,211,32,27,5,0.84375,11,10,1,0.9090909090909092,0.8752025931928686,GPT4,coral,breastca,PROMPT1_ICL_entailment
127,212,26,24,2,0.9230769230769232,9,8,1,0.8888888888888888,0.9056603773584906,GPT4,coral,breastca,PROMPT1_ICL_entailment
128,213,22,19,3,0.8636363636363636,11,10,1,0.9090909090909092,0.8857808857808858,GPT4,coral,breastca,PROMPT1_ICL_entailment
129,214,25,16,9,0.64,28,19,9,0.6785714285714286,0.6587215601300109,GPT4,coral,breastca,PROMPT1_ICL_entailment
130,215,81,54,27,0.6666666666666666,37,27,10,0.7297297297297297,0.6967741935483871,GPT4,coral,breastca,PROMPT1_ICL_entailment
131,216,34,31,3,0.9117647058823528,15,13,2,0.8666666666666667,0.8886438809261301,GPT4,coral,breastca,PROMPT1_ICL_entailment
132,22,23,17,6,0.7391304347826086,7,7,0,1.0,0.85,GPT4,coral,breastca,PROMPT1_ICL_entailment
133,23,19,16,3,0.8421052631578947,9,9,0,1.0,0.9142857142857144,GPT4,coral,breastca,PROMPT1_ICL_entailment
134,24,18,15,3,0.8333333333333334,10,10,0,1.0,0.9090909090909092,GPT4,coral,breastca,PROMPT1_ICL_entailment
135,25,26,26,0,1.0,8,7,1,0.875,0.9333333333333332,GPT4,coral,breastca,PROMPT1_ICL_entailment
136,26,22,21,1,0.9545454545454546,11,9,2,0.8181818181818182,0.881118881118881,GPT4,coral,breastca,PROMPT1_ICL_entailment
137,27,26,25,1,0.9615384615384616,12,9,3,0.75,0.8426966292134831,GPT4,coral,breastca,PROMPT1_ICL_entailment
138,28,36,30,6,0.8333333333333334,18,15,3,0.8333333333333334,0.8333333333333334,GPT4,coral,breastca,PROMPT1_ICL_entailment
139,29,40,32,8,0.8,9,5,4,0.5555555555555556,0.6557377049180328,GPT4,coral,breastca,PROMPT1_ICL_entailment
140,3,37,33,4,0.8918918918918919,11,6,5,0.5454545454545454,0.676923076923077,GPT4,coral,breastca,PROMPT1_ICL_entailment
141,30,40,19,21,0.475,18,14,4,0.7777777777777778,0.58980044345898,GPT4,coral,breastca,PROMPT1_ICL_entailment
142,31,24,15,9,0.625,13,9,4,0.6923076923076923,0.6569343065693432,GPT4,coral,breastca,PROMPT1_ICL_entailment
143,32,21,18,3,0.8571428571428571,9,8,1,0.8888888888888888,0.8727272727272727,GPT4,coral,breastca,PROMPT1_ICL_entailment
144,33,26,21,5,0.8076923076923077,8,8,0,1.0,0.8936170212765957,GPT4,coral,breastca,PROMPT1_ICL_entailment
145,34,13,13,0,1.0,10,9,1,0.9,0.9473684210526316,GPT4,coral,breastca,PROMPT1_ICL_entailment
146,35,28,19,9,0.6785714285714286,12,9,3,0.75,0.7124999999999999,GPT4,coral,breastca,PROMPT1_ICL_entailment
147,36,26,25,1,0.9615384615384616,11,9,2,0.8181818181818182,0.8840864440078586,GPT4,coral,breastca,PROMPT1_ICL_entailment
148,37,21,19,2,0.9047619047619048,11,10,1,0.9090909090909092,0.9069212410501194,GPT4,coral,breastca,PROMPT1_ICL_entailment
149,38,27,26,1,0.9629629629629628,11,9,2,0.8181818181818182,0.8846880907372401,GPT4,coral,breastca,PROMPT1_ICL_entailment
150,39,18,18,0,1.0,11,11,0,1.0,1.0,GPT4,coral,breastca,PROMPT1_ICL_entailment
151,4,48,31,17,0.6458333333333334,59,32,27,0.5423728813559322,0.5895988112927192,GPT4,coral,breastca,PROMPT1_ICL_entailment
152,40,24,21,3,0.875,9,8,1,0.8888888888888888,0.8818897637795274,GPT4,coral,breastca,PROMPT1_ICL_entailment
153,41,26,23,3,0.8846153846153846,14,10,4,0.7142857142857143,0.7903780068728522,GPT4,coral,breastca,PROMPT1_ICL_entailment
154,42,26,19,7,0.7307692307692307,9,7,2,0.7777777777777778,0.7535410764872521,GPT4,coral,breastca,PROMPT1_ICL_entailment
155,43,17,16,1,0.9411764705882352,9,8,1,0.8888888888888888,0.9142857142857144,GPT4,coral,breastca,PROMPT1_ICL_entailment
156,44,13,13,0,1.0,9,9,0,1.0,1.0,GPT4,coral,breastca,PROMPT1_ICL_entailment
157,45,6,6,0,1.0,2,2,0,1.0,1.0,GPT4,coral,breastca,PROMPT1_ICL_entailment
158,46,19,19,0,1.0,5,5,0,1.0,1.0,GPT4,coral,breastca,PROMPT1_ICL_entailment
159,47,14,12,2,0.8571428571428571,2,2,0,1.0,0.923076923076923,GPT4,coral,breastca,PROMPT1_ICL_entailment
160,48,18,17,1,0.9444444444444444,5,5,0,1.0,0.9714285714285714,GPT4,coral,breastca,PROMPT1_ICL_entailment
161,49,31,21,10,0.6774193548387096,16,12,4,0.75,0.7118644067796611,GPT4,coral,breastca,PROMPT1_ICL_entailment
162,5,47,42,5,0.8936170212765957,12,10,2,0.8333333333333334,0.8624229979466119,GPT4,coral,breastca,PROMPT1_ICL_entailment
163,50,47,32,15,0.6808510638297872,16,11,5,0.6875,0.6841593780369291,GPT4,coral,breastca,PROMPT1_ICL_entailment
164,51,41,39,2,0.951219512195122,11,9,2,0.8181818181818182,0.8796992481203008,GPT4,coral,breastca,PROMPT1_ICL_entailment
165,52,17,16,1,0.9411764705882352,10,10,0,1.0,0.9696969696969696,GPT4,coral,breastca,PROMPT1_ICL_entailment
166,53,25,24,1,0.96,10,10,0,1.0,0.979591836734694,GPT4,coral,breastca,PROMPT1_ICL_entailment
167,54,28,27,1,0.9642857142857144,9,9,0,1.0,0.9818181818181818,GPT4,coral,breastca,PROMPT1_ICL_entailment
168,55,3,3,0,1.0,1,1,0,1.0,1.0,GPT4,coral,breastca,PROMPT1_ICL_entailment
169,56,12,12,0,1.0,18,5,13,0.2777777777777778,0.4347826086956522,GPT4,coral,breastca,PROMPT1_ICL_entailment
170,57,36,34,2,0.9444444444444444,10,9,1,0.9,0.9216867469879516,GPT4,coral,breastca,PROMPT1_ICL_entailment
171,58,32,29,3,0.90625,10,10,0,1.0,0.9508196721311476,GPT4,coral,breastca,PROMPT1_ICL_entailment
172,59,21,21,0,1.0,9,7,2,0.7777777777777778,0.8750000000000001,GPT4,coral,breastca,PROMPT1_ICL_entailment
173,6,19,16,3,0.8421052631578947,8,7,1,0.875,0.8582375478927203,GPT4,coral,breastca,PROMPT1_ICL_entailment
174,60,19,18,1,0.9473684210526316,10,9,1,0.9,0.9230769230769232,GPT4,coral,breastca,PROMPT1_ICL_entailment
175,61,19,19,0,1.0,11,10,1,0.9090909090909092,0.9523809523809524,GPT4,coral,breastca,PROMPT1_ICL_entailment
176,62,30,26,4,0.8666666666666667,10,10,0,1.0,0.9285714285714286,GPT4,coral,breastca,PROMPT1_ICL_entailment
177,63,21,19,2,0.9047619047619048,11,10,1,0.9090909090909092,0.9069212410501194,GPT4,coral,breastca,PROMPT1_ICL_entailment
178,64,11,10,1,0.9090909090909092,18,8,10,0.4444444444444444,0.5970149253731343,GPT4,coral,breastca,PROMPT1_ICL_entailment
179,65,37,36,1,0.972972972972973,6,6,0,1.0,0.9863013698630138,GPT4,coral,breastca,PROMPT1_ICL_entailment
180,66,28,26,2,0.9285714285714286,10,8,2,0.8,0.859504132231405,GPT4,coral,breastca,PROMPT1_ICL_entailment
181,67,58,29,29,0.5,49,20,29,0.4081632653061224,0.449438202247191,GPT4,coral,breastca,PROMPT1_ICL_entailment
182,68,25,21,4,0.84,8,8,0,1.0,0.9130434782608696,GPT4,coral,breastca,PROMPT1_ICL_entailment
183,69,36,23,13,0.6388888888888888,12,5,7,0.4166666666666667,0.5043859649122807,GPT4,coral,breastca,PROMPT1_ICL_entailment
184,7,20,20,0,1.0,11,10,1,0.9090909090909092,0.9523809523809524,GPT4,coral,breastca,PROMPT1_ICL_entailment
185,70,152,129,23,0.8486842105263158,51,36,15,0.7058823529411765,0.7707244212098581,GPT4,coral,breastca,PROMPT1_ICL_entailment
186,71,18,16,2,0.8888888888888888,5,3,2,0.6,0.7164179104477612,GPT4,coral,breastca,PROMPT1_ICL_entailment
187,72,13,13,0,1.0,3,3,0,1.0,1.0,GPT4,coral,breastca,PROMPT1_ICL_entailment
188,73,15,15,0,1.0,1,1,0,1.0,1.0,GPT4,coral,breastca,PROMPT1_ICL_entailment
189,74,17,16,1,0.9411764705882352,2,2,0,1.0,0.9696969696969696,GPT4,coral,breastca,PROMPT1_ICL_entailment
190,75,22,20,2,0.9090909090909092,6,6,0,1.0,0.9523809523809524,GPT4,coral,breastca,PROMPT1_ICL_entailment
191,76,17,17,0,1.0,7,6,1,0.8571428571428571,0.923076923076923,GPT4,coral,breastca,PROMPT1_ICL_entailment
192,77,17,17,0,1.0,15,8,7,0.5333333333333333,0.6956521739130436,GPT4,coral,breastca,PROMPT1_ICL_entailment
193,78,24,23,1,0.9583333333333334,8,8,0,1.0,0.9787234042553192,GPT4,coral,breastca,PROMPT1_ICL_entailment
194,79,14,14,0,1.0,8,8,0,1.0,1.0,GPT4,coral,breastca,PROMPT1_ICL_entailment
195,8,12,11,1,0.9166666666666666,9,7,2,0.7777777777777778,0.8415300546448087,GPT4,coral,breastca,PROMPT1_ICL_entailment
196,80,40,39,1,0.975,24,16,8,0.6666666666666666,0.7918781725888324,GPT4,coral,breastca,PROMPT1_ICL_entailment
197,81,16,14,2,0.875,11,10,1,0.9090909090909092,0.8917197452229298,GPT4,coral,breastca,PROMPT1_ICL_entailment
198,82,14,13,1,0.9285714285714286,6,6,0,1.0,0.962962962962963,GPT4,coral,breastca,PROMPT1_ICL_entailment
199,83,14,13,1,0.9285714285714286,6,5,1,0.8333333333333334,0.8783783783783784,GPT4,coral,breastca,PROMPT1_ICL_entailment
200,84,24,20,4,0.8333333333333334,11,9,2,0.8181818181818182,0.8256880733944955,GPT4,coral,breastca,PROMPT1_ICL_entailment
201,85,24,23,1,0.9583333333333334,7,7,0,1.0,0.9787234042553192,GPT4,coral,breastca,PROMPT1_ICL_entailment
202,86,24,17,7,0.7083333333333334,16,15,1,0.9375,0.8069620253164557,GPT4,coral,breastca,PROMPT1_ICL_entailment
203,87,18,17,1,0.9444444444444444,8,8,0,1.0,0.9714285714285714,GPT4,coral,breastca,PROMPT1_ICL_entailment
204,88,11,11,0,1.0,8,8,0,1.0,1.0,GPT4,coral,breastca,PROMPT1_ICL_entailment
205,89,16,15,1,0.9375,11,10,1,0.9090909090909092,0.923076923076923,GPT4,coral,breastca,PROMPT1_ICL_entailment
206,9,20,16,4,0.8,6,4,2,0.6666666666666666,0.7272727272727272,GPT4,coral,breastca,PROMPT1_ICL_entailment
207,90,42,28,14,0.6666666666666666,18,15,3,0.8333333333333334,0.7407407407407408,GPT4,coral,breastca,PROMPT1_ICL_entailment
208,91,23,18,5,0.782608695652174,7,5,2,0.7142857142857143,0.7468879668049793,GPT4,coral,breastca,PROMPT1_ICL_entailment
209,92,7,7,0,1.0,2,2,0,1.0,1.0,GPT4,coral,breastca,PROMPT1_ICL_entailment
210,93,62,59,3,0.9516129032258064,13,10,3,0.7692307692307693,0.8507570295602019,GPT4,coral,breastca,PROMPT1_ICL_entailment
211,94,33,21,12,0.6363636363636364,25,20,5,0.8,0.7088607594936709,GPT4,coral,breastca,PROMPT1_ICL_entailment
212,95,33,32,1,0.9696969696969696,13,6,7,0.4615384615384615,0.6254071661237786,GPT4,coral,breastca,PROMPT1_ICL_entailment
213,96,21,20,1,0.9523809523809524,10,9,1,0.9,0.9254498714652956,GPT4,coral,breastca,PROMPT1_ICL_entailment
214,97,35,34,1,0.9714285714285714,11,10,1,0.9090909090909092,0.9392265193370164,GPT4,coral,breastca,PROMPT1_ICL_entailment
215,98,13,12,1,0.9230769230769232,2,2,0,1.0,0.96,GPT4,coral,breastca,PROMPT1_ICL_entailment
216,99,34,33,1,0.9705882352941176,15,10,5,0.6666666666666666,0.7904191616766466,GPT4,coral,breastca,PROMPT1_ICL_entailment
0,0,35,34,1,0.9714285714285714,10,10,0,1.0,0.9855072463768116,GPT4,coral,breastca,PROMPT2_ICL_entailment
1,1,55,42,13,0.7636363636363637,12,8,4,0.6666666666666666,0.711864406779661,GPT4,coral,breastca,PROMPT2_ICL_entailment
2,10,30,27,3,0.9,10,10,0,1.0,0.9473684210526316,GPT4,coral,breastca,PROMPT2_ICL_entailment
3,100,35,24,11,0.6857142857142857,26,10,16,0.3846153846153846,0.4928131416837782,GPT4,coral,breastca,PROMPT2_ICL_entailment
4,101,51,49,2,0.9607843137254902,18,12,6,0.6666666666666666,0.78714859437751,GPT4,coral,breastca,PROMPT2_ICL_entailment
5,102,14,13,1,0.9285714285714286,7,7,0,1.0,0.962962962962963,GPT4,coral,breastca,PROMPT2_ICL_entailment
6,103,52,51,1,0.9807692307692308,10,10,0,1.0,0.9902912621359222,GPT4,coral,breastca,PROMPT2_ICL_entailment
7,104,50,38,12,0.76,26,21,5,0.8076923076923077,0.7831207065750736,GPT4,coral,breastca,PROMPT2_ICL_entailment
8,105,28,27,1,0.9642857142857144,15,15,0,1.0,0.9818181818181818,GPT4,coral,breastca,PROMPT2_ICL_entailment
9,106,21,20,1,0.9523809523809524,9,9,0,1.0,0.975609756097561,GPT4,coral,breastca,PROMPT2_ICL_entailment
10,107,18,14,4,0.7777777777777778,9,9,0,1.0,0.8750000000000001,GPT4,coral,breastca,PROMPT2_ICL_entailment
11,108,28,27,1,0.9642857142857144,11,11,0,1.0,0.9818181818181818,GPT4,coral,breastca,PROMPT2_ICL_entailment
12,109,24,23,1,0.9583333333333334,11,10,1,0.9090909090909092,0.9330628803245437,GPT4,coral,breastca,PROMPT2_ICL_entailment
13,11,12,10,2,0.8333333333333334,3,3,0,1.0,0.9090909090909092,GPT4,coral,breastca,PROMPT2_ICL_entailment
14,110,16,16,0,1.0,11,10,1,0.9090909090909092,0.9523809523809524,GPT4,coral,breastca,PROMPT2_ICL_entailment
15,111,23,18,5,0.782608695652174,10,8,2,0.8,0.7912087912087912,GPT4,coral,breastca,PROMPT2_ICL_entailment
16,112,22,22,0,1.0,10,10,0,1.0,1.0,GPT4,coral,breastca,PROMPT2_ICL_entailment
17,113,63,55,8,0.873015873015873,49,21,28,0.4285714285714285,0.5749128919860627,GPT4,coral,breastca,PROMPT2_ICL_entailment
18,114,45,35,10,0.7777777777777778,21,12,9,0.5714285714285714,0.6588235294117646,GPT4,coral,breastca,PROMPT2_ICL_entailment
19,115,20,17,3,0.85,9,8,1,0.8888888888888888,0.8690095846645367,GPT4,coral,breastca,PROMPT2_ICL_entailment
20,116,33,28,5,0.8484848484848485,14,11,3,0.7857142857142857,0.8158940397350993,GPT4,coral,breastca,PROMPT2_ICL_entailment
21,117,9,8,1,0.8888888888888888,2,1,1,0.5,0.64,GPT4,coral,breastca,PROMPT2_ICL_entailment
22,118,18,18,0,1.0,19,5,14,0.2631578947368421,0.4166666666666667,GPT4,coral,breastca,PROMPT2_ICL_entailment
23,119,21,20,1,0.9523809523809524,10,9,1,0.9,0.9254498714652956,GPT4,coral,breastca,PROMPT2_ICL_entailment
24,12,38,36,2,0.9473684210526316,10,8,2,0.8,0.8674698795180723,GPT4,coral,breastca,PROMPT2_ICL_entailment
25,120,24,23,1,0.9583333333333334,9,9,0,1.0,0.9787234042553192,GPT4,coral,breastca,PROMPT2_ICL_entailment
26,121,29,25,4,0.8620689655172413,10,9,1,0.9,0.8806262230919765,GPT4,coral,breastca,PROMPT2_ICL_entailment
27,122,21,21,0,1.0,9,9,0,1.0,1.0,GPT4,coral,breastca,PROMPT2_ICL_entailment
28,123,26,26,0,1.0,8,7,1,0.875,0.9333333333333332,GPT4,coral,breastca,PROMPT2_ICL_entailment
29,124,23,22,1,0.9565217391304348,10,9,1,0.9,0.9274004683840747,GPT4,coral,breastca,PROMPT2_ICL_entailment
30,125,26,22,4,0.8461538461538461,11,7,4,0.6363636363636364,0.7264150943396226,GPT4,coral,breastca,PROMPT2_ICL_entailment
31,126,23,23,0,1.0,10,10,0,1.0,1.0,GPT4,coral,breastca,PROMPT2_ICL_entailment
32,127,35,30,5,0.8571428571428571,10,10,0,1.0,0.923076923076923,GPT4,coral,breastca,PROMPT2_ICL_entailment
33,128,26,26,0,1.0,11,11,0,1.0,1.0,GPT4,coral,breastca,PROMPT2_ICL_entailment
34,129,27,23,4,0.8518518518518519,11,8,3,0.7272727272727273,0.7846481876332624,GPT4,coral,breastca,PROMPT2_ICL_entailment
35,13,22,15,7,0.6818181818181818,10,9,1,0.9,0.7758620689655172,GPT4,coral,breastca,PROMPT2_ICL_entailment
36,130,12,10,2,0.8333333333333334,7,1,6,0.1428571428571428,0.2439024390243902,GPT4,coral,breastca,PROMPT2_ICL_entailment
37,131,51,48,3,0.9411764705882352,10,10,0,1.0,0.9696969696969696,GPT4,coral,breastca,PROMPT2_ICL_entailment
38,132,19,18,1,0.9473684210526316,8,7,1,0.875,0.9097472924187724,GPT4,coral,breastca,PROMPT2_ICL_entailment
39,133,52,43,9,0.8269230769230769,29,15,14,0.5172413793103449,0.6364084854464725,GPT4,coral,breastca,PROMPT2_ICL_entailment
40,134,35,11,24,0.3142857142857143,11,8,3,0.7272727272727273,0.4389027431421446,GPT4,coral,breastca,PROMPT2_ICL_entailment
41,135,27,21,6,0.7777777777777778,16,13,3,0.8125,0.7947598253275109,GPT4,coral,breastca,PROMPT2_ICL_entailment
42,136,24,20,4,0.8333333333333334,10,9,1,0.9,0.8653846153846153,GPT4,coral,breastca,PROMPT2_ICL_entailment
43,137,15,15,0,1.0,10,10,0,1.0,1.0,GPT4,coral,breastca,PROMPT2_ICL_entailment
44,138,12,12,0,1.0,10,10,0,1.0,1.0,GPT4,coral,breastca,PROMPT2_ICL_entailment
45,139,24,23,1,0.9583333333333334,11,9,2,0.8181818181818182,0.8827292110874201,GPT4,coral,breastca,PROMPT2_ICL_entailment
46,14,30,21,9,0.7,59,16,43,0.2711864406779661,0.3909249563699825,GPT4,coral,breastca,PROMPT2_ICL_entailment
47,140,44,39,5,0.8863636363636364,9,8,1,0.8888888888888888,0.887624466571835,GPT4,coral,breastca,PROMPT2_ICL_entailment
48,141,35,30,5,0.8571428571428571,11,11,0,1.0,0.923076923076923,GPT4,coral,breastca,PROMPT2_ICL_entailment
49,142,17,16,1,0.9411764705882352,10,10,0,1.0,0.9696969696969696,GPT4,coral,breastca,PROMPT2_ICL_entailment
50,143,18,17,1,0.9444444444444444,10,8,2,0.8,0.8662420382165604,GPT4,coral,breastca,PROMPT2_ICL_entailment
51,144,23,23,0,1.0,5,5,0,1.0,1.0,GPT4,coral,breastca,PROMPT2_ICL_entailment
52,145,15,15,0,1.0,5,4,1,0.8,0.888888888888889,GPT4,coral,breastca,PROMPT2_ICL_entailment
53,146,24,21,3,0.875,9,9,0,1.0,0.9333333333333332,GPT4,coral,breastca,PROMPT2_ICL_entailment
54,147,24,19,5,0.7916666666666666,5,4,1,0.8,0.7958115183246073,GPT4,coral,breastca,PROMPT2_ICL_entailment
55,148,20,17,3,0.85,4,0,4,0.0,0.0,GPT4,coral,breastca,PROMPT2_ICL_entailment
56,149,19,18,1,0.9473684210526316,1,1,0,1.0,0.972972972972973,GPT4,coral,breastca,PROMPT2_ICL_entailment
57,15,60,45,15,0.75,16,10,6,0.625,0.6818181818181818,GPT4,coral,breastca,PROMPT2_ICL_entailment
58,150,20,17,3,0.85,2,2,0,1.0,0.9189189189189187,GPT4,coral,breastca,PROMPT2_ICL_entailment
59,151,16,15,1,0.9375,9,8,1,0.8888888888888888,0.9125475285171102,GPT4,coral,breastca,PROMPT2_ICL_entailment
60,152,20,19,1,0.95,16,10,6,0.625,0.753968253968254,GPT4,coral,breastca,PROMPT2_ICL_entailment
61,153,16,15,1,0.9375,1,1,0,1.0,0.967741935483871,GPT4,coral,breastca,PROMPT2_ICL_entailment
62,154,15,14,1,0.9333333333333332,10,8,2,0.8,0.8615384615384616,GPT4,coral,breastca,PROMPT2_ICL_entailment
63,155,29,26,3,0.896551724137931,9,9,0,1.0,0.9454545454545454,GPT4,coral,breastca,PROMPT2_ICL_entailment
64,156,26,25,1,0.9615384615384616,8,8,0,1.0,0.9803921568627452,GPT4,coral,breastca,PROMPT2_ICL_entailment
65,157,27,25,2,0.925925925925926,9,9,0,1.0,0.9615384615384616,GPT4,coral,breastca,PROMPT2_ICL_entailment
66,158,57,41,16,0.7192982456140351,16,16,0,1.0,0.8367346938775511,GPT4,coral,breastca,PROMPT2_ICL_entailment
67,159,33,25,8,0.7575757575757576,29,14,15,0.4827586206896552,0.5897219882055602,GPT4,coral,breastca,PROMPT2_ICL_entailment
68,16,24,23,1,0.9583333333333334,10,9,1,0.9,0.9282511210762332,GPT4,coral,breastca,PROMPT2_ICL_entailment
69,160,87,66,21,0.7586206896551724,18,12,6,0.6666666666666666,0.7096774193548386,GPT4,coral,breastca,PROMPT2_ICL_entailment
70,161,38,38,0,1.0,11,9,2,0.8181818181818182,0.9,GPT4,coral,breastca,PROMPT2_ICL_entailment
71,162,28,25,3,0.8928571428571429,16,14,2,0.875,0.8838383838383839,GPT4,coral,breastca,PROMPT2_ICL_entailment
72,163,19,17,2,0.8947368421052632,11,9,2,0.8181818181818182,0.8547486033519553,GPT4,coral,breastca,PROMPT2_ICL_entailment
73,164,27,25,2,0.925925925925926,8,7,1,0.875,0.8997429305912596,GPT4,coral,breastca,PROMPT2_ICL_entailment
74,165,26,26,0,1.0,12,10,2,0.8333333333333334,0.9090909090909092,GPT4,coral,breastca,PROMPT2_ICL_entailment
75,166,25,25,0,1.0,10,7,3,0.7,0.8235294117647058,GPT4,coral,breastca,PROMPT2_ICL_entailment
76,167,29,25,4,0.8620689655172413,7,7,0,1.0,0.925925925925926,GPT4,coral,breastca,PROMPT2_ICL_entailment
77,168,21,18,3,0.8571428571428571,7,6,1,0.8571428571428571,0.8571428571428571,GPT4,coral,breastca,PROMPT2_ICL_entailment
78,169,16,14,2,0.875,11,8,3,0.7272727272727273,0.7943262411347517,GPT4,coral,breastca,PROMPT2_ICL_entailment
79,17,8,8,0,1.0,3,3,0,1.0,1.0,GPT4,coral,breastca,PROMPT2_ICL_entailment
80,170,20,20,0,1.0,10,10,0,1.0,1.0,GPT4,coral,breastca,PROMPT2_ICL_entailment
81,171,28,27,1,0.9642857142857144,9,8,1,0.8888888888888888,0.925053533190578,GPT4,coral,breastca,PROMPT2_ICL_entailment
82,172,56,50,6,0.8928571428571429,32,20,12,0.625,0.7352941176470589,GPT4,coral,breastca,PROMPT2_ICL_entailment
83,173,23,21,2,0.9130434782608696,11,9,2,0.8181818181818182,0.863013698630137,GPT4,coral,breastca,PROMPT2_ICL_entailment
84,174,21,17,4,0.8095238095238095,7,6,1,0.8571428571428571,0.8326530612244899,GPT4,coral,breastca,PROMPT2_ICL_entailment
85,175,14,11,3,0.7857142857142857,10,9,1,0.9,0.8389830508474577,GPT4,coral,breastca,PROMPT2_ICL_entailment
86,176,14,14,0,1.0,10,10,0,1.0,1.0,GPT4,coral,breastca,PROMPT2_ICL_entailment
87,177,27,26,1,0.9629629629629628,9,9,0,1.0,0.981132075471698,GPT4,coral,breastca,PROMPT2_ICL_entailment
88,178,31,25,6,0.8064516129032258,10,10,0,1.0,0.8928571428571428,GPT4,coral,breastca,PROMPT2_ICL_entailment
89,179,27,27,0,1.0,9,9,0,1.0,1.0,GPT4,coral,breastca,PROMPT2_ICL_entailment
90,18,26,26,0,1.0,8,8,0,1.0,1.0,GPT4,coral,breastca,PROMPT2_ICL_entailment
91,180,25,22,3,0.88,10,9,1,0.9,0.8898876404494382,GPT4,coral,breastca,PROMPT2_ICL_entailment
92,181,17,16,1,0.9411764705882352,9,7,2,0.7777777777777778,0.8517110266159694,GPT4,coral,breastca,PROMPT2_ICL_entailment
93,182,21,19,2,0.9047619047619048,9,9,0,1.0,0.95,GPT4,coral,breastca,PROMPT2_ICL_entailment
94,183,20,19,1,0.95,10,10,0,1.0,0.9743589743589745,GPT4,coral,breastca,PROMPT2_ICL_entailment
95,184,28,27,1,0.9642857142857144,9,9,0,1.0,0.9818181818181818,GPT4,coral,breastca,PROMPT2_ICL_entailment
96,185,28,27,1,0.9642857142857144,10,9,1,0.9,0.9310344827586208,GPT4,coral,breastca,PROMPT2_ICL_entailment
97,186,11,11,0,1.0,5,5,0,1.0,1.0,GPT4,coral,breastca,PROMPT2_ICL_entailment
98,187,65,58,7,0.8923076923076924,26,19,7,0.7307692307692307,0.8034998177178272,GPT4,coral,breastca,PROMPT2_ICL_entailment
99,188,19,19,0,1.0,9,9,0,1.0,1.0,GPT4,coral,breastca,PROMPT2_ICL_entailment
100,189,20,20,0,1.0,9,5,4,0.5555555555555556,0.7142857142857143,GPT4,coral,breastca,PROMPT2_ICL_entailment
101,19,22,19,3,0.8636363636363636,8,8,0,1.0,0.9268292682926828,GPT4,coral,breastca,PROMPT2_ICL_entailment
102,190,47,23,24,0.4893617021276595,34,16,18,0.4705882352941176,0.4797913950456323,GPT4,coral,breastca,PROMPT2_ICL_entailment
103,191,45,38,7,0.8444444444444444,14,7,7,0.5,0.6280991735537189,GPT4,coral,breastca,PROMPT2_ICL_entailment
104,192,27,26,1,0.9629629629629628,12,12,0,1.0,0.981132075471698,GPT4,coral,breastca,PROMPT2_ICL_entailment
105,193,15,15,0,1.0,2,2,0,1.0,1.0,GPT4,coral,breastca,PROMPT2_ICL_entailment
106,194,58,57,1,0.9827586206896552,15,13,2,0.8666666666666667,0.9210689869484152,GPT4,coral,breastca,PROMPT2_ICL_entailment
107,195,20,19,1,0.95,13,11,2,0.8461538461538461,0.8950749464668094,GPT4,coral,breastca,PROMPT2_ICL_entailment
108,196,43,37,6,0.8604651162790697,30,20,10,0.6666666666666666,0.7512690355329947,GPT4,coral,breastca,PROMPT2_ICL_entailment
109,197,50,43,7,0.86,14,12,2,0.8571428571428571,0.8585690515806988,GPT4,coral,breastca,PROMPT2_ICL_entailment
110,198,29,27,2,0.9310344827586208,11,9,2,0.8181818181818182,0.8709677419354839,GPT4,coral,breastca,PROMPT2_ICL_entailment
111,199,6,6,0,1.0,2,2,0,1.0,1.0,GPT4,coral,breastca,PROMPT2_ICL_entailment
112,2,50,42,8,0.84,10,6,4,0.6,0.7000000000000001,GPT4,coral,breastca,PROMPT2_ICL_entailment
113,20,27,23,4,0.8518518518518519,17,9,8,0.5294117647058824,0.6529968454258674,GPT4,coral,breastca,PROMPT2_ICL_entailment
114,200,74,72,2,0.972972972972973,15,14,1,0.9333333333333332,0.9527410207939508,GPT4,coral,breastca,PROMPT2_ICL_entailment
115,201,34,26,8,0.7647058823529411,26,20,6,0.7692307692307693,0.7669616519174042,GPT4,coral,breastca,PROMPT2_ICL_entailment
116,202,22,20,2,0.9090909090909092,17,14,3,0.8235294117647058,0.8641975308641976,GPT4,coral,breastca,PROMPT2_ICL_entailment
117,203,69,61,8,0.8840579710144928,27,11,16,0.4074074074074074,0.5577722360764755,GPT4,coral,breastca,PROMPT2_ICL_entailment
118,204,26,25,1,0.9615384615384616,11,10,1,0.9090909090909092,0.9345794392523366,GPT4,coral,breastca,PROMPT2_ICL_entailment
119,205,21,21,0,1.0,11,11,0,1.0,1.0,GPT4,coral,breastca,PROMPT2_ICL_entailment
120,206,22,22,0,1.0,4,4,0,1.0,1.0,GPT4,coral,breastca,PROMPT2_ICL_entailment
121,207,33,27,6,0.8181818181818182,12,10,2,0.8333333333333334,0.8256880733944955,GPT4,coral,breastca,PROMPT2_ICL_entailment
122,208,19,19,0,1.0,9,9,0,1.0,1.0,GPT4,coral,breastca,PROMPT2_ICL_entailment
123,209,51,47,4,0.9215686274509804,11,10,1,0.9090909090909092,0.9152872444011684,GPT4,coral,breastca,PROMPT2_ICL_entailment
124,21,89,54,35,0.6067415730337079,27,20,7,0.7407407407407407,0.6670784434836319,GPT4,coral,breastca,PROMPT2_ICL_entailment
125,210,49,39,10,0.7959183673469388,13,8,5,0.6153846153846154,0.6941045606229144,GPT4,coral,breastca,PROMPT2_ICL_entailment
126,211,34,27,7,0.7941176470588235,11,9,2,0.8181818181818182,0.8059701492537314,GPT4,coral,breastca,PROMPT2_ICL_entailment
127,212,32,26,6,0.8125,9,7,2,0.7777777777777778,0.7947598253275109,GPT4,coral,breastca,PROMPT2_ICL_entailment
128,213,28,23,5,0.8214285714285714,11,11,0,1.0,0.9019607843137256,GPT4,coral,breastca,PROMPT2_ICL_entailment
129,214,20,9,11,0.45,28,11,17,0.3928571428571428,0.4194915254237288,GPT4,coral,breastca,PROMPT2_ICL_entailment
130,215,56,35,21,0.625,37,25,12,0.6756756756756757,0.6493506493506493,GPT4,coral,breastca,PROMPT2_ICL_entailment
131,216,44,40,4,0.9090909090909092,15,13,2,0.8666666666666667,0.887372013651877,GPT4,coral,breastca,PROMPT2_ICL_entailment
132,22,27,21,6,0.7777777777777778,7,6,1,0.8571428571428571,0.8155339805825242,GPT4,coral,breastca,PROMPT2_ICL_entailment
133,23,15,14,1,0.9333333333333332,9,8,1,0.8888888888888888,0.9105691056910568,GPT4,coral,breastca,PROMPT2_ICL_entailment
134,24,20,17,3,0.85,10,10,0,1.0,0.9189189189189187,GPT4,coral,breastca,PROMPT2_ICL_entailment
135,25,23,22,1,0.9565217391304348,8,8,0,1.0,0.9777777777777776,GPT4,coral,breastca,PROMPT2_ICL_entailment
136,26,24,24,0,1.0,11,11,0,1.0,1.0,GPT4,coral,breastca,PROMPT2_ICL_entailment
137,27,26,24,2,0.9230769230769232,12,9,3,0.75,0.8275862068965517,GPT4,coral,breastca,PROMPT2_ICL_entailment
138,28,33,31,2,0.9393939393939394,18,16,2,0.8888888888888888,0.9134438305709024,GPT4,coral,breastca,PROMPT2_ICL_entailment
139,29,45,37,8,0.8222222222222222,9,5,4,0.5555555555555556,0.6630824372759856,GPT4,coral,breastca,PROMPT2_ICL_entailment
140,3,33,27,6,0.8181818181818182,11,7,4,0.6363636363636364,0.7159090909090909,GPT4,coral,breastca,PROMPT2_ICL_entailment
141,30,84,60,24,0.7142857142857143,18,13,5,0.7222222222222222,0.7182320441988951,GPT4,coral,breastca,PROMPT2_ICL_entailment
142,31,22,15,7,0.6818181818181818,13,12,1,0.9230769230769232,0.7843137254901961,GPT4,coral,breastca,PROMPT2_ICL_entailment
143,32,19,15,4,0.7894736842105263,9,8,1,0.8888888888888888,0.8362369337979094,GPT4,coral,breastca,PROMPT2_ICL_entailment
144,33,24,22,2,0.9166666666666666,8,8,0,1.0,0.9565217391304348,GPT4,coral,breastca,PROMPT2_ICL_entailment
145,34,14,14,0,1.0,10,9,1,0.9,0.9473684210526316,GPT4,coral,breastca,PROMPT2_ICL_entailment
146,35,25,22,3,0.88,12,10,2,0.8333333333333334,0.8560311284046693,GPT4,coral,breastca,PROMPT2_ICL_entailment
147,36,31,30,1,0.967741935483871,11,10,1,0.9090909090909092,0.9375,GPT4,coral,breastca,PROMPT2_ICL_entailment
148,37,18,18,0,1.0,11,8,3,0.7272727272727273,0.8421052631578948,GPT4,coral,breastca,PROMPT2_ICL_entailment
149,38,28,26,2,0.9285714285714286,11,8,3,0.7272727272727273,0.8156862745098039,GPT4,coral,breastca,PROMPT2_ICL_entailment
150,39,22,22,0,1.0,11,10,1,0.9090909090909092,0.9523809523809524,GPT4,coral,breastca,PROMPT2_ICL_entailment
151,4,85,43,42,0.5058823529411764,59,34,25,0.576271186440678,0.5387875437626681,GPT4,coral,breastca,PROMPT2_ICL_entailment
152,40,24,23,1,0.9583333333333334,9,9,0,1.0,0.9787234042553192,GPT4,coral,breastca,PROMPT2_ICL_entailment
153,41,20,18,2,0.9,14,11,3,0.7857142857142857,0.8389830508474577,GPT4,coral,breastca,PROMPT2_ICL_entailment
154,42,26,22,4,0.8461538461538461,9,7,2,0.7777777777777778,0.8105263157894737,GPT4,coral,breastca,PROMPT2_ICL_entailment
155,43,20,19,1,0.95,9,7,2,0.7777777777777778,0.855305466237942,GPT4,coral,breastca,PROMPT2_ICL_entailment
156,44,19,18,1,0.9473684210526316,9,9,0,1.0,0.972972972972973,GPT4,coral,breastca,PROMPT2_ICL_entailment
157,45,8,7,1,0.875,2,2,0,1.0,0.9333333333333332,GPT4,coral,breastca,PROMPT2_ICL_entailment
158,46,22,21,1,0.9545454545454546,5,5,0,1.0,0.9767441860465116,GPT4,coral,breastca,PROMPT2_ICL_entailment
159,47,16,15,1,0.9375,2,2,0,1.0,0.967741935483871,GPT4,coral,breastca,PROMPT2_ICL_entailment
160,48,18,17,1,0.9444444444444444,5,5,0,1.0,0.9714285714285714,GPT4,coral,breastca,PROMPT2_ICL_entailment
161,49,36,26,10,0.7222222222222222,16,13,3,0.8125,0.7647058823529411,GPT4,coral,breastca,PROMPT2_ICL_entailment
162,5,52,48,4,0.9230769230769232,12,9,3,0.75,0.8275862068965517,GPT4,coral,breastca,PROMPT2_ICL_entailment
163,50,39,31,8,0.7948717948717948,16,10,6,0.625,0.6997742663656885,GPT4,coral,breastca,PROMPT2_ICL_entailment
164,51,45,38,7,0.8444444444444444,11,10,1,0.9090909090909092,0.8755760368663594,GPT4,coral,breastca,PROMPT2_ICL_entailment
165,52,20,18,2,0.9,10,10,0,1.0,0.9473684210526316,GPT4,coral,breastca,PROMPT2_ICL_entailment
166,53,23,21,2,0.9130434782608696,10,10,0,1.0,0.9545454545454544,GPT4,coral,breastca,PROMPT2_ICL_entailment
167,54,32,29,3,0.90625,9,7,2,0.7777777777777778,0.8371134020618558,GPT4,coral,breastca,PROMPT2_ICL_entailment
168,55,6,6,0,1.0,1,1,0,1.0,1.0,GPT4,coral,breastca,PROMPT2_ICL_entailment
169,56,18,18,0,1.0,18,7,11,0.3888888888888889,0.56,GPT4,coral,breastca,PROMPT2_ICL_entailment
170,57,32,31,1,0.96875,10,10,0,1.0,0.984126984126984,GPT4,coral,breastca,PROMPT2_ICL_entailment
171,58,26,25,1,0.9615384615384616,10,10,0,1.0,0.9803921568627452,GPT4,coral,breastca,PROMPT2_ICL_entailment
172,59,19,18,1,0.9473684210526316,9,7,2,0.7777777777777778,0.8542372881355932,GPT4,coral,breastca,PROMPT2_ICL_entailment
173,6,25,21,4,0.84,8,8,0,1.0,0.9130434782608696,GPT4,coral,breastca,PROMPT2_ICL_entailment
174,60,20,20,0,1.0,10,10,0,1.0,1.0,GPT4,coral,breastca,PROMPT2_ICL_entailment
175,61,22,21,1,0.9545454545454546,11,10,1,0.9090909090909092,0.9312638580931264,GPT4,coral,breastca,PROMPT2_ICL_entailment
176,62,31,26,5,0.8387096774193549,10,9,1,0.9,0.8682745825602969,GPT4,coral,breastca,PROMPT2_ICL_entailment
177,63,25,23,2,0.92,11,10,1,0.9090909090909092,0.9145129224652088,GPT4,coral,breastca,PROMPT2_ICL_entailment
178,64,12,11,1,0.9166666666666666,18,11,7,0.6111111111111112,0.7333333333333334,GPT4,coral,breastca,PROMPT2_ICL_entailment
179,65,39,38,1,0.9743589743589745,6,6,0,1.0,0.9870129870129868,GPT4,coral,breastca,PROMPT2_ICL_entailment
180,66,26,25,1,0.9615384615384616,10,8,2,0.8,0.8733624454148472,GPT4,coral,breastca,PROMPT2_ICL_entailment
181,67,59,31,28,0.5254237288135594,49,21,28,0.4285714285714285,0.4720812182741117,GPT4,coral,breastca,PROMPT2_ICL_entailment
182,68,24,19,5,0.7916666666666666,8,7,1,0.875,0.8312499999999999,GPT4,coral,breastca,PROMPT2_ICL_entailment
183,69,37,23,14,0.6216216216216216,12,4,8,0.3333333333333333,0.4339622641509433,GPT4,coral,breastca,PROMPT2_ICL_entailment
184,7,29,27,2,0.9310344827586208,11,11,0,1.0,0.9642857142857144,GPT4,coral,breastca,PROMPT2_ICL_entailment
185,70,102,74,28,0.7254901960784313,51,23,28,0.4509803921568627,0.5562091503267973,GPT4,coral,breastca,PROMPT2_ICL_entailment
186,71,16,14,2,0.875,5,5,0,1.0,0.9333333333333332,GPT4,coral,breastca,PROMPT2_ICL_entailment
187,72,13,13,0,1.0,3,2,1,0.6666666666666666,0.8,GPT4,coral,breastca,PROMPT2_ICL_entailment
188,73,16,16,0,1.0,1,1,0,1.0,1.0,GPT4,coral,breastca,PROMPT2_ICL_entailment
189,74,19,18,1,0.9473684210526316,2,2,0,1.0,0.972972972972973,GPT4,coral,breastca,PROMPT2_ICL_entailment
190,75,30,27,3,0.9,6,6,0,1.0,0.9473684210526316,GPT4,coral,breastca,PROMPT2_ICL_entailment
191,76,19,19,0,1.0,7,6,1,0.8571428571428571,0.923076923076923,GPT4,coral,breastca,PROMPT2_ICL_entailment
192,77,16,16,0,1.0,15,8,7,0.5333333333333333,0.6956521739130436,GPT4,coral,breastca,PROMPT2_ICL_entailment
193,78,24,22,2,0.9166666666666666,8,8,0,1.0,0.9565217391304348,GPT4,coral,breastca,PROMPT2_ICL_entailment
194,79,16,15,1,0.9375,8,8,0,1.0,0.967741935483871,GPT4,coral,breastca,PROMPT2_ICL_entailment
195,8,16,13,3,0.8125,9,8,1,0.8888888888888888,0.8489795918367347,GPT4,coral,breastca,PROMPT2_ICL_entailment
196,80,45,43,2,0.9555555555555556,24,14,10,0.5833333333333334,0.7244283995186522,GPT4,coral,breastca,PROMPT2_ICL_entailment
197,81,23,20,3,0.8695652173913043,11,10,1,0.9090909090909092,0.888888888888889,GPT4,coral,breastca,PROMPT2_ICL_entailment
198,82,14,13,1,0.9285714285714286,6,5,1,0.8333333333333334,0.8783783783783784,GPT4,coral,breastca,PROMPT2_ICL_entailment
199,83,18,18,0,1.0,6,5,1,0.8333333333333334,0.9090909090909092,GPT4,coral,breastca,PROMPT2_ICL_entailment
200,84,27,23,4,0.8518518518518519,11,10,1,0.9090909090909092,0.8795411089866157,GPT4,coral,breastca,PROMPT2_ICL_entailment
201,85,25,23,2,0.92,7,7,0,1.0,0.9583333333333334,GPT4,coral,breastca,PROMPT2_ICL_entailment
202,86,27,21,6,0.7777777777777778,16,15,1,0.9375,0.8502024291497976,GPT4,coral,breastca,PROMPT2_ICL_entailment
203,87,19,18,1,0.9473684210526316,8,8,0,1.0,0.972972972972973,GPT4,coral,breastca,PROMPT2_ICL_entailment
204,88,11,10,1,0.9090909090909092,8,8,0,1.0,0.9523809523809524,GPT4,coral,breastca,PROMPT2_ICL_entailment
205,89,17,16,1,0.9411764705882352,11,11,0,1.0,0.9696969696969696,GPT4,coral,breastca,PROMPT2_ICL_entailment
206,9,23,21,2,0.9130434782608696,6,6,0,1.0,0.9545454545454544,GPT4,coral,breastca,PROMPT2_ICL_entailment
207,90,61,38,23,0.6229508196721312,18,10,8,0.5555555555555556,0.5873261205564142,GPT4,coral,breastca,PROMPT2_ICL_entailment
208,91,22,21,1,0.9545454545454546,7,6,1,0.8571428571428571,0.9032258064516128,GPT4,coral,breastca,PROMPT2_ICL_entailment
209,92,9,9,0,1.0,2,2,0,1.0,1.0,GPT4,coral,breastca,PROMPT2_ICL_entailment
210,93,39,38,1,0.9743589743589745,13,9,4,0.6923076923076923,0.8094674556213018,GPT4,coral,breastca,PROMPT2_ICL_entailment
211,94,31,23,8,0.7419354838709677,25,21,4,0.84,0.7879282218597062,GPT4,coral,breastca,PROMPT2_ICL_entailment
212,95,41,37,4,0.902439024390244,13,8,5,0.6153846153846154,0.7317676143386898,GPT4,coral,breastca,PROMPT2_ICL_entailment
213,96,22,19,3,0.8636363636363636,10,10,0,1.0,0.9268292682926828,GPT4,coral,breastca,PROMPT2_ICL_entailment
214,97,35,34,1,0.9714285714285714,11,10,1,0.9090909090909092,0.9392265193370164,GPT4,coral,breastca,PROMPT2_ICL_entailment
215,98,14,13,1,0.9285714285714286,2,1,1,0.5,0.65,GPT4,coral,breastca,PROMPT2_ICL_entailment
216,99,44,43,1,0.9772727272727272,15,11,4,0.7333333333333333,0.837909654561559,GPT4,coral,breastca,PROMPT2_ICL_entailment
0,0,15,15,0,1.0,10,10,0,1.0,1.0,GPT4,coral,breastca,PROMPT2_entailment
1,1,55,46,9,0.8363636363636363,12,9,3,0.75,0.7908309455587391,GPT4,coral,breastca,PROMPT2_entailment
2,10,19,19,0,1.0,10,10,0,1.0,1.0,GPT4,coral,breastca,PROMPT2_entailment
3,100,32,24,8,0.75,26,7,19,0.2692307692307692,0.3962264150943396,GPT4,coral,breastca,PROMPT2_entailment
4,101,34,32,2,0.9411764705882352,18,13,5,0.7222222222222222,0.8172888015717094,GPT4,coral,breastca,PROMPT2_entailment
5,102,14,13,1,0.9285714285714286,7,7,0,1.0,0.962962962962963,GPT4,coral,breastca,PROMPT2_entailment
6,103,30,30,0,1.0,10,10,0,1.0,1.0,GPT4,coral,breastca,PROMPT2_entailment
7,104,52,47,5,0.903846153846154,26,17,9,0.6538461538461539,0.7587844254510921,GPT4,coral,breastca,PROMPT2_entailment
8,105,25,25,0,1.0,15,15,0,1.0,1.0,GPT4,coral,breastca,PROMPT2_entailment
9,106,17,15,2,0.8823529411764706,9,9,0,1.0,0.9375,GPT4,coral,breastca,PROMPT2_entailment
10,107,14,12,2,0.8571428571428571,9,9,0,1.0,0.923076923076923,GPT4,coral,breastca,PROMPT2_entailment
11,108,14,13,1,0.9285714285714286,11,8,3,0.7272727272727273,0.8156862745098039,GPT4,coral,breastca,PROMPT2_entailment
12,109,16,14,2,0.875,11,11,0,1.0,0.9333333333333332,GPT4,coral,breastca,PROMPT2_entailment
13,11,12,11,1,0.9166666666666666,3,3,0,1.0,0.9565217391304348,GPT4,coral,breastca,PROMPT2_entailment
14,110,17,15,2,0.8823529411764706,11,8,3,0.7272727272727273,0.7973421926910299,GPT4,coral,breastca,PROMPT2_entailment
15,111,19,15,4,0.7894736842105263,10,9,1,0.9,0.8411214953271027,GPT4,coral,breastca,PROMPT2_entailment
16,112,15,15,0,1.0,10,10,0,1.0,1.0,GPT4,coral,breastca,PROMPT2_entailment
17,113,44,32,12,0.7272727272727273,49,23,26,0.4693877551020408,0.5705426356589147,GPT4,coral,breastca,PROMPT2_entailment
18,114,39,34,5,0.8717948717948718,21,11,10,0.5238095238095238,0.6544181977252844,GPT4,coral,breastca,PROMPT2_entailment
19,115,15,14,1,0.9333333333333332,9,8,1,0.8888888888888888,0.9105691056910568,GPT4,coral,breastca,PROMPT2_entailment
20,116,21,20,1,0.9523809523809524,14,11,3,0.7857142857142857,0.8610567514677103,GPT4,coral,breastca,PROMPT2_entailment
21,117,9,8,1,0.8888888888888888,2,2,0,1.0,0.9411764705882352,GPT4,coral,breastca,PROMPT2_entailment
22,118,18,18,0,1.0,19,4,15,0.2105263157894736,0.3478260869565217,GPT4,coral,breastca,PROMPT2_entailment
23,119,14,13,1,0.9285714285714286,10,9,1,0.9,0.9140625,GPT4,coral,breastca,PROMPT2_entailment
24,12,13,13,0,1.0,10,9,1,0.9,0.9473684210526316,GPT4,coral,breastca,PROMPT2_entailment
25,120,21,21,0,1.0,9,9,0,1.0,1.0,GPT4,coral,breastca,PROMPT2_entailment
26,121,22,18,4,0.8181818181818182,10,10,0,1.0,0.9,GPT4,coral,breastca,PROMPT2_entailment
27,122,18,18,0,1.0,9,9,0,1.0,1.0,GPT4,coral,breastca,PROMPT2_entailment
28,123,15,15,0,1.0,8,8,0,1.0,1.0,GPT4,coral,breastca,PROMPT2_entailment
29,124,21,20,1,0.9523809523809524,10,10,0,1.0,0.975609756097561,GPT4,coral,breastca,PROMPT2_entailment
30,125,24,20,4,0.8333333333333334,11,8,3,0.7272727272727273,0.7766990291262137,GPT4,coral,breastca,PROMPT2_entailment
31,126,18,17,1,0.9444444444444444,10,10,0,1.0,0.9714285714285714,GPT4,coral,breastca,PROMPT2_entailment
32,127,21,20,1,0.9523809523809524,10,9,1,0.9,0.9254498714652956,GPT4,coral,breastca,PROMPT2_entailment
33,128,24,22,2,0.9166666666666666,11,9,2,0.8181818181818182,0.8646288209606987,GPT4,coral,breastca,PROMPT2_entailment
34,129,24,23,1,0.9583333333333334,11,9,2,0.8181818181818182,0.8827292110874201,GPT4,coral,breastca,PROMPT2_entailment
35,13,18,13,5,0.7222222222222222,10,7,3,0.7,0.7109375000000001,GPT4,coral,breastca,PROMPT2_entailment
36,130,10,10,0,1.0,7,4,3,0.5714285714285714,0.7272727272727273,GPT4,coral,breastca,PROMPT2_entailment
37,131,39,39,0,1.0,10,8,2,0.8,0.888888888888889,GPT4,coral,breastca,PROMPT2_entailment
38,132,17,16,1,0.9411764705882352,8,7,1,0.875,0.9068825910931174,GPT4,coral,breastca,PROMPT2_entailment
39,133,31,26,5,0.8387096774193549,29,22,7,0.7586206896551724,0.796657381615599,GPT4,coral,breastca,PROMPT2_entailment
40,134,30,11,19,0.3666666666666666,11,9,2,0.8181818181818182,0.5063938618925831,GPT4,coral,breastca,PROMPT2_entailment
41,135,27,20,7,0.7407407407407407,16,13,3,0.8125,0.7749627421758569,GPT4,coral,breastca,PROMPT2_entailment
42,136,19,17,2,0.8947368421052632,10,7,3,0.7,0.7854785478547854,GPT4,coral,breastca,PROMPT2_entailment
43,137,15,15,0,1.0,10,10,0,1.0,1.0,GPT4,coral,breastca,PROMPT2_entailment
44,138,12,12,0,1.0,10,10,0,1.0,1.0,GPT4,coral,breastca,PROMPT2_entailment
45,139,21,17,4,0.8095238095238095,11,9,2,0.8181818181818182,0.8138297872340425,GPT4,coral,breastca,PROMPT2_entailment
46,14,61,46,15,0.7540983606557377,59,19,40,0.3220338983050847,0.4513297185644203,GPT4,coral,breastca,PROMPT2_entailment
47,140,25,22,3,0.88,9,9,0,1.0,0.9361702127659576,GPT4,coral,breastca,PROMPT2_entailment
48,141,26,22,4,0.8461538461538461,11,11,0,1.0,0.9166666666666666,GPT4,coral,breastca,PROMPT2_entailment
49,142,12,12,0,1.0,10,10,0,1.0,1.0,GPT4,coral,breastca,PROMPT2_entailment
50,143,13,10,3,0.7692307692307693,10,9,1,0.9,0.8294930875576038,GPT4,coral,breastca,PROMPT2_entailment
51,144,16,16,0,1.0,5,3,2,0.6,0.7499999999999999,GPT4,coral,breastca,PROMPT2_entailment
52,145,14,14,0,1.0,5,5,0,1.0,1.0,GPT4,coral,breastca,PROMPT2_entailment
53,146,16,16,0,1.0,9,9,0,1.0,1.0,GPT4,coral,breastca,PROMPT2_entailment
54,147,26,25,1,0.9615384615384616,5,4,1,0.8,0.8733624454148472,GPT4,coral,breastca,PROMPT2_entailment
55,148,18,14,4,0.7777777777777778,4,3,1,0.75,0.7636363636363638,GPT4,coral,breastca,PROMPT2_entailment
56,149,11,11,0,1.0,1,1,0,1.0,1.0,GPT4,coral,breastca,PROMPT2_entailment
57,15,34,27,7,0.7941176470588235,16,7,9,0.4375,0.564179104477612,GPT4,coral,breastca,PROMPT2_entailment
58,150,19,17,2,0.8947368421052632,2,2,0,1.0,0.9444444444444444,GPT4,coral,breastca,PROMPT2_entailment
59,151,13,13,0,1.0,9,8,1,0.8888888888888888,0.9411764705882352,GPT4,coral,breastca,PROMPT2_entailment
60,152,16,13,3,0.8125,16,14,2,0.875,0.8425925925925926,GPT4,coral,breastca,PROMPT2_entailment
61,153,14,13,1,0.9285714285714286,1,1,0,1.0,0.962962962962963,GPT4,coral,breastca,PROMPT2_entailment
62,154,14,13,1,0.9285714285714286,10,10,0,1.0,0.962962962962963,GPT4,coral,breastca,PROMPT2_entailment
63,155,28,24,4,0.8571428571428571,9,9,0,1.0,0.923076923076923,GPT4,coral,breastca,PROMPT2_entailment
64,156,20,19,1,0.95,8,8,0,1.0,0.9743589743589745,GPT4,coral,breastca,PROMPT2_entailment
65,157,15,15,0,1.0,9,9,0,1.0,1.0,GPT4,coral,breastca,PROMPT2_entailment
66,158,38,26,12,0.6842105263157895,16,14,2,0.875,0.7679324894514769,GPT4,coral,breastca,PROMPT2_entailment
67,159,30,24,6,0.8,29,16,13,0.5517241379310345,0.6530612244897959,GPT4,coral,breastca,PROMPT2_entailment
68,16,23,22,1,0.9565217391304348,10,8,2,0.8,0.8712871287128713,GPT4,coral,breastca,PROMPT2_entailment
69,160,25,21,4,0.84,18,12,6,0.6666666666666666,0.743362831858407,GPT4,coral,breastca,PROMPT2_entailment
70,161,37,37,0,1.0,11,10,1,0.9090909090909092,0.9523809523809524,GPT4,coral,breastca,PROMPT2_entailment
71,162,17,17,0,1.0,16,11,5,0.6875,0.8148148148148148,GPT4,coral,breastca,PROMPT2_entailment
72,163,17,17,0,1.0,11,10,1,0.9090909090909092,0.9523809523809524,GPT4,coral,breastca,PROMPT2_entailment
73,164,13,12,1,0.9230769230769232,8,5,3,0.625,0.7453416149068324,GPT4,coral,breastca,PROMPT2_entailment
74,165,20,20,0,1.0,12,8,4,0.6666666666666666,0.8,GPT4,coral,breastca,PROMPT2_entailment
75,166,13,12,1,0.9230769230769232,10,6,4,0.6,0.7272727272727274,GPT4,coral,breastca,PROMPT2_entailment
76,167,25,20,5,0.8,7,7,0,1.0,0.888888888888889,GPT4,coral,breastca,PROMPT2_entailment
77,168,13,10,3,0.7692307692307693,7,4,3,0.5714285714285714,0.6557377049180327,GPT4,coral,breastca,PROMPT2_entailment
78,169,13,13,0,1.0,11,6,5,0.5454545454545454,0.7058823529411764,GPT4,coral,breastca,PROMPT2_entailment
79,17,6,5,1,0.8333333333333334,3,3,0,1.0,0.9090909090909092,GPT4,coral,breastca,PROMPT2_entailment
80,170,16,15,1,0.9375,10,10,0,1.0,0.967741935483871,GPT4,coral,breastca,PROMPT2_entailment
81,171,25,25,0,1.0,9,8,1,0.8888888888888888,0.9411764705882352,GPT4,coral,breastca,PROMPT2_entailment
82,172,47,46,1,0.9787234042553192,32,19,13,0.59375,0.7391120507399578,GPT4,coral,breastca,PROMPT2_entailment
83,173,16,14,2,0.875,11,9,2,0.8181818181818182,0.8456375838926175,GPT4,coral,breastca,PROMPT2_entailment
84,174,15,12,3,0.8,7,5,2,0.7142857142857143,0.7547169811320756,GPT4,coral,breastca,PROMPT2_entailment
85,175,12,10,2,0.8333333333333334,10,9,1,0.9,0.8653846153846153,GPT4,coral,breastca,PROMPT2_entailment
86,176,15,15,0,1.0,10,10,0,1.0,1.0,GPT4,coral,breastca,PROMPT2_entailment
87,177,20,20,0,1.0,9,9,0,1.0,1.0,GPT4,coral,breastca,PROMPT2_entailment
88,178,19,16,3,0.8421052631578947,10,9,1,0.9,0.8700906344410877,GPT4,coral,breastca,PROMPT2_entailment
89,179,21,20,1,0.9523809523809524,9,8,1,0.8888888888888888,0.9195402298850576,GPT4,coral,breastca,PROMPT2_entailment
90,18,22,22,0,1.0,8,8,0,1.0,1.0,GPT4,coral,breastca,PROMPT2_entailment
91,180,17,16,1,0.9411764705882352,10,9,1,0.9,0.9201277955271564,GPT4,coral,breastca,PROMPT2_entailment
92,181,14,11,3,0.7857142857142857,9,8,1,0.8888888888888888,0.8341232227488152,GPT4,coral,breastca,PROMPT2_entailment
93,182,20,19,1,0.95,9,9,0,1.0,0.9743589743589745,GPT4,coral,breastca,PROMPT2_entailment
94,183,16,16,0,1.0,10,8,2,0.8,0.888888888888889,GPT4,coral,breastca,PROMPT2_entailment
95,184,20,17,3,0.85,9,7,2,0.7777777777777778,0.8122866894197952,GPT4,coral,breastca,PROMPT2_entailment
96,185,30,29,1,0.9666666666666668,10,9,1,0.9,0.9321428571428572,GPT4,coral,breastca,PROMPT2_entailment
97,186,10,10,0,1.0,5,5,0,1.0,1.0,GPT4,coral,breastca,PROMPT2_entailment
98,187,23,20,3,0.8695652173913043,26,15,11,0.5769230769230769,0.6936416184971097,GPT4,coral,breastca,PROMPT2_entailment
99,188,15,15,0,1.0,9,9,0,1.0,1.0,GPT4,coral,breastca,PROMPT2_entailment
100,189,18,18,0,1.0,9,8,1,0.8888888888888888,0.9411764705882352,GPT4,coral,breastca,PROMPT2_entailment
101,19,19,16,3,0.8421052631578947,8,7,1,0.875,0.8582375478927203,GPT4,coral,breastca,PROMPT2_entailment
102,190,38,21,17,0.5526315789473685,34,17,17,0.5,0.525,GPT4,coral,breastca,PROMPT2_entailment
103,191,32,26,6,0.8125,14,5,9,0.3571428571428571,0.4961832061068702,GPT4,coral,breastca,PROMPT2_entailment
104,192,21,17,4,0.8095238095238095,12,10,2,0.8333333333333334,0.8212560386473431,GPT4,coral,breastca,PROMPT2_entailment
105,193,13,13,0,1.0,2,2,0,1.0,1.0,GPT4,coral,breastca,PROMPT2_entailment
106,194,32,32,0,1.0,15,13,2,0.8666666666666667,0.9285714285714286,GPT4,coral,breastca,PROMPT2_entailment
107,195,21,19,2,0.9047619047619048,13,13,0,1.0,0.95,GPT4,coral,breastca,PROMPT2_entailment
108,196,32,26,6,0.8125,30,22,8,0.7333333333333333,0.77088948787062,GPT4,coral,breastca,PROMPT2_entailment
109,197,43,41,2,0.9534883720930232,14,9,5,0.6428571428571429,0.7679500520291364,GPT4,coral,breastca,PROMPT2_entailment
110,198,21,20,1,0.9523809523809524,11,10,1,0.9090909090909092,0.9302325581395348,GPT4,coral,breastca,PROMPT2_entailment
111,199,5,5,0,1.0,2,2,0,1.0,1.0,GPT4,coral,breastca,PROMPT2_entailment
112,2,28,22,6,0.7857142857142857,10,8,2,0.8,0.7927927927927927,GPT4,coral,breastca,PROMPT2_entailment
113,20,18,15,3,0.8333333333333334,17,9,8,0.5294117647058824,0.6474820143884893,GPT4,coral,breastca,PROMPT2_entailment
114,200,30,29,1,0.9666666666666668,15,12,3,0.8,0.8754716981132077,GPT4,coral,breastca,PROMPT2_entailment
115,201,31,23,8,0.7419354838709677,26,22,4,0.8461538461538461,0.7906250000000001,GPT4,coral,breastca,PROMPT2_entailment
116,202,24,19,5,0.7916666666666666,17,14,3,0.8235294117647058,0.8072837632776934,GPT4,coral,breastca,PROMPT2_entailment
117,203,43,39,4,0.9069767441860463,27,17,10,0.6296296296296297,0.7432735426008968,GPT4,coral,breastca,PROMPT2_entailment
118,204,15,15,0,1.0,11,10,1,0.9090909090909092,0.9523809523809524,GPT4,coral,breastca,PROMPT2_entailment
119,205,16,16,0,1.0,11,11,0,1.0,1.0,GPT4,coral,breastca,PROMPT2_entailment
120,206,18,18,0,1.0,4,4,0,1.0,1.0,GPT4,coral,breastca,PROMPT2_entailment
121,207,15,14,1,0.9333333333333332,12,7,5,0.5833333333333334,0.7179487179487181,GPT4,coral,breastca,PROMPT2_entailment
122,208,15,15,0,1.0,9,9,0,1.0,1.0,GPT4,coral,breastca,PROMPT2_entailment
123,209,49,47,2,0.9591836734693876,11,7,4,0.6363636363636364,0.7651162790697675,GPT4,coral,breastca,PROMPT2_entailment
124,21,47,30,17,0.6382978723404256,27,16,11,0.5925925925925926,0.614596670934699,GPT4,coral,breastca,PROMPT2_entailment
125,210,26,24,2,0.9230769230769232,13,11,2,0.8461538461538461,0.8829431438127091,GPT4,coral,breastca,PROMPT2_entailment
126,211,22,18,4,0.8181818181818182,11,6,5,0.5454545454545454,0.6545454545454545,GPT4,coral,breastca,PROMPT2_entailment
127,212,24,23,1,0.9583333333333334,9,8,1,0.8888888888888888,0.9223057644110276,GPT4,coral,breastca,PROMPT2_entailment
128,213,24,20,4,0.8333333333333334,11,10,1,0.9090909090909092,0.8695652173913043,GPT4,coral,breastca,PROMPT2_entailment
129,214,18,11,7,0.6111111111111112,28,18,10,0.6428571428571429,0.6265822784810128,GPT4,coral,breastca,PROMPT2_entailment
130,215,44,20,24,0.4545454545454545,37,19,18,0.5135135135135135,0.482233502538071,GPT4,coral,breastca,PROMPT2_entailment
131,216,36,32,4,0.8888888888888888,15,13,2,0.8666666666666667,0.8776371308016878,GPT4,coral,breastca,PROMPT2_entailment
132,22,26,19,7,0.7307692307692307,7,6,1,0.8571428571428571,0.7889273356401383,GPT4,coral,breastca,PROMPT2_entailment
133,23,16,15,1,0.9375,9,8,1,0.8888888888888888,0.9125475285171102,GPT4,coral,breastca,PROMPT2_entailment
134,24,14,13,1,0.9285714285714286,10,9,1,0.9,0.9140625,GPT4,coral,breastca,PROMPT2_entailment
135,25,27,27,0,1.0,8,8,0,1.0,1.0,GPT4,coral,breastca,PROMPT2_entailment
136,26,16,16,0,1.0,11,6,5,0.5454545454545454,0.7058823529411764,GPT4,coral,breastca,PROMPT2_entailment
137,27,16,15,1,0.9375,12,9,3,0.75,0.8333333333333334,GPT4,coral,breastca,PROMPT2_entailment
138,28,30,29,1,0.9666666666666668,18,14,4,0.7777777777777778,0.861995753715499,GPT4,coral,breastca,PROMPT2_entailment
139,29,34,27,7,0.7941176470588235,9,4,5,0.4444444444444444,0.5699208443271767,GPT4,coral,breastca,PROMPT2_entailment
140,3,26,18,8,0.6923076923076923,11,7,4,0.6363636363636364,0.663157894736842,GPT4,coral,breastca,PROMPT2_entailment
141,30,55,38,17,0.6909090909090909,18,14,4,0.7777777777777778,0.7317744154057773,GPT4,coral,breastca,PROMPT2_entailment
142,31,23,14,9,0.6086956521739131,13,10,3,0.7692307692307693,0.679611650485437,GPT4,coral,breastca,PROMPT2_entailment
143,32,17,15,2,0.8823529411764706,9,9,0,1.0,0.9375,GPT4,coral,breastca,PROMPT2_entailment
144,33,22,17,5,0.7727272727272727,8,5,3,0.625,0.6910569105691057,GPT4,coral,breastca,PROMPT2_entailment
145,34,13,12,1,0.9230769230769232,10,7,3,0.7,0.7962085308056872,GPT4,coral,breastca,PROMPT2_entailment
146,35,21,18,3,0.8571428571428571,12,10,2,0.8333333333333334,0.8450704225352113,GPT4,coral,breastca,PROMPT2_entailment
147,36,15,13,2,0.8666666666666667,11,9,2,0.8181818181818182,0.8417266187050358,GPT4,coral,breastca,PROMPT2_entailment
148,37,12,10,2,0.8333333333333334,11,9,2,0.8181818181818182,0.8256880733944955,GPT4,coral,breastca,PROMPT2_entailment
149,38,21,21,0,1.0,11,7,4,0.6363636363636364,0.7777777777777778,GPT4,coral,breastca,PROMPT2_entailment
150,39,16,16,0,1.0,11,9,2,0.8181818181818182,0.9,GPT4,coral,breastca,PROMPT2_entailment
151,4,59,39,20,0.6610169491525424,59,28,31,0.4745762711864407,0.5524917783961548,GPT4,coral,breastca,PROMPT2_entailment
152,40,14,14,0,1.0,9,7,2,0.7777777777777778,0.8750000000000001,GPT4,coral,breastca,PROMPT2_entailment
153,41,29,22,7,0.7586206896551724,14,10,4,0.7142857142857143,0.7357859531772576,GPT4,coral,breastca,PROMPT2_entailment
154,42,26,22,4,0.8461538461538461,9,6,3,0.6666666666666666,0.7457627118644068,GPT4,coral,breastca,PROMPT2_entailment
155,43,14,14,0,1.0,9,7,2,0.7777777777777778,0.8750000000000001,GPT4,coral,breastca,PROMPT2_entailment
156,44,13,13,0,1.0,9,9,0,1.0,1.0,GPT4,coral,breastca,PROMPT2_entailment
157,45,1,0,1,0.0,2,0,2,0.0,,GPT4,coral,breastca,PROMPT2_entailment
158,46,18,17,1,0.9444444444444444,5,5,0,1.0,0.9714285714285714,GPT4,coral,breastca,PROMPT2_entailment
159,47,15,13,2,0.8666666666666667,2,2,0,1.0,0.9285714285714286,GPT4,coral,breastca,PROMPT2_entailment
160,48,19,18,1,0.9473684210526316,5,4,1,0.8,0.8674698795180723,GPT4,coral,breastca,PROMPT2_entailment
161,49,31,24,7,0.7741935483870968,16,12,4,0.75,0.7619047619047619,GPT4,coral,breastca,PROMPT2_entailment
162,5,37,34,3,0.918918918918919,12,9,3,0.75,0.8259109311740892,GPT4,coral,breastca,PROMPT2_entailment
163,50,26,16,10,0.6153846153846154,16,10,6,0.625,0.6201550387596899,GPT4,coral,breastca,PROMPT2_entailment
164,51,41,33,8,0.8048780487804879,11,10,1,0.9090909090909092,0.8538163001293662,GPT4,coral,breastca,PROMPT2_entailment
165,52,19,16,3,0.8421052631578947,10,10,0,1.0,0.9142857142857144,GPT4,coral,breastca,PROMPT2_entailment
166,53,20,19,1,0.95,10,10,0,1.0,0.9743589743589745,GPT4,coral,breastca,PROMPT2_entailment
167,54,17,15,2,0.8823529411764706,9,8,1,0.8888888888888888,0.8856088560885608,GPT4,coral,breastca,PROMPT2_entailment
168,55,3,3,0,1.0,1,1,0,1.0,1.0,GPT4,coral,breastca,PROMPT2_entailment
169,56,9,8,1,0.8888888888888888,18,5,13,0.2777777777777778,0.4232804232804233,GPT4,coral,breastca,PROMPT2_entailment
170,57,34,33,1,0.9705882352941176,10,9,1,0.9,0.9339622641509434,GPT4,coral,breastca,PROMPT2_entailment
171,58,25,23,2,0.92,10,9,1,0.9,0.90989010989011,GPT4,coral,breastca,PROMPT2_entailment
172,59,15,15,0,1.0,9,7,2,0.7777777777777778,0.8750000000000001,GPT4,coral,breastca,PROMPT2_entailment
173,6,16,14,2,0.875,8,8,0,1.0,0.9333333333333332,GPT4,coral,breastca,PROMPT2_entailment
174,60,19,19,0,1.0,10,10,0,1.0,1.0,GPT4,coral,breastca,PROMPT2_entailment
175,61,21,20,1,0.9523809523809524,11,10,1,0.9090909090909092,0.9302325581395348,GPT4,coral,breastca,PROMPT2_entailment
176,62,24,21,3,0.875,10,9,1,0.9,0.8873239436619719,GPT4,coral,breastca,PROMPT2_entailment
177,63,14,14,0,1.0,11,10,1,0.9090909090909092,0.9523809523809524,GPT4,coral,breastca,PROMPT2_entailment
178,64,12,12,0,1.0,18,8,10,0.4444444444444444,0.6153846153846153,GPT4,coral,breastca,PROMPT2_entailment
179,65,32,31,1,0.96875,6,6,0,1.0,0.984126984126984,GPT4,coral,breastca,PROMPT2_entailment
180,66,21,21,0,1.0,10,10,0,1.0,1.0,GPT4,coral,breastca,PROMPT2_entailment
181,67,39,22,17,0.5641025641025641,49,23,26,0.4693877551020408,0.5124050632911392,GPT4,coral,breastca,PROMPT2_entailment
182,68,13,13,0,1.0,8,8,0,1.0,1.0,GPT4,coral,breastca,PROMPT2_entailment
183,69,19,15,4,0.7894736842105263,12,5,7,0.4166666666666667,0.5454545454545454,GPT4,coral,breastca,PROMPT2_entailment
184,7,17,16,1,0.9411764705882352,11,9,2,0.8181818181818182,0.8753799392097266,GPT4,coral,breastca,PROMPT2_entailment
185,70,100,83,17,0.83,51,18,33,0.3529411764705882,0.4952759820984586,GPT4,coral,breastca,PROMPT2_entailment
186,71,15,15,0,1.0,5,5,0,1.0,1.0,GPT4,coral,breastca,PROMPT2_entailment
187,72,11,11,0,1.0,3,2,1,0.6666666666666666,0.8,GPT4,coral,breastca,PROMPT2_entailment
188,73,14,14,0,1.0,1,1,0,1.0,1.0,GPT4,coral,breastca,PROMPT2_entailment
189,74,12,10,2,0.8333333333333334,2,2,0,1.0,0.9090909090909092,GPT4,coral,breastca,PROMPT2_entailment
190,75,21,18,3,0.8571428571428571,6,6,0,1.0,0.923076923076923,GPT4,coral,breastca,PROMPT2_entailment
191,76,15,15,0,1.0,7,7,0,1.0,1.0,GPT4,coral,breastca,PROMPT2_entailment
192,77,14,13,1,0.9285714285714286,15,8,7,0.5333333333333333,0.6775244299674267,GPT4,coral,breastca,PROMPT2_entailment
193,78,19,19,0,1.0,8,8,0,1.0,1.0,GPT4,coral,breastca,PROMPT2_entailment
194,79,13,12,1,0.9230769230769232,8,8,0,1.0,0.96,GPT4,coral,breastca,PROMPT2_entailment
195,8,12,12,0,1.0,9,9,0,1.0,1.0,GPT4,coral,breastca,PROMPT2_entailment
196,80,29,29,0,1.0,24,15,9,0.625,0.7692307692307693,GPT4,coral,breastca,PROMPT2_entailment
197,81,11,9,2,0.8181818181818182,11,10,1,0.9090909090909092,0.861244019138756,GPT4,coral,breastca,PROMPT2_entailment
198,82,12,9,3,0.75,6,6,0,1.0,0.8571428571428571,GPT4,coral,breastca,PROMPT2_entailment
199,83,14,14,0,1.0,6,6,0,1.0,1.0,GPT4,coral,breastca,PROMPT2_entailment
200,84,20,16,4,0.8,11,9,2,0.8181818181818182,0.8089887640449439,GPT4,coral,breastca,PROMPT2_entailment
201,85,19,18,1,0.9473684210526316,7,7,0,1.0,0.972972972972973,GPT4,coral,breastca,PROMPT2_entailment
202,86,22,15,7,0.6818181818181818,16,15,1,0.9375,0.7894736842105263,GPT4,coral,breastca,PROMPT2_entailment
203,87,17,16,1,0.9411764705882352,8,8,0,1.0,0.9696969696969696,GPT4,coral,breastca,PROMPT2_entailment
204,88,10,10,0,1.0,8,8,0,1.0,1.0,GPT4,coral,breastca,PROMPT2_entailment
205,89,13,13,0,1.0,11,11,0,1.0,1.0,GPT4,coral,breastca,PROMPT2_entailment
206,9,21,17,4,0.8095238095238095,6,6,0,1.0,0.8947368421052632,GPT4,coral,breastca,PROMPT2_entailment
207,90,40,26,14,0.65,18,15,3,0.8333333333333334,0.7303370786516855,GPT4,coral,breastca,PROMPT2_entailment
208,91,19,18,1,0.9473684210526316,7,5,2,0.7142857142857143,0.8144796380090498,GPT4,coral,breastca,PROMPT2_entailment
209,92,7,6,1,0.8571428571428571,2,1,1,0.5,0.631578947368421,GPT4,coral,breastca,PROMPT2_entailment
210,93,25,24,1,0.96,13,11,2,0.8461538461538461,0.8994889267461669,GPT4,coral,breastca,PROMPT2_entailment
211,94,28,23,5,0.8214285714285714,25,19,6,0.76,0.7895212285456187,GPT4,coral,breastca,PROMPT2_entailment
212,95,49,40,9,0.8163265306122449,13,4,9,0.3076923076923077,0.446927374301676,GPT4,coral,breastca,PROMPT2_entailment
213,96,14,12,2,0.8571428571428571,10,10,0,1.0,0.923076923076923,GPT4,coral,breastca,PROMPT2_entailment
214,97,33,32,1,0.9696969696969696,11,7,4,0.6363636363636364,0.7684391080617496,GPT4,coral,breastca,PROMPT2_entailment
215,98,13,13,0,1.0,2,2,0,1.0,1.0,GPT4,coral,breastca,PROMPT2_entailment
216,99,30,27,3,0.9,15,8,7,0.5333333333333333,0.6697674418604651,GPT4,coral,breastca,PROMPT2_entailment
0,0,11,8,3,0.7272727272727273,11,10,1,0.9090909090909092,0.8080808080808082,GPT4,mimiciii,nursing_note,PROMPT1_entailment
1,1,22,18,4,0.8181818181818182,31,24,7,0.7741935483870968,0.7955801104972376,GPT4,mimiciii,nursing_note,PROMPT1_entailment
2,10,22,15,7,0.6818181818181818,18,13,5,0.7222222222222222,0.7014388489208633,GPT4,mimiciii,nursing_note,PROMPT1_entailment
3,100,10,10,0,1.0,6,6,0,1.0,1.0,GPT4,mimiciii,nursing_note,PROMPT1_entailment
4,101,27,23,4,0.8518518518518519,27,26,1,0.9629629629629628,0.9040060468631896,GPT4,mimiciii,nursing_note,PROMPT1_entailment
5,102,19,16,3,0.8421052631578947,26,18,8,0.6923076923076923,0.7598944591029023,GPT4,mimiciii,nursing_note,PROMPT1_entailment
6,103,22,19,3,0.8636363636363636,22,22,0,1.0,0.9268292682926828,GPT4,mimiciii,nursing_note,PROMPT1_entailment
7,104,26,19,7,0.7307692307692307,20,20,0,1.0,0.8444444444444443,GPT4,mimiciii,nursing_note,PROMPT1_entailment
8,105,19,15,4,0.7894736842105263,20,20,0,1.0,0.8823529411764706,GPT4,mimiciii,nursing_note,PROMPT1_entailment
9,106,6,6,0,1.0,4,4,0,1.0,1.0,GPT4,mimiciii,nursing_note,PROMPT1_entailment
10,107,50,34,16,0.68,49,41,8,0.8367346938775511,0.7502691065662003,GPT4,mimiciii,nursing_note,PROMPT1_entailment
11,108,37,35,2,0.945945945945946,28,24,4,0.8571428571428571,0.899357601713062,GPT4,mimiciii,nursing_note,PROMPT1_entailment
12,109,5,5,0,1.0,4,4,0,1.0,1.0,GPT4,mimiciii,nursing_note,PROMPT1_entailment
13,11,3,3,0,1.0,2,2,0,1.0,1.0,GPT4,mimiciii,nursing_note,PROMPT1_entailment
14,110,12,12,0,1.0,13,11,2,0.8461538461538461,0.9166666666666666,GPT4,mimiciii,nursing_note,PROMPT1_entailment
15,111,22,12,10,0.5454545454545454,32,25,7,0.78125,0.6423982869379015,GPT4,mimiciii,nursing_note,PROMPT1_entailment
16,112,40,28,12,0.7,37,34,3,0.918918918918919,0.7946577629382303,GPT4,mimiciii,nursing_note,PROMPT1_entailment
17,113,6,6,0,1.0,5,4,1,0.8,0.888888888888889,GPT4,mimiciii,nursing_note,PROMPT1_entailment
18,114,18,10,8,0.5555555555555556,19,14,5,0.7368421052631579,0.6334841628959277,GPT4,mimiciii,nursing_note,PROMPT1_entailment
19,115,11,11,0,1.0,7,7,0,1.0,1.0,GPT4,mimiciii,nursing_note,PROMPT1_entailment
20,116,27,26,1,0.9629629629629628,31,28,3,0.9032258064516128,0.9321382842509603,GPT4,mimiciii,nursing_note,PROMPT1_entailment
21,117,38,36,2,0.9473684210526316,18,13,5,0.7222222222222222,0.8196147110332749,GPT4,mimiciii,nursing_note,PROMPT1_entailment
22,118,26,19,7,0.7307692307692307,25,22,3,0.88,0.7984718242597898,GPT4,mimiciii,nursing_note,PROMPT1_entailment
23,119,23,20,3,0.8695652173913043,26,24,2,0.9230769230769232,0.8955223880597014,GPT4,mimiciii,nursing_note,PROMPT1_entailment
24,12,21,20,1,0.9523809523809524,18,15,3,0.8333333333333334,0.888888888888889,GPT4,mimiciii,nursing_note,PROMPT1_entailment
25,120,18,14,4,0.7777777777777778,18,18,0,1.0,0.8750000000000001,GPT4,mimiciii,nursing_note,PROMPT1_entailment
26,121,27,25,2,0.925925925925926,37,32,5,0.8648648648648649,0.8943543879262157,GPT4,mimiciii,nursing_note,PROMPT1_entailment
27,122,15,10,5,0.6666666666666666,11,10,1,0.9090909090909092,0.7692307692307692,GPT4,mimiciii,nursing_note,PROMPT1_entailment
28,123,5,5,0,1.0,6,6,0,1.0,1.0,GPT4,mimiciii,nursing_note,PROMPT1_entailment
29,124,7,7,0,1.0,5,5,0,1.0,1.0,GPT4,mimiciii,nursing_note,PROMPT1_entailment
30,125,15,15,0,1.0,43,38,5,0.8837209302325582,0.9382716049382716,GPT4,mimiciii,nursing_note,PROMPT1_entailment
31,126,15,13,2,0.8666666666666667,28,27,1,0.9642857142857144,0.9128738621586476,GPT4,mimiciii,nursing_note,PROMPT1_entailment
32,127,13,13,0,1.0,10,10,0,1.0,1.0,GPT4,mimiciii,nursing_note,PROMPT1_entailment
33,128,24,24,0,1.0,17,17,0,1.0,1.0,GPT4,mimiciii,nursing_note,PROMPT1_entailment
34,129,26,24,2,0.9230769230769232,29,26,3,0.896551724137931,0.9096209912536444,GPT4,mimiciii,nursing_note,PROMPT1_entailment
35,13,25,24,1,0.96,24,18,6,0.75,0.8421052631578947,GPT4,mimiciii,nursing_note,PROMPT1_entailment
36,130,35,22,13,0.6285714285714286,33,28,5,0.8484848484848485,0.7221570926143024,GPT4,mimiciii,nursing_note,PROMPT1_entailment
37,131,32,29,3,0.90625,31,27,4,0.8709677419354839,0.8882586500283607,GPT4,mimiciii,nursing_note,PROMPT1_entailment
38,132,22,12,10,0.5454545454545454,17,16,1,0.9411764705882352,0.6906474820143884,GPT4,mimiciii,nursing_note,PROMPT1_entailment
39,133,16,13,3,0.8125,10,10,0,1.0,0.896551724137931,GPT4,mimiciii,nursing_note,PROMPT1_entailment
40,134,29,8,21,0.2758620689655172,30,24,6,0.8,0.4102564102564103,GPT4,mimiciii,nursing_note,PROMPT1_entailment
41,135,42,27,15,0.6428571428571429,42,31,11,0.7380952380952381,0.6871921182266011,GPT4,mimiciii,nursing_note,PROMPT1_entailment
42,136,38,32,6,0.8421052631578947,41,38,3,0.926829268292683,0.8824383164005807,GPT4,mimiciii,nursing_note,PROMPT1_entailment
43,137,3,3,0,1.0,2,2,0,1.0,1.0,GPT4,mimiciii,nursing_note,PROMPT1_entailment
44,138,5,5,0,1.0,5,4,1,0.8,0.888888888888889,GPT4,mimiciii,nursing_note,PROMPT1_entailment
45,139,7,7,0,1.0,4,3,1,0.75,0.8571428571428571,GPT4,mimiciii,nursing_note,PROMPT1_entailment
46,14,24,23,1,0.9583333333333334,25,23,2,0.92,0.9387755102040816,GPT4,mimiciii,nursing_note,PROMPT1_entailment
47,140,25,17,8,0.68,24,24,0,1.0,0.8095238095238095,GPT4,mimiciii,nursing_note,PROMPT1_entailment
48,141,13,12,1,0.9230769230769232,11,10,1,0.9090909090909092,0.9160305343511452,GPT4,mimiciii,nursing_note,PROMPT1_entailment
49,142,22,19,3,0.8636363636363636,8,8,0,1.0,0.9268292682926828,GPT4,mimiciii,nursing_note,PROMPT1_entailment
50,143,12,10,2,0.8333333333333334,2,1,1,0.5,0.625,GPT4,mimiciii,nursing_note,PROMPT1_entailment
51,144,9,8,1,0.8888888888888888,5,5,0,1.0,0.9411764705882352,GPT4,mimiciii,nursing_note,PROMPT1_entailment
52,145,18,16,2,0.8888888888888888,19,17,2,0.8947368421052632,0.8918032786885245,GPT4,mimiciii,nursing_note,PROMPT1_entailment
53,146,8,7,1,0.875,6,5,1,0.8333333333333334,0.8536585365853658,GPT4,mimiciii,nursing_note,PROMPT1_entailment
54,147,16,12,4,0.75,26,23,3,0.8846153846153846,0.8117647058823529,GPT4,mimiciii,nursing_note,PROMPT1_entailment
55,148,9,9,0,1.0,7,7,0,1.0,1.0,GPT4,mimiciii,nursing_note,PROMPT1_entailment
56,149,23,17,6,0.7391304347826086,36,27,9,0.75,0.7445255474452556,GPT4,mimiciii,nursing_note,PROMPT1_entailment
57,15,29,26,3,0.896551724137931,33,24,9,0.7272727272727273,0.8030888030888031,GPT4,mimiciii,nursing_note,PROMPT1_entailment
58,150,10,10,0,1.0,8,7,1,0.875,0.9333333333333332,GPT4,mimiciii,nursing_note,PROMPT1_entailment
59,151,11,10,1,0.9090909090909092,26,22,4,0.8461538461538461,0.8764940239043824,GPT4,mimiciii,nursing_note,PROMPT1_entailment
60,152,28,27,1,0.9642857142857144,44,35,9,0.7954545454545454,0.871771217712177,GPT4,mimiciii,nursing_note,PROMPT1_entailment
61,153,4,4,0,1.0,4,3,1,0.75,0.8571428571428571,GPT4,mimiciii,nursing_note,PROMPT1_entailment
62,154,35,32,3,0.9142857142857144,34,28,6,0.8235294117647058,0.8665377176015474,GPT4,mimiciii,nursing_note,PROMPT1_entailment
63,155,50,41,9,0.82,51,46,5,0.9019607843137256,0.8590298337508541,GPT4,mimiciii,nursing_note,PROMPT1_entailment
64,156,18,17,1,0.9444444444444444,26,22,4,0.8461538461538461,0.8926014319809069,GPT4,mimiciii,nursing_note,PROMPT1_entailment
65,157,5,5,0,1.0,5,4,1,0.8,0.888888888888889,GPT4,mimiciii,nursing_note,PROMPT1_entailment
66,158,27,25,2,0.925925925925926,22,20,2,0.9090909090909092,0.9174311926605504,GPT4,mimiciii,nursing_note,PROMPT1_entailment
67,159,7,6,1,0.8571428571428571,8,7,1,0.875,0.8659793814432989,GPT4,mimiciii,nursing_note,PROMPT1_entailment
68,16,33,30,3,0.9090909090909092,30,24,6,0.8,0.8510638297872342,GPT4,mimiciii,nursing_note,PROMPT1_entailment
69,160,26,26,0,1.0,21,21,0,1.0,1.0,GPT4,mimiciii,nursing_note,PROMPT1_entailment
70,161,5,5,0,1.0,6,5,1,0.8333333333333334,0.9090909090909092,GPT4,mimiciii,nursing_note,PROMPT1_entailment
71,162,25,23,2,0.92,31,22,9,0.7096774193548387,0.8012668250197941,GPT4,mimiciii,nursing_note,PROMPT1_entailment
72,163,10,10,0,1.0,4,4,0,1.0,1.0,GPT4,mimiciii,nursing_note,PROMPT1_entailment
73,164,17,15,2,0.8823529411764706,13,11,2,0.8461538461538461,0.8638743455497382,GPT4,mimiciii,nursing_note,PROMPT1_entailment
74,165,25,23,2,0.92,24,21,3,0.875,0.8969359331476324,GPT4,mimiciii,nursing_note,PROMPT1_entailment
75,166,10,10,0,1.0,3,3,0,1.0,1.0,GPT4,mimiciii,nursing_note,PROMPT1_entailment
76,167,23,20,3,0.8695652173913043,16,16,0,1.0,0.9302325581395348,GPT4,mimiciii,nursing_note,PROMPT1_entailment
77,168,18,16,2,0.8888888888888888,25,18,7,0.72,0.7955801104972375,GPT4,mimiciii,nursing_note,PROMPT1_entailment
78,169,19,16,3,0.8421052631578947,12,12,0,1.0,0.9142857142857144,GPT4,mimiciii,nursing_note,PROMPT1_entailment
79,17,27,17,10,0.6296296296296297,39,31,8,0.7948717948717948,0.7026666666666667,GPT4,mimiciii,nursing_note,PROMPT1_entailment
80,170,25,19,6,0.76,21,17,4,0.8095238095238095,0.7839805825242718,GPT4,mimiciii,nursing_note,PROMPT1_entailment
81,171,8,7,1,0.875,8,7,1,0.875,0.875,GPT4,mimiciii,nursing_note,PROMPT1_entailment
82,172,40,37,3,0.925,38,28,10,0.7368421052631579,0.8202692003167064,GPT4,mimiciii,nursing_note,PROMPT1_entailment
83,173,24,20,4,0.8333333333333334,19,18,1,0.9473684210526316,0.8866995073891626,GPT4,mimiciii,nursing_note,PROMPT1_entailment
84,174,8,8,0,1.0,8,8,0,1.0,1.0,GPT4,mimiciii,nursing_note,PROMPT1_entailment
85,175,6,6,0,1.0,4,4,0,1.0,1.0,GPT4,mimiciii,nursing_note,PROMPT1_entailment
86,176,14,12,2,0.8571428571428571,13,10,3,0.7692307692307693,0.8108108108108107,GPT4,mimiciii,nursing_note,PROMPT1_entailment
87,177,40,30,10,0.75,38,29,9,0.7631578947368421,0.7565217391304349,GPT4,mimiciii,nursing_note,PROMPT1_entailment
88,178,26,26,0,1.0,25,22,3,0.88,0.9361702127659576,GPT4,mimiciii,nursing_note,PROMPT1_entailment
89,179,28,26,2,0.9285714285714286,22,20,2,0.9090909090909092,0.9187279151943464,GPT4,mimiciii,nursing_note,PROMPT1_entailment
90,18,17,15,2,0.8823529411764706,25,18,7,0.72,0.7929515418502202,GPT4,mimiciii,nursing_note,PROMPT1_entailment
91,180,25,21,4,0.84,27,24,3,0.8888888888888888,0.8637532133676092,GPT4,mimiciii,nursing_note,PROMPT1_entailment
92,181,24,12,12,0.5,25,25,0,1.0,0.6666666666666666,GPT4,mimiciii,nursing_note,PROMPT1_entailment
93,182,11,9,2,0.8181818181818182,10,9,1,0.9,0.8571428571428572,GPT4,mimiciii,nursing_note,PROMPT1_entailment
94,183,7,7,0,1.0,5,4,1,0.8,0.888888888888889,GPT4,mimiciii,nursing_note,PROMPT1_entailment
95,184,15,15,0,1.0,1,1,0,1.0,1.0,GPT4,mimiciii,nursing_note,PROMPT1_entailment
96,185,26,19,7,0.7307692307692307,30,26,4,0.8666666666666667,0.7929373996789726,GPT4,mimiciii,nursing_note,PROMPT1_entailment
97,186,5,5,0,1.0,4,3,1,0.75,0.8571428571428571,GPT4,mimiciii,nursing_note,PROMPT1_entailment
98,187,24,23,1,0.9583333333333334,37,33,4,0.8918918918918919,0.923919659160073,GPT4,mimiciii,nursing_note,PROMPT1_entailment
99,188,4,4,0,1.0,2,2,0,1.0,1.0,GPT4,mimiciii,nursing_note,PROMPT1_entailment
100,189,32,28,4,0.875,21,19,2,0.9047619047619048,0.8896321070234113,GPT4,mimiciii,nursing_note,PROMPT1_entailment
101,19,20,14,6,0.7,45,36,9,0.8,0.7466666666666666,GPT4,mimiciii,nursing_note,PROMPT1_entailment
102,190,10,10,0,1.0,24,23,1,0.9583333333333334,0.9787234042553192,GPT4,mimiciii,nursing_note,PROMPT1_entailment
103,191,28,27,1,0.9642857142857144,29,22,7,0.7586206896551724,0.8491779842744818,GPT4,mimiciii,nursing_note,PROMPT1_entailment
104,192,13,13,0,1.0,15,15,0,1.0,1.0,GPT4,mimiciii,nursing_note,PROMPT1_entailment
105,193,33,29,4,0.8787878787878788,36,27,9,0.75,0.8093023255813953,GPT4,mimiciii,nursing_note,PROMPT1_entailment
106,194,10,10,0,1.0,11,11,0,1.0,1.0,GPT4,mimiciii,nursing_note,PROMPT1_entailment
107,195,7,7,0,1.0,7,7,0,1.0,1.0,GPT4,mimiciii,nursing_note,PROMPT1_entailment
108,196,36,30,6,0.8333333333333334,34,31,3,0.9117647058823528,0.8707865168539325,GPT4,mimiciii,nursing_note,PROMPT1_entailment
109,197,27,19,8,0.7037037037037037,27,23,4,0.8518518518518519,0.7707231040564373,GPT4,mimiciii,nursing_note,PROMPT1_entailment
110,198,37,33,4,0.8918918918918919,38,33,5,0.868421052631579,0.88,GPT4,mimiciii,nursing_note,PROMPT1_entailment
111,199,13,13,0,1.0,14,12,2,0.8571428571428571,0.923076923076923,GPT4,mimiciii,nursing_note,PROMPT1_entailment
112,2,47,25,22,0.5319148936170213,43,34,9,0.7906976744186046,0.6359895248784136,GPT4,mimiciii,nursing_note,PROMPT1_entailment
113,20,30,19,11,0.6333333333333333,46,36,10,0.782608695652174,0.7001023541453429,GPT4,mimiciii,nursing_note,PROMPT1_entailment
114,200,26,19,7,0.7307692307692307,44,29,15,0.6590909090909091,0.6930817610062893,GPT4,mimiciii,nursing_note,PROMPT1_entailment
115,201,24,23,1,0.9583333333333334,29,27,2,0.9310344827586208,0.9444866920152092,GPT4,mimiciii,nursing_note,PROMPT1_entailment
116,202,9,7,2,0.7777777777777778,9,8,1,0.8888888888888888,0.8296296296296296,GPT4,mimiciii,nursing_note,PROMPT1_entailment
117,203,11,11,0,1.0,7,7,0,1.0,1.0,GPT4,mimiciii,nursing_note,PROMPT1_entailment
118,204,19,16,3,0.8421052631578947,24,22,2,0.9166666666666666,0.8778054862842893,GPT4,mimiciii,nursing_note,PROMPT1_entailment
119,205,20,18,2,0.9,47,33,14,0.7021276595744681,0.7888446215139443,GPT4,mimiciii,nursing_note,PROMPT1_entailment
120,206,8,8,0,1.0,6,4,2,0.6666666666666666,0.8,GPT4,mimiciii,nursing_note,PROMPT1_entailment
121,207,40,39,1,0.975,29,23,6,0.7931034482758621,0.8746952705997073,GPT4,mimiciii,nursing_note,PROMPT1_entailment
122,208,12,12,0,1.0,7,7,0,1.0,1.0,GPT4,mimiciii,nursing_note,PROMPT1_entailment
123,209,3,3,0,1.0,2,2,0,1.0,1.0,GPT4,mimiciii,nursing_note,PROMPT1_entailment
124,21,6,6,0,1.0,6,5,1,0.8333333333333334,0.9090909090909092,GPT4,mimiciii,nursing_note,PROMPT1_entailment
125,210,22,16,6,0.7272727272727273,22,21,1,0.9545454545454546,0.8255528255528255,GPT4,mimiciii,nursing_note,PROMPT1_entailment
126,211,5,5,0,1.0,4,4,0,1.0,1.0,GPT4,mimiciii,nursing_note,PROMPT1_entailment
127,212,32,28,4,0.875,37,31,6,0.8378378378378378,0.8560157790927022,GPT4,mimiciii,nursing_note,PROMPT1_entailment
128,213,17,15,2,0.8823529411764706,18,15,3,0.8333333333333334,0.8571428571428571,GPT4,mimiciii,nursing_note,PROMPT1_entailment
129,214,10,10,0,1.0,3,3,0,1.0,1.0,GPT4,mimiciii,nursing_note,PROMPT1_entailment
130,215,10,10,0,1.0,7,7,0,1.0,1.0,GPT4,mimiciii,nursing_note,PROMPT1_entailment
131,216,14,12,2,0.8571428571428571,13,10,3,0.7692307692307693,0.8108108108108107,GPT4,mimiciii,nursing_note,PROMPT1_entailment
132,217,28,25,3,0.8928571428571429,25,21,4,0.84,0.8656224237427864,GPT4,mimiciii,nursing_note,PROMPT1_entailment
133,218,20,17,3,0.85,18,14,4,0.7777777777777778,0.8122866894197952,GPT4,mimiciii,nursing_note,PROMPT1_entailment
134,219,11,9,2,0.8181818181818182,14,14,0,1.0,0.9,GPT4,mimiciii,nursing_note,PROMPT1_entailment
135,22,25,20,5,0.8,26,23,3,0.8846153846153846,0.8401826484018265,GPT4,mimiciii,nursing_note,PROMPT1_entailment
136,220,12,11,1,0.9166666666666666,5,3,2,0.6,0.7252747252747253,GPT4,mimiciii,nursing_note,PROMPT1_entailment
137,221,29,12,17,0.4137931034482758,35,26,9,0.7428571428571429,0.5315161839863713,GPT4,mimiciii,nursing_note,PROMPT1_entailment
138,222,4,4,0,1.0,3,3,0,1.0,1.0,GPT4,mimiciii,nursing_note,PROMPT1_entailment
139,223,21,10,11,0.4761904761904761,30,29,1,0.9666666666666668,0.6380638063806381,GPT4,mimiciii,nursing_note,PROMPT1_entailment
140,224,10,10,0,1.0,6,6,0,1.0,1.0,GPT4,mimiciii,nursing_note,PROMPT1_entailment
141,225,43,22,21,0.5116279069767442,45,36,9,0.8,0.624113475177305,GPT4,mimiciii,nursing_note,PROMPT1_entailment
142,226,19,17,2,0.8947368421052632,20,19,1,0.95,0.9215406562054208,GPT4,mimiciii,nursing_note,PROMPT1_entailment
143,227,19,18,1,0.9473684210526316,15,13,2,0.8666666666666667,0.9052224371373307,GPT4,mimiciii,nursing_note,PROMPT1_entailment
144,228,26,15,11,0.5769230769230769,38,28,10,0.7368421052631579,0.6471494607087828,GPT4,mimiciii,nursing_note,PROMPT1_entailment
145,229,21,17,4,0.8095238095238095,22,21,1,0.9545454545454546,0.8760736196319019,GPT4,mimiciii,nursing_note,PROMPT1_entailment
146,23,43,35,8,0.813953488372093,35,30,5,0.8571428571428571,0.8349900596421471,GPT4,mimiciii,nursing_note,PROMPT1_entailment
147,230,12,12,0,1.0,7,6,1,0.8571428571428571,0.923076923076923,GPT4,mimiciii,nursing_note,PROMPT1_entailment
148,231,19,18,1,0.9473684210526316,15,12,3,0.8,0.8674698795180723,GPT4,mimiciii,nursing_note,PROMPT1_entailment
149,232,8,6,2,0.75,2,2,0,1.0,0.8571428571428571,GPT4,mimiciii,nursing_note,PROMPT1_entailment
150,233,23,16,7,0.6956521739130435,33,28,5,0.8484848484848485,0.7645051194539249,GPT4,mimiciii,nursing_note,PROMPT1_entailment
151,234,15,15,0,1.0,32,28,4,0.875,0.9333333333333332,GPT4,mimiciii,nursing_note,PROMPT1_entailment
152,235,14,14,0,1.0,10,9,1,0.9,0.9473684210526316,GPT4,mimiciii,nursing_note,PROMPT1_entailment
153,236,10,8,2,0.8,7,7,0,1.0,0.888888888888889,GPT4,mimiciii,nursing_note,PROMPT1_entailment
154,237,28,25,3,0.8928571428571429,35,27,8,0.7714285714285715,0.8277130594727161,GPT4,mimiciii,nursing_note,PROMPT1_entailment
155,238,44,27,17,0.6136363636363636,42,37,5,0.8809523809523809,0.723388848660391,GPT4,mimiciii,nursing_note,PROMPT1_entailment
156,239,25,15,10,0.6,21,17,4,0.8095238095238095,0.6891891891891893,GPT4,mimiciii,nursing_note,PROMPT1_entailment
157,24,9,9,0,1.0,5,5,0,1.0,1.0,GPT4,mimiciii,nursing_note,PROMPT1_entailment
158,240,31,28,3,0.9032258064516128,42,30,12,0.7142857142857143,0.7977207977207977,GPT4,mimiciii,nursing_note,PROMPT1_entailment
159,241,24,17,7,0.7083333333333334,21,20,1,0.9523809523809524,0.8124253285543609,GPT4,mimiciii,nursing_note,PROMPT1_entailment
160,242,23,17,6,0.7391304347826086,16,13,3,0.8125,0.7740805604203151,GPT4,mimiciii,nursing_note,PROMPT1_entailment
161,243,7,7,0,1.0,5,4,1,0.8,0.888888888888889,GPT4,mimiciii,nursing_note,PROMPT1_entailment
162,244,26,18,8,0.6923076923076923,16,12,4,0.75,0.7199999999999999,GPT4,mimiciii,nursing_note,PROMPT1_entailment
163,245,33,27,6,0.8181818181818182,37,34,3,0.918918918918919,0.8656294200848657,GPT4,mimiciii,nursing_note,PROMPT1_entailment
164,246,17,14,3,0.8235294117647058,10,10,0,1.0,0.9032258064516128,GPT4,mimiciii,nursing_note,PROMPT1_entailment
165,247,8,8,0,1.0,6,5,1,0.8333333333333334,0.9090909090909092,GPT4,mimiciii,nursing_note,PROMPT1_entailment
166,248,33,25,8,0.7575757575757576,42,35,7,0.8333333333333334,0.7936507936507938,GPT4,mimiciii,nursing_note,PROMPT1_entailment
167,249,32,26,6,0.8125,39,33,6,0.8461538461538461,0.8289855072463768,GPT4,mimiciii,nursing_note,PROMPT1_entailment
168,25,29,20,9,0.6896551724137931,23,19,4,0.8260869565217391,0.7517309594460929,GPT4,mimiciii,nursing_note,PROMPT1_entailment
169,26,30,27,3,0.9,35,27,8,0.7714285714285715,0.8307692307692307,GPT4,mimiciii,nursing_note,PROMPT1_entailment
170,27,5,5,0,1.0,3,2,1,0.6666666666666666,0.8,GPT4,mimiciii,nursing_note,PROMPT1_entailment
171,28,30,28,2,0.9333333333333332,16,8,8,0.5,0.6511627906976745,GPT4,mimiciii,nursing_note,PROMPT1_entailment
172,29,13,12,1,0.9230769230769232,33,25,8,0.7575757575757576,0.8321775312066575,GPT4,mimiciii,nursing_note,PROMPT1_entailment
173,3,12,10,2,0.8333333333333334,6,5,1,0.8333333333333334,0.8333333333333334,GPT4,mimiciii,nursing_note,PROMPT1_entailment
174,30,15,14,1,0.9333333333333332,13,11,2,0.8461538461538461,0.8876080691642652,GPT4,mimiciii,nursing_note,PROMPT1_entailment
175,31,17,14,3,0.8235294117647058,19,17,2,0.8947368421052632,0.8576576576576577,GPT4,mimiciii,nursing_note,PROMPT1_entailment
176,32,34,32,2,0.9411764705882352,44,36,8,0.8181818181818182,0.8753799392097266,GPT4,mimiciii,nursing_note,PROMPT1_entailment
177,33,8,8,0,1.0,5,5,0,1.0,1.0,GPT4,mimiciii,nursing_note,PROMPT1_entailment
178,34,5,5,0,1.0,3,3,0,1.0,1.0,GPT4,mimiciii,nursing_note,PROMPT1_entailment
179,35,8,8,0,1.0,7,7,0,1.0,1.0,GPT4,mimiciii,nursing_note,PROMPT1_entailment
180,36,65,51,14,0.7846153846153846,62,54,8,0.8709677419354839,0.8255395683453237,GPT4,mimiciii,nursing_note,PROMPT1_entailment
181,37,32,17,15,0.53125,38,31,7,0.8157894736842105,0.6434676434676434,GPT4,mimiciii,nursing_note,PROMPT1_entailment
182,38,24,16,8,0.6666666666666666,26,24,2,0.9230769230769232,0.7741935483870968,GPT4,mimiciii,nursing_note,PROMPT1_entailment
183,39,11,9,2,0.8181818181818182,3,1,2,0.3333333333333333,0.4736842105263157,GPT4,mimiciii,nursing_note,PROMPT1_entailment
184,4,26,16,10,0.6153846153846154,26,23,3,0.8846153846153846,0.7258382642998028,GPT4,mimiciii,nursing_note,PROMPT1_entailment
185,40,8,8,0,1.0,3,3,0,1.0,1.0,GPT4,mimiciii,nursing_note,PROMPT1_entailment
186,41,40,37,3,0.925,50,34,16,0.68,0.7838006230529596,GPT4,mimiciii,nursing_note,PROMPT1_entailment
187,42,31,21,10,0.6774193548387096,7,7,0,1.0,0.8076923076923077,GPT4,mimiciii,nursing_note,PROMPT1_entailment
188,43,22,14,8,0.6363636363636364,14,13,1,0.9285714285714286,0.7551867219917012,GPT4,mimiciii,nursing_note,PROMPT1_entailment
189,44,6,6,0,1.0,3,3,0,1.0,1.0,GPT4,mimiciii,nursing_note,PROMPT1_entailment
190,45,40,39,1,0.975,34,29,5,0.8529411764705882,0.909895414320193,GPT4,mimiciii,nursing_note,PROMPT1_entailment
191,46,22,21,1,0.9545454545454546,31,21,10,0.6774193548387096,0.7924528301886793,GPT4,mimiciii,nursing_note,PROMPT1_entailment
192,47,27,21,6,0.7777777777777778,14,14,0,1.0,0.8750000000000001,GPT4,mimiciii,nursing_note,PROMPT1_entailment
193,48,13,12,1,0.9230769230769232,9,8,1,0.8888888888888888,0.9056603773584906,GPT4,mimiciii,nursing_note,PROMPT1_entailment
194,49,6,6,0,1.0,3,2,1,0.6666666666666666,0.8,GPT4,mimiciii,nursing_note,PROMPT1_entailment
195,5,11,11,0,1.0,15,14,1,0.9333333333333332,0.9655172413793104,GPT4,mimiciii,nursing_note,PROMPT1_entailment
196,50,17,16,1,0.9411764705882352,16,12,4,0.75,0.8347826086956521,GPT4,mimiciii,nursing_note,PROMPT1_entailment
197,51,8,8,0,1.0,6,6,0,1.0,1.0,GPT4,mimiciii,nursing_note,PROMPT1_entailment
198,52,38,26,12,0.6842105263157895,38,22,16,0.5789473684210527,0.6271929824561404,GPT4,mimiciii,nursing_note,PROMPT1_entailment
199,53,7,7,0,1.0,6,5,1,0.8333333333333334,0.9090909090909092,GPT4,mimiciii,nursing_note,PROMPT1_entailment
200,54,29,19,10,0.6551724137931034,37,29,8,0.7837837837837838,0.7137305699481865,GPT4,mimiciii,nursing_note,PROMPT1_entailment
201,55,26,18,8,0.6923076923076923,35,29,6,0.8285714285714286,0.754335260115607,GPT4,mimiciii,nursing_note,PROMPT1_entailment
202,56,10,10,0,1.0,2,2,0,1.0,1.0,GPT4,mimiciii,nursing_note,PROMPT1_entailment
203,57,33,33,0,1.0,17,13,4,0.7647058823529411,0.8666666666666666,GPT4,mimiciii,nursing_note,PROMPT1_entailment
204,58,16,14,2,0.875,25,17,8,0.68,0.7652733118971061,GPT4,mimiciii,nursing_note,PROMPT1_entailment
205,59,10,9,1,0.9,8,7,1,0.875,0.8873239436619719,GPT4,mimiciii,nursing_note,PROMPT1_entailment
206,6,11,10,1,0.9090909090909092,8,8,0,1.0,0.9523809523809524,GPT4,mimiciii,nursing_note,PROMPT1_entailment
207,60,25,18,7,0.72,27,23,4,0.8518518518518519,0.7803958529688972,GPT4,mimiciii,nursing_note,PROMPT1_entailment
208,61,20,15,5,0.75,20,19,1,0.95,0.838235294117647,GPT4,mimiciii,nursing_note,PROMPT1_entailment
209,62,32,22,10,0.6875,37,30,7,0.8108108108108109,0.7440811724915445,GPT4,mimiciii,nursing_note,PROMPT1_entailment
210,63,5,5,0,1.0,5,4,1,0.8,0.888888888888889,GPT4,mimiciii,nursing_note,PROMPT1_entailment
211,64,41,38,3,0.926829268292683,27,24,3,0.8888888888888888,0.9074626865671644,GPT4,mimiciii,nursing_note,PROMPT1_entailment
212,65,16,14,2,0.875,19,14,5,0.7368421052631579,0.7999999999999999,GPT4,mimiciii,nursing_note,PROMPT1_entailment
213,66,11,11,0,1.0,1,1,0,1.0,1.0,GPT4,mimiciii,nursing_note,PROMPT1_entailment
214,67,11,9,2,0.8181818181818182,7,5,2,0.7142857142857143,0.7627118644067797,GPT4,mimiciii,nursing_note,PROMPT1_entailment
215,68,21,17,4,0.8095238095238095,18,16,2,0.8888888888888888,0.8473520249221184,GPT4,mimiciii,nursing_note,PROMPT1_entailment
216,69,26,20,6,0.7692307692307693,25,23,2,0.92,0.8378870673952641,GPT4,mimiciii,nursing_note,PROMPT1_entailment
217,7,5,5,0,1.0,2,2,0,1.0,1.0,GPT4,mimiciii,nursing_note,PROMPT1_entailment
218,70,38,33,5,0.868421052631579,45,27,18,0.6,0.7096774193548387,GPT4,mimiciii,nursing_note,PROMPT1_entailment
219,71,32,17,15,0.53125,51,36,15,0.7058823529411765,0.6062407132243685,GPT4,mimiciii,nursing_note,PROMPT1_entailment
220,72,12,10,2,0.8333333333333334,12,7,5,0.5833333333333334,0.6862745098039216,GPT4,mimiciii,nursing_note,PROMPT1_entailment
221,73,36,29,7,0.8055555555555556,38,30,8,0.7894736842105263,0.7974335472043996,GPT4,mimiciii,nursing_note,PROMPT1_entailment
222,74,8,7,1,0.875,7,6,1,0.8571428571428571,0.8659793814432989,GPT4,mimiciii,nursing_note,PROMPT1_entailment
223,75,26,22,4,0.8461538461538461,27,24,3,0.8888888888888888,0.8669950738916256,GPT4,mimiciii,nursing_note,PROMPT1_entailment
224,76,2,2,0,1.0,1,1,0,1.0,1.0,GPT4,mimiciii,nursing_note,PROMPT1_entailment
225,77,44,33,11,0.75,59,41,18,0.6949152542372882,0.7214076246334312,GPT4,mimiciii,nursing_note,PROMPT1_entailment
226,78,25,17,8,0.68,20,19,1,0.95,0.792638036809816,GPT4,mimiciii,nursing_note,PROMPT1_entailment
227,79,34,31,3,0.9117647058823528,30,29,1,0.9666666666666668,0.9384133611691022,GPT4,mimiciii,nursing_note,PROMPT1_entailment
228,8,12,12,0,1.0,11,9,2,0.8181818181818182,0.9,GPT4,mimiciii,nursing_note,PROMPT1_entailment
229,80,29,23,6,0.7931034482758621,22,19,3,0.8636363636363636,0.826868495742668,GPT4,mimiciii,nursing_note,PROMPT1_entailment
230,81,23,16,7,0.6956521739130435,22,21,1,0.9545454545454546,0.8047904191616767,GPT4,mimiciii,nursing_note,PROMPT1_entailment
231,82,18,15,3,0.8333333333333334,17,12,5,0.7058823529411765,0.7643312101910827,GPT4,mimiciii,nursing_note,PROMPT1_entailment
232,83,20,14,6,0.7,28,23,5,0.8214285714285714,0.755868544600939,GPT4,mimiciii,nursing_note,PROMPT1_entailment
233,84,10,10,0,1.0,6,6,0,1.0,1.0,GPT4,mimiciii,nursing_note,PROMPT1_entailment
234,85,13,12,1,0.9230769230769232,24,21,3,0.875,0.8983957219251337,GPT4,mimiciii,nursing_note,PROMPT1_entailment
235,86,40,26,14,0.65,40,32,8,0.8,0.7172413793103448,GPT4,mimiciii,nursing_note,PROMPT1_entailment
236,87,19,16,3,0.8421052631578947,15,13,2,0.8666666666666667,0.8542094455852155,GPT4,mimiciii,nursing_note,PROMPT1_entailment
237,88,19,13,6,0.6842105263157895,15,12,3,0.8,0.7375886524822695,GPT4,mimiciii,nursing_note,PROMPT1_entailment
238,89,25,24,1,0.96,29,28,1,0.9655172413793104,0.9627507163323782,GPT4,mimiciii,nursing_note,PROMPT1_entailment
239,9,32,29,3,0.90625,17,14,3,0.8235294117647058,0.8629117959617428,GPT4,mimiciii,nursing_note,PROMPT1_entailment
240,90,12,8,4,0.6666666666666666,14,10,4,0.7142857142857143,0.689655172413793,GPT4,mimiciii,nursing_note,PROMPT1_entailment
241,91,22,16,6,0.7272727272727273,24,22,2,0.9166666666666666,0.8110599078341013,GPT4,mimiciii,nursing_note,PROMPT1_entailment
242,92,36,35,1,0.9722222222222222,28,25,3,0.8928571428571429,0.9308510638297872,GPT4,mimiciii,nursing_note,PROMPT1_entailment
243,93,21,15,6,0.7142857142857143,23,22,1,0.9565217391304348,0.8178438661710038,GPT4,mimiciii,nursing_note,PROMPT1_entailment
244,94,6,6,0,1.0,5,5,0,1.0,1.0,GPT4,mimiciii,nursing_note,PROMPT1_entailment
245,95,18,13,5,0.7222222222222222,14,12,2,0.8571428571428571,0.7839195979899497,GPT4,mimiciii,nursing_note,PROMPT1_entailment
246,96,10,9,1,0.9,6,6,0,1.0,0.9473684210526316,GPT4,mimiciii,nursing_note,PROMPT1_entailment
247,97,10,10,0,1.0,10,10,0,1.0,1.0,GPT4,mimiciii,nursing_note,PROMPT1_entailment
248,98,34,28,6,0.8235294117647058,2,1,1,0.5,0.6222222222222222,GPT4,mimiciii,nursing_note,PROMPT1_entailment
249,99,42,37,5,0.8809523809523809,1,0,1,0.0,0.0,GPT4,mimiciii,nursing_note,PROMPT1_entailment
0,0,17,10,7,0.5882352941176471,11,8,3,0.7272727272727273,0.6504065040650407,GPT4,mimiciii,nursing_note,PROMPT1_ICL_entailment
1,1,45,20,25,0.4444444444444444,31,23,8,0.7419354838709677,0.5558912386706949,GPT4,mimiciii,nursing_note,PROMPT1_ICL_entailment
2,10,29,23,6,0.7931034482758621,18,14,4,0.7777777777777778,0.7853658536585366,GPT4,mimiciii,nursing_note,PROMPT1_ICL_entailment
3,100,13,13,0,1.0,6,5,1,0.8333333333333334,0.9090909090909092,GPT4,mimiciii,nursing_note,PROMPT1_ICL_entailment
4,101,41,37,4,0.902439024390244,27,25,2,0.925925925925926,0.9140316205533596,GPT4,mimiciii,nursing_note,PROMPT1_ICL_entailment
5,102,36,30,6,0.8333333333333334,26,20,6,0.7692307692307693,0.8,GPT4,mimiciii,nursing_note,PROMPT1_ICL_entailment
6,103,26,19,7,0.7307692307692307,22,20,2,0.9090909090909092,0.8102345415778252,GPT4,mimiciii,nursing_note,PROMPT1_ICL_entailment
7,104,28,26,2,0.9285714285714286,20,19,1,0.95,0.9391634980988592,GPT4,mimiciii,nursing_note,PROMPT1_ICL_entailment
8,105,46,35,11,0.7608695652173914,20,17,3,0.85,0.8029689608636977,GPT4,mimiciii,nursing_note,PROMPT1_ICL_entailment
9,106,9,9,0,1.0,4,3,1,0.75,0.8571428571428571,GPT4,mimiciii,nursing_note,PROMPT1_ICL_entailment
10,107,60,42,18,0.7,49,38,11,0.7755102040816326,0.7358229598893499,GPT4,mimiciii,nursing_note,PROMPT1_ICL_entailment
11,108,45,44,1,0.9777777777777776,28,20,8,0.7142857142857143,0.8255159474671669,GPT4,mimiciii,nursing_note,PROMPT1_ICL_entailment
12,109,5,5,0,1.0,4,4,0,1.0,1.0,GPT4,mimiciii,nursing_note,PROMPT1_ICL_entailment
13,11,2,2,0,1.0,2,2,0,1.0,1.0,GPT4,mimiciii,nursing_note,PROMPT1_ICL_entailment
14,110,20,20,0,1.0,13,11,2,0.8461538461538461,0.9166666666666666,GPT4,mimiciii,nursing_note,PROMPT1_ICL_entailment
15,111,38,34,4,0.8947368421052632,32,27,5,0.84375,0.8684957426679281,GPT4,mimiciii,nursing_note,PROMPT1_ICL_entailment
16,112,53,41,12,0.7735849056603774,37,33,4,0.8918918918918919,0.8285364360073484,GPT4,mimiciii,nursing_note,PROMPT1_ICL_entailment
17,113,9,9,0,1.0,5,5,0,1.0,1.0,GPT4,mimiciii,nursing_note,PROMPT1_ICL_entailment
18,114,21,10,11,0.4761904761904761,19,15,4,0.7894736842105263,0.594059405940594,GPT4,mimiciii,nursing_note,PROMPT1_ICL_entailment
19,115,14,14,0,1.0,7,6,1,0.8571428571428571,0.923076923076923,GPT4,mimiciii,nursing_note,PROMPT1_ICL_entailment
20,116,38,36,2,0.9473684210526316,31,28,3,0.9032258064516128,0.9247706422018348,GPT4,mimiciii,nursing_note,PROMPT1_ICL_entailment
21,117,49,41,8,0.8367346938775511,18,15,3,0.8333333333333334,0.8350305498981672,GPT4,mimiciii,nursing_note,PROMPT1_ICL_entailment
22,118,33,22,11,0.6666666666666666,25,21,4,0.84,0.743362831858407,GPT4,mimiciii,nursing_note,PROMPT1_ICL_entailment
23,119,38,33,5,0.868421052631579,26,22,4,0.8461538461538461,0.8571428571428572,GPT4,mimiciii,nursing_note,PROMPT1_ICL_entailment
24,12,33,31,2,0.9393939393939394,18,14,4,0.7777777777777778,0.8509803921568627,GPT4,mimiciii,nursing_note,PROMPT1_ICL_entailment
25,120,22,19,3,0.8636363636363636,18,17,1,0.9444444444444444,0.9022346368715084,GPT4,mimiciii,nursing_note,PROMPT1_ICL_entailment
26,121,54,45,9,0.8333333333333334,37,30,7,0.8108108108108109,0.8219178082191781,GPT4,mimiciii,nursing_note,PROMPT1_ICL_entailment
27,122,29,26,3,0.896551724137931,11,9,2,0.8181818181818182,0.8555758683729433,GPT4,mimiciii,nursing_note,PROMPT1_ICL_entailment
28,123,6,6,0,1.0,6,6,0,1.0,1.0,GPT4,mimiciii,nursing_note,PROMPT1_ICL_entailment
29,124,8,8,0,1.0,5,5,0,1.0,1.0,GPT4,mimiciii,nursing_note,PROMPT1_ICL_entailment
30,125,55,54,1,0.9818181818181818,43,37,6,0.8604651162790697,0.9171448244204728,GPT4,mimiciii,nursing_note,PROMPT1_ICL_entailment
31,126,34,25,9,0.7352941176470589,28,23,5,0.8214285714285714,0.775978407557355,GPT4,mimiciii,nursing_note,PROMPT1_ICL_entailment
32,127,21,20,1,0.9523809523809524,10,9,1,0.9,0.9254498714652956,GPT4,mimiciii,nursing_note,PROMPT1_ICL_entailment
33,128,31,25,6,0.8064516129032258,17,14,3,0.8235294117647058,0.8149010477299184,GPT4,mimiciii,nursing_note,PROMPT1_ICL_entailment
34,129,41,31,10,0.7560975609756098,29,27,2,0.9310344827586208,0.8344965104685942,GPT4,mimiciii,nursing_note,PROMPT1_ICL_entailment
35,13,42,41,1,0.9761904761904762,34,25,9,0.7352941176470589,0.8387888707037643,GPT4,mimiciii,nursing_note,PROMPT1_ICL_entailment
36,130,42,30,12,0.7142857142857143,33,21,12,0.6363636363636364,0.673076923076923,GPT4,mimiciii,nursing_note,PROMPT1_ICL_entailment
37,131,38,33,5,0.868421052631579,31,28,3,0.9032258064516128,0.8854815524676569,GPT4,mimiciii,nursing_note,PROMPT1_ICL_entailment
38,132,38,29,9,0.7631578947368421,17,16,1,0.9411764705882352,0.8428701180744778,GPT4,mimiciii,nursing_note,PROMPT1_ICL_entailment
39,133,21,16,5,0.7619047619047619,10,10,0,1.0,0.8648648648648648,GPT4,mimiciii,nursing_note,PROMPT1_ICL_entailment
40,134,54,26,28,0.4814814814814814,30,20,10,0.6666666666666666,0.5591397849462365,GPT4,mimiciii,nursing_note,PROMPT1_ICL_entailment
41,135,45,32,13,0.7111111111111111,42,35,7,0.8333333333333334,0.7673860911270984,GPT4,mimiciii,nursing_note,PROMPT1_ICL_entailment
42,136,52,46,6,0.8846153846153846,41,36,5,0.8780487804878049,0.8813198509845662,GPT4,mimiciii,nursing_note,PROMPT1_ICL_entailment
43,137,5,5,0,1.0,2,1,1,0.5,0.6666666666666666,GPT4,mimiciii,nursing_note,PROMPT1_ICL_entailment
44,138,5,5,0,1.0,5,4,1,0.8,0.888888888888889,GPT4,mimiciii,nursing_note,PROMPT1_ICL_entailment
45,139,6,5,1,0.8333333333333334,4,3,1,0.75,0.7894736842105262,GPT4,mimiciii,nursing_note,PROMPT1_ICL_entailment
46,14,30,26,4,0.8666666666666667,25,24,1,0.96,0.910948905109489,GPT4,mimiciii,nursing_note,PROMPT1_ICL_entailment
47,140,36,27,9,0.75,24,24,0,1.0,0.8571428571428571,GPT4,mimiciii,nursing_note,PROMPT1_ICL_entailment
48,141,16,15,1,0.9375,11,11,0,1.0,0.967741935483871,GPT4,mimiciii,nursing_note,PROMPT1_ICL_entailment
49,142,49,38,11,0.7755102040816326,8,7,1,0.875,0.82225656877898,GPT4,mimiciii,nursing_note,PROMPT1_ICL_entailment
50,143,18,15,3,0.8333333333333334,2,2,0,1.0,0.9090909090909092,GPT4,mimiciii,nursing_note,PROMPT1_ICL_entailment
51,144,9,8,1,0.8888888888888888,5,4,1,0.8,0.8421052631578948,GPT4,mimiciii,nursing_note,PROMPT1_ICL_entailment
52,145,35,28,7,0.8,19,17,2,0.8947368421052632,0.84472049689441,GPT4,mimiciii,nursing_note,PROMPT1_ICL_entailment
53,146,10,9,1,0.9,6,6,0,1.0,0.9473684210526316,GPT4,mimiciii,nursing_note,PROMPT1_ICL_entailment
54,147,35,29,6,0.8285714285714286,26,18,8,0.6923076923076923,0.754335260115607,GPT4,mimiciii,nursing_note,PROMPT1_ICL_entailment
55,148,12,11,1,0.9166666666666666,7,6,1,0.8571428571428571,0.8859060402684563,GPT4,mimiciii,nursing_note,PROMPT1_ICL_entailment
56,149,45,35,10,0.7777777777777778,36,29,7,0.8055555555555556,0.7914230019493177,GPT4,mimiciii,nursing_note,PROMPT1_ICL_entailment
57,15,30,26,4,0.8666666666666667,33,24,9,0.7272727272727273,0.790874524714829,GPT4,mimiciii,nursing_note,PROMPT1_ICL_entailment
58,150,13,13,0,1.0,8,7,1,0.875,0.9333333333333332,GPT4,mimiciii,nursing_note,PROMPT1_ICL_entailment
59,151,36,32,4,0.8888888888888888,26,24,2,0.9230769230769232,0.9056603773584906,GPT4,mimiciii,nursing_note,PROMPT1_ICL_entailment
60,152,52,46,6,0.8846153846153846,44,34,10,0.7727272727272727,0.8248945147679325,GPT4,mimiciii,nursing_note,PROMPT1_ICL_entailment
61,153,6,6,0,1.0,4,4,0,1.0,1.0,GPT4,mimiciii,nursing_note,PROMPT1_ICL_entailment
62,154,40,37,3,0.925,34,26,8,0.7647058823529411,0.8372497824194952,GPT4,mimiciii,nursing_note,PROMPT1_ICL_entailment
63,155,60,45,15,0.75,51,47,4,0.9215686274509804,0.8269794721407625,GPT4,mimiciii,nursing_note,PROMPT1_ICL_entailment
64,156,27,25,2,0.925925925925926,26,21,5,0.8076923076923077,0.8627773212818406,GPT4,mimiciii,nursing_note,PROMPT1_ICL_entailment
65,157,7,7,0,1.0,5,4,1,0.8,0.888888888888889,GPT4,mimiciii,nursing_note,PROMPT1_ICL_entailment
66,158,42,40,2,0.9523809523809524,22,14,8,0.6363636363636364,0.762942779291553,GPT4,mimiciii,nursing_note,PROMPT1_ICL_entailment
67,159,13,11,2,0.8461538461538461,8,7,1,0.875,0.8603351955307262,GPT4,mimiciii,nursing_note,PROMPT1_ICL_entailment
68,16,37,36,1,0.972972972972973,30,19,11,0.6333333333333333,0.7672462142456534,GPT4,mimiciii,nursing_note,PROMPT1_ICL_entailment
69,160,42,39,3,0.9285714285714286,21,17,4,0.8095238095238095,0.8649706457925637,GPT4,mimiciii,nursing_note,PROMPT1_ICL_entailment
70,161,6,6,0,1.0,6,5,1,0.8333333333333334,0.9090909090909092,GPT4,mimiciii,nursing_note,PROMPT1_ICL_entailment
71,162,36,31,5,0.8611111111111112,31,23,8,0.7419354838709677,0.7970933482392398,GPT4,mimiciii,nursing_note,PROMPT1_ICL_entailment
72,163,10,10,0,1.0,4,4,0,1.0,1.0,GPT4,mimiciii,nursing_note,PROMPT1_ICL_entailment
73,164,23,22,1,0.9565217391304348,13,10,3,0.7692307692307693,0.8527131782945736,GPT4,mimiciii,nursing_note,PROMPT1_ICL_entailment
74,165,41,39,2,0.951219512195122,24,21,3,0.875,0.9115191986644408,GPT4,mimiciii,nursing_note,PROMPT1_ICL_entailment
75,166,14,14,0,1.0,3,3,0,1.0,1.0,GPT4,mimiciii,nursing_note,PROMPT1_ICL_entailment
76,167,38,30,8,0.7894736842105263,16,16,0,1.0,0.8823529411764706,GPT4,mimiciii,nursing_note,PROMPT1_ICL_entailment
77,168,29,20,9,0.6896551724137931,25,18,7,0.72,0.7045009784735812,GPT4,mimiciii,nursing_note,PROMPT1_ICL_entailment
78,169,27,24,3,0.8888888888888888,12,11,1,0.9166666666666666,0.9025641025641026,GPT4,mimiciii,nursing_note,PROMPT1_ICL_entailment
79,17,28,24,4,0.8571428571428571,39,33,6,0.8461538461538461,0.8516129032258064,GPT4,mimiciii,nursing_note,PROMPT1_ICL_entailment
80,170,44,41,3,0.9318181818181818,21,18,3,0.8571428571428571,0.8929219600725952,GPT4,mimiciii,nursing_note,PROMPT1_ICL_entailment
81,171,10,8,2,0.8,8,7,1,0.875,0.8358208955223881,GPT4,mimiciii,nursing_note,PROMPT1_ICL_entailment
82,172,42,39,3,0.9285714285714286,38,34,4,0.8947368421052632,0.911340206185567,GPT4,mimiciii,nursing_note,PROMPT1_ICL_entailment
83,173,33,29,4,0.8787878787878788,19,16,3,0.8421052631578947,0.8600556070435588,GPT4,mimiciii,nursing_note,PROMPT1_ICL_entailment
84,174,10,10,0,1.0,8,6,2,0.75,0.8571428571428571,GPT4,mimiciii,nursing_note,PROMPT1_ICL_entailment
85,175,5,5,0,1.0,4,4,0,1.0,1.0,GPT4,mimiciii,nursing_note,PROMPT1_ICL_entailment
86,176,25,18,7,0.72,13,11,2,0.8461538461538461,0.7779960707269156,GPT4,mimiciii,nursing_note,PROMPT1_ICL_entailment
87,177,41,37,4,0.902439024390244,38,29,9,0.7631578947368421,0.8269749518304431,GPT4,mimiciii,nursing_note,PROMPT1_ICL_entailment
88,178,50,48,2,0.96,25,18,7,0.72,0.8228571428571428,GPT4,mimiciii,nursing_note,PROMPT1_ICL_entailment
89,179,36,29,7,0.8055555555555556,22,15,7,0.6818181818181818,0.7385398981324277,GPT4,mimiciii,nursing_note,PROMPT1_ICL_entailment
90,18,42,33,9,0.7857142857142857,25,14,11,0.56,0.653927813163482,GPT4,mimiciii,nursing_note,PROMPT1_ICL_entailment
91,180,48,42,6,0.875,27,23,4,0.8518518518518519,0.8632707774798928,GPT4,mimiciii,nursing_note,PROMPT1_ICL_entailment
92,181,38,27,11,0.7105263157894737,25,20,5,0.8,0.7526132404181184,GPT4,mimiciii,nursing_note,PROMPT1_ICL_entailment
93,182,33,29,4,0.8787878787878788,10,7,3,0.7,0.7792706333973128,GPT4,mimiciii,nursing_note,PROMPT1_ICL_entailment
94,183,7,6,1,0.8571428571428571,5,4,1,0.8,0.8275862068965518,GPT4,mimiciii,nursing_note,PROMPT1_ICL_entailment
95,184,15,14,1,0.9333333333333332,1,1,0,1.0,0.9655172413793104,GPT4,mimiciii,nursing_note,PROMPT1_ICL_entailment
96,185,33,28,5,0.8484848484848485,30,28,2,0.9333333333333332,0.888888888888889,GPT4,mimiciii,nursing_note,PROMPT1_ICL_entailment
97,186,5,5,0,1.0,4,3,1,0.75,0.8571428571428571,GPT4,mimiciii,nursing_note,PROMPT1_ICL_entailment
98,187,45,45,0,1.0,37,33,4,0.8918918918918919,0.9428571428571428,GPT4,mimiciii,nursing_note,PROMPT1_ICL_entailment
99,188,5,5,0,1.0,2,1,1,0.5,0.6666666666666666,GPT4,mimiciii,nursing_note,PROMPT1_ICL_entailment
100,189,45,41,4,0.9111111111111112,21,18,3,0.8571428571428571,0.8833034111310591,GPT4,mimiciii,nursing_note,PROMPT1_ICL_entailment
101,19,42,31,11,0.7380952380952381,45,37,8,0.8222222222222222,0.7778908104442184,GPT4,mimiciii,nursing_note,PROMPT1_ICL_entailment
102,190,34,33,1,0.9705882352941176,24,23,1,0.9583333333333334,0.9644218551461246,GPT4,mimiciii,nursing_note,PROMPT1_ICL_entailment
103,191,33,30,3,0.9090909090909092,29,27,2,0.9310344827586208,0.919931856899489,GPT4,mimiciii,nursing_note,PROMPT1_ICL_entailment
104,192,23,19,4,0.8260869565217391,15,15,0,1.0,0.9047619047619048,GPT4,mimiciii,nursing_note,PROMPT1_ICL_entailment
105,193,53,43,10,0.8113207547169812,36,33,3,0.9166666666666666,0.8607825295723386,GPT4,mimiciii,nursing_note,PROMPT1_ICL_entailment
106,194,14,14,0,1.0,11,11,0,1.0,1.0,GPT4,mimiciii,nursing_note,PROMPT1_ICL_entailment
107,195,8,8,0,1.0,7,7,0,1.0,1.0,GPT4,mimiciii,nursing_note,PROMPT1_ICL_entailment
108,196,40,31,9,0.775,34,29,5,0.8529411764705882,0.8121047877145438,GPT4,mimiciii,nursing_note,PROMPT1_ICL_entailment
109,197,44,32,12,0.7272727272727273,27,24,3,0.8888888888888888,0.7999999999999999,GPT4,mimiciii,nursing_note,PROMPT1_ICL_entailment
110,198,42,34,8,0.8095238095238095,38,34,4,0.8947368421052632,0.8500000000000001,GPT4,mimiciii,nursing_note,PROMPT1_ICL_entailment
111,199,20,18,2,0.9,14,13,1,0.9285714285714286,0.9140625,GPT4,mimiciii,nursing_note,PROMPT1_ICL_entailment
112,2,52,25,27,0.4807692307692308,43,35,8,0.813953488372093,0.6044905008635579,GPT4,mimiciii,nursing_note,PROMPT1_ICL_entailment
113,20,45,28,17,0.6222222222222222,46,28,18,0.6086956521739131,0.6153846153846154,GPT4,mimiciii,nursing_note,PROMPT1_ICL_entailment
114,200,50,36,14,0.72,44,32,12,0.7272727272727273,0.7236180904522613,GPT4,mimiciii,nursing_note,PROMPT1_ICL_entailment
115,201,34,32,2,0.9411764705882352,29,22,7,0.7586206896551724,0.8400954653937948,GPT4,mimiciii,nursing_note,PROMPT1_ICL_entailment
116,202,10,9,1,0.9,9,8,1,0.8888888888888888,0.8944099378881988,GPT4,mimiciii,nursing_note,PROMPT1_ICL_entailment
117,203,13,13,0,1.0,7,7,0,1.0,1.0,GPT4,mimiciii,nursing_note,PROMPT1_ICL_entailment
118,204,35,27,8,0.7714285714285715,24,18,6,0.75,0.7605633802816902,GPT4,mimiciii,nursing_note,PROMPT1_ICL_entailment
119,205,53,52,1,0.981132075471698,47,36,11,0.7659574468085106,0.8602941176470589,GPT4,mimiciii,nursing_note,PROMPT1_ICL_entailment
120,206,9,9,0,1.0,6,4,2,0.6666666666666666,0.8,GPT4,mimiciii,nursing_note,PROMPT1_ICL_entailment
121,207,44,42,2,0.9545454545454546,29,23,6,0.7931034482758621,0.8663677130044842,GPT4,mimiciii,nursing_note,PROMPT1_ICL_entailment
122,208,13,13,0,1.0,7,7,0,1.0,1.0,GPT4,mimiciii,nursing_note,PROMPT1_ICL_entailment
123,209,3,3,0,1.0,2,2,0,1.0,1.0,GPT4,mimiciii,nursing_note,PROMPT1_ICL_entailment
124,21,7,7,0,1.0,6,5,1,0.8333333333333334,0.9090909090909092,GPT4,mimiciii,nursing_note,PROMPT1_ICL_entailment
125,210,27,17,10,0.6296296296296297,22,20,2,0.9090909090909092,0.7439824945295405,GPT4,mimiciii,nursing_note,PROMPT1_ICL_entailment
126,211,2,2,0,1.0,4,4,0,1.0,1.0,GPT4,mimiciii,nursing_note,PROMPT1_ICL_entailment
127,212,45,41,4,0.9111111111111112,37,31,6,0.8378378378378378,0.8729395604395603,GPT4,mimiciii,nursing_note,PROMPT1_ICL_entailment
128,213,28,23,5,0.8214285714285714,18,17,1,0.9444444444444444,0.8786516853932583,GPT4,mimiciii,nursing_note,PROMPT1_ICL_entailment
129,214,9,9,0,1.0,3,3,0,1.0,1.0,GPT4,mimiciii,nursing_note,PROMPT1_ICL_entailment
130,215,13,13,0,1.0,7,7,0,1.0,1.0,GPT4,mimiciii,nursing_note,PROMPT1_ICL_entailment
131,216,25,15,10,0.6,13,10,3,0.7692307692307693,0.6741573033707865,GPT4,mimiciii,nursing_note,PROMPT1_ICL_entailment
132,217,47,41,6,0.8723404255319149,25,21,4,0.84,0.8558648111332008,GPT4,mimiciii,nursing_note,PROMPT1_ICL_entailment
133,218,18,15,3,0.8333333333333334,18,15,3,0.8333333333333334,0.8333333333333334,GPT4,mimiciii,nursing_note,PROMPT1_ICL_entailment
134,219,32,23,9,0.71875,14,12,2,0.8571428571428571,0.7818696883852689,GPT4,mimiciii,nursing_note,PROMPT1_ICL_entailment
135,22,42,34,8,0.8095238095238095,26,21,5,0.8076923076923077,0.8086070215175538,GPT4,mimiciii,nursing_note,PROMPT1_ICL_entailment
136,220,13,12,1,0.9230769230769232,5,3,2,0.6,0.7272727272727274,GPT4,mimiciii,nursing_note,PROMPT1_ICL_entailment
137,221,29,19,10,0.6551724137931034,35,26,9,0.7428571428571429,0.6962649753347427,GPT4,mimiciii,nursing_note,PROMPT1_ICL_entailment
138,222,6,6,0,1.0,3,2,1,0.6666666666666666,0.8,GPT4,mimiciii,nursing_note,PROMPT1_ICL_entailment
139,223,37,21,16,0.5675675675675675,30,28,2,0.9333333333333332,0.7058823529411765,GPT4,mimiciii,nursing_note,PROMPT1_ICL_entailment
140,224,8,8,0,1.0,6,5,1,0.8333333333333334,0.9090909090909092,GPT4,mimiciii,nursing_note,PROMPT1_ICL_entailment
141,225,49,28,21,0.5714285714285714,45,38,7,0.8444444444444444,0.6816143497757847,GPT4,mimiciii,nursing_note,PROMPT1_ICL_entailment
142,226,40,40,0,1.0,20,16,4,0.8,0.888888888888889,GPT4,mimiciii,nursing_note,PROMPT1_ICL_entailment
143,227,21,21,0,1.0,15,13,2,0.8666666666666667,0.9285714285714286,GPT4,mimiciii,nursing_note,PROMPT1_ICL_entailment
144,228,40,29,11,0.725,38,29,9,0.7631578947368421,0.7435897435897436,GPT4,mimiciii,nursing_note,PROMPT1_ICL_entailment
145,229,33,30,3,0.9090909090909092,22,22,0,1.0,0.9523809523809524,GPT4,mimiciii,nursing_note,PROMPT1_ICL_entailment
146,23,45,40,5,0.8888888888888888,35,30,5,0.8571428571428571,0.8727272727272727,GPT4,mimiciii,nursing_note,PROMPT1_ICL_entailment
147,230,13,13,0,1.0,7,6,1,0.8571428571428571,0.923076923076923,GPT4,mimiciii,nursing_note,PROMPT1_ICL_entailment
148,231,65,57,8,0.8769230769230769,15,12,3,0.8,0.8366972477064221,GPT4,mimiciii,nursing_note,PROMPT1_ICL_entailment
149,232,9,7,2,0.7777777777777778,2,1,1,0.5,0.6086956521739131,GPT4,mimiciii,nursing_note,PROMPT1_ICL_entailment
150,233,33,24,9,0.7272727272727273,33,27,6,0.8181818181818182,0.770053475935829,GPT4,mimiciii,nursing_note,PROMPT1_ICL_entailment
151,234,47,45,2,0.9574468085106383,32,28,4,0.875,0.9143686502177067,GPT4,mimiciii,nursing_note,PROMPT1_ICL_entailment
152,235,21,21,0,1.0,10,10,0,1.0,1.0,GPT4,mimiciii,nursing_note,PROMPT1_ICL_entailment
153,236,16,15,1,0.9375,7,7,0,1.0,0.967741935483871,GPT4,mimiciii,nursing_note,PROMPT1_ICL_entailment
154,237,43,41,2,0.9534883720930232,35,27,8,0.7714285714285715,0.8528505392912172,GPT4,mimiciii,nursing_note,PROMPT1_ICL_entailment
155,238,49,32,17,0.6530612244897959,42,30,12,0.7142857142857143,0.6823027718550106,GPT4,mimiciii,nursing_note,PROMPT1_ICL_entailment
156,239,45,35,10,0.7777777777777778,21,18,3,0.8571428571428571,0.8155339805825242,GPT4,mimiciii,nursing_note,PROMPT1_ICL_entailment
157,24,11,11,0,1.0,5,5,0,1.0,1.0,GPT4,mimiciii,nursing_note,PROMPT1_ICL_entailment
158,240,37,32,5,0.8648648648648649,42,32,10,0.7619047619047619,0.810126582278481,GPT4,mimiciii,nursing_note,PROMPT1_ICL_entailment
159,241,29,23,6,0.7931034482758621,21,18,3,0.8571428571428571,0.8238805970149252,GPT4,mimiciii,nursing_note,PROMPT1_ICL_entailment
160,242,41,31,10,0.7560975609756098,16,13,3,0.8125,0.783284742468416,GPT4,mimiciii,nursing_note,PROMPT1_ICL_entailment
161,243,10,10,0,1.0,5,3,2,0.6,0.7499999999999999,GPT4,mimiciii,nursing_note,PROMPT1_ICL_entailment
162,244,39,32,7,0.8205128205128205,16,10,6,0.625,0.7095343680709534,GPT4,mimiciii,nursing_note,PROMPT1_ICL_entailment
163,245,41,33,8,0.8048780487804879,37,30,7,0.8108108108108109,0.8078335373317014,GPT4,mimiciii,nursing_note,PROMPT1_ICL_entailment
164,246,35,33,2,0.9428571428571428,10,9,1,0.9,0.9209302325581394,GPT4,mimiciii,nursing_note,PROMPT1_ICL_entailment
165,247,8,8,0,1.0,6,5,1,0.8333333333333334,0.9090909090909092,GPT4,mimiciii,nursing_note,PROMPT1_ICL_entailment
166,248,50,45,5,0.9,42,34,8,0.8095238095238095,0.8523676880222841,GPT4,mimiciii,nursing_note,PROMPT1_ICL_entailment
167,249,41,30,11,0.7317073170731707,39,30,9,0.7692307692307693,0.7499999999999999,GPT4,mimiciii,nursing_note,PROMPT1_ICL_entailment
168,25,37,32,5,0.8648648648648649,23,18,5,0.782608695652174,0.8216833095577747,GPT4,mimiciii,nursing_note,PROMPT1_ICL_entailment
169,26,44,37,7,0.8409090909090909,35,33,2,0.9428571428571428,0.8889697852202402,GPT4,mimiciii,nursing_note,PROMPT1_ICL_entailment
170,27,5,5,0,1.0,3,2,1,0.6666666666666666,0.8,GPT4,mimiciii,nursing_note,PROMPT1_ICL_entailment
171,28,41,32,9,0.7804878048780488,16,7,9,0.4375,0.560700876095119,GPT4,mimiciii,nursing_note,PROMPT1_ICL_entailment
172,29,27,23,4,0.8518518518518519,33,23,10,0.696969696969697,0.7666666666666667,GPT4,mimiciii,nursing_note,PROMPT1_ICL_entailment
173,3,12,11,1,0.9166666666666666,6,4,2,0.6666666666666666,0.7719298245614035,GPT4,mimiciii,nursing_note,PROMPT1_ICL_entailment
174,30,18,18,0,1.0,13,11,2,0.8461538461538461,0.9166666666666666,GPT4,mimiciii,nursing_note,PROMPT1_ICL_entailment
175,31,22,18,4,0.8181818181818182,19,17,2,0.8947368421052632,0.8547486033519553,GPT4,mimiciii,nursing_note,PROMPT1_ICL_entailment
176,32,62,57,5,0.9193548387096774,44,43,1,0.9772727272727272,0.9474294549671436,GPT4,mimiciii,nursing_note,PROMPT1_ICL_entailment
177,33,10,10,0,1.0,5,5,0,1.0,1.0,GPT4,mimiciii,nursing_note,PROMPT1_ICL_entailment
178,34,6,6,0,1.0,3,3,0,1.0,1.0,GPT4,mimiciii,nursing_note,PROMPT1_ICL_entailment
179,35,18,18,0,1.0,7,7,0,1.0,1.0,GPT4,mimiciii,nursing_note,PROMPT1_ICL_entailment
180,36,72,52,20,0.7222222222222222,62,57,5,0.9193548387096774,0.8089519650655022,GPT4,mimiciii,nursing_note,PROMPT1_ICL_entailment
181,37,45,29,16,0.6444444444444445,38,31,7,0.8157894736842105,0.7200640768922708,GPT4,mimiciii,nursing_note,PROMPT1_ICL_entailment
182,38,30,24,6,0.8,26,25,1,0.9615384615384616,0.8733624454148472,GPT4,mimiciii,nursing_note,PROMPT1_ICL_entailment
183,39,18,16,2,0.8888888888888888,3,2,1,0.6666666666666666,0.761904761904762,GPT4,mimiciii,nursing_note,PROMPT1_ICL_entailment
184,4,35,22,13,0.6285714285714286,26,25,1,0.9615384615384616,0.7601935038009674,GPT4,mimiciii,nursing_note,PROMPT1_ICL_entailment
185,40,11,11,0,1.0,3,3,0,1.0,1.0,GPT4,mimiciii,nursing_note,PROMPT1_ICL_entailment
186,41,50,45,5,0.9,50,42,8,0.84,0.8689655172413793,GPT4,mimiciii,nursing_note,PROMPT1_ICL_entailment
187,42,40,31,9,0.775,7,6,1,0.8571428571428571,0.8140043763676149,GPT4,mimiciii,nursing_note,PROMPT1_ICL_entailment
188,43,37,30,7,0.8108108108108109,14,13,1,0.9285714285714286,0.8657047724750279,GPT4,mimiciii,nursing_note,PROMPT1_ICL_entailment
189,44,8,8,0,1.0,3,3,0,1.0,1.0,GPT4,mimiciii,nursing_note,PROMPT1_ICL_entailment
190,45,42,39,3,0.9285714285714286,34,29,5,0.8529411764705882,0.8891509433962265,GPT4,mimiciii,nursing_note,PROMPT1_ICL_entailment
191,46,52,49,3,0.9423076923076924,31,25,6,0.8064516129032258,0.8691025186236254,GPT4,mimiciii,nursing_note,PROMPT1_ICL_entailment
192,47,29,19,10,0.6551724137931034,14,14,0,1.0,0.7916666666666666,GPT4,mimiciii,nursing_note,PROMPT1_ICL_entailment
193,48,28,21,7,0.75,9,9,0,1.0,0.8571428571428571,GPT4,mimiciii,nursing_note,PROMPT1_ICL_entailment
194,49,8,8,0,1.0,3,2,1,0.6666666666666666,0.8,GPT4,mimiciii,nursing_note,PROMPT1_ICL_entailment
195,5,30,24,6,0.8,15,14,1,0.9333333333333332,0.8615384615384616,GPT4,mimiciii,nursing_note,PROMPT1_ICL_entailment
196,50,29,24,5,0.8275862068965517,16,13,3,0.8125,0.8199737187910645,GPT4,mimiciii,nursing_note,PROMPT1_ICL_entailment
197,51,10,10,0,1.0,6,6,0,1.0,1.0,GPT4,mimiciii,nursing_note,PROMPT1_ICL_entailment
198,52,41,31,10,0.7560975609756098,38,28,10,0.7368421052631579,0.7463456577815993,GPT4,mimiciii,nursing_note,PROMPT1_ICL_entailment
199,53,7,7,0,1.0,6,5,1,0.8333333333333334,0.9090909090909092,GPT4,mimiciii,nursing_note,PROMPT1_ICL_entailment
200,54,38,29,9,0.7631578947368421,37,26,11,0.7027027027027027,0.7316836487142164,GPT4,mimiciii,nursing_note,PROMPT1_ICL_entailment
201,55,49,43,6,0.8775510204081632,35,26,9,0.7428571428571429,0.8046059733717165,GPT4,mimiciii,nursing_note,PROMPT1_ICL_entailment
202,56,14,14,0,1.0,2,2,0,1.0,1.0,GPT4,mimiciii,nursing_note,PROMPT1_ICL_entailment
203,57,46,43,3,0.9347826086956522,17,10,7,0.5882352941176471,0.7220822837951302,GPT4,mimiciii,nursing_note,PROMPT1_ICL_entailment
204,58,36,30,6,0.8333333333333334,25,24,1,0.96,0.8921933085501859,GPT4,mimiciii,nursing_note,PROMPT1_ICL_entailment
205,59,11,11,0,1.0,8,7,1,0.875,0.9333333333333332,GPT4,mimiciii,nursing_note,PROMPT1_ICL_entailment
206,6,15,15,0,1.0,8,8,0,1.0,1.0,GPT4,mimiciii,nursing_note,PROMPT1_ICL_entailment
207,60,44,31,13,0.7045454545454546,27,17,10,0.6296296296296297,0.6649842271293376,GPT4,mimiciii,nursing_note,PROMPT1_ICL_entailment
208,61,33,22,11,0.6666666666666666,20,17,3,0.85,0.7472527472527473,GPT4,mimiciii,nursing_note,PROMPT1_ICL_entailment
209,62,46,34,12,0.7391304347826086,37,27,10,0.7297297297297297,0.7344,GPT4,mimiciii,nursing_note,PROMPT1_ICL_entailment
210,63,10,10,0,1.0,5,5,0,1.0,1.0,GPT4,mimiciii,nursing_note,PROMPT1_ICL_entailment
211,64,58,55,3,0.9482758620689656,27,22,5,0.8148148148148148,0.8764940239043825,GPT4,mimiciii,nursing_note,PROMPT1_ICL_entailment
212,65,21,21,0,1.0,19,15,4,0.7894736842105263,0.8823529411764706,GPT4,mimiciii,nursing_note,PROMPT1_ICL_entailment
213,66,12,12,0,1.0,1,1,0,1.0,1.0,GPT4,mimiciii,nursing_note,PROMPT1_ICL_entailment
214,67,12,9,3,0.75,7,6,1,0.8571428571428571,0.7999999999999999,GPT4,mimiciii,nursing_note,PROMPT1_ICL_entailment
215,68,36,29,7,0.8055555555555556,18,15,3,0.8333333333333334,0.8192090395480227,GPT4,mimiciii,nursing_note,PROMPT1_ICL_entailment
216,69,33,24,9,0.7272727272727273,25,21,4,0.84,0.7795823665893271,GPT4,mimiciii,nursing_note,PROMPT1_ICL_entailment
217,7,6,5,1,0.8333333333333334,2,2,0,1.0,0.9090909090909092,GPT4,mimiciii,nursing_note,PROMPT1_ICL_entailment
218,70,52,43,9,0.8269230769230769,45,32,13,0.7111111111111111,0.764656849124757,GPT4,mimiciii,nursing_note,PROMPT1_ICL_entailment
219,71,55,31,24,0.5636363636363636,51,38,13,0.7450980392156863,0.6417869790247889,GPT4,mimiciii,nursing_note,PROMPT1_ICL_entailment
220,72,29,24,5,0.8275862068965517,12,8,4,0.6666666666666666,0.7384615384615385,GPT4,mimiciii,nursing_note,PROMPT1_ICL_entailment
221,73,36,25,11,0.6944444444444444,38,28,10,0.7368421052631579,0.7150153217568949,GPT4,mimiciii,nursing_note,PROMPT1_ICL_entailment
222,74,14,13,1,0.9285714285714286,7,6,1,0.8571428571428571,0.8914285714285715,GPT4,mimiciii,nursing_note,PROMPT1_ICL_entailment
223,75,48,39,9,0.8125,27,16,11,0.5925925925925926,0.6853377265238879,GPT4,mimiciii,nursing_note,PROMPT1_ICL_entailment
224,76,4,4,0,1.0,1,1,0,1.0,1.0,GPT4,mimiciii,nursing_note,PROMPT1_ICL_entailment
225,77,61,36,25,0.5901639344262295,59,45,14,0.7627118644067796,0.6654343807763401,GPT4,mimiciii,nursing_note,PROMPT1_ICL_entailment
226,78,42,25,17,0.5952380952380952,20,16,4,0.8,0.6825938566552902,GPT4,mimiciii,nursing_note,PROMPT1_ICL_entailment
227,79,39,36,3,0.9230769230769232,30,28,2,0.9333333333333332,0.9281767955801106,GPT4,mimiciii,nursing_note,PROMPT1_ICL_entailment
228,8,14,13,1,0.9285714285714286,11,11,0,1.0,0.962962962962963,GPT4,mimiciii,nursing_note,PROMPT1_ICL_entailment
229,80,40,35,5,0.875,22,13,9,0.5909090909090909,0.7054263565891474,GPT4,mimiciii,nursing_note,PROMPT1_ICL_entailment
230,81,34,24,10,0.7058823529411765,22,20,2,0.9090909090909092,0.794701986754967,GPT4,mimiciii,nursing_note,PROMPT1_ICL_entailment
231,82,41,36,5,0.8780487804878049,17,11,6,0.6470588235294118,0.7450611476952024,GPT4,mimiciii,nursing_note,PROMPT1_ICL_entailment
232,83,20,13,7,0.65,28,19,9,0.6785714285714286,0.6639784946236559,GPT4,mimiciii,nursing_note,PROMPT1_ICL_entailment
233,84,11,11,0,1.0,6,5,1,0.8333333333333334,0.9090909090909092,GPT4,mimiciii,nursing_note,PROMPT1_ICL_entailment
234,85,33,31,2,0.9393939393939394,24,20,4,0.8333333333333334,0.8831908831908831,GPT4,mimiciii,nursing_note,PROMPT1_ICL_entailment
235,86,49,42,7,0.8571428571428571,40,34,6,0.85,0.8535564853556485,GPT4,mimiciii,nursing_note,PROMPT1_ICL_entailment
236,87,26,21,5,0.8076923076923077,15,12,3,0.8,0.8038277511961722,GPT4,mimiciii,nursing_note,PROMPT1_ICL_entailment
237,88,35,28,7,0.8,15,12,3,0.8,0.8000000000000002,GPT4,mimiciii,nursing_note,PROMPT1_ICL_entailment
238,89,27,20,7,0.7407407407407407,29,27,2,0.9310344827586208,0.8250572956455309,GPT4,mimiciii,nursing_note,PROMPT1_ICL_entailment
239,9,40,35,5,0.875,17,14,3,0.8235294117647058,0.8484848484848485,GPT4,mimiciii,nursing_note,PROMPT1_ICL_entailment
240,90,34,28,6,0.8235294117647058,14,12,2,0.8571428571428571,0.84,GPT4,mimiciii,nursing_note,PROMPT1_ICL_entailment
241,91,29,16,13,0.5517241379310345,24,22,2,0.9166666666666666,0.6888454011741681,GPT4,mimiciii,nursing_note,PROMPT1_ICL_entailment
242,92,41,36,5,0.8780487804878049,28,27,1,0.9642857142857144,0.9191489361702128,GPT4,mimiciii,nursing_note,PROMPT1_ICL_entailment
243,93,34,29,5,0.8529411764705882,23,21,2,0.9130434782608696,0.8819695872556118,GPT4,mimiciii,nursing_note,PROMPT1_ICL_entailment
244,94,8,8,0,1.0,5,5,0,1.0,1.0,GPT4,mimiciii,nursing_note,PROMPT1_ICL_entailment
245,95,35,28,7,0.8,14,12,2,0.8571428571428571,0.8275862068965518,GPT4,mimiciii,nursing_note,PROMPT1_ICL_entailment
246,96,11,11,0,1.0,6,6,0,1.0,1.0,GPT4,mimiciii,nursing_note,PROMPT1_ICL_entailment
247,97,17,17,0,1.0,10,9,1,0.9,0.9473684210526316,GPT4,mimiciii,nursing_note,PROMPT1_ICL_entailment
248,98,54,50,4,0.925925925925926,13,12,1,0.9230769230769232,0.9244992295839756,GPT4,mimiciii,nursing_note,PROMPT1_ICL_entailment
249,99,52,47,5,0.903846153846154,44,39,5,0.8863636363636364,0.89501953125,GPT4,mimiciii,nursing_note,PROMPT1_ICL_entailment
0,0,18,11,7,0.6111111111111112,11,9,2,0.8181818181818182,0.6996466431095407,GPT4,mimiciii,nursing_note,PROMPT2_ICL_entailment
1,1,42,12,30,0.2857142857142857,31,23,8,0.7419354838709677,0.4125560538116591,GPT4,mimiciii,nursing_note,PROMPT2_ICL_entailment
2,10,26,19,7,0.7307692307692307,18,14,4,0.7777777777777778,0.7535410764872521,GPT4,mimiciii,nursing_note,PROMPT2_ICL_entailment
3,100,19,19,0,1.0,6,5,1,0.8333333333333334,0.9090909090909092,GPT4,mimiciii,nursing_note,PROMPT2_ICL_entailment
4,101,46,38,8,0.8260869565217391,27,26,1,0.9629629629629628,0.8892889288928892,GPT4,mimiciii,nursing_note,PROMPT2_ICL_entailment
5,102,36,27,9,0.75,26,23,3,0.8846153846153846,0.8117647058823529,GPT4,mimiciii,nursing_note,PROMPT2_ICL_entailment
6,103,33,26,7,0.7878787878787878,22,19,3,0.8636363636363636,0.8240200166805672,GPT4,mimiciii,nursing_note,PROMPT2_ICL_entailment
7,104,28,26,2,0.9285714285714286,20,19,1,0.95,0.9391634980988592,GPT4,mimiciii,nursing_note,PROMPT2_ICL_entailment
8,105,44,33,11,0.75,20,16,4,0.8,0.7741935483870969,GPT4,mimiciii,nursing_note,PROMPT2_ICL_entailment
9,106,9,9,0,1.0,4,3,1,0.75,0.8571428571428571,GPT4,mimiciii,nursing_note,PROMPT2_ICL_entailment
10,107,69,53,16,0.7681159420289855,49,37,12,0.7551020408163265,0.7615533980582524,GPT4,mimiciii,nursing_note,PROMPT2_ICL_entailment
11,108,55,54,1,0.9818181818181818,28,20,8,0.7142857142857143,0.8269525267993875,GPT4,mimiciii,nursing_note,PROMPT2_ICL_entailment
12,109,8,8,0,1.0,4,4,0,1.0,1.0,GPT4,mimiciii,nursing_note,PROMPT2_ICL_entailment
13,11,4,4,0,1.0,2,2,0,1.0,1.0,GPT4,mimiciii,nursing_note,PROMPT2_ICL_entailment
14,110,20,19,1,0.95,13,12,1,0.9230769230769232,0.9363449691991786,GPT4,mimiciii,nursing_note,PROMPT2_ICL_entailment
15,111,35,30,5,0.8571428571428571,32,27,5,0.84375,0.8503937007874015,GPT4,mimiciii,nursing_note,PROMPT2_ICL_entailment
16,112,63,42,21,0.6666666666666666,37,33,4,0.8918918918918919,0.7630057803468207,GPT4,mimiciii,nursing_note,PROMPT2_ICL_entailment
17,113,7,7,0,1.0,5,5,0,1.0,1.0,GPT4,mimiciii,nursing_note,PROMPT2_ICL_entailment
18,114,23,18,5,0.782608695652174,19,12,7,0.631578947368421,0.6990291262135923,GPT4,mimiciii,nursing_note,PROMPT2_ICL_entailment
19,115,14,14,0,1.0,7,6,1,0.8571428571428571,0.923076923076923,GPT4,mimiciii,nursing_note,PROMPT2_ICL_entailment
20,116,35,34,1,0.9714285714285714,31,28,3,0.9032258064516128,0.936086529006883,GPT4,mimiciii,nursing_note,PROMPT2_ICL_entailment
21,117,52,44,8,0.8461538461538461,18,11,7,0.6111111111111112,0.7096774193548387,GPT4,mimiciii,nursing_note,PROMPT2_ICL_entailment
22,118,30,22,8,0.7333333333333333,25,21,4,0.84,0.783050847457627,GPT4,mimiciii,nursing_note,PROMPT2_ICL_entailment
23,119,44,34,10,0.7727272727272727,26,22,4,0.8461538461538461,0.8077753779697625,GPT4,mimiciii,nursing_note,PROMPT2_ICL_entailment
24,12,38,34,4,0.8947368421052632,18,15,3,0.8333333333333334,0.8629441624365481,GPT4,mimiciii,nursing_note,PROMPT2_ICL_entailment
25,120,20,12,8,0.6,18,16,2,0.8888888888888888,0.7164179104477612,GPT4,mimiciii,nursing_note,PROMPT2_ICL_entailment
26,121,67,57,10,0.8507462686567164,37,34,3,0.918918918918919,0.8835194894005016,GPT4,mimiciii,nursing_note,PROMPT2_ICL_entailment
27,122,30,26,4,0.8666666666666667,11,9,2,0.8181818181818182,0.8417266187050358,GPT4,mimiciii,nursing_note,PROMPT2_ICL_entailment
28,123,7,7,0,1.0,6,6,0,1.0,1.0,GPT4,mimiciii,nursing_note,PROMPT2_ICL_entailment
29,124,9,9,0,1.0,5,4,1,0.8,0.888888888888889,GPT4,mimiciii,nursing_note,PROMPT2_ICL_entailment
30,125,49,48,1,0.979591836734694,43,35,8,0.813953488372093,0.8891241069065892,GPT4,mimiciii,nursing_note,PROMPT2_ICL_entailment
31,126,40,31,9,0.775,28,24,4,0.8571428571428571,0.8140043763676149,GPT4,mimiciii,nursing_note,PROMPT2_ICL_entailment
32,127,21,17,4,0.8095238095238095,10,9,1,0.9,0.8523676880222841,GPT4,mimiciii,nursing_note,PROMPT2_ICL_entailment
33,128,31,30,1,0.967741935483871,17,16,1,0.9411764705882352,0.9542743538767396,GPT4,mimiciii,nursing_note,PROMPT2_ICL_entailment
34,129,39,33,6,0.8461538461538461,29,24,5,0.8275862068965517,0.8367670364500792,GPT4,mimiciii,nursing_note,PROMPT2_ICL_entailment
35,13,58,54,4,0.9310344827586208,34,29,5,0.8529411764705882,0.8902785673678226,GPT4,mimiciii,nursing_note,PROMPT2_ICL_entailment
36,130,44,28,16,0.6363636363636364,33,16,17,0.4848484848484848,0.5503685503685505,GPT4,mimiciii,nursing_note,PROMPT2_ICL_entailment
37,131,38,30,8,0.7894736842105263,31,28,3,0.9032258064516128,0.8425275827482448,GPT4,mimiciii,nursing_note,PROMPT2_ICL_entailment
38,132,47,35,12,0.7446808510638298,17,16,1,0.9411764705882352,0.8314773570898293,GPT4,mimiciii,nursing_note,PROMPT2_ICL_entailment
39,133,20,16,4,0.8,10,7,3,0.7,0.7466666666666666,GPT4,mimiciii,nursing_note,PROMPT2_ICL_entailment
40,134,51,21,30,0.4117647058823529,30,23,7,0.7666666666666667,0.5357737104825291,GPT4,mimiciii,nursing_note,PROMPT2_ICL_entailment
41,135,60,48,12,0.8,42,38,4,0.9047619047619048,0.8491620111731844,GPT4,mimiciii,nursing_note,PROMPT2_ICL_entailment
42,136,79,73,6,0.9240506329113924,41,34,7,0.8292682926829268,0.8740975523859835,GPT4,mimiciii,nursing_note,PROMPT2_ICL_entailment
43,137,6,6,0,1.0,2,2,0,1.0,1.0,GPT4,mimiciii,nursing_note,PROMPT2_ICL_entailment
44,138,8,8,0,1.0,5,4,1,0.8,0.888888888888889,GPT4,mimiciii,nursing_note,PROMPT2_ICL_entailment
45,139,12,11,1,0.9166666666666666,4,3,1,0.75,0.8250000000000001,GPT4,mimiciii,nursing_note,PROMPT2_ICL_entailment
46,14,31,30,1,0.967741935483871,25,24,1,0.96,0.963855421686747,GPT4,mimiciii,nursing_note,PROMPT2_ICL_entailment
47,140,38,25,13,0.6578947368421053,24,21,3,0.875,0.7510729613733906,GPT4,mimiciii,nursing_note,PROMPT2_ICL_entailment
48,141,19,17,2,0.8947368421052632,11,9,2,0.8181818181818182,0.8547486033519553,GPT4,mimiciii,nursing_note,PROMPT2_ICL_entailment
49,142,63,51,12,0.8095238095238095,8,6,2,0.75,0.7786259541984734,GPT4,mimiciii,nursing_note,PROMPT2_ICL_entailment
50,143,17,14,3,0.8235294117647058,2,1,1,0.5,0.6222222222222222,GPT4,mimiciii,nursing_note,PROMPT2_ICL_entailment
51,144,14,13,1,0.9285714285714286,5,5,0,1.0,0.962962962962963,GPT4,mimiciii,nursing_note,PROMPT2_ICL_entailment
52,145,36,27,9,0.75,19,18,1,0.9473684210526316,0.8372093023255814,GPT4,mimiciii,nursing_note,PROMPT2_ICL_entailment
53,146,14,14,0,1.0,6,5,1,0.8333333333333334,0.9090909090909092,GPT4,mimiciii,nursing_note,PROMPT2_ICL_entailment
54,147,42,33,9,0.7857142857142857,26,21,5,0.8076923076923077,0.796551724137931,GPT4,mimiciii,nursing_note,PROMPT2_ICL_entailment
55,148,22,21,1,0.9545454545454546,7,5,2,0.7142857142857143,0.8171206225680934,GPT4,mimiciii,nursing_note,PROMPT2_ICL_entailment
56,149,41,35,6,0.8536585365853658,36,24,12,0.6666666666666666,0.7486631016042781,GPT4,mimiciii,nursing_note,PROMPT2_ICL_entailment
57,15,33,29,4,0.8787878787878788,33,26,7,0.7878787878787878,0.8308539944903581,GPT4,mimiciii,nursing_note,PROMPT2_ICL_entailment
58,150,15,15,0,1.0,8,8,0,1.0,1.0,GPT4,mimiciii,nursing_note,PROMPT2_ICL_entailment
59,151,35,30,5,0.8571428571428571,26,20,6,0.7692307692307693,0.8108108108108107,GPT4,mimiciii,nursing_note,PROMPT2_ICL_entailment
60,152,57,51,6,0.8947368421052632,44,31,13,0.7045454545454546,0.7883320867614061,GPT4,mimiciii,nursing_note,PROMPT2_ICL_entailment
61,153,9,9,0,1.0,4,3,1,0.75,0.8571428571428571,GPT4,mimiciii,nursing_note,PROMPT2_ICL_entailment
62,154,38,37,1,0.9736842105263158,34,27,7,0.7941176470588235,0.8747810858143608,GPT4,mimiciii,nursing_note,PROMPT2_ICL_entailment
63,155,62,52,10,0.8387096774193549,51,43,8,0.8431372549019608,0.8409176382098533,GPT4,mimiciii,nursing_note,PROMPT2_ICL_entailment
64,156,28,25,3,0.8928571428571429,26,17,9,0.6538461538461539,0.7548845470692718,GPT4,mimiciii,nursing_note,PROMPT2_ICL_entailment
65,157,7,7,0,1.0,5,4,1,0.8,0.888888888888889,GPT4,mimiciii,nursing_note,PROMPT2_ICL_entailment
66,158,44,43,1,0.9772727272727272,22,17,5,0.7727272727272727,0.8630460448642266,GPT4,mimiciii,nursing_note,PROMPT2_ICL_entailment
67,159,14,11,3,0.7857142857142857,8,6,2,0.75,0.7674418604651163,GPT4,mimiciii,nursing_note,PROMPT2_ICL_entailment
68,16,56,50,6,0.8928571428571429,30,19,11,0.6333333333333333,0.7410296411856474,GPT4,mimiciii,nursing_note,PROMPT2_ICL_entailment
69,160,44,40,4,0.9090909090909092,21,17,4,0.8095238095238095,0.8564231738035265,GPT4,mimiciii,nursing_note,PROMPT2_ICL_entailment
70,161,6,6,0,1.0,6,5,1,0.8333333333333334,0.9090909090909092,GPT4,mimiciii,nursing_note,PROMPT2_ICL_entailment
71,162,34,29,5,0.8529411764705882,31,21,10,0.6774193548387096,0.7551146931184128,GPT4,mimiciii,nursing_note,PROMPT2_ICL_entailment
72,163,15,15,0,1.0,4,4,0,1.0,1.0,GPT4,mimiciii,nursing_note,PROMPT2_ICL_entailment
73,164,26,25,1,0.9615384615384616,13,11,2,0.8461538461538461,0.900163666121113,GPT4,mimiciii,nursing_note,PROMPT2_ICL_entailment
74,165,47,40,7,0.851063829787234,24,18,6,0.75,0.79734219269103,GPT4,mimiciii,nursing_note,PROMPT2_ICL_entailment
75,166,17,17,0,1.0,3,3,0,1.0,1.0,GPT4,mimiciii,nursing_note,PROMPT2_ICL_entailment
76,167,40,32,8,0.8,16,14,2,0.875,0.8358208955223881,GPT4,mimiciii,nursing_note,PROMPT2_ICL_entailment
77,168,37,23,14,0.6216216216216216,25,18,7,0.72,0.6672038678485092,GPT4,mimiciii,nursing_note,PROMPT2_ICL_entailment
78,169,26,24,2,0.9230769230769232,12,11,1,0.9166666666666666,0.9198606271777002,GPT4,mimiciii,nursing_note,PROMPT2_ICL_entailment
79,17,29,24,5,0.8275862068965517,39,28,11,0.717948717948718,0.7688787185354691,GPT4,mimiciii,nursing_note,PROMPT2_ICL_entailment
80,170,51,47,4,0.9215686274509804,21,17,4,0.8095238095238095,0.8619201725997843,GPT4,mimiciii,nursing_note,PROMPT2_ICL_entailment
81,171,13,13,0,1.0,8,7,1,0.875,0.9333333333333332,GPT4,mimiciii,nursing_note,PROMPT2_ICL_entailment
82,172,55,52,3,0.9454545454545454,38,25,13,0.6578947368421053,0.7758877946881528,GPT4,mimiciii,nursing_note,PROMPT2_ICL_entailment
83,173,33,33,0,1.0,19,14,5,0.7368421052631579,0.8484848484848484,GPT4,mimiciii,nursing_note,PROMPT2_ICL_entailment
84,174,12,12,0,1.0,8,5,3,0.625,0.7692307692307693,GPT4,mimiciii,nursing_note,PROMPT2_ICL_entailment
85,175,8,8,0,1.0,4,4,0,1.0,1.0,GPT4,mimiciii,nursing_note,PROMPT2_ICL_entailment
86,176,26,19,7,0.7307692307692307,13,10,3,0.7692307692307693,0.7495069033530571,GPT4,mimiciii,nursing_note,PROMPT2_ICL_entailment
87,177,50,43,7,0.86,38,27,11,0.7105263157894737,0.7781501340482574,GPT4,mimiciii,nursing_note,PROMPT2_ICL_entailment
88,178,52,49,3,0.9423076923076924,25,22,3,0.88,0.9100886449978892,GPT4,mimiciii,nursing_note,PROMPT2_ICL_entailment
89,179,34,30,4,0.8823529411764706,22,20,2,0.9090909090909092,0.8955223880597014,GPT4,mimiciii,nursing_note,PROMPT2_ICL_entailment
90,18,39,35,4,0.8974358974358975,25,18,7,0.72,0.7989854153455929,GPT4,mimiciii,nursing_note,PROMPT2_ICL_entailment
91,180,47,38,9,0.8085106382978723,27,20,7,0.7407407407407407,0.7731434384537132,GPT4,mimiciii,nursing_note,PROMPT2_ICL_entailment
92,181,39,24,15,0.6153846153846154,25,21,4,0.84,0.7103594080338267,GPT4,mimiciii,nursing_note,PROMPT2_ICL_entailment
93,182,25,19,6,0.76,10,8,2,0.8,0.7794871794871796,GPT4,mimiciii,nursing_note,PROMPT2_ICL_entailment
94,183,7,6,1,0.8571428571428571,5,4,1,0.8,0.8275862068965518,GPT4,mimiciii,nursing_note,PROMPT2_ICL_entailment
95,184,18,18,0,1.0,1,1,0,1.0,1.0,GPT4,mimiciii,nursing_note,PROMPT2_ICL_entailment
96,185,33,28,5,0.8484848484848485,30,27,3,0.9,0.8734835355285963,GPT4,mimiciii,nursing_note,PROMPT2_ICL_entailment
97,186,5,5,0,1.0,4,3,1,0.75,0.8571428571428571,GPT4,mimiciii,nursing_note,PROMPT2_ICL_entailment
98,187,46,45,1,0.9782608695652174,37,30,7,0.8108108108108109,0.8866995073891626,GPT4,mimiciii,nursing_note,PROMPT2_ICL_entailment
99,188,5,5,0,1.0,2,1,1,0.5,0.6666666666666666,GPT4,mimiciii,nursing_note,PROMPT2_ICL_entailment
100,189,48,42,6,0.875,21,18,3,0.8571428571428571,0.8659793814432989,GPT4,mimiciii,nursing_note,PROMPT2_ICL_entailment
101,19,58,40,18,0.6896551724137931,45,35,10,0.7777777777777778,0.731070496083551,GPT4,mimiciii,nursing_note,PROMPT2_ICL_entailment
102,190,41,37,4,0.902439024390244,24,18,6,0.75,0.8191881918819189,GPT4,mimiciii,nursing_note,PROMPT2_ICL_entailment
103,191,37,32,5,0.8648648648648649,29,22,7,0.7586206896551724,0.8082663605051665,GPT4,mimiciii,nursing_note,PROMPT2_ICL_entailment
104,192,24,22,2,0.9166666666666666,15,12,3,0.8,0.854368932038835,GPT4,mimiciii,nursing_note,PROMPT2_ICL_entailment
105,193,52,40,12,0.7692307692307693,36,30,6,0.8333333333333334,0.8,GPT4,mimiciii,nursing_note,PROMPT2_ICL_entailment
106,194,14,14,0,1.0,11,11,0,1.0,1.0,GPT4,mimiciii,nursing_note,PROMPT2_ICL_entailment
107,195,8,8,0,1.0,7,7,0,1.0,1.0,GPT4,mimiciii,nursing_note,PROMPT2_ICL_entailment
108,196,49,40,9,0.8163265306122449,34,28,6,0.8235294117647058,0.8199121522693996,GPT4,mimiciii,nursing_note,PROMPT2_ICL_entailment
109,197,55,44,11,0.8,27,23,4,0.8518518518518519,0.8251121076233184,GPT4,mimiciii,nursing_note,PROMPT2_ICL_entailment
110,198,53,47,6,0.8867924528301887,38,27,11,0.7105263157894737,0.788933789244638,GPT4,mimiciii,nursing_note,PROMPT2_ICL_entailment
111,199,21,17,4,0.8095238095238095,14,11,3,0.7857142857142857,0.7974413646055437,GPT4,mimiciii,nursing_note,PROMPT2_ICL_entailment
112,2,52,25,27,0.4807692307692308,43,34,9,0.7906976744186046,0.5979599015124868,GPT4,mimiciii,nursing_note,PROMPT2_ICL_entailment
113,20,68,51,17,0.75,46,28,18,0.6086956521739131,0.672,GPT4,mimiciii,nursing_note,PROMPT2_ICL_entailment
114,200,59,47,12,0.7966101694915254,44,33,11,0.75,0.7726027397260273,GPT4,mimiciii,nursing_note,PROMPT2_ICL_entailment
115,201,35,31,4,0.8857142857142857,29,18,11,0.6206896551724138,0.7298888162197515,GPT4,mimiciii,nursing_note,PROMPT2_ICL_entailment
116,202,11,10,1,0.9090909090909092,9,8,1,0.8888888888888888,0.8988764044943819,GPT4,mimiciii,nursing_note,PROMPT2_ICL_entailment
117,203,13,13,0,1.0,7,6,1,0.8571428571428571,0.923076923076923,GPT4,mimiciii,nursing_note,PROMPT2_ICL_entailment
118,204,39,28,11,0.717948717948718,24,17,7,0.7083333333333334,0.7131086142322098,GPT4,mimiciii,nursing_note,PROMPT2_ICL_entailment
119,205,54,53,1,0.9814814814814816,47,40,7,0.851063829787234,0.911631907116749,GPT4,mimiciii,nursing_note,PROMPT2_ICL_entailment
120,206,10,10,0,1.0,6,6,0,1.0,1.0,GPT4,mimiciii,nursing_note,PROMPT2_ICL_entailment
121,207,43,41,2,0.9534883720930232,29,22,7,0.7586206896551724,0.8449648711943794,GPT4,mimiciii,nursing_note,PROMPT2_ICL_entailment
122,208,14,14,0,1.0,7,7,0,1.0,1.0,GPT4,mimiciii,nursing_note,PROMPT2_ICL_entailment
123,209,3,3,0,1.0,2,2,0,1.0,1.0,GPT4,mimiciii,nursing_note,PROMPT2_ICL_entailment
124,21,7,7,0,1.0,6,5,1,0.8333333333333334,0.9090909090909092,GPT4,mimiciii,nursing_note,PROMPT2_ICL_entailment
125,210,27,24,3,0.8888888888888888,22,21,1,0.9545454545454546,0.9205479452054794,GPT4,mimiciii,nursing_note,PROMPT2_ICL_entailment
126,211,8,8,0,1.0,4,4,0,1.0,1.0,GPT4,mimiciii,nursing_note,PROMPT2_ICL_entailment
127,212,49,44,5,0.8979591836734694,37,27,10,0.7297297297297297,0.8051507963402236,GPT4,mimiciii,nursing_note,PROMPT2_ICL_entailment
128,213,26,22,4,0.8461538461538461,18,16,2,0.8888888888888888,0.8669950738916256,GPT4,mimiciii,nursing_note,PROMPT2_ICL_entailment
129,214,16,12,4,0.75,3,3,0,1.0,0.8571428571428571,GPT4,mimiciii,nursing_note,PROMPT2_ICL_entailment
130,215,15,15,0,1.0,7,6,1,0.8571428571428571,0.923076923076923,GPT4,mimiciii,nursing_note,PROMPT2_ICL_entailment
131,216,25,17,8,0.68,13,8,5,0.6153846153846154,0.6460807600950118,GPT4,mimiciii,nursing_note,PROMPT2_ICL_entailment
132,217,53,44,9,0.8301886792452831,25,18,7,0.72,0.7711781888997079,GPT4,mimiciii,nursing_note,PROMPT2_ICL_entailment
133,218,21,16,5,0.7619047619047619,18,16,2,0.8888888888888888,0.8205128205128205,GPT4,mimiciii,nursing_note,PROMPT2_ICL_entailment
134,219,31,23,8,0.7419354838709677,14,13,1,0.9285714285714286,0.8248275862068967,GPT4,mimiciii,nursing_note,PROMPT2_ICL_entailment
135,22,43,35,8,0.813953488372093,26,24,2,0.9230769230769232,0.8650875386199794,GPT4,mimiciii,nursing_note,PROMPT2_ICL_entailment
136,220,15,14,1,0.9333333333333332,5,2,3,0.4,0.5599999999999999,GPT4,mimiciii,nursing_note,PROMPT2_ICL_entailment
137,221,30,23,7,0.7666666666666667,35,27,8,0.7714285714285715,0.7690402476780187,GPT4,mimiciii,nursing_note,PROMPT2_ICL_entailment
138,222,7,7,0,1.0,3,3,0,1.0,1.0,GPT4,mimiciii,nursing_note,PROMPT2_ICL_entailment
139,223,38,19,19,0.5,30,25,5,0.8333333333333334,0.625,GPT4,mimiciii,nursing_note,PROMPT2_ICL_entailment
140,224,9,9,0,1.0,6,3,3,0.5,0.6666666666666666,GPT4,mimiciii,nursing_note,PROMPT2_ICL_entailment
141,225,61,26,35,0.4262295081967213,45,30,15,0.6666666666666666,0.52,GPT4,mimiciii,nursing_note,PROMPT2_ICL_entailment
142,226,39,39,0,1.0,20,18,2,0.9,0.9473684210526316,GPT4,mimiciii,nursing_note,PROMPT2_ICL_entailment
143,227,20,17,3,0.85,15,14,1,0.9333333333333332,0.8897196261682243,GPT4,mimiciii,nursing_note,PROMPT2_ICL_entailment
144,228,52,31,21,0.5961538461538461,38,32,6,0.8421052631578947,0.6980999296270232,GPT4,mimiciii,nursing_note,PROMPT2_ICL_entailment
145,229,41,38,3,0.926829268292683,22,20,2,0.9090909090909092,0.9178743961352656,GPT4,mimiciii,nursing_note,PROMPT2_ICL_entailment
146,23,52,45,7,0.8653846153846154,35,28,7,0.8,0.8314087759815243,GPT4,mimiciii,nursing_note,PROMPT2_ICL_entailment
147,230,15,14,1,0.9333333333333332,7,6,1,0.8571428571428571,0.8936170212765957,GPT4,mimiciii,nursing_note,PROMPT2_ICL_entailment
148,231,63,55,8,0.873015873015873,15,12,3,0.8,0.8349146110056926,GPT4,mimiciii,nursing_note,PROMPT2_ICL_entailment
149,232,9,7,2,0.7777777777777778,2,1,1,0.5,0.6086956521739131,GPT4,mimiciii,nursing_note,PROMPT2_ICL_entailment
150,233,39,21,18,0.5384615384615384,33,26,7,0.7878787878787878,0.6397188049209138,GPT4,mimiciii,nursing_note,PROMPT2_ICL_entailment
151,234,46,45,1,0.9782608695652174,32,23,9,0.71875,0.8286629303442755,GPT4,mimiciii,nursing_note,PROMPT2_ICL_entailment
152,235,24,24,0,1.0,10,10,0,1.0,1.0,GPT4,mimiciii,nursing_note,PROMPT2_ICL_entailment
153,236,16,14,2,0.875,7,6,1,0.8571428571428571,0.8659793814432989,GPT4,mimiciii,nursing_note,PROMPT2_ICL_entailment
154,237,60,54,6,0.9,35,25,10,0.7142857142857143,0.7964601769911505,GPT4,mimiciii,nursing_note,PROMPT2_ICL_entailment
155,238,61,44,17,0.7213114754098361,42,26,16,0.6190476190476191,0.666278392545137,GPT4,mimiciii,nursing_note,PROMPT2_ICL_entailment
156,239,49,36,13,0.7346938775510204,21,18,3,0.8571428571428571,0.7912087912087913,GPT4,mimiciii,nursing_note,PROMPT2_ICL_entailment
157,24,13,13,0,1.0,5,5,0,1.0,1.0,GPT4,mimiciii,nursing_note,PROMPT2_ICL_entailment
158,240,42,39,3,0.9285714285714286,42,32,10,0.7619047619047619,0.8370221327967807,GPT4,mimiciii,nursing_note,PROMPT2_ICL_entailment
159,241,31,16,15,0.5161290322580645,21,18,3,0.8571428571428571,0.6442953020134228,GPT4,mimiciii,nursing_note,PROMPT2_ICL_entailment
160,242,49,35,14,0.7142857142857143,16,9,7,0.5625,0.6293706293706294,GPT4,mimiciii,nursing_note,PROMPT2_ICL_entailment
161,243,11,11,0,1.0,5,3,2,0.6,0.7499999999999999,GPT4,mimiciii,nursing_note,PROMPT2_ICL_entailment
162,244,39,31,8,0.7948717948717948,16,10,6,0.625,0.6997742663656885,GPT4,mimiciii,nursing_note,PROMPT2_ICL_entailment
163,245,45,33,12,0.7333333333333333,37,30,7,0.8108108108108109,0.7701283547257877,GPT4,mimiciii,nursing_note,PROMPT2_ICL_entailment
164,246,35,31,4,0.8857142857142857,10,7,3,0.7,0.7819819819819819,GPT4,mimiciii,nursing_note,PROMPT2_ICL_entailment
165,247,8,8,0,1.0,6,5,1,0.8333333333333334,0.9090909090909092,GPT4,mimiciii,nursing_note,PROMPT2_ICL_entailment
166,248,52,46,6,0.8846153846153846,42,26,16,0.6190476190476191,0.7283800243605361,GPT4,mimiciii,nursing_note,PROMPT2_ICL_entailment
167,249,47,38,9,0.8085106382978723,39,28,11,0.717948717948718,0.7605432451751252,GPT4,mimiciii,nursing_note,PROMPT2_ICL_entailment
168,25,40,31,9,0.775,23,19,4,0.8260869565217391,0.7997284453496266,GPT4,mimiciii,nursing_note,PROMPT2_ICL_entailment
169,26,48,44,4,0.9166666666666666,35,30,5,0.8571428571428571,0.8859060402684563,GPT4,mimiciii,nursing_note,PROMPT2_ICL_entailment
170,27,9,9,0,1.0,3,2,1,0.6666666666666666,0.8,GPT4,mimiciii,nursing_note,PROMPT2_ICL_entailment
171,28,40,37,3,0.925,16,11,5,0.6875,0.7887596899224807,GPT4,mimiciii,nursing_note,PROMPT2_ICL_entailment
172,29,34,26,8,0.7647058823529411,33,21,12,0.6363636363636364,0.6946564885496184,GPT4,mimiciii,nursing_note,PROMPT2_ICL_entailment
173,3,12,10,2,0.8333333333333334,6,5,1,0.8333333333333334,0.8333333333333334,GPT4,mimiciii,nursing_note,PROMPT2_ICL_entailment
174,30,20,19,1,0.95,13,10,3,0.7692307692307693,0.8501118568232661,GPT4,mimiciii,nursing_note,PROMPT2_ICL_entailment
175,31,32,29,3,0.90625,19,16,3,0.8421052631578947,0.8730009407337723,GPT4,mimiciii,nursing_note,PROMPT2_ICL_entailment
176,32,73,71,2,0.9726027397260274,44,42,2,0.9545454545454546,0.9634894991922456,GPT4,mimiciii,nursing_note,PROMPT2_ICL_entailment
177,33,11,11,0,1.0,5,5,0,1.0,1.0,GPT4,mimiciii,nursing_note,PROMPT2_ICL_entailment
178,34,6,6,0,1.0,3,3,0,1.0,1.0,GPT4,mimiciii,nursing_note,PROMPT2_ICL_entailment
179,35,15,15,0,1.0,7,7,0,1.0,1.0,GPT4,mimiciii,nursing_note,PROMPT2_ICL_entailment
180,36,90,65,25,0.7222222222222222,62,48,14,0.7741935483870968,0.7473053892215569,GPT4,mimiciii,nursing_note,PROMPT2_ICL_entailment
181,37,42,24,18,0.5714285714285714,38,32,6,0.8421052631578947,0.6808510638297872,GPT4,mimiciii,nursing_note,PROMPT2_ICL_entailment
182,38,33,27,6,0.8181818181818182,26,22,4,0.8461538461538461,0.8319327731092436,GPT4,mimiciii,nursing_note,PROMPT2_ICL_entailment
183,39,21,16,5,0.7619047619047619,3,1,2,0.3333333333333333,0.463768115942029,GPT4,mimiciii,nursing_note,PROMPT2_ICL_entailment
184,4,32,25,7,0.78125,26,23,3,0.8846153846153846,0.8297258297258296,GPT4,mimiciii,nursing_note,PROMPT2_ICL_entailment
185,40,12,12,0,1.0,3,3,0,1.0,1.0,GPT4,mimiciii,nursing_note,PROMPT2_ICL_entailment
186,41,63,59,4,0.9365079365079364,50,38,12,0.76,0.8390718562874252,GPT4,mimiciii,nursing_note,PROMPT2_ICL_entailment
187,42,42,33,9,0.7857142857142857,7,5,2,0.7142857142857143,0.7482993197278911,GPT4,mimiciii,nursing_note,PROMPT2_ICL_entailment
188,43,36,31,5,0.8611111111111112,14,11,3,0.7857142857142857,0.8216867469879519,GPT4,mimiciii,nursing_note,PROMPT2_ICL_entailment
189,44,10,9,1,0.9,3,3,0,1.0,0.9473684210526316,GPT4,mimiciii,nursing_note,PROMPT2_ICL_entailment
190,45,58,56,2,0.9655172413793104,34,28,6,0.8235294117647058,0.888888888888889,GPT4,mimiciii,nursing_note,PROMPT2_ICL_entailment
191,46,66,62,4,0.9393939393939394,31,26,5,0.8387096774193549,0.8862012094557449,GPT4,mimiciii,nursing_note,PROMPT2_ICL_entailment
192,47,30,21,9,0.7,14,13,1,0.9285714285714286,0.7982456140350878,GPT4,mimiciii,nursing_note,PROMPT2_ICL_entailment
193,48,28,24,4,0.8571428571428571,9,9,0,1.0,0.923076923076923,GPT4,mimiciii,nursing_note,PROMPT2_ICL_entailment
194,49,10,10,0,1.0,3,3,0,1.0,1.0,GPT4,mimiciii,nursing_note,PROMPT2_ICL_entailment
195,5,40,34,6,0.85,15,10,5,0.6666666666666666,0.7472527472527473,GPT4,mimiciii,nursing_note,PROMPT2_ICL_entailment
196,50,32,23,9,0.71875,16,14,2,0.875,0.7892156862745098,GPT4,mimiciii,nursing_note,PROMPT2_ICL_entailment
197,51,11,11,0,1.0,6,6,0,1.0,1.0,GPT4,mimiciii,nursing_note,PROMPT2_ICL_entailment
198,52,40,27,13,0.675,38,30,8,0.7894736842105263,0.7277628032345014,GPT4,mimiciii,nursing_note,PROMPT2_ICL_entailment
199,53,7,7,0,1.0,6,5,1,0.8333333333333334,0.9090909090909092,GPT4,mimiciii,nursing_note,PROMPT2_ICL_entailment
200,54,39,27,12,0.6923076923076923,37,27,10,0.7297297297297297,0.7105263157894737,GPT4,mimiciii,nursing_note,PROMPT2_ICL_entailment
201,55,49,46,3,0.9387755102040816,35,25,10,0.7142857142857143,0.8112874779541447,GPT4,mimiciii,nursing_note,PROMPT2_ICL_entailment
202,56,19,18,1,0.9473684210526316,2,2,0,1.0,0.972972972972973,GPT4,mimiciii,nursing_note,PROMPT2_ICL_entailment
203,57,56,50,6,0.8928571428571429,17,8,9,0.4705882352941176,0.6163328197226502,GPT4,mimiciii,nursing_note,PROMPT2_ICL_entailment
204,58,57,47,10,0.8245614035087719,25,24,1,0.96,0.8871411718442784,GPT4,mimiciii,nursing_note,PROMPT2_ICL_entailment
205,59,11,11,0,1.0,8,7,1,0.875,0.9333333333333332,GPT4,mimiciii,nursing_note,PROMPT2_ICL_entailment
206,6,17,17,0,1.0,8,7,1,0.875,0.9333333333333332,GPT4,mimiciii,nursing_note,PROMPT2_ICL_entailment
207,60,48,35,13,0.7291666666666666,27,20,7,0.7407407407407407,0.7349081364829395,GPT4,mimiciii,nursing_note,PROMPT2_ICL_entailment
208,61,35,20,15,0.5714285714285714,20,18,2,0.9,0.6990291262135921,GPT4,mimiciii,nursing_note,PROMPT2_ICL_entailment
209,62,46,36,10,0.782608695652174,37,27,10,0.7297297297297297,0.7552447552447553,GPT4,mimiciii,nursing_note,PROMPT2_ICL_entailment
210,63,7,7,0,1.0,5,4,1,0.8,0.888888888888889,GPT4,mimiciii,nursing_note,PROMPT2_ICL_entailment
211,64,63,57,6,0.9047619047619048,27,22,5,0.8148148148148148,0.8574358974358974,GPT4,mimiciii,nursing_note,PROMPT2_ICL_entailment
212,65,29,25,4,0.8620689655172413,19,13,6,0.6842105263157895,0.7629107981220656,GPT4,mimiciii,nursing_note,PROMPT2_ICL_entailment
213,66,17,17,0,1.0,1,1,0,1.0,1.0,GPT4,mimiciii,nursing_note,PROMPT2_ICL_entailment
214,67,17,15,2,0.8823529411764706,7,5,2,0.7142857142857143,0.7894736842105262,GPT4,mimiciii,nursing_note,PROMPT2_ICL_entailment
215,68,36,30,6,0.8333333333333334,18,13,5,0.7222222222222222,0.7738095238095238,GPT4,mimiciii,nursing_note,PROMPT2_ICL_entailment
216,69,37,27,10,0.7297297297297297,25,21,4,0.84,0.78099173553719,GPT4,mimiciii,nursing_note,PROMPT2_ICL_entailment
217,7,5,5,0,1.0,2,2,0,1.0,1.0,GPT4,mimiciii,nursing_note,PROMPT2_ICL_entailment
218,70,52,45,7,0.8653846153846154,45,23,22,0.5111111111111111,0.6426575597640484,GPT4,mimiciii,nursing_note,PROMPT2_ICL_entailment
219,71,61,34,27,0.5573770491803278,51,39,12,0.7647058823529411,0.6447848285922684,GPT4,mimiciii,nursing_note,PROMPT2_ICL_entailment
220,72,30,27,3,0.9,12,8,4,0.6666666666666666,0.7659574468085106,GPT4,mimiciii,nursing_note,PROMPT2_ICL_entailment
221,73,41,29,12,0.7073170731707317,38,26,12,0.6842105263157895,0.6955719557195571,GPT4,mimiciii,nursing_note,PROMPT2_ICL_entailment
222,74,21,19,2,0.9047619047619048,7,6,1,0.8571428571428571,0.8803088803088803,GPT4,mimiciii,nursing_note,PROMPT2_ICL_entailment
223,75,51,37,14,0.7254901960784313,27,17,10,0.6296296296296297,0.6741693461950696,GPT4,mimiciii,nursing_note,PROMPT2_ICL_entailment
224,76,4,4,0,1.0,1,1,0,1.0,1.0,GPT4,mimiciii,nursing_note,PROMPT2_ICL_entailment
225,77,65,30,35,0.4615384615384615,59,35,24,0.5932203389830508,0.5191594561186651,GPT4,mimiciii,nursing_note,PROMPT2_ICL_entailment
226,78,48,29,19,0.6041666666666666,20,10,10,0.5,0.5471698113207547,GPT4,mimiciii,nursing_note,PROMPT2_ICL_entailment
227,79,46,44,2,0.9565217391304348,30,26,4,0.8666666666666667,0.9093799682034976,GPT4,mimiciii,nursing_note,PROMPT2_ICL_entailment
228,8,16,16,0,1.0,11,11,0,1.0,1.0,GPT4,mimiciii,nursing_note,PROMPT2_ICL_entailment
229,80,40,32,8,0.8,22,15,7,0.6818181818181818,0.7361963190184048,GPT4,mimiciii,nursing_note,PROMPT2_ICL_entailment
230,81,37,26,11,0.7027027027027027,22,18,4,0.8181818181818182,0.7560581583198709,GPT4,mimiciii,nursing_note,PROMPT2_ICL_entailment
231,82,44,40,4,0.9090909090909092,17,10,7,0.5882352941176471,0.7142857142857143,GPT4,mimiciii,nursing_note,PROMPT2_ICL_entailment
232,83,23,16,7,0.6956521739130435,28,19,9,0.6785714285714286,0.6870056497175141,GPT4,mimiciii,nursing_note,PROMPT2_ICL_entailment
233,84,13,13,0,1.0,6,5,1,0.8333333333333334,0.9090909090909092,GPT4,mimiciii,nursing_note,PROMPT2_ICL_entailment
234,85,38,36,2,0.9473684210526316,24,21,3,0.875,0.9097472924187724,GPT4,mimiciii,nursing_note,PROMPT2_ICL_entailment
235,86,74,56,18,0.7567567567567568,40,31,9,0.775,0.7657697397441552,GPT4,mimiciii,nursing_note,PROMPT2_ICL_entailment
236,87,26,22,4,0.8461538461538461,15,13,2,0.8666666666666667,0.8562874251497006,GPT4,mimiciii,nursing_note,PROMPT2_ICL_entailment
237,88,51,36,15,0.7058823529411765,15,13,2,0.8666666666666667,0.7780548628428927,GPT4,mimiciii,nursing_note,PROMPT2_ICL_entailment
238,89,36,32,4,0.8888888888888888,29,25,4,0.8620689655172413,0.87527352297593,GPT4,mimiciii,nursing_note,PROMPT2_ICL_entailment
239,9,46,40,6,0.8695652173913043,17,13,4,0.7647058823529411,0.8137715179968701,GPT4,mimiciii,nursing_note,PROMPT2_ICL_entailment
240,90,35,27,8,0.7714285714285715,14,12,2,0.8571428571428571,0.81203007518797,GPT4,mimiciii,nursing_note,PROMPT2_ICL_entailment
241,91,32,22,10,0.6875,24,22,2,0.9166666666666666,0.7857142857142857,GPT4,mimiciii,nursing_note,PROMPT2_ICL_entailment
242,92,47,43,4,0.9148936170212766,28,22,6,0.7857142857142857,0.8453976764968723,GPT4,mimiciii,nursing_note,PROMPT2_ICL_entailment
243,93,39,34,5,0.8717948717948718,23,17,6,0.7391304347826086,0.7999999999999999,GPT4,mimiciii,nursing_note,PROMPT2_ICL_entailment
244,94,9,9,0,1.0,5,5,0,1.0,1.0,GPT4,mimiciii,nursing_note,PROMPT2_ICL_entailment
245,95,37,28,9,0.7567567567567568,14,11,3,0.7857142857142857,0.7709637046307884,GPT4,mimiciii,nursing_note,PROMPT2_ICL_entailment
246,96,11,11,0,1.0,6,6,0,1.0,1.0,GPT4,mimiciii,nursing_note,PROMPT2_ICL_entailment
247,97,21,21,0,1.0,10,8,2,0.8,0.888888888888889,GPT4,mimiciii,nursing_note,PROMPT2_ICL_entailment
248,98,68,61,7,0.8970588235294118,13,11,2,0.8461538461538461,0.8708630759247241,GPT4,mimiciii,nursing_note,PROMPT2_ICL_entailment
249,99,55,51,4,0.9272727272727272,44,36,8,0.8181818181818182,0.8693181818181819,GPT4,mimiciii,nursing_note,PROMPT2_ICL_entailment
0,0,16,8,8,0.5,11,9,2,0.8181818181818182,0.6206896551724137,GPT4,mimiciii,nursing_note,PROMPT2_entailment
1,1,43,21,22,0.4883720930232558,31,19,12,0.6129032258064516,0.5435967302452317,GPT4,mimiciii,nursing_note,PROMPT2_entailment
2,10,24,15,9,0.625,18,13,5,0.7222222222222222,0.6701030927835051,GPT4,mimiciii,nursing_note,PROMPT2_entailment
3,100,11,11,0,1.0,6,5,1,0.8333333333333334,0.9090909090909092,GPT4,mimiciii,nursing_note,PROMPT2_entailment
4,101,43,36,7,0.8372093023255814,27,24,3,0.8888888888888888,0.8622754491017963,GPT4,mimiciii,nursing_note,PROMPT2_entailment
5,102,36,31,5,0.8611111111111112,26,22,4,0.8461538461538461,0.853566958698373,GPT4,mimiciii,nursing_note,PROMPT2_entailment
6,103,27,21,6,0.7777777777777778,22,22,0,1.0,0.8750000000000001,GPT4,mimiciii,nursing_note,PROMPT2_entailment
7,104,27,21,6,0.7777777777777778,20,19,1,0.95,0.855305466237942,GPT4,mimiciii,nursing_note,PROMPT2_entailment
8,105,30,23,7,0.7666666666666667,20,18,2,0.9,0.8280000000000001,GPT4,mimiciii,nursing_note,PROMPT2_entailment
9,106,9,9,0,1.0,4,3,1,0.75,0.8571428571428571,GPT4,mimiciii,nursing_note,PROMPT2_entailment
10,107,61,51,10,0.8360655737704918,49,35,14,0.7142857142857143,0.770392749244713,GPT4,mimiciii,nursing_note,PROMPT2_entailment
11,108,46,46,0,1.0,28,17,11,0.6071428571428571,0.7555555555555554,GPT4,mimiciii,nursing_note,PROMPT2_entailment
12,109,6,6,0,1.0,4,4,0,1.0,1.0,GPT4,mimiciii,nursing_note,PROMPT2_entailment
13,11,2,2,0,1.0,2,2,0,1.0,1.0,GPT4,mimiciii,nursing_note,PROMPT2_entailment
14,110,15,15,0,1.0,13,12,1,0.9230769230769232,0.96,GPT4,mimiciii,nursing_note,PROMPT2_entailment
15,111,35,24,11,0.6857142857142857,32,25,7,0.78125,0.7303712720632988,GPT4,mimiciii,nursing_note,PROMPT2_entailment
16,112,40,25,15,0.625,37,27,10,0.7297297297297297,0.6733167082294264,GPT4,mimiciii,nursing_note,PROMPT2_entailment
17,113,6,6,0,1.0,5,5,0,1.0,1.0,GPT4,mimiciii,nursing_note,PROMPT2_entailment
18,114,25,20,5,0.8,19,12,7,0.631578947368421,0.7058823529411765,GPT4,mimiciii,nursing_note,PROMPT2_entailment
19,115,14,14,0,1.0,7,7,0,1.0,1.0,GPT4,mimiciii,nursing_note,PROMPT2_entailment
20,116,34,32,2,0.9411764705882352,31,27,4,0.8709677419354839,0.9047120418848168,GPT4,mimiciii,nursing_note,PROMPT2_entailment
21,117,48,42,6,0.875,18,10,8,0.5555555555555556,0.6796116504854369,GPT4,mimiciii,nursing_note,PROMPT2_entailment
22,118,26,21,5,0.8076923076923077,25,20,5,0.8,0.8038277511961722,GPT4,mimiciii,nursing_note,PROMPT2_entailment
23,119,31,28,3,0.9032258064516128,26,24,2,0.9230769230769232,0.9130434782608696,GPT4,mimiciii,nursing_note,PROMPT2_entailment
24,12,27,26,1,0.9629629629629628,18,14,4,0.7777777777777778,0.8605200945626477,GPT4,mimiciii,nursing_note,PROMPT2_entailment
25,120,21,17,4,0.8095238095238095,18,18,0,1.0,0.8947368421052632,GPT4,mimiciii,nursing_note,PROMPT2_entailment
26,121,29,24,5,0.8275862068965517,37,26,11,0.7027027027027027,0.7600487210718636,GPT4,mimiciii,nursing_note,PROMPT2_entailment
27,122,29,26,3,0.896551724137931,11,9,2,0.8181818181818182,0.8555758683729433,GPT4,mimiciii,nursing_note,PROMPT2_entailment
28,123,7,7,0,1.0,6,6,0,1.0,1.0,GPT4,mimiciii,nursing_note,PROMPT2_entailment
29,124,8,8,0,1.0,5,5,0,1.0,1.0,GPT4,mimiciii,nursing_note,PROMPT2_entailment
30,125,42,40,2,0.9523809523809524,43,27,16,0.627906976744186,0.756832515767344,GPT4,mimiciii,nursing_note,PROMPT2_entailment
31,126,33,27,6,0.8181818181818182,28,25,3,0.8928571428571429,0.8538899430740038,GPT4,mimiciii,nursing_note,PROMPT2_entailment
32,127,22,20,2,0.9090909090909092,10,9,1,0.9,0.9045226130653266,GPT4,mimiciii,nursing_note,PROMPT2_entailment
33,128,30,25,5,0.8333333333333334,17,14,3,0.8235294117647058,0.8284023668639053,GPT4,mimiciii,nursing_note,PROMPT2_entailment
34,129,41,32,9,0.7804878048780488,29,24,5,0.8275862068965517,0.803347280334728,GPT4,mimiciii,nursing_note,PROMPT2_entailment
35,13,48,45,3,0.9375,34,27,7,0.7941176470588235,0.8598726114649681,GPT4,mimiciii,nursing_note,PROMPT2_entailment
36,130,41,25,16,0.6097560975609756,33,25,8,0.7575757575757576,0.6756756756756757,GPT4,mimiciii,nursing_note,PROMPT2_entailment
37,131,35,32,3,0.9142857142857144,31,26,5,0.8387096774193549,0.8748685594111463,GPT4,mimiciii,nursing_note,PROMPT2_entailment
38,132,37,23,14,0.6216216216216216,17,16,1,0.9411764705882352,0.7487283825025433,GPT4,mimiciii,nursing_note,PROMPT2_entailment
39,133,20,19,1,0.95,10,9,1,0.9,0.9243243243243242,GPT4,mimiciii,nursing_note,PROMPT2_entailment
40,134,43,19,24,0.4418604651162791,30,20,10,0.6666666666666666,0.5314685314685315,GPT4,mimiciii,nursing_note,PROMPT2_entailment
41,135,56,44,12,0.7857142857142857,42,34,8,0.8095238095238095,0.7974413646055437,GPT4,mimiciii,nursing_note,PROMPT2_entailment
42,136,48,45,3,0.9375,41,29,12,0.7073170731707317,0.8063021316033364,GPT4,mimiciii,nursing_note,PROMPT2_entailment
43,137,5,3,2,0.6,2,1,1,0.5,0.5454545454545454,GPT4,mimiciii,nursing_note,PROMPT2_entailment
44,138,5,5,0,1.0,5,4,1,0.8,0.888888888888889,GPT4,mimiciii,nursing_note,PROMPT2_entailment
45,139,7,6,1,0.8571428571428571,4,3,1,0.75,0.7999999999999999,GPT4,mimiciii,nursing_note,PROMPT2_entailment
46,14,26,24,2,0.9230769230769232,25,24,1,0.96,0.9411764705882352,GPT4,mimiciii,nursing_note,PROMPT2_entailment
47,140,35,24,11,0.6857142857142857,24,22,2,0.9166666666666666,0.7845468053491828,GPT4,mimiciii,nursing_note,PROMPT2_entailment
48,141,16,15,1,0.9375,11,10,1,0.9090909090909092,0.923076923076923,GPT4,mimiciii,nursing_note,PROMPT2_entailment
49,142,43,32,11,0.7441860465116279,8,6,2,0.75,0.7470817120622568,GPT4,mimiciii,nursing_note,PROMPT2_entailment
50,143,16,13,3,0.8125,2,1,1,0.5,0.6190476190476191,GPT4,mimiciii,nursing_note,PROMPT2_entailment
51,144,9,8,1,0.8888888888888888,5,5,0,1.0,0.9411764705882352,GPT4,mimiciii,nursing_note,PROMPT2_entailment
52,145,28,24,4,0.8571428571428571,19,14,5,0.7368421052631579,0.7924528301886793,GPT4,mimiciii,nursing_note,PROMPT2_entailment
53,146,9,9,0,1.0,6,5,1,0.8333333333333334,0.9090909090909092,GPT4,mimiciii,nursing_note,PROMPT2_entailment
54,147,42,28,14,0.6666666666666666,26,19,7,0.7307692307692307,0.6972477064220183,GPT4,mimiciii,nursing_note,PROMPT2_entailment
55,148,15,14,1,0.9333333333333332,7,6,1,0.8571428571428571,0.8936170212765957,GPT4,mimiciii,nursing_note,PROMPT2_entailment
56,149,44,33,11,0.75,36,19,17,0.5277777777777778,0.6195652173913044,GPT4,mimiciii,nursing_note,PROMPT2_entailment
57,15,29,23,6,0.7931034482758621,33,22,11,0.6666666666666666,0.7244094488188977,GPT4,mimiciii,nursing_note,PROMPT2_entailment
58,150,10,10,0,1.0,8,7,1,0.875,0.9333333333333332,GPT4,mimiciii,nursing_note,PROMPT2_entailment
59,151,33,25,8,0.7575757575757576,26,24,2,0.9230769230769232,0.8321775312066575,GPT4,mimiciii,nursing_note,PROMPT2_entailment
60,152,47,40,7,0.851063829787234,44,27,17,0.6136363636363636,0.7131066358534169,GPT4,mimiciii,nursing_note,PROMPT2_entailment
61,153,5,5,0,1.0,4,3,1,0.75,0.8571428571428571,GPT4,mimiciii,nursing_note,PROMPT2_entailment
62,154,37,36,1,0.972972972972973,34,30,4,0.8823529411764706,0.9254498714652956,GPT4,mimiciii,nursing_note,PROMPT2_entailment
63,155,56,46,10,0.8214285714285714,51,40,11,0.7843137254901961,0.8024422154382903,GPT4,mimiciii,nursing_note,PROMPT2_entailment
64,156,29,25,4,0.8620689655172413,26,17,9,0.6538461538461539,0.7436570428696412,GPT4,mimiciii,nursing_note,PROMPT2_entailment
65,157,6,6,0,1.0,5,3,2,0.6,0.7499999999999999,GPT4,mimiciii,nursing_note,PROMPT2_entailment
66,158,33,32,1,0.9696969696969696,22,20,2,0.9090909090909092,0.93841642228739,GPT4,mimiciii,nursing_note,PROMPT2_entailment
67,159,12,10,2,0.8333333333333334,8,8,0,1.0,0.9090909090909092,GPT4,mimiciii,nursing_note,PROMPT2_entailment
68,16,37,37,0,1.0,30,19,11,0.6333333333333333,0.7755102040816326,GPT4,mimiciii,nursing_note,PROMPT2_entailment
69,160,44,40,4,0.9090909090909092,21,19,2,0.9047619047619048,0.9069212410501194,GPT4,mimiciii,nursing_note,PROMPT2_entailment
70,161,6,6,0,1.0,6,5,1,0.8333333333333334,0.9090909090909092,GPT4,mimiciii,nursing_note,PROMPT2_entailment
71,162,33,29,4,0.8787878787878788,31,19,12,0.6129032258064516,0.7221494102228047,GPT4,mimiciii,nursing_note,PROMPT2_entailment
72,163,10,10,0,1.0,4,4,0,1.0,1.0,GPT4,mimiciii,nursing_note,PROMPT2_entailment
73,164,19,18,1,0.9473684210526316,13,11,2,0.8461538461538461,0.8939051918735891,GPT4,mimiciii,nursing_note,PROMPT2_entailment
74,165,37,30,7,0.8108108108108109,24,19,5,0.7916666666666666,0.8011243851018974,GPT4,mimiciii,nursing_note,PROMPT2_entailment
75,166,14,14,0,1.0,3,3,0,1.0,1.0,GPT4,mimiciii,nursing_note,PROMPT2_entailment
76,167,36,30,6,0.8333333333333334,16,12,4,0.75,0.7894736842105262,GPT4,mimiciii,nursing_note,PROMPT2_entailment
77,168,32,17,15,0.53125,25,18,7,0.72,0.6113886113886114,GPT4,mimiciii,nursing_note,PROMPT2_entailment
78,169,26,23,3,0.8846153846153846,12,12,0,1.0,0.9387755102040816,GPT4,mimiciii,nursing_note,PROMPT2_entailment
79,17,29,25,4,0.8620689655172413,39,32,7,0.8205128205128205,0.8407777193904361,GPT4,mimiciii,nursing_note,PROMPT2_entailment
80,170,37,26,11,0.7027027027027027,21,18,3,0.8571428571428571,0.7722772277227723,GPT4,mimiciii,nursing_note,PROMPT2_entailment
81,171,9,9,0,1.0,8,6,2,0.75,0.8571428571428571,GPT4,mimiciii,nursing_note,PROMPT2_entailment
82,172,38,35,3,0.9210526315789472,38,23,15,0.6052631578947368,0.7304900181488203,GPT4,mimiciii,nursing_note,PROMPT2_entailment
83,173,29,24,5,0.8275862068965517,19,18,1,0.9473684210526316,0.8834355828220859,GPT4,mimiciii,nursing_note,PROMPT2_entailment
84,174,10,10,0,1.0,8,7,1,0.875,0.9333333333333332,GPT4,mimiciii,nursing_note,PROMPT2_entailment
85,175,5,5,0,1.0,4,3,1,0.75,0.8571428571428571,GPT4,mimiciii,nursing_note,PROMPT2_entailment
86,176,25,19,6,0.76,13,9,4,0.6923076923076923,0.7245762711864407,GPT4,mimiciii,nursing_note,PROMPT2_entailment
87,177,40,33,7,0.825,38,29,9,0.7631578947368421,0.7928748964374482,GPT4,mimiciii,nursing_note,PROMPT2_entailment
88,178,45,42,3,0.9333333333333332,25,23,2,0.92,0.9266187050359712,GPT4,mimiciii,nursing_note,PROMPT2_entailment
89,179,31,28,3,0.9032258064516128,22,15,7,0.6818181818181818,0.7770582793709527,GPT4,mimiciii,nursing_note,PROMPT2_entailment
90,18,39,31,8,0.7948717948717948,25,15,10,0.6,0.6838235294117647,GPT4,mimiciii,nursing_note,PROMPT2_entailment
91,180,43,33,10,0.7674418604651163,27,21,6,0.7777777777777778,0.7725752508361206,GPT4,mimiciii,nursing_note,PROMPT2_entailment
92,181,37,27,10,0.7297297297297297,25,24,1,0.96,0.8291746641074855,GPT4,mimiciii,nursing_note,PROMPT2_entailment
93,182,31,24,7,0.7741935483870968,10,7,3,0.7,0.7352297592997812,GPT4,mimiciii,nursing_note,PROMPT2_entailment
94,183,6,5,1,0.8333333333333334,5,4,1,0.8,0.816326530612245,GPT4,mimiciii,nursing_note,PROMPT2_entailment
95,184,14,14,0,1.0,1,1,0,1.0,1.0,GPT4,mimiciii,nursing_note,PROMPT2_entailment
96,185,30,25,5,0.8333333333333334,30,25,5,0.8333333333333334,0.8333333333333334,GPT4,mimiciii,nursing_note,PROMPT2_entailment
97,186,5,5,0,1.0,4,3,1,0.75,0.8571428571428571,GPT4,mimiciii,nursing_note,PROMPT2_entailment
98,187,44,41,3,0.9318181818181818,37,30,7,0.8108108108108109,0.8671131476912232,GPT4,mimiciii,nursing_note,PROMPT2_entailment
99,188,4,4,0,1.0,2,2,0,1.0,1.0,GPT4,mimiciii,nursing_note,PROMPT2_entailment
100,189,38,31,7,0.8157894736842105,21,21,0,1.0,0.898550724637681,GPT4,mimiciii,nursing_note,PROMPT2_entailment
101,19,39,27,12,0.6923076923076923,45,28,17,0.6222222222222222,0.6553966189856958,GPT4,mimiciii,nursing_note,PROMPT2_entailment
102,190,33,30,3,0.9090909090909092,24,18,6,0.75,0.821917808219178,GPT4,mimiciii,nursing_note,PROMPT2_entailment
103,191,36,28,8,0.7777777777777778,29,20,9,0.6896551724137931,0.731070496083551,GPT4,mimiciii,nursing_note,PROMPT2_entailment
104,192,14,14,0,1.0,15,13,2,0.8666666666666667,0.9285714285714286,GPT4,mimiciii,nursing_note,PROMPT2_entailment
105,193,53,45,8,0.8490566037735849,36,31,5,0.8611111111111112,0.8550413729696599,GPT4,mimiciii,nursing_note,PROMPT2_entailment
106,194,14,14,0,1.0,11,10,1,0.9090909090909092,0.9523809523809524,GPT4,mimiciii,nursing_note,PROMPT2_entailment
107,195,9,9,0,1.0,7,7,0,1.0,1.0,GPT4,mimiciii,nursing_note,PROMPT2_entailment
108,196,42,35,7,0.8333333333333334,34,31,3,0.9117647058823528,0.8707865168539325,GPT4,mimiciii,nursing_note,PROMPT2_entailment
109,197,35,24,11,0.6857142857142857,27,26,1,0.9629629629629628,0.8010269576379974,GPT4,mimiciii,nursing_note,PROMPT2_entailment
110,198,46,42,4,0.9130434782608696,38,28,10,0.7368421052631579,0.8155339805825242,GPT4,mimiciii,nursing_note,PROMPT2_entailment
111,199,19,19,0,1.0,14,12,2,0.8571428571428571,0.923076923076923,GPT4,mimiciii,nursing_note,PROMPT2_entailment
112,2,52,24,28,0.4615384615384615,43,15,28,0.3488372093023256,0.3973509933774834,GPT4,mimiciii,nursing_note,PROMPT2_entailment
113,20,53,35,18,0.660377358490566,46,28,18,0.6086956521739131,0.6334841628959276,GPT4,mimiciii,nursing_note,PROMPT2_entailment
114,200,51,39,12,0.7647058823529411,44,25,19,0.5681818181818182,0.6519558676028084,GPT4,mimiciii,nursing_note,PROMPT2_entailment
115,201,34,33,1,0.9705882352941176,29,21,8,0.7241379310344828,0.829443447037702,GPT4,mimiciii,nursing_note,PROMPT2_entailment
116,202,11,9,2,0.8181818181818182,9,7,2,0.7777777777777778,0.7974683544303799,GPT4,mimiciii,nursing_note,PROMPT2_entailment
117,203,13,13,0,1.0,7,6,1,0.8571428571428571,0.923076923076923,GPT4,mimiciii,nursing_note,PROMPT2_entailment
118,204,30,27,3,0.9,24,19,5,0.7916666666666666,0.8423645320197045,GPT4,mimiciii,nursing_note,PROMPT2_entailment
119,205,51,47,4,0.9215686274509804,47,35,12,0.7446808510638298,0.8237356034051075,GPT4,mimiciii,nursing_note,PROMPT2_entailment
120,206,10,10,0,1.0,6,4,2,0.6666666666666666,0.8,GPT4,mimiciii,nursing_note,PROMPT2_entailment
121,207,51,47,4,0.9215686274509804,29,24,5,0.8275862068965517,0.8720525705450328,GPT4,mimiciii,nursing_note,PROMPT2_entailment
122,208,13,12,1,0.9230769230769232,7,7,0,1.0,0.96,GPT4,mimiciii,nursing_note,PROMPT2_entailment
123,209,3,3,0,1.0,2,2,0,1.0,1.0,GPT4,mimiciii,nursing_note,PROMPT2_entailment
124,21,9,9,0,1.0,6,5,1,0.8333333333333334,0.9090909090909092,GPT4,mimiciii,nursing_note,PROMPT2_entailment
125,210,24,18,6,0.75,22,20,2,0.9090909090909092,0.821917808219178,GPT4,mimiciii,nursing_note,PROMPT2_entailment
126,211,5,5,0,1.0,4,4,0,1.0,1.0,GPT4,mimiciii,nursing_note,PROMPT2_entailment
127,212,45,39,6,0.8666666666666667,37,30,7,0.8108108108108109,0.8378088077336198,GPT4,mimiciii,nursing_note,PROMPT2_entailment
128,213,23,18,5,0.782608695652174,18,16,2,0.8888888888888888,0.8323699421965318,GPT4,mimiciii,nursing_note,PROMPT2_entailment
129,214,14,12,2,0.8571428571428571,3,3,0,1.0,0.923076923076923,GPT4,mimiciii,nursing_note,PROMPT2_entailment
130,215,11,11,0,1.0,7,6,1,0.8571428571428571,0.923076923076923,GPT4,mimiciii,nursing_note,PROMPT2_entailment
131,216,24,15,9,0.625,13,9,4,0.6923076923076923,0.6569343065693432,GPT4,mimiciii,nursing_note,PROMPT2_entailment
132,217,39,32,7,0.8205128205128205,25,19,6,0.76,0.7890979883192732,GPT4,mimiciii,nursing_note,PROMPT2_entailment
133,218,21,17,4,0.8095238095238095,18,8,10,0.4444444444444444,0.5738396624472574,GPT4,mimiciii,nursing_note,PROMPT2_entailment
134,219,33,24,9,0.7272727272727273,14,13,1,0.9285714285714286,0.8156862745098039,GPT4,mimiciii,nursing_note,PROMPT2_entailment
135,22,37,31,6,0.8378378378378378,26,19,7,0.7307692307692307,0.7806494367130551,GPT4,mimiciii,nursing_note,PROMPT2_entailment
136,220,14,12,2,0.8571428571428571,5,3,2,0.6,0.7058823529411764,GPT4,mimiciii,nursing_note,PROMPT2_entailment
137,221,28,12,16,0.4285714285714285,35,24,11,0.6857142857142857,0.5274725274725274,GPT4,mimiciii,nursing_note,PROMPT2_entailment
138,222,6,6,0,1.0,3,2,1,0.6666666666666666,0.8,GPT4,mimiciii,nursing_note,PROMPT2_entailment
139,223,34,16,18,0.4705882352941176,30,23,7,0.7666666666666667,0.5832012678288431,GPT4,mimiciii,nursing_note,PROMPT2_entailment
140,224,9,9,0,1.0,6,5,1,0.8333333333333334,0.9090909090909092,GPT4,mimiciii,nursing_note,PROMPT2_entailment
141,225,48,23,25,0.4791666666666667,45,34,11,0.7555555555555555,0.5864266966629171,GPT4,mimiciii,nursing_note,PROMPT2_entailment
142,226,22,22,0,1.0,20,16,4,0.8,0.888888888888889,GPT4,mimiciii,nursing_note,PROMPT2_entailment
143,227,21,18,3,0.8571428571428571,15,15,0,1.0,0.923076923076923,GPT4,mimiciii,nursing_note,PROMPT2_entailment
144,228,45,30,15,0.6666666666666666,38,19,19,0.5,0.5714285714285715,GPT4,mimiciii,nursing_note,PROMPT2_entailment
145,229,31,26,5,0.8387096774193549,22,19,3,0.8636363636363636,0.8509905254091301,GPT4,mimiciii,nursing_note,PROMPT2_entailment
146,23,53,48,5,0.9056603773584906,35,25,10,0.7142857142857143,0.7986688851913478,GPT4,mimiciii,nursing_note,PROMPT2_entailment
147,230,12,11,1,0.9166666666666666,7,5,2,0.7142857142857143,0.8029197080291971,GPT4,mimiciii,nursing_note,PROMPT2_entailment
148,231,59,49,10,0.8305084745762712,15,11,4,0.7333333333333333,0.7789017341040462,GPT4,mimiciii,nursing_note,PROMPT2_entailment
149,232,9,8,1,0.8888888888888888,2,1,1,0.5,0.64,GPT4,mimiciii,nursing_note,PROMPT2_entailment
150,233,34,23,11,0.6764705882352942,33,26,7,0.7878787878787878,0.7279367011564212,GPT4,mimiciii,nursing_note,PROMPT2_entailment
151,234,47,46,1,0.9787234042553192,32,24,8,0.75,0.8492307692307693,GPT4,mimiciii,nursing_note,PROMPT2_entailment
152,235,19,19,0,1.0,10,10,0,1.0,1.0,GPT4,mimiciii,nursing_note,PROMPT2_entailment
153,236,19,16,3,0.8421052631578947,7,6,1,0.8571428571428571,0.8495575221238938,GPT4,mimiciii,nursing_note,PROMPT2_entailment
154,237,41,35,6,0.8536585365853658,35,21,14,0.6,0.7046979865771812,GPT4,mimiciii,nursing_note,PROMPT2_entailment
155,238,56,37,19,0.6607142857142857,42,31,11,0.7380952380952381,0.6972644376899697,GPT4,mimiciii,nursing_note,PROMPT2_entailment
156,239,34,23,11,0.6764705882352942,21,19,2,0.9047619047619048,0.7741364038972542,GPT4,mimiciii,nursing_note,PROMPT2_entailment
157,24,12,12,0,1.0,5,5,0,1.0,1.0,GPT4,mimiciii,nursing_note,PROMPT2_entailment
158,240,34,32,2,0.9411764705882352,42,33,9,0.7857142857142857,0.8564476885644767,GPT4,mimiciii,nursing_note,PROMPT2_entailment
159,241,28,18,10,0.6428571428571429,21,20,1,0.9523809523809524,0.7675906183368869,GPT4,mimiciii,nursing_note,PROMPT2_entailment
160,242,30,19,11,0.6333333333333333,16,11,5,0.6875,0.6593059936908517,GPT4,mimiciii,nursing_note,PROMPT2_entailment
161,243,9,9,0,1.0,5,3,2,0.6,0.7499999999999999,GPT4,mimiciii,nursing_note,PROMPT2_entailment
162,244,35,26,9,0.7428571428571429,16,8,8,0.5,0.5977011494252874,GPT4,mimiciii,nursing_note,PROMPT2_entailment
163,245,38,24,14,0.631578947368421,37,25,12,0.6756756756756757,0.6528835690968443,GPT4,mimiciii,nursing_note,PROMPT2_entailment
164,246,30,28,2,0.9333333333333332,10,8,2,0.8,0.8615384615384616,GPT4,mimiciii,nursing_note,PROMPT2_entailment
165,247,8,8,0,1.0,6,5,1,0.8333333333333334,0.9090909090909092,GPT4,mimiciii,nursing_note,PROMPT2_entailment
166,248,44,40,4,0.9090909090909092,42,32,10,0.7619047619047619,0.8290155440414507,GPT4,mimiciii,nursing_note,PROMPT2_entailment
167,249,40,27,13,0.675,39,33,6,0.8461538461538461,0.7509481668773705,GPT4,mimiciii,nursing_note,PROMPT2_entailment
168,25,39,28,11,0.717948717948718,23,18,5,0.782608695652174,0.74888558692422,GPT4,mimiciii,nursing_note,PROMPT2_entailment
169,26,41,37,4,0.902439024390244,35,24,11,0.6857142857142857,0.7792891619131197,GPT4,mimiciii,nursing_note,PROMPT2_entailment
170,27,5,5,0,1.0,3,2,1,0.6666666666666666,0.8,GPT4,mimiciii,nursing_note,PROMPT2_entailment
171,28,37,32,5,0.8648648648648649,16,10,6,0.625,0.7256235827664399,GPT4,mimiciii,nursing_note,PROMPT2_entailment
172,29,36,26,10,0.7222222222222222,33,23,10,0.696969696969697,0.7093712930011863,GPT4,mimiciii,nursing_note,PROMPT2_entailment
173,3,12,10,2,0.8333333333333334,6,6,0,1.0,0.9090909090909092,GPT4,mimiciii,nursing_note,PROMPT2_entailment
174,30,17,16,1,0.9411764705882352,13,9,4,0.6923076923076923,0.7977839335180056,GPT4,mimiciii,nursing_note,PROMPT2_entailment
175,31,21,13,8,0.6190476190476191,19,13,6,0.6842105263157895,0.6500000000000001,GPT4,mimiciii,nursing_note,PROMPT2_entailment
176,32,46,42,4,0.9130434782608696,44,39,5,0.8863636363636364,0.899505766062603,GPT4,mimiciii,nursing_note,PROMPT2_entailment
177,33,10,10,0,1.0,5,5,0,1.0,1.0,GPT4,mimiciii,nursing_note,PROMPT2_entailment
178,34,5,5,0,1.0,3,3,0,1.0,1.0,GPT4,mimiciii,nursing_note,PROMPT2_entailment
179,35,16,16,0,1.0,7,7,0,1.0,1.0,GPT4,mimiciii,nursing_note,PROMPT2_entailment
180,36,74,50,24,0.6756756756756757,62,51,11,0.8225806451612904,0.741926098341577,GPT4,mimiciii,nursing_note,PROMPT2_entailment
181,37,40,22,18,0.55,38,27,11,0.7105263157894737,0.6200417536534447,GPT4,mimiciii,nursing_note,PROMPT2_entailment
182,38,27,19,8,0.7037037037037037,26,23,3,0.8846153846153846,0.7838565022421524,GPT4,mimiciii,nursing_note,PROMPT2_entailment
183,39,17,15,2,0.8823529411764706,3,1,2,0.3333333333333333,0.4838709677419354,GPT4,mimiciii,nursing_note,PROMPT2_entailment
184,4,31,21,10,0.6774193548387096,26,20,6,0.7692307692307693,0.7204116638078902,GPT4,mimiciii,nursing_note,PROMPT2_entailment
185,40,10,10,0,1.0,3,2,1,0.6666666666666666,0.8,GPT4,mimiciii,nursing_note,PROMPT2_entailment
186,41,46,44,2,0.9565217391304348,50,35,15,0.7,0.8083989501312336,GPT4,mimiciii,nursing_note,PROMPT2_entailment
187,42,40,28,12,0.7,7,5,2,0.7142857142857143,0.7070707070707072,GPT4,mimiciii,nursing_note,PROMPT2_entailment
188,43,33,26,7,0.7878787878787878,14,12,2,0.8571428571428571,0.8210526315789474,GPT4,mimiciii,nursing_note,PROMPT2_entailment
189,44,7,7,0,1.0,3,3,0,1.0,1.0,GPT4,mimiciii,nursing_note,PROMPT2_entailment
190,45,41,40,1,0.975609756097561,34,26,8,0.7647058823529411,0.8573784006595218,GPT4,mimiciii,nursing_note,PROMPT2_entailment
191,46,47,45,2,0.9574468085106383,31,21,10,0.6774193548387096,0.7934508816120907,GPT4,mimiciii,nursing_note,PROMPT2_entailment
192,47,29,19,10,0.6551724137931034,14,13,1,0.9285714285714286,0.7682737169517885,GPT4,mimiciii,nursing_note,PROMPT2_entailment
193,48,20,18,2,0.9,9,7,2,0.7777777777777778,0.8344370860927153,GPT4,mimiciii,nursing_note,PROMPT2_entailment
194,49,7,7,0,1.0,3,2,1,0.6666666666666666,0.8,GPT4,mimiciii,nursing_note,PROMPT2_entailment
195,5,36,31,5,0.8611111111111112,15,11,4,0.7333333333333333,0.7921022067363529,GPT4,mimiciii,nursing_note,PROMPT2_entailment
196,50,21,19,2,0.9047619047619048,16,13,3,0.8125,0.856152512998267,GPT4,mimiciii,nursing_note,PROMPT2_entailment
197,51,8,8,0,1.0,6,6,0,1.0,1.0,GPT4,mimiciii,nursing_note,PROMPT2_entailment
198,52,38,27,11,0.7105263157894737,38,27,11,0.7105263157894737,0.7105263157894737,GPT4,mimiciii,nursing_note,PROMPT2_entailment
199,53,7,7,0,1.0,6,5,1,0.8333333333333334,0.9090909090909092,GPT4,mimiciii,nursing_note,PROMPT2_entailment
200,54,35,26,9,0.7428571428571429,37,26,11,0.7027027027027027,0.7222222222222223,GPT4,mimiciii,nursing_note,PROMPT2_entailment
201,55,44,39,5,0.8863636363636364,35,18,17,0.5142857142857142,0.650904033379694,GPT4,mimiciii,nursing_note,PROMPT2_entailment
202,56,12,12,0,1.0,2,1,1,0.5,0.6666666666666666,GPT4,mimiciii,nursing_note,PROMPT2_entailment
203,57,46,43,3,0.9347826086956522,17,12,5,0.7058823529411765,0.8043647700701481,GPT4,mimiciii,nursing_note,PROMPT2_entailment
204,58,45,34,11,0.7555555555555555,25,23,2,0.92,0.8297082228116711,GPT4,mimiciii,nursing_note,PROMPT2_entailment
205,59,11,11,0,1.0,8,7,1,0.875,0.9333333333333332,GPT4,mimiciii,nursing_note,PROMPT2_entailment
206,6,15,14,1,0.9333333333333332,8,8,0,1.0,0.9655172413793104,GPT4,mimiciii,nursing_note,PROMPT2_entailment
207,60,38,23,15,0.6052631578947368,27,23,4,0.8518518518518519,0.7076923076923076,GPT4,mimiciii,nursing_note,PROMPT2_entailment
208,61,27,16,11,0.5925925925925926,20,17,3,0.85,0.698331193838254,GPT4,mimiciii,nursing_note,PROMPT2_entailment
209,62,39,29,10,0.7435897435897436,37,24,13,0.6486486486486487,0.692882030861125,GPT4,mimiciii,nursing_note,PROMPT2_entailment
210,63,7,7,0,1.0,5,4,1,0.8,0.888888888888889,GPT4,mimiciii,nursing_note,PROMPT2_entailment
211,64,50,47,3,0.94,27,23,4,0.8518518518518519,0.8937577511368334,GPT4,mimiciii,nursing_note,PROMPT2_entailment
212,65,20,19,1,0.95,19,16,3,0.8421052631578947,0.8928046989720998,GPT4,mimiciii,nursing_note,PROMPT2_entailment
213,66,9,9,0,1.0,1,1,0,1.0,1.0,GPT4,mimiciii,nursing_note,PROMPT2_entailment
214,67,13,10,3,0.7692307692307693,7,6,1,0.8571428571428571,0.8108108108108107,GPT4,mimiciii,nursing_note,PROMPT2_entailment
215,68,32,21,11,0.65625,18,14,4,0.7777777777777778,0.711864406779661,GPT4,mimiciii,nursing_note,PROMPT2_entailment
216,69,29,22,7,0.7586206896551724,25,23,2,0.92,0.8315529991783073,GPT4,mimiciii,nursing_note,PROMPT2_entailment
217,7,5,5,0,1.0,2,2,0,1.0,1.0,GPT4,mimiciii,nursing_note,PROMPT2_entailment
218,70,46,40,6,0.8695652173913043,45,25,20,0.5555555555555556,0.6779661016949152,GPT4,mimiciii,nursing_note,PROMPT2_entailment
219,71,49,33,16,0.673469387755102,51,37,14,0.7254901960784313,0.698512585812357,GPT4,mimiciii,nursing_note,PROMPT2_entailment
220,72,21,18,3,0.8571428571428571,12,9,3,0.75,0.7999999999999999,GPT4,mimiciii,nursing_note,PROMPT2_entailment
221,73,38,27,11,0.7105263157894737,38,29,9,0.7631578947368421,0.7359022556390976,GPT4,mimiciii,nursing_note,PROMPT2_entailment
222,74,7,7,0,1.0,7,6,1,0.8571428571428571,0.923076923076923,GPT4,mimiciii,nursing_note,PROMPT2_entailment
223,75,44,34,10,0.7727272727272727,27,16,11,0.5925925925925926,0.6707768187422934,GPT4,mimiciii,nursing_note,PROMPT2_entailment
224,76,2,2,0,1.0,1,1,0,1.0,1.0,GPT4,mimiciii,nursing_note,PROMPT2_entailment
225,77,48,19,29,0.3958333333333333,59,44,15,0.7457627118644068,0.517166718218373,GPT4,mimiciii,nursing_note,PROMPT2_entailment
226,78,43,22,21,0.5116279069767442,20,13,7,0.65,0.5725725725725727,GPT4,mimiciii,nursing_note,PROMPT2_entailment
227,79,41,37,4,0.902439024390244,30,20,10,0.6666666666666666,0.7668393782383419,GPT4,mimiciii,nursing_note,PROMPT2_entailment
228,8,11,11,0,1.0,11,11,0,1.0,1.0,GPT4,mimiciii,nursing_note,PROMPT2_entailment
229,80,39,32,7,0.8205128205128205,22,19,3,0.8636363636363636,0.841522491349481,GPT4,mimiciii,nursing_note,PROMPT2_entailment
230,81,29,20,9,0.6896551724137931,22,20,2,0.9090909090909092,0.7843137254901961,GPT4,mimiciii,nursing_note,PROMPT2_entailment
231,82,38,35,3,0.9210526315789472,17,12,5,0.7058823529411765,0.7992388201712655,GPT4,mimiciii,nursing_note,PROMPT2_entailment
232,83,21,17,4,0.8095238095238095,28,21,7,0.75,0.7786259541984734,GPT4,mimiciii,nursing_note,PROMPT2_entailment
233,84,11,11,0,1.0,6,6,0,1.0,1.0,GPT4,mimiciii,nursing_note,PROMPT2_entailment
234,85,27,27,0,1.0,24,21,3,0.875,0.9333333333333332,GPT4,mimiciii,nursing_note,PROMPT2_entailment
235,86,39,28,11,0.717948717948718,40,28,12,0.7,0.708860759493671,GPT4,mimiciii,nursing_note,PROMPT2_entailment
236,87,25,19,6,0.76,15,11,4,0.7333333333333333,0.7464285714285716,GPT4,mimiciii,nursing_note,PROMPT2_entailment
237,88,37,28,9,0.7567567567567568,15,10,5,0.6666666666666666,0.7088607594936708,GPT4,mimiciii,nursing_note,PROMPT2_entailment
238,89,28,25,3,0.8928571428571429,29,27,2,0.9310344827586208,0.911546252532073,GPT4,mimiciii,nursing_note,PROMPT2_entailment
239,9,42,37,5,0.8809523809523809,17,14,3,0.8235294117647058,0.8512736236647493,GPT4,mimiciii,nursing_note,PROMPT2_entailment
240,90,29,23,6,0.7931034482758621,14,13,1,0.9285714285714286,0.8555078683834049,GPT4,mimiciii,nursing_note,PROMPT2_entailment
241,91,28,19,9,0.6785714285714286,24,23,1,0.9583333333333334,0.7945454545454546,GPT4,mimiciii,nursing_note,PROMPT2_entailment
242,92,43,39,4,0.9069767441860463,28,22,6,0.7857142857142857,0.8420019627085378,GPT4,mimiciii,nursing_note,PROMPT2_entailment
243,93,34,29,5,0.8529411764705882,23,17,6,0.7391304347826086,0.7919678714859437,GPT4,mimiciii,nursing_note,PROMPT2_entailment
244,94,7,7,0,1.0,5,5,0,1.0,1.0,GPT4,mimiciii,nursing_note,PROMPT2_entailment
245,95,32,25,7,0.78125,14,13,1,0.9285714285714286,0.8485639686684073,GPT4,mimiciii,nursing_note,PROMPT2_entailment
246,96,11,10,1,0.9090909090909092,6,6,0,1.0,0.9523809523809524,GPT4,mimiciii,nursing_note,PROMPT2_entailment
247,97,14,14,0,1.0,10,9,1,0.9,0.9473684210526316,GPT4,mimiciii,nursing_note,PROMPT2_entailment
248,98,51,43,8,0.8431372549019608,13,7,6,0.5384615384615384,0.6572052401746725,GPT4,mimiciii,nursing_note,PROMPT2_entailment
249,99,51,46,5,0.9019607843137256,44,30,14,0.6818181818181818,0.7765897580191334,GPT4,mimiciii,nursing_note,PROMPT2_entailment
0,0,19,13,6,0.6842105263157895,21,15,6,0.7142857142857143,0.6989247311827957,GPT4,mimiciii,radiology_report,PROMPT1_entailment
1,1,9,6,3,0.6666666666666666,15,8,7,0.5333333333333333,0.5925925925925926,GPT4,mimiciii,radiology_report,PROMPT1_entailment
2,10,10,5,5,0.5,18,14,4,0.7777777777777778,0.6086956521739131,GPT4,mimiciii,radiology_report,PROMPT1_entailment
3,100,8,8,0,1.0,9,8,1,0.8888888888888888,0.9411764705882352,GPT4,mimiciii,radiology_report,PROMPT1_entailment
4,101,12,8,4,0.6666666666666666,15,13,2,0.8666666666666667,0.7536231884057971,GPT4,mimiciii,radiology_report,PROMPT1_entailment
5,102,10,10,0,1.0,16,13,3,0.8125,0.896551724137931,GPT4,mimiciii,radiology_report,PROMPT1_entailment
6,103,10,8,2,0.8,19,17,2,0.8947368421052632,0.84472049689441,GPT4,mimiciii,radiology_report,PROMPT1_entailment
7,104,9,6,3,0.6666666666666666,17,14,3,0.8235294117647058,0.7368421052631577,GPT4,mimiciii,radiology_report,PROMPT1_entailment
8,105,6,6,0,1.0,8,7,1,0.875,0.9333333333333332,GPT4,mimiciii,radiology_report,PROMPT1_entailment
9,106,9,8,1,0.8888888888888888,12,11,1,0.9166666666666666,0.9025641025641026,GPT4,mimiciii,radiology_report,PROMPT1_entailment
10,107,15,13,2,0.8666666666666667,19,14,5,0.7368421052631579,0.7964989059080962,GPT4,mimiciii,radiology_report,PROMPT1_entailment
11,108,10,9,1,0.9,13,11,2,0.8461538461538461,0.8722466960352422,GPT4,mimiciii,radiology_report,PROMPT1_entailment
12,109,13,7,6,0.5384615384615384,20,18,2,0.9,0.6737967914438503,GPT4,mimiciii,radiology_report,PROMPT1_entailment
13,11,16,15,1,0.9375,24,22,2,0.9166666666666666,0.9269662921348316,GPT4,mimiciii,radiology_report,PROMPT1_entailment
14,110,9,5,4,0.5555555555555556,17,14,3,0.8235294117647058,0.6635071090047393,GPT4,mimiciii,radiology_report,PROMPT1_entailment
15,111,13,9,4,0.6923076923076923,20,16,4,0.8,0.7422680412371134,GPT4,mimiciii,radiology_report,PROMPT1_entailment
16,112,9,8,1,0.8888888888888888,14,11,3,0.7857142857142857,0.8341232227488152,GPT4,mimiciii,radiology_report,PROMPT1_entailment
17,113,14,8,6,0.5714285714285714,20,16,4,0.8,0.6666666666666666,GPT4,mimiciii,radiology_report,PROMPT1_entailment
18,114,14,7,7,0.5,23,20,3,0.8695652173913043,0.634920634920635,GPT4,mimiciii,radiology_report,PROMPT1_entailment
19,115,13,11,2,0.8461538461538461,20,15,5,0.75,0.7951807228915662,GPT4,mimiciii,radiology_report,PROMPT1_entailment
20,116,7,5,2,0.7142857142857143,13,10,3,0.7692307692307693,0.7407407407407408,GPT4,mimiciii,radiology_report,PROMPT1_entailment
21,117,9,6,3,0.6666666666666666,16,11,5,0.6875,0.676923076923077,GPT4,mimiciii,radiology_report,PROMPT1_entailment
22,118,13,8,5,0.6153846153846154,24,17,7,0.7083333333333334,0.6585956416464891,GPT4,mimiciii,radiology_report,PROMPT1_entailment
23,119,12,12,0,1.0,17,14,3,0.8235294117647058,0.9032258064516128,GPT4,mimiciii,radiology_report,PROMPT1_entailment
24,12,11,11,0,1.0,17,15,2,0.8823529411764706,0.9375,GPT4,mimiciii,radiology_report,PROMPT1_entailment
25,120,15,10,5,0.6666666666666666,16,10,6,0.625,0.6451612903225806,GPT4,mimiciii,radiology_report,PROMPT1_entailment
26,121,15,12,3,0.8,26,22,4,0.8461538461538461,0.8224299065420562,GPT4,mimiciii,radiology_report,PROMPT1_entailment
27,122,13,11,2,0.8461538461538461,20,14,6,0.7,0.7661691542288558,GPT4,mimiciii,radiology_report,PROMPT1_entailment
28,123,10,9,1,0.9,13,10,3,0.7692307692307693,0.8294930875576038,GPT4,mimiciii,radiology_report,PROMPT1_entailment
29,124,10,9,1,0.9,12,7,5,0.5833333333333334,0.7078651685393258,GPT4,mimiciii,radiology_report,PROMPT1_entailment
30,125,16,13,3,0.8125,23,19,4,0.8260869565217391,0.8192371475953565,GPT4,mimiciii,radiology_report,PROMPT1_entailment
31,126,6,4,2,0.6666666666666666,9,7,2,0.7777777777777778,0.717948717948718,GPT4,mimiciii,radiology_report,PROMPT1_entailment
32,127,19,19,0,1.0,50,34,16,0.68,0.8095238095238095,GPT4,mimiciii,radiology_report,PROMPT1_entailment
33,128,7,3,4,0.4285714285714285,14,10,4,0.7142857142857143,0.5357142857142858,GPT4,mimiciii,radiology_report,PROMPT1_entailment
34,129,11,8,3,0.7272727272727273,16,14,2,0.875,0.7943262411347517,GPT4,mimiciii,radiology_report,PROMPT1_entailment
35,13,10,7,3,0.7,17,14,3,0.8235294117647058,0.7567567567567567,GPT4,mimiciii,radiology_report,PROMPT1_entailment
36,130,15,14,1,0.9333333333333332,29,19,10,0.6551724137931034,0.7698986975397973,GPT4,mimiciii,radiology_report,PROMPT1_entailment
37,131,13,11,2,0.8461538461538461,45,26,19,0.5777777777777777,0.6866746698679471,GPT4,mimiciii,radiology_report,PROMPT1_entailment
38,132,14,11,3,0.7857142857142857,23,19,4,0.8260869565217391,0.8053949903660885,GPT4,mimiciii,radiology_report,PROMPT1_entailment
39,133,13,11,2,0.8461538461538461,21,17,4,0.8095238095238095,0.8274336283185841,GPT4,mimiciii,radiology_report,PROMPT1_entailment
40,134,12,9,3,0.75,23,20,3,0.8695652173913043,0.8053691275167786,GPT4,mimiciii,radiology_report,PROMPT1_entailment
41,135,13,12,1,0.9230769230769232,20,15,5,0.75,0.8275862068965517,GPT4,mimiciii,radiology_report,PROMPT1_entailment
42,136,8,8,0,1.0,14,11,3,0.7857142857142857,0.88,GPT4,mimiciii,radiology_report,PROMPT1_entailment
43,137,7,6,1,0.8571428571428571,10,8,2,0.8,0.8275862068965518,GPT4,mimiciii,radiology_report,PROMPT1_entailment
44,138,10,9,1,0.9,14,12,2,0.8571428571428571,0.8780487804878048,GPT4,mimiciii,radiology_report,PROMPT1_entailment
45,139,9,6,3,0.6666666666666666,13,10,3,0.7692307692307693,0.7142857142857142,GPT4,mimiciii,radiology_report,PROMPT1_entailment
46,14,8,8,0,1.0,12,11,1,0.9166666666666666,0.9565217391304348,GPT4,mimiciii,radiology_report,PROMPT1_entailment
47,140,14,8,6,0.5714285714285714,18,15,3,0.8333333333333334,0.6779661016949152,GPT4,mimiciii,radiology_report,PROMPT1_entailment
48,141,12,9,3,0.75,16,12,4,0.75,0.75,GPT4,mimiciii,radiology_report,PROMPT1_entailment
49,142,10,9,1,0.9,14,13,1,0.9285714285714286,0.9140625,GPT4,mimiciii,radiology_report,PROMPT1_entailment
50,143,14,13,1,0.9285714285714286,32,21,11,0.65625,0.7690140845070422,GPT4,mimiciii,radiology_report,PROMPT1_entailment
51,144,15,13,2,0.8666666666666667,26,19,7,0.7307692307692307,0.7929373996789726,GPT4,mimiciii,radiology_report,PROMPT1_entailment
52,145,10,9,1,0.9,18,16,2,0.8888888888888888,0.8944099378881988,GPT4,mimiciii,radiology_report,PROMPT1_entailment
53,146,10,9,1,0.9,11,9,2,0.8181818181818182,0.8571428571428572,GPT4,mimiciii,radiology_report,PROMPT1_entailment
54,147,9,7,2,0.7777777777777778,10,9,1,0.9,0.8344370860927153,GPT4,mimiciii,radiology_report,PROMPT1_entailment
55,148,15,12,3,0.8,32,21,11,0.65625,0.721030042918455,GPT4,mimiciii,radiology_report,PROMPT1_entailment
56,149,12,8,4,0.6666666666666666,20,17,3,0.85,0.7472527472527473,GPT4,mimiciii,radiology_report,PROMPT1_entailment
57,15,17,9,8,0.5294117647058824,29,24,5,0.8275862068965517,0.6457399103139013,GPT4,mimiciii,radiology_report,PROMPT1_entailment
58,150,9,4,5,0.4444444444444444,14,11,3,0.7857142857142857,0.5677419354838709,GPT4,mimiciii,radiology_report,PROMPT1_entailment
59,151,12,9,3,0.75,15,8,7,0.5333333333333333,0.6233766233766235,GPT4,mimiciii,radiology_report,PROMPT1_entailment
60,152,12,7,5,0.5833333333333334,18,13,5,0.7222222222222222,0.6453900709219859,GPT4,mimiciii,radiology_report,PROMPT1_entailment
61,153,11,8,3,0.7272727272727273,16,14,2,0.875,0.7943262411347517,GPT4,mimiciii,radiology_report,PROMPT1_entailment
62,154,13,8,5,0.6153846153846154,23,22,1,0.9565217391304348,0.748936170212766,GPT4,mimiciii,radiology_report,PROMPT1_entailment
63,155,24,20,4,0.8333333333333334,47,38,9,0.8085106382978723,0.8207343412526997,GPT4,mimiciii,radiology_report,PROMPT1_entailment
64,156,16,11,5,0.6875,20,16,4,0.8,0.7394957983193278,GPT4,mimiciii,radiology_report,PROMPT1_entailment
65,157,11,9,2,0.8181818181818182,12,11,1,0.9166666666666666,0.8646288209606987,GPT4,mimiciii,radiology_report,PROMPT1_entailment
66,158,5,5,0,1.0,6,4,2,0.6666666666666666,0.8,GPT4,mimiciii,radiology_report,PROMPT1_entailment
67,159,10,8,2,0.8,13,11,2,0.8461538461538461,0.8224299065420562,GPT4,mimiciii,radiology_report,PROMPT1_entailment
68,16,14,8,6,0.5714285714285714,17,14,3,0.8235294117647058,0.6746987951807228,GPT4,mimiciii,radiology_report,PROMPT1_entailment
69,160,8,6,2,0.75,12,11,1,0.9166666666666666,0.8250000000000001,GPT4,mimiciii,radiology_report,PROMPT1_entailment
70,161,12,9,3,0.75,13,9,4,0.6923076923076923,0.7199999999999999,GPT4,mimiciii,radiology_report,PROMPT1_entailment
71,162,10,9,1,0.9,11,9,2,0.8181818181818182,0.8571428571428572,GPT4,mimiciii,radiology_report,PROMPT1_entailment
72,163,10,8,2,0.8,8,4,4,0.5,0.6153846153846154,GPT4,mimiciii,radiology_report,PROMPT1_entailment
73,164,8,8,0,1.0,10,10,0,1.0,1.0,GPT4,mimiciii,radiology_report,PROMPT1_entailment
74,165,16,12,4,0.75,31,20,11,0.6451612903225806,0.6936416184971099,GPT4,mimiciii,radiology_report,PROMPT1_entailment
75,166,11,6,5,0.5454545454545454,26,16,10,0.6153846153846154,0.5783132530120482,GPT4,mimiciii,radiology_report,PROMPT1_entailment
76,167,8,7,1,0.875,10,7,3,0.7,0.7777777777777777,GPT4,mimiciii,radiology_report,PROMPT1_entailment
77,168,10,8,2,0.8,13,7,6,0.5384615384615384,0.6436781609195402,GPT4,mimiciii,radiology_report,PROMPT1_entailment
78,169,14,8,6,0.5714285714285714,22,20,2,0.9090909090909092,0.7017543859649122,GPT4,mimiciii,radiology_report,PROMPT1_entailment
79,17,9,9,0,1.0,12,8,4,0.6666666666666666,0.8,GPT4,mimiciii,radiology_report,PROMPT1_entailment
80,170,18,15,3,0.8333333333333334,24,20,4,0.8333333333333334,0.8333333333333334,GPT4,mimiciii,radiology_report,PROMPT1_entailment
81,171,5,5,0,1.0,7,6,1,0.8571428571428571,0.923076923076923,GPT4,mimiciii,radiology_report,PROMPT1_entailment
82,172,7,6,1,0.8571428571428571,14,12,2,0.8571428571428571,0.8571428571428571,GPT4,mimiciii,radiology_report,PROMPT1_entailment
83,173,9,8,1,0.8888888888888888,12,10,2,0.8333333333333334,0.8602150537634408,GPT4,mimiciii,radiology_report,PROMPT1_entailment
84,174,13,8,5,0.6153846153846154,20,13,7,0.65,0.6322188449848025,GPT4,mimiciii,radiology_report,PROMPT1_entailment
85,175,6,6,0,1.0,8,7,1,0.875,0.9333333333333332,GPT4,mimiciii,radiology_report,PROMPT1_entailment
86,176,10,3,7,0.3,19,16,3,0.8421052631578947,0.4423963133640552,GPT4,mimiciii,radiology_report,PROMPT1_entailment
87,177,12,9,3,0.75,16,12,4,0.75,0.75,GPT4,mimiciii,radiology_report,PROMPT1_entailment
88,178,15,10,5,0.6666666666666666,25,23,2,0.92,0.7731092436974789,GPT4,mimiciii,radiology_report,PROMPT1_entailment
89,179,11,11,0,1.0,20,15,5,0.75,0.8571428571428571,GPT4,mimiciii,radiology_report,PROMPT1_entailment
90,18,15,14,1,0.9333333333333332,17,12,5,0.7058823529411765,0.8038277511961724,GPT4,mimiciii,radiology_report,PROMPT1_entailment
91,180,10,10,0,1.0,11,10,1,0.9090909090909092,0.9523809523809524,GPT4,mimiciii,radiology_report,PROMPT1_entailment
92,181,17,7,10,0.4117647058823529,26,20,6,0.7692307692307693,0.5363984674329502,GPT4,mimiciii,radiology_report,PROMPT1_entailment
93,182,12,7,5,0.5833333333333334,23,18,5,0.782608695652174,0.6684350132625995,GPT4,mimiciii,radiology_report,PROMPT1_entailment
94,183,11,10,1,0.9090909090909092,17,13,4,0.7647058823529411,0.8306709265175718,GPT4,mimiciii,radiology_report,PROMPT1_entailment
95,184,11,9,2,0.8181818181818182,15,11,4,0.7333333333333333,0.7734375,GPT4,mimiciii,radiology_report,PROMPT1_entailment
96,185,7,7,0,1.0,6,6,0,1.0,1.0,GPT4,mimiciii,radiology_report,PROMPT1_entailment
97,186,15,12,3,0.8,26,21,5,0.8076923076923077,0.8038277511961722,GPT4,mimiciii,radiology_report,PROMPT1_entailment
98,187,13,13,0,1.0,14,13,1,0.9285714285714286,0.962962962962963,GPT4,mimiciii,radiology_report,PROMPT1_entailment
99,188,17,11,6,0.6470588235294118,22,17,5,0.7727272727272727,0.7043314500941619,GPT4,mimiciii,radiology_report,PROMPT1_entailment
100,189,13,11,2,0.8461538461538461,15,12,3,0.8,0.8224299065420562,GPT4,mimiciii,radiology_report,PROMPT1_entailment
101,19,9,8,1,0.8888888888888888,14,9,5,0.6428571428571429,0.7461139896373057,GPT4,mimiciii,radiology_report,PROMPT1_entailment
102,190,12,9,3,0.75,17,14,3,0.8235294117647058,0.7850467289719627,GPT4,mimiciii,radiology_report,PROMPT1_entailment
103,191,13,12,1,0.9230769230769232,15,12,3,0.8,0.8571428571428571,GPT4,mimiciii,radiology_report,PROMPT1_entailment
104,192,20,16,4,0.8,28,26,2,0.9285714285714286,0.859504132231405,GPT4,mimiciii,radiology_report,PROMPT1_entailment
105,193,12,12,0,1.0,14,14,0,1.0,1.0,GPT4,mimiciii,radiology_report,PROMPT1_entailment
106,194,17,16,1,0.9411764705882352,49,35,14,0.7142857142857143,0.8121827411167514,GPT4,mimiciii,radiology_report,PROMPT1_entailment
107,195,14,8,6,0.5714285714285714,21,18,3,0.8571428571428571,0.6857142857142857,GPT4,mimiciii,radiology_report,PROMPT1_entailment
108,196,10,10,0,1.0,18,14,4,0.7777777777777778,0.8750000000000001,GPT4,mimiciii,radiology_report,PROMPT1_entailment
109,197,11,9,2,0.8181818181818182,15,10,5,0.6666666666666666,0.7346938775510203,GPT4,mimiciii,radiology_report,PROMPT1_entailment
110,198,7,6,1,0.8571428571428571,9,6,3,0.6666666666666666,0.75,GPT4,mimiciii,radiology_report,PROMPT1_entailment
111,199,13,9,4,0.6923076923076923,23,21,2,0.9130434782608696,0.7875,GPT4,mimiciii,radiology_report,PROMPT1_entailment
112,2,8,7,1,0.875,15,12,3,0.8,0.8358208955223881,GPT4,mimiciii,radiology_report,PROMPT1_entailment
113,20,6,6,0,1.0,42,38,4,0.9047619047619048,0.95,GPT4,mimiciii,radiology_report,PROMPT1_entailment
114,200,10,10,0,1.0,14,13,1,0.9285714285714286,0.962962962962963,GPT4,mimiciii,radiology_report,PROMPT1_entailment
115,201,11,9,2,0.8181818181818182,18,15,3,0.8333333333333334,0.8256880733944955,GPT4,mimiciii,radiology_report,PROMPT1_entailment
116,202,16,13,3,0.8125,25,20,5,0.8,0.8062015503875969,GPT4,mimiciii,radiology_report,PROMPT1_entailment
117,203,12,7,5,0.5833333333333334,19,13,6,0.6842105263157895,0.629757785467128,GPT4,mimiciii,radiology_report,PROMPT1_entailment
118,204,12,10,2,0.8333333333333334,23,20,3,0.8695652173913043,0.851063829787234,GPT4,mimiciii,radiology_report,PROMPT1_entailment
119,205,9,9,0,1.0,14,14,0,1.0,1.0,GPT4,mimiciii,radiology_report,PROMPT1_entailment
120,206,9,7,2,0.7777777777777778,13,13,0,1.0,0.8750000000000001,GPT4,mimiciii,radiology_report,PROMPT1_entailment
121,207,7,7,0,1.0,9,7,2,0.7777777777777778,0.8750000000000001,GPT4,mimiciii,radiology_report,PROMPT1_entailment
122,208,11,9,2,0.8181818181818182,18,15,3,0.8333333333333334,0.8256880733944955,GPT4,mimiciii,radiology_report,PROMPT1_entailment
123,209,12,8,4,0.6666666666666666,16,14,2,0.875,0.7567567567567567,GPT4,mimiciii,radiology_report,PROMPT1_entailment
124,21,15,13,2,0.8666666666666667,27,19,8,0.7037037037037037,0.7767295597484277,GPT4,mimiciii,radiology_report,PROMPT1_entailment
125,210,8,7,1,0.875,14,8,6,0.5714285714285714,0.691358024691358,GPT4,mimiciii,radiology_report,PROMPT1_entailment
126,211,7,4,3,0.5714285714285714,13,11,2,0.8461538461538461,0.6821705426356589,GPT4,mimiciii,radiology_report,PROMPT1_entailment
127,212,12,6,6,0.5,19,19,0,1.0,0.6666666666666666,GPT4,mimiciii,radiology_report,PROMPT1_entailment
128,213,14,12,2,0.8571428571428571,22,17,5,0.7727272727272727,0.8127490039840638,GPT4,mimiciii,radiology_report,PROMPT1_entailment
129,214,13,9,4,0.6923076923076923,23,20,3,0.8695652173913043,0.7708779443254816,GPT4,mimiciii,radiology_report,PROMPT1_entailment
130,215,8,6,2,0.75,10,8,2,0.8,0.7741935483870969,GPT4,mimiciii,radiology_report,PROMPT1_entailment
131,216,10,6,4,0.6,19,14,5,0.7368421052631579,0.6614173228346457,GPT4,mimiciii,radiology_report,PROMPT1_entailment
132,217,10,7,3,0.7,20,15,5,0.75,0.7241379310344827,GPT4,mimiciii,radiology_report,PROMPT1_entailment
133,218,14,6,8,0.4285714285714285,15,12,3,0.8,0.5581395348837209,GPT4,mimiciii,radiology_report,PROMPT1_entailment
134,219,8,8,0,1.0,13,9,4,0.6923076923076923,0.8181818181818181,GPT4,mimiciii,radiology_report,PROMPT1_entailment
135,22,10,7,3,0.7,19,16,3,0.8421052631578947,0.7645051194539249,GPT4,mimiciii,radiology_report,PROMPT1_entailment
136,220,10,8,2,0.8,19,19,0,1.0,0.888888888888889,GPT4,mimiciii,radiology_report,PROMPT1_entailment
137,221,18,12,6,0.6666666666666666,27,22,5,0.8148148148148148,0.7333333333333333,GPT4,mimiciii,radiology_report,PROMPT1_entailment
138,222,9,7,2,0.7777777777777778,16,13,3,0.8125,0.7947598253275109,GPT4,mimiciii,radiology_report,PROMPT1_entailment
139,223,16,14,2,0.875,21,20,1,0.9523809523809524,0.9120521172638436,GPT4,mimiciii,radiology_report,PROMPT1_entailment
140,224,16,15,1,0.9375,17,14,3,0.8235294117647058,0.8768267223382046,GPT4,mimiciii,radiology_report,PROMPT1_entailment
141,225,8,7,1,0.875,11,7,4,0.6363636363636364,0.7368421052631579,GPT4,mimiciii,radiology_report,PROMPT1_entailment
142,226,14,10,4,0.7142857142857143,18,15,3,0.8333333333333334,0.7692307692307692,GPT4,mimiciii,radiology_report,PROMPT1_entailment
143,227,14,10,4,0.7142857142857143,18,15,3,0.8333333333333334,0.7692307692307692,GPT4,mimiciii,radiology_report,PROMPT1_entailment
144,228,9,5,4,0.5555555555555556,17,14,3,0.8235294117647058,0.6635071090047393,GPT4,mimiciii,radiology_report,PROMPT1_entailment
145,229,20,20,0,1.0,49,36,13,0.7346938775510204,0.8470588235294119,GPT4,mimiciii,radiology_report,PROMPT1_entailment
146,23,15,11,4,0.7333333333333333,15,13,2,0.8666666666666667,0.7944444444444444,GPT4,mimiciii,radiology_report,PROMPT1_entailment
147,230,11,9,2,0.8181818181818182,17,15,2,0.8823529411764706,0.8490566037735848,GPT4,mimiciii,radiology_report,PROMPT1_entailment
148,231,10,9,1,0.9,13,11,2,0.8461538461538461,0.8722466960352422,GPT4,mimiciii,radiology_report,PROMPT1_entailment
149,232,9,6,3,0.6666666666666666,18,16,2,0.8888888888888888,0.761904761904762,GPT4,mimiciii,radiology_report,PROMPT1_entailment
150,233,9,9,0,1.0,17,13,4,0.7647058823529411,0.8666666666666666,GPT4,mimiciii,radiology_report,PROMPT1_entailment
151,234,7,6,1,0.8571428571428571,11,7,4,0.6363636363636364,0.7304347826086957,GPT4,mimiciii,radiology_report,PROMPT1_entailment
152,235,9,8,1,0.8888888888888888,14,11,3,0.7857142857142857,0.8341232227488152,GPT4,mimiciii,radiology_report,PROMPT1_entailment
153,236,9,4,5,0.4444444444444444,11,9,2,0.8181818181818182,0.5760000000000001,GPT4,mimiciii,radiology_report,PROMPT1_entailment
154,237,10,6,4,0.6,17,14,3,0.8235294117647058,0.6942148760330579,GPT4,mimiciii,radiology_report,PROMPT1_entailment
155,238,13,9,4,0.6923076923076923,20,17,3,0.85,0.7630922693266834,GPT4,mimiciii,radiology_report,PROMPT1_entailment
156,239,12,4,8,0.3333333333333333,17,14,3,0.8235294117647058,0.4745762711864407,GPT4,mimiciii,radiology_report,PROMPT1_entailment
157,24,13,10,3,0.7692307692307693,18,14,4,0.7777777777777778,0.7734806629834255,GPT4,mimiciii,radiology_report,PROMPT1_entailment
158,240,10,9,1,0.9,13,12,1,0.9230769230769232,0.9113924050632912,GPT4,mimiciii,radiology_report,PROMPT1_entailment
159,241,11,8,3,0.7272727272727273,16,12,4,0.75,0.7384615384615384,GPT4,mimiciii,radiology_report,PROMPT1_entailment
160,242,13,11,2,0.8461538461538461,18,16,2,0.8888888888888888,0.8669950738916256,GPT4,mimiciii,radiology_report,PROMPT1_entailment
161,243,8,7,1,0.875,13,8,5,0.6153846153846154,0.7225806451612904,GPT4,mimiciii,radiology_report,PROMPT1_entailment
162,244,11,4,7,0.3636363636363636,17,17,0,1.0,0.5333333333333333,GPT4,mimiciii,radiology_report,PROMPT1_entailment
163,245,15,9,6,0.6,28,21,7,0.75,0.6666666666666665,GPT4,mimiciii,radiology_report,PROMPT1_entailment
164,246,10,9,1,0.9,12,8,4,0.6666666666666666,0.7659574468085106,GPT4,mimiciii,radiology_report,PROMPT1_entailment
165,247,9,6,3,0.6666666666666666,12,9,3,0.75,0.7058823529411765,GPT4,mimiciii,radiology_report,PROMPT1_entailment
166,248,13,10,3,0.7692307692307693,17,14,3,0.8235294117647058,0.7954545454545454,GPT4,mimiciii,radiology_report,PROMPT1_entailment
167,249,13,9,4,0.6923076923076923,23,18,5,0.782608695652174,0.7346938775510203,GPT4,mimiciii,radiology_report,PROMPT1_entailment
168,25,16,10,6,0.625,27,21,6,0.7777777777777778,0.6930693069306931,GPT4,mimiciii,radiology_report,PROMPT1_entailment
169,250,8,7,1,0.875,8,6,2,0.75,0.8076923076923077,GPT4,mimiciii,radiology_report,PROMPT1_entailment
170,251,11,7,4,0.6363636363636364,22,19,3,0.8636363636363636,0.7327823691460055,GPT4,mimiciii,radiology_report,PROMPT1_entailment
171,252,7,5,2,0.7142857142857143,10,8,2,0.8,0.7547169811320756,GPT4,mimiciii,radiology_report,PROMPT1_entailment
172,253,19,11,8,0.5789473684210527,24,23,1,0.9583333333333334,0.7218259629101283,GPT4,mimiciii,radiology_report,PROMPT1_entailment
173,254,9,8,1,0.8888888888888888,13,11,2,0.8461538461538461,0.8669950738916256,GPT4,mimiciii,radiology_report,PROMPT1_entailment
174,255,11,8,3,0.7272727272727273,16,11,5,0.6875,0.7068273092369478,GPT4,mimiciii,radiology_report,PROMPT1_entailment
175,256,12,6,6,0.5,19,16,3,0.8421052631578947,0.6274509803921569,GPT4,mimiciii,radiology_report,PROMPT1_entailment
176,257,10,8,2,0.8,15,13,2,0.8666666666666667,0.832,GPT4,mimiciii,radiology_report,PROMPT1_entailment
177,258,12,9,3,0.75,20,11,9,0.55,0.6346153846153847,GPT4,mimiciii,radiology_report,PROMPT1_entailment
178,259,13,8,5,0.6153846153846154,17,13,4,0.7647058823529411,0.6819672131147541,GPT4,mimiciii,radiology_report,PROMPT1_entailment
179,26,13,12,1,0.9230769230769232,18,13,5,0.7222222222222222,0.8103896103896105,GPT4,mimiciii,radiology_report,PROMPT1_entailment
180,260,15,9,6,0.6,20,13,7,0.65,0.624,GPT4,mimiciii,radiology_report,PROMPT1_entailment
181,261,18,9,9,0.5,31,29,2,0.935483870967742,0.6516853932584269,GPT4,mimiciii,radiology_report,PROMPT1_entailment
182,262,15,11,4,0.7333333333333333,23,19,4,0.8260869565217391,0.7769516728624535,GPT4,mimiciii,radiology_report,PROMPT1_entailment
183,263,10,7,3,0.7,27,24,3,0.8888888888888888,0.7832167832167831,GPT4,mimiciii,radiology_report,PROMPT1_entailment
184,264,11,8,3,0.7272727272727273,20,17,3,0.85,0.7838616714697406,GPT4,mimiciii,radiology_report,PROMPT1_entailment
185,265,7,6,1,0.8571428571428571,9,8,1,0.8888888888888888,0.8727272727272727,GPT4,mimiciii,radiology_report,PROMPT1_entailment
186,266,12,9,3,0.75,18,17,1,0.9444444444444444,0.8360655737704917,GPT4,mimiciii,radiology_report,PROMPT1_entailment
187,267,12,10,2,0.8333333333333334,16,11,5,0.6875,0.7534246575342466,GPT4,mimiciii,radiology_report,PROMPT1_entailment
188,268,12,8,4,0.6666666666666666,20,13,7,0.65,0.6582278481012659,GPT4,mimiciii,radiology_report,PROMPT1_entailment
189,269,19,17,2,0.8947368421052632,30,20,10,0.6666666666666666,0.7640449438202247,GPT4,mimiciii,radiology_report,PROMPT1_entailment
190,27,10,9,1,0.9,14,11,3,0.7857142857142857,0.8389830508474577,GPT4,mimiciii,radiology_report,PROMPT1_entailment
191,270,15,13,2,0.8666666666666667,17,13,4,0.7647058823529411,0.8125,GPT4,mimiciii,radiology_report,PROMPT1_entailment
192,271,14,13,1,0.9285714285714286,20,15,5,0.75,0.8297872340425532,GPT4,mimiciii,radiology_report,PROMPT1_entailment
193,272,12,10,2,0.8333333333333334,17,16,1,0.9411764705882352,0.8839779005524863,GPT4,mimiciii,radiology_report,PROMPT1_entailment
194,273,8,6,2,0.75,12,9,3,0.75,0.75,GPT4,mimiciii,radiology_report,PROMPT1_entailment
195,274,13,6,7,0.4615384615384615,20,13,7,0.65,0.5397923875432526,GPT4,mimiciii,radiology_report,PROMPT1_entailment
196,275,11,10,1,0.9090909090909092,12,11,1,0.9166666666666666,0.9128630705394192,GPT4,mimiciii,radiology_report,PROMPT1_entailment
197,276,15,12,3,0.8,29,21,8,0.7241379310344828,0.7601809954751131,GPT4,mimiciii,radiology_report,PROMPT1_entailment
198,277,14,8,6,0.5714285714285714,25,22,3,0.88,0.6929133858267715,GPT4,mimiciii,radiology_report,PROMPT1_entailment
199,278,13,10,3,0.7692307692307693,16,13,3,0.8125,0.790273556231003,GPT4,mimiciii,radiology_report,PROMPT1_entailment
200,279,9,7,2,0.7777777777777778,10,7,3,0.7,0.7368421052631577,GPT4,mimiciii,radiology_report,PROMPT1_entailment
201,28,16,7,9,0.4375,30,25,5,0.8333333333333334,0.5737704918032787,GPT4,mimiciii,radiology_report,PROMPT1_entailment
202,280,8,6,2,0.75,12,11,1,0.9166666666666666,0.8250000000000001,GPT4,mimiciii,radiology_report,PROMPT1_entailment
203,281,15,12,3,0.8,24,19,5,0.7916666666666666,0.7958115183246073,GPT4,mimiciii,radiology_report,PROMPT1_entailment
204,282,11,11,0,1.0,12,11,1,0.9166666666666666,0.9565217391304348,GPT4,mimiciii,radiology_report,PROMPT1_entailment
205,283,14,11,3,0.7857142857142857,28,22,6,0.7857142857142857,0.7857142857142857,GPT4,mimiciii,radiology_report,PROMPT1_entailment
206,284,12,9,3,0.75,14,11,3,0.7857142857142857,0.7674418604651163,GPT4,mimiciii,radiology_report,PROMPT1_entailment
207,285,10,6,4,0.6,18,17,1,0.9444444444444444,0.7338129496402879,GPT4,mimiciii,radiology_report,PROMPT1_entailment
208,286,7,6,1,0.8571428571428571,6,6,0,1.0,0.923076923076923,GPT4,mimiciii,radiology_report,PROMPT1_entailment
209,287,11,9,2,0.8181818181818182,18,15,3,0.8333333333333334,0.8256880733944955,GPT4,mimiciii,radiology_report,PROMPT1_entailment
210,288,25,16,9,0.64,32,29,3,0.90625,0.750202101859337,GPT4,mimiciii,radiology_report,PROMPT1_entailment
211,289,15,11,4,0.7333333333333333,20,17,3,0.85,0.7873684210526316,GPT4,mimiciii,radiology_report,PROMPT1_entailment
212,29,9,8,1,0.8888888888888888,8,6,2,0.75,0.8135593220338982,GPT4,mimiciii,radiology_report,PROMPT1_entailment
213,290,11,9,2,0.8181818181818182,11,9,2,0.8181818181818182,0.8181818181818182,GPT4,mimiciii,radiology_report,PROMPT1_entailment
214,291,14,10,4,0.7142857142857143,24,15,9,0.625,0.6666666666666666,GPT4,mimiciii,radiology_report,PROMPT1_entailment
215,292,11,7,4,0.6363636363636364,21,17,4,0.8095238095238095,0.7125748502994012,GPT4,mimiciii,radiology_report,PROMPT1_entailment
216,293,13,10,3,0.7692307692307693,18,13,5,0.7222222222222222,0.7449856733524356,GPT4,mimiciii,radiology_report,PROMPT1_entailment
217,294,13,10,3,0.7692307692307693,22,14,8,0.6363636363636364,0.6965174129353234,GPT4,mimiciii,radiology_report,PROMPT1_entailment
218,295,14,11,3,0.7857142857142857,39,24,15,0.6153846153846154,0.6901960784313727,GPT4,mimiciii,radiology_report,PROMPT1_entailment
219,296,13,9,4,0.6923076923076923,17,15,2,0.8823529411764706,0.7758620689655172,GPT4,mimiciii,radiology_report,PROMPT1_entailment
220,297,13,9,4,0.6923076923076923,24,18,6,0.75,0.7199999999999999,GPT4,mimiciii,radiology_report,PROMPT1_entailment
221,298,15,13,2,0.8666666666666667,20,18,2,0.9,0.8830188679245283,GPT4,mimiciii,radiology_report,PROMPT1_entailment
222,299,15,15,0,1.0,32,25,7,0.78125,0.8771929824561403,GPT4,mimiciii,radiology_report,PROMPT1_entailment
223,3,12,10,2,0.8333333333333334,20,17,3,0.85,0.8415841584158417,GPT4,mimiciii,radiology_report,PROMPT1_entailment
224,30,14,10,4,0.7142857142857143,25,20,5,0.8,0.7547169811320756,GPT4,mimiciii,radiology_report,PROMPT1_entailment
225,300,10,7,3,0.7,13,9,4,0.6923076923076923,0.6961325966850829,GPT4,mimiciii,radiology_report,PROMPT1_entailment
226,301,10,10,0,1.0,19,18,1,0.9473684210526316,0.972972972972973,GPT4,mimiciii,radiology_report,PROMPT1_entailment
227,302,9,7,2,0.7777777777777778,15,13,2,0.8666666666666667,0.81981981981982,GPT4,mimiciii,radiology_report,PROMPT1_entailment
228,303,16,8,8,0.5,24,19,5,0.7916666666666666,0.6129032258064516,GPT4,mimiciii,radiology_report,PROMPT1_entailment
229,304,11,10,1,0.9090909090909092,21,17,4,0.8095238095238095,0.8564231738035265,GPT4,mimiciii,radiology_report,PROMPT1_entailment
230,305,14,6,8,0.4285714285714285,24,16,8,0.6666666666666666,0.5217391304347826,GPT4,mimiciii,radiology_report,PROMPT1_entailment
231,306,11,9,2,0.8181818181818182,14,10,4,0.7142857142857143,0.7627118644067797,GPT4,mimiciii,radiology_report,PROMPT1_entailment
232,307,11,8,3,0.7272727272727273,17,15,2,0.8823529411764706,0.7973421926910299,GPT4,mimiciii,radiology_report,PROMPT1_entailment
233,308,14,11,3,0.7857142857142857,15,11,4,0.7333333333333333,0.7586206896551724,GPT4,mimiciii,radiology_report,PROMPT1_entailment
234,309,14,11,3,0.7857142857142857,29,21,8,0.7241379310344828,0.7536704730831975,GPT4,mimiciii,radiology_report,PROMPT1_entailment
235,31,11,8,3,0.7272727272727273,19,14,5,0.7368421052631579,0.7320261437908497,GPT4,mimiciii,radiology_report,PROMPT1_entailment
236,310,14,12,2,0.8571428571428571,24,20,4,0.8333333333333334,0.8450704225352113,GPT4,mimiciii,radiology_report,PROMPT1_entailment
237,311,10,9,1,0.9,15,13,2,0.8666666666666667,0.8830188679245283,GPT4,mimiciii,radiology_report,PROMPT1_entailment
238,312,9,9,0,1.0,18,13,5,0.7222222222222222,0.8387096774193548,GPT4,mimiciii,radiology_report,PROMPT1_entailment
239,313,11,8,3,0.7272727272727273,17,13,4,0.7647058823529411,0.7455197132616488,GPT4,mimiciii,radiology_report,PROMPT1_entailment
240,314,9,4,5,0.4444444444444444,15,14,1,0.9333333333333332,0.6021505376344086,GPT4,mimiciii,radiology_report,PROMPT1_entailment
241,315,13,9,4,0.6923076923076923,25,17,8,0.68,0.6860986547085203,GPT4,mimiciii,radiology_report,PROMPT1_entailment
242,316,8,8,0,1.0,10,9,1,0.9,0.9473684210526316,GPT4,mimiciii,radiology_report,PROMPT1_entailment
243,317,15,13,2,0.8666666666666667,26,24,2,0.9230769230769232,0.8939828080229226,GPT4,mimiciii,radiology_report,PROMPT1_entailment
244,318,13,7,6,0.5384615384615384,21,18,3,0.8571428571428571,0.6614173228346457,GPT4,mimiciii,radiology_report,PROMPT1_entailment
245,319,9,8,1,0.8888888888888888,12,11,1,0.9166666666666666,0.9025641025641026,GPT4,mimiciii,radiology_report,PROMPT1_entailment
246,32,10,10,0,1.0,15,12,3,0.8,0.888888888888889,GPT4,mimiciii,radiology_report,PROMPT1_entailment
247,320,8,8,0,1.0,11,8,3,0.7272727272727273,0.8421052631578948,GPT4,mimiciii,radiology_report,PROMPT1_entailment
248,321,12,8,4,0.6666666666666666,21,18,3,0.8571428571428571,0.75,GPT4,mimiciii,radiology_report,PROMPT1_entailment
249,322,6,6,0,1.0,8,6,2,0.75,0.8571428571428571,GPT4,mimiciii,radiology_report,PROMPT1_entailment
250,323,17,12,5,0.7058823529411765,29,20,9,0.6896551724137931,0.6976744186046512,GPT4,mimiciii,radiology_report,PROMPT1_entailment
251,324,15,13,2,0.8666666666666667,18,13,5,0.7222222222222222,0.7878787878787877,GPT4,mimiciii,radiology_report,PROMPT1_entailment
252,325,18,13,5,0.7222222222222222,22,17,5,0.7727272727272727,0.7466216216216217,GPT4,mimiciii,radiology_report,PROMPT1_entailment
253,326,14,11,3,0.7857142857142857,23,19,4,0.8260869565217391,0.8053949903660885,GPT4,mimiciii,radiology_report,PROMPT1_entailment
254,327,7,7,0,1.0,9,9,0,1.0,1.0,GPT4,mimiciii,radiology_report,PROMPT1_entailment
255,328,13,7,6,0.5384615384615384,17,12,5,0.7058823529411765,0.6109090909090908,GPT4,mimiciii,radiology_report,PROMPT1_entailment
256,329,14,12,2,0.8571428571428571,28,20,8,0.7142857142857143,0.7792207792207793,GPT4,mimiciii,radiology_report,PROMPT1_entailment
257,33,8,7,1,0.875,9,8,1,0.8888888888888888,0.8818897637795274,GPT4,mimiciii,radiology_report,PROMPT1_entailment
258,330,9,9,0,1.0,11,11,0,1.0,1.0,GPT4,mimiciii,radiology_report,PROMPT1_entailment
259,331,12,11,1,0.9166666666666666,15,14,1,0.9333333333333332,0.9249249249249248,GPT4,mimiciii,radiology_report,PROMPT1_entailment
260,332,15,10,5,0.6666666666666666,20,15,5,0.75,0.7058823529411765,GPT4,mimiciii,radiology_report,PROMPT1_entailment
261,333,10,10,0,1.0,13,11,2,0.8461538461538461,0.9166666666666666,GPT4,mimiciii,radiology_report,PROMPT1_entailment
262,334,13,10,3,0.7692307692307693,20,19,1,0.95,0.8501118568232661,GPT4,mimiciii,radiology_report,PROMPT1_entailment
263,335,11,9,2,0.8181818181818182,17,15,2,0.8823529411764706,0.8490566037735848,GPT4,mimiciii,radiology_report,PROMPT1_entailment
264,336,12,8,4,0.6666666666666666,16,15,1,0.9375,0.7792207792207793,GPT4,mimiciii,radiology_report,PROMPT1_entailment
265,337,11,11,0,1.0,16,14,2,0.875,0.9333333333333332,GPT4,mimiciii,radiology_report,PROMPT1_entailment
266,338,13,11,2,0.8461538461538461,13,10,3,0.7692307692307693,0.8058608058608059,GPT4,mimiciii,radiology_report,PROMPT1_entailment
267,339,6,5,1,0.8333333333333334,28,23,5,0.8214285714285714,0.827338129496403,GPT4,mimiciii,radiology_report,PROMPT1_entailment
268,34,9,6,3,0.6666666666666666,14,12,2,0.8571428571428571,0.75,GPT4,mimiciii,radiology_report,PROMPT1_entailment
269,340,19,15,4,0.7894736842105263,15,14,1,0.9333333333333332,0.8553971486761711,GPT4,mimiciii,radiology_report,PROMPT1_entailment
270,341,4,3,1,0.75,6,5,1,0.8333333333333334,0.7894736842105262,GPT4,mimiciii,radiology_report,PROMPT1_entailment
271,342,11,10,1,0.9090909090909092,15,13,2,0.8666666666666667,0.887372013651877,GPT4,mimiciii,radiology_report,PROMPT1_entailment
272,343,14,12,2,0.8571428571428571,26,20,6,0.7692307692307693,0.8108108108108107,GPT4,mimiciii,radiology_report,PROMPT1_entailment
273,344,11,4,7,0.3636363636363636,19,15,4,0.7894736842105263,0.4979253112033195,GPT4,mimiciii,radiology_report,PROMPT1_entailment
274,345,6,3,3,0.5,22,20,2,0.9090909090909092,0.6451612903225806,GPT4,mimiciii,radiology_report,PROMPT1_entailment
275,346,11,7,4,0.6363636363636364,15,12,3,0.8,0.7088607594936709,GPT4,mimiciii,radiology_report,PROMPT1_entailment
276,347,12,10,2,0.8333333333333334,15,12,3,0.8,0.816326530612245,GPT4,mimiciii,radiology_report,PROMPT1_entailment
277,348,9,6,3,0.6666666666666666,12,7,5,0.5833333333333334,0.6222222222222222,GPT4,mimiciii,radiology_report,PROMPT1_entailment
278,349,11,10,1,0.9090909090909092,16,13,3,0.8125,0.858085808580858,GPT4,mimiciii,radiology_report,PROMPT1_entailment
279,35,12,4,8,0.3333333333333333,21,13,8,0.6190476190476191,0.4333333333333333,GPT4,mimiciii,radiology_report,PROMPT1_entailment
280,350,13,12,1,0.9230769230769232,21,17,4,0.8095238095238095,0.8625792811839323,GPT4,mimiciii,radiology_report,PROMPT1_entailment
281,351,15,8,7,0.5333333333333333,21,19,2,0.9047619047619048,0.6710816777041942,GPT4,mimiciii,radiology_report,PROMPT1_entailment
282,352,12,9,3,0.75,22,16,6,0.7272727272727273,0.7384615384615384,GPT4,mimiciii,radiology_report,PROMPT1_entailment
283,353,11,8,3,0.7272727272727273,26,19,7,0.7307692307692307,0.7290167865707434,GPT4,mimiciii,radiology_report,PROMPT1_entailment
284,354,12,8,4,0.6666666666666666,26,20,6,0.7692307692307693,0.7142857142857142,GPT4,mimiciii,radiology_report,PROMPT1_entailment
285,355,12,12,0,1.0,18,16,2,0.8888888888888888,0.9411764705882352,GPT4,mimiciii,radiology_report,PROMPT1_entailment
286,356,16,13,3,0.8125,22,18,4,0.8181818181818182,0.8153310104529616,GPT4,mimiciii,radiology_report,PROMPT1_entailment
287,357,8,5,3,0.625,15,10,5,0.6666666666666666,0.6451612903225806,GPT4,mimiciii,radiology_report,PROMPT1_entailment
288,358,12,6,6,0.5,12,7,5,0.5833333333333334,0.5384615384615384,GPT4,mimiciii,radiology_report,PROMPT1_entailment
289,359,10,7,3,0.7,18,16,2,0.8888888888888888,0.7832167832167831,GPT4,mimiciii,radiology_report,PROMPT1_entailment
290,36,14,10,4,0.7142857142857143,22,15,7,0.6818181818181818,0.6976744186046512,GPT4,mimiciii,radiology_report,PROMPT1_entailment
291,360,13,13,0,1.0,15,13,2,0.8666666666666667,0.9285714285714286,GPT4,mimiciii,radiology_report,PROMPT1_entailment
292,361,11,9,2,0.8181818181818182,23,20,3,0.8695652173913043,0.8430913348946135,GPT4,mimiciii,radiology_report,PROMPT1_entailment
293,362,17,8,9,0.4705882352941176,24,15,9,0.625,0.5369127516778524,GPT4,mimiciii,radiology_report,PROMPT1_entailment
294,363,17,13,4,0.7647058823529411,22,17,5,0.7727272727272727,0.768695652173913,GPT4,mimiciii,radiology_report,PROMPT1_entailment
295,364,7,7,0,1.0,11,9,2,0.8181818181818182,0.9,GPT4,mimiciii,radiology_report,PROMPT1_entailment
296,365,16,12,4,0.75,29,23,6,0.7931034482758621,0.770949720670391,GPT4,mimiciii,radiology_report,PROMPT1_entailment
297,366,11,9,2,0.8181818181818182,13,8,5,0.6153846153846154,0.7024390243902439,GPT4,mimiciii,radiology_report,PROMPT1_entailment
298,367,13,7,6,0.5384615384615384,16,12,4,0.75,0.6268656716417911,GPT4,mimiciii,radiology_report,PROMPT1_entailment
299,368,11,7,4,0.6363636363636364,20,15,5,0.75,0.6885245901639345,GPT4,mimiciii,radiology_report,PROMPT1_entailment
300,369,12,8,4,0.6666666666666666,20,18,2,0.9,0.7659574468085106,GPT4,mimiciii,radiology_report,PROMPT1_entailment
301,37,11,10,1,0.9090909090909092,21,17,4,0.8095238095238095,0.8564231738035265,GPT4,mimiciii,radiology_report,PROMPT1_entailment
302,370,13,9,4,0.6923076923076923,19,11,8,0.5789473684210527,0.6305732484076433,GPT4,mimiciii,radiology_report,PROMPT1_entailment
303,371,14,11,3,0.7857142857142857,17,14,3,0.8235294117647058,0.8041775456919059,GPT4,mimiciii,radiology_report,PROMPT1_entailment
304,372,14,11,3,0.7857142857142857,31,30,1,0.967741935483871,0.8672798948751643,GPT4,mimiciii,radiology_report,PROMPT1_entailment
305,373,17,13,4,0.7647058823529411,23,15,8,0.6521739130434783,0.703971119133574,GPT4,mimiciii,radiology_report,PROMPT1_entailment
306,374,9,8,1,0.8888888888888888,11,9,2,0.8181818181818182,0.8520710059171598,GPT4,mimiciii,radiology_report,PROMPT1_entailment
307,375,9,8,1,0.8888888888888888,16,13,3,0.8125,0.8489795918367347,GPT4,mimiciii,radiology_report,PROMPT1_entailment
308,376,12,7,5,0.5833333333333334,18,13,5,0.7222222222222222,0.6453900709219859,GPT4,mimiciii,radiology_report,PROMPT1_entailment
309,377,10,10,0,1.0,10,8,2,0.8,0.888888888888889,GPT4,mimiciii,radiology_report,PROMPT1_entailment
310,378,15,10,5,0.6666666666666666,24,19,5,0.7916666666666666,0.7238095238095237,GPT4,mimiciii,radiology_report,PROMPT1_entailment
311,379,11,8,3,0.7272727272727273,18,15,3,0.8333333333333334,0.7766990291262137,GPT4,mimiciii,radiology_report,PROMPT1_entailment
312,38,12,9,3,0.75,19,16,3,0.8421052631578947,0.7933884297520661,GPT4,mimiciii,radiology_report,PROMPT1_entailment
313,380,8,8,0,1.0,8,6,2,0.75,0.8571428571428571,GPT4,mimiciii,radiology_report,PROMPT1_entailment
314,381,10,6,4,0.6,14,11,3,0.7857142857142857,0.6804123711340206,GPT4,mimiciii,radiology_report,PROMPT1_entailment
315,382,7,6,1,0.8571428571428571,16,14,2,0.875,0.8659793814432989,GPT4,mimiciii,radiology_report,PROMPT1_entailment
316,383,14,11,3,0.7857142857142857,17,16,1,0.9411764705882352,0.8564476885644767,GPT4,mimiciii,radiology_report,PROMPT1_entailment
317,384,9,9,0,1.0,13,12,1,0.9230769230769232,0.96,GPT4,mimiciii,radiology_report,PROMPT1_entailment
318,385,14,6,8,0.4285714285714285,27,22,5,0.8148148148148148,0.5617021276595745,GPT4,mimiciii,radiology_report,PROMPT1_entailment
319,386,12,11,1,0.9166666666666666,18,15,3,0.8333333333333334,0.8730158730158729,GPT4,mimiciii,radiology_report,PROMPT1_entailment
320,387,12,11,1,0.9166666666666666,19,16,3,0.8421052631578947,0.8778054862842893,GPT4,mimiciii,radiology_report,PROMPT1_entailment
321,388,15,12,3,0.8,33,30,3,0.9090909090909092,0.8510638297872342,GPT4,mimiciii,radiology_report,PROMPT1_entailment
322,389,12,8,4,0.6666666666666666,12,8,4,0.6666666666666666,0.6666666666666666,GPT4,mimiciii,radiology_report,PROMPT1_entailment
323,39,10,7,3,0.7,10,8,2,0.8,0.7466666666666666,GPT4,mimiciii,radiology_report,PROMPT1_entailment
324,390,9,7,2,0.7777777777777778,14,14,0,1.0,0.8750000000000001,GPT4,mimiciii,radiology_report,PROMPT1_entailment
325,391,10,8,2,0.8,13,7,6,0.5384615384615384,0.6436781609195402,GPT4,mimiciii,radiology_report,PROMPT1_entailment
326,392,11,8,3,0.7272727272727273,15,12,3,0.8,0.761904761904762,GPT4,mimiciii,radiology_report,PROMPT1_entailment
327,393,13,9,4,0.6923076923076923,19,14,5,0.7368421052631579,0.7138810198300283,GPT4,mimiciii,radiology_report,PROMPT1_entailment
328,394,12,11,1,0.9166666666666666,18,18,0,1.0,0.9565217391304348,GPT4,mimiciii,radiology_report,PROMPT1_entailment
329,395,11,8,3,0.7272727272727273,16,10,6,0.625,0.6722689075630253,GPT4,mimiciii,radiology_report,PROMPT1_entailment
330,396,11,9,2,0.8181818181818182,19,15,4,0.7894736842105263,0.8035714285714286,GPT4,mimiciii,radiology_report,PROMPT1_entailment
331,397,13,10,3,0.7692307692307693,18,15,3,0.8333333333333334,0.8,GPT4,mimiciii,radiology_report,PROMPT1_entailment
332,398,16,10,6,0.625,21,18,3,0.8571428571428571,0.7228915662650602,GPT4,mimiciii,radiology_report,PROMPT1_entailment
333,399,11,9,2,0.8181818181818182,19,16,3,0.8421052631578947,0.829971181556196,GPT4,mimiciii,radiology_report,PROMPT1_entailment
334,4,14,14,0,1.0,16,14,2,0.875,0.9333333333333332,GPT4,mimiciii,radiology_report,PROMPT1_entailment
335,40,17,13,4,0.7647058823529411,17,12,5,0.7058823529411765,0.7341176470588234,GPT4,mimiciii,radiology_report,PROMPT1_entailment
336,400,9,8,1,0.8888888888888888,13,9,4,0.6923076923076923,0.7783783783783783,GPT4,mimiciii,radiology_report,PROMPT1_entailment
337,401,7,7,0,1.0,9,9,0,1.0,1.0,GPT4,mimiciii,radiology_report,PROMPT1_entailment
338,402,14,10,4,0.7142857142857143,20,17,3,0.85,0.776255707762557,GPT4,mimiciii,radiology_report,PROMPT1_entailment
339,403,12,11,1,0.9166666666666666,18,15,3,0.8333333333333334,0.8730158730158729,GPT4,mimiciii,radiology_report,PROMPT1_entailment
340,404,14,12,2,0.8571428571428571,19,16,3,0.8421052631578947,0.8495575221238938,GPT4,mimiciii,radiology_report,PROMPT1_entailment
341,405,13,10,3,0.7692307692307693,14,11,3,0.7857142857142857,0.7773851590106008,GPT4,mimiciii,radiology_report,PROMPT1_entailment
342,406,14,8,6,0.5714285714285714,25,21,4,0.84,0.680161943319838,GPT4,mimiciii,radiology_report,PROMPT1_entailment
343,407,10,6,4,0.6,20,18,2,0.9,0.7200000000000001,GPT4,mimiciii,radiology_report,PROMPT1_entailment
344,408,12,7,5,0.5833333333333334,20,14,6,0.7,0.6363636363636365,GPT4,mimiciii,radiology_report,PROMPT1_entailment
345,409,16,11,5,0.6875,21,20,1,0.9523809523809524,0.7985480943738658,GPT4,mimiciii,radiology_report,PROMPT1_entailment
346,41,14,13,1,0.9285714285714286,26,17,9,0.6538461538461539,0.7673611111111112,GPT4,mimiciii,radiology_report,PROMPT1_entailment
347,410,11,8,3,0.7272727272727273,20,13,7,0.65,0.6864686468646864,GPT4,mimiciii,radiology_report,PROMPT1_entailment
348,411,5,5,0,1.0,6,5,1,0.8333333333333334,0.9090909090909092,GPT4,mimiciii,radiology_report,PROMPT1_entailment
349,412,12,9,3,0.75,26,24,2,0.9230769230769232,0.8275862068965517,GPT4,mimiciii,radiology_report,PROMPT1_entailment
350,413,13,12,1,0.9230769230769232,14,13,1,0.9285714285714286,0.9258160237388724,GPT4,mimiciii,radiology_report,PROMPT1_entailment
351,414,16,8,8,0.5,28,22,6,0.7857142857142857,0.6111111111111112,GPT4,mimiciii,radiology_report,PROMPT1_entailment
352,415,12,11,1,0.9166666666666666,20,18,2,0.9,0.908256880733945,GPT4,mimiciii,radiology_report,PROMPT1_entailment
353,416,12,10,2,0.8333333333333334,19,15,4,0.7894736842105263,0.8108108108108109,GPT4,mimiciii,radiology_report,PROMPT1_entailment
354,417,17,8,9,0.4705882352941176,20,16,4,0.8,0.5925925925925927,GPT4,mimiciii,radiology_report,PROMPT1_entailment
355,418,13,12,1,0.9230769230769232,14,12,2,0.8571428571428571,0.888888888888889,GPT4,mimiciii,radiology_report,PROMPT1_entailment
356,419,10,9,1,0.9,16,12,4,0.75,0.8181818181818182,GPT4,mimiciii,radiology_report,PROMPT1_entailment
357,42,13,11,2,0.8461538461538461,14,9,5,0.6428571428571429,0.7306273062730628,GPT4,mimiciii,radiology_report,PROMPT1_entailment
358,420,14,9,5,0.6428571428571429,15,11,4,0.7333333333333333,0.6851211072664359,GPT4,mimiciii,radiology_report,PROMPT1_entailment
359,421,12,6,6,0.5,23,16,7,0.6956521739130435,0.5818181818181818,GPT4,mimiciii,radiology_report,PROMPT1_entailment
360,422,15,11,4,0.7333333333333333,20,18,2,0.9,0.8081632653061224,GPT4,mimiciii,radiology_report,PROMPT1_entailment
361,423,9,9,0,1.0,12,11,1,0.9166666666666666,0.9565217391304348,GPT4,mimiciii,radiology_report,PROMPT1_entailment
362,424,6,6,0,1.0,9,7,2,0.7777777777777778,0.8750000000000001,GPT4,mimiciii,radiology_report,PROMPT1_entailment
363,425,15,12,3,0.8,19,13,6,0.6842105263157895,0.7375886524822695,GPT4,mimiciii,radiology_report,PROMPT1_entailment
364,426,7,4,3,0.5714285714285714,16,12,4,0.75,0.6486486486486486,GPT4,mimiciii,radiology_report,PROMPT1_entailment
365,427,8,8,0,1.0,15,11,4,0.7333333333333333,0.846153846153846,GPT4,mimiciii,radiology_report,PROMPT1_entailment
366,428,9,6,3,0.6666666666666666,15,13,2,0.8666666666666667,0.7536231884057971,GPT4,mimiciii,radiology_report,PROMPT1_entailment
367,429,12,11,1,0.9166666666666666,13,9,4,0.6923076923076923,0.7888446215139442,GPT4,mimiciii,radiology_report,PROMPT1_entailment
368,43,12,12,0,1.0,7,7,0,1.0,1.0,GPT4,mimiciii,radiology_report,PROMPT1_entailment
369,430,6,6,0,1.0,7,5,2,0.7142857142857143,0.8333333333333333,GPT4,mimiciii,radiology_report,PROMPT1_entailment
370,431,9,5,4,0.5555555555555556,18,16,2,0.8888888888888888,0.6837606837606838,GPT4,mimiciii,radiology_report,PROMPT1_entailment
371,432,13,6,7,0.4615384615384615,13,11,2,0.8461538461538461,0.5972850678733032,GPT4,mimiciii,radiology_report,PROMPT1_entailment
372,433,11,11,0,1.0,18,15,3,0.8333333333333334,0.9090909090909092,GPT4,mimiciii,radiology_report,PROMPT1_entailment
373,434,17,8,9,0.4705882352941176,27,22,5,0.8148148148148148,0.5966101694915255,GPT4,mimiciii,radiology_report,PROMPT1_entailment
374,435,9,6,3,0.6666666666666666,13,12,1,0.9230769230769232,0.7741935483870968,GPT4,mimiciii,radiology_report,PROMPT1_entailment
375,436,16,10,6,0.625,25,19,6,0.76,0.6859205776173285,GPT4,mimiciii,radiology_report,PROMPT1_entailment
376,437,5,4,1,0.8,7,5,2,0.7142857142857143,0.7547169811320756,GPT4,mimiciii,radiology_report,PROMPT1_entailment
377,438,12,12,0,1.0,19,14,5,0.7368421052631579,0.8484848484848484,GPT4,mimiciii,radiology_report,PROMPT1_entailment
378,439,16,8,8,0.5,22,19,3,0.8636363636363636,0.6333333333333333,GPT4,mimiciii,radiology_report,PROMPT1_entailment
379,44,12,10,2,0.8333333333333334,16,13,3,0.8125,0.8227848101265822,GPT4,mimiciii,radiology_report,PROMPT1_entailment
380,440,14,10,4,0.7142857142857143,19,12,7,0.631578947368421,0.670391061452514,GPT4,mimiciii,radiology_report,PROMPT1_entailment
381,441,14,8,6,0.5714285714285714,17,16,1,0.9411764705882352,0.7111111111111111,GPT4,mimiciii,radiology_report,PROMPT1_entailment
382,442,11,11,0,1.0,12,11,1,0.9166666666666666,0.9565217391304348,GPT4,mimiciii,radiology_report,PROMPT1_entailment
383,443,10,8,2,0.8,21,14,7,0.6666666666666666,0.7272727272727272,GPT4,mimiciii,radiology_report,PROMPT1_entailment
384,444,8,7,1,0.875,8,5,3,0.625,0.7291666666666666,GPT4,mimiciii,radiology_report,PROMPT1_entailment
385,445,14,11,3,0.7857142857142857,22,19,3,0.8636363636363636,0.8228346456692914,GPT4,mimiciii,radiology_report,PROMPT1_entailment
386,446,13,10,3,0.7692307692307693,22,16,6,0.7272727272727273,0.7476635514018691,GPT4,mimiciii,radiology_report,PROMPT1_entailment
387,447,10,9,1,0.9,14,14,0,1.0,0.9473684210526316,GPT4,mimiciii,radiology_report,PROMPT1_entailment
388,448,21,14,7,0.6666666666666666,36,24,12,0.6666666666666666,0.6666666666666666,GPT4,mimiciii,radiology_report,PROMPT1_entailment
389,449,7,6,1,0.8571428571428571,9,9,0,1.0,0.923076923076923,GPT4,mimiciii,radiology_report,PROMPT1_entailment
390,45,12,6,6,0.5,20,14,6,0.7,0.5833333333333334,GPT4,mimiciii,radiology_report,PROMPT1_entailment
391,450,13,11,2,0.8461538461538461,21,18,3,0.8571428571428571,0.8516129032258064,GPT4,mimiciii,radiology_report,PROMPT1_entailment
392,451,7,7,0,1.0,10,9,1,0.9,0.9473684210526316,GPT4,mimiciii,radiology_report,PROMPT1_entailment
393,452,10,8,2,0.8,16,14,2,0.875,0.8358208955223881,GPT4,mimiciii,radiology_report,PROMPT1_entailment
394,453,10,9,1,0.9,14,11,3,0.7857142857142857,0.8389830508474577,GPT4,mimiciii,radiology_report,PROMPT1_entailment
395,454,8,6,2,0.75,10,6,4,0.6,0.6666666666666665,GPT4,mimiciii,radiology_report,PROMPT1_entailment
396,455,12,9,3,0.75,16,14,2,0.875,0.8076923076923077,GPT4,mimiciii,radiology_report,PROMPT1_entailment
397,456,12,11,1,0.9166666666666666,21,18,3,0.8571428571428571,0.8859060402684563,GPT4,mimiciii,radiology_report,PROMPT1_entailment
398,457,11,9,2,0.8181818181818182,12,9,3,0.75,0.7826086956521738,GPT4,mimiciii,radiology_report,PROMPT1_entailment
399,458,11,8,3,0.7272727272727273,16,14,2,0.875,0.7943262411347517,GPT4,mimiciii,radiology_report,PROMPT1_entailment
400,459,11,10,1,0.9090909090909092,13,9,4,0.6923076923076923,0.7860262008733625,GPT4,mimiciii,radiology_report,PROMPT1_entailment
401,46,11,10,1,0.9090909090909092,26,12,14,0.4615384615384615,0.6122448979591837,GPT4,mimiciii,radiology_report,PROMPT1_entailment
402,460,13,7,6,0.5384615384615384,20,16,4,0.8,0.6436781609195402,GPT4,mimiciii,radiology_report,PROMPT1_entailment
403,461,9,4,5,0.4444444444444444,22,16,6,0.7272727272727273,0.5517241379310345,GPT4,mimiciii,radiology_report,PROMPT1_entailment
404,462,15,9,6,0.6,20,18,2,0.9,0.7200000000000001,GPT4,mimiciii,radiology_report,PROMPT1_entailment
405,463,8,7,1,0.875,12,9,3,0.75,0.8076923076923077,GPT4,mimiciii,radiology_report,PROMPT1_entailment
406,464,19,11,8,0.5789473684210527,25,20,5,0.8,0.6717557251908397,GPT4,mimiciii,radiology_report,PROMPT1_entailment
407,465,15,14,1,0.9333333333333332,33,26,7,0.7878787878787878,0.8544600938967136,GPT4,mimiciii,radiology_report,PROMPT1_entailment
408,466,12,7,5,0.5833333333333334,22,18,4,0.8181818181818182,0.6810810810810811,GPT4,mimiciii,radiology_report,PROMPT1_entailment
409,467,10,9,1,0.9,14,13,1,0.9285714285714286,0.9140625,GPT4,mimiciii,radiology_report,PROMPT1_entailment
410,468,11,8,3,0.7272727272727273,18,12,6,0.6666666666666666,0.6956521739130435,GPT4,mimiciii,radiology_report,PROMPT1_entailment
411,469,15,9,6,0.6,25,19,6,0.76,0.6705882352941176,GPT4,mimiciii,radiology_report,PROMPT1_entailment
412,47,10,6,4,0.6,15,10,5,0.6666666666666666,0.631578947368421,GPT4,mimiciii,radiology_report,PROMPT1_entailment
413,470,9,6,3,0.6666666666666666,15,14,1,0.9333333333333332,0.7777777777777778,GPT4,mimiciii,radiology_report,PROMPT1_entailment
414,471,14,10,4,0.7142857142857143,18,13,5,0.7222222222222222,0.7182320441988951,GPT4,mimiciii,radiology_report,PROMPT1_entailment
415,472,14,12,2,0.8571428571428571,16,10,6,0.625,0.7228915662650602,GPT4,mimiciii,radiology_report,PROMPT1_entailment
416,473,9,8,1,0.8888888888888888,11,10,1,0.9090909090909092,0.8988764044943819,GPT4,mimiciii,radiology_report,PROMPT1_entailment
417,474,16,12,4,0.75,25,21,4,0.84,0.7924528301886793,GPT4,mimiciii,radiology_report,PROMPT1_entailment
418,475,6,6,0,1.0,7,4,3,0.5714285714285714,0.7272727272727273,GPT4,mimiciii,radiology_report,PROMPT1_entailment
419,476,14,13,1,0.9285714285714286,12,10,2,0.8333333333333334,0.8783783783783784,GPT4,mimiciii,radiology_report,PROMPT1_entailment
420,477,10,8,2,0.8,16,14,2,0.875,0.8358208955223881,GPT4,mimiciii,radiology_report,PROMPT1_entailment
421,478,13,11,2,0.8461538461538461,21,15,6,0.7142857142857143,0.7746478873239436,GPT4,mimiciii,radiology_report,PROMPT1_entailment
422,479,13,12,1,0.9230769230769232,22,18,4,0.8181818181818182,0.8674698795180724,GPT4,mimiciii,radiology_report,PROMPT1_entailment
423,48,12,9,3,0.75,21,18,3,0.8571428571428571,0.7999999999999999,GPT4,mimiciii,radiology_report,PROMPT1_entailment
424,480,10,9,1,0.9,10,7,3,0.7,0.7875,GPT4,mimiciii,radiology_report,PROMPT1_entailment
425,481,13,8,5,0.6153846153846154,17,13,4,0.7647058823529411,0.6819672131147541,GPT4,mimiciii,radiology_report,PROMPT1_entailment
426,482,13,9,4,0.6923076923076923,19,15,4,0.7894736842105263,0.7377049180327868,GPT4,mimiciii,radiology_report,PROMPT1_entailment
427,483,13,13,0,1.0,27,17,10,0.6296296296296297,0.7727272727272727,GPT4,mimiciii,radiology_report,PROMPT1_entailment
428,484,8,5,3,0.625,13,8,5,0.6153846153846154,0.6201550387596899,GPT4,mimiciii,radiology_report,PROMPT1_entailment
429,485,16,16,0,1.0,27,19,8,0.7037037037037037,0.8260869565217391,GPT4,mimiciii,radiology_report,PROMPT1_entailment
430,486,13,12,1,0.9230769230769232,11,10,1,0.9090909090909092,0.9160305343511452,GPT4,mimiciii,radiology_report,PROMPT1_entailment
431,487,10,8,2,0.8,20,13,7,0.65,0.7172413793103448,GPT4,mimiciii,radiology_report,PROMPT1_entailment
432,488,10,8,2,0.8,15,12,3,0.8,0.8000000000000002,GPT4,mimiciii,radiology_report,PROMPT1_entailment
433,489,14,11,3,0.7857142857142857,18,12,6,0.6666666666666666,0.721311475409836,GPT4,mimiciii,radiology_report,PROMPT1_entailment
434,49,13,11,2,0.8461538461538461,24,19,5,0.7916666666666666,0.8180039138943248,GPT4,mimiciii,radiology_report,PROMPT1_entailment
435,490,7,7,0,1.0,8,5,3,0.625,0.7692307692307693,GPT4,mimiciii,radiology_report,PROMPT1_entailment
436,491,13,9,4,0.6923076923076923,17,13,4,0.7647058823529411,0.7267080745341614,GPT4,mimiciii,radiology_report,PROMPT1_entailment
437,492,14,12,2,0.8571428571428571,13,11,2,0.8461538461538461,0.8516129032258064,GPT4,mimiciii,radiology_report,PROMPT1_entailment
438,493,10,9,1,0.9,9,7,2,0.7777777777777778,0.8344370860927153,GPT4,mimiciii,radiology_report,PROMPT1_entailment
439,494,9,9,0,1.0,8,5,3,0.625,0.7692307692307693,GPT4,mimiciii,radiology_report,PROMPT1_entailment
440,495,8,8,0,1.0,12,12,0,1.0,1.0,GPT4,mimiciii,radiology_report,PROMPT1_entailment
441,496,16,14,2,0.875,36,22,14,0.6111111111111112,0.7196261682242991,GPT4,mimiciii,radiology_report,PROMPT1_entailment
442,497,13,13,0,1.0,25,17,8,0.68,0.8095238095238095,GPT4,mimiciii,radiology_report,PROMPT1_entailment
443,498,11,6,5,0.5454545454545454,22,15,7,0.6818181818181818,0.6060606060606061,GPT4,mimiciii,radiology_report,PROMPT1_entailment
444,499,13,11,2,0.8461538461538461,17,15,2,0.8823529411764706,0.8638743455497382,GPT4,mimiciii,radiology_report,PROMPT1_entailment
445,5,14,10,4,0.7142857142857143,22,18,4,0.8181818181818182,0.7627118644067797,GPT4,mimiciii,radiology_report,PROMPT1_entailment
446,50,9,9,0,1.0,15,11,4,0.7333333333333333,0.846153846153846,GPT4,mimiciii,radiology_report,PROMPT1_entailment
447,51,10,9,1,0.9,13,11,2,0.8461538461538461,0.8722466960352422,GPT4,mimiciii,radiology_report,PROMPT1_entailment
448,52,12,9,3,0.75,21,17,4,0.8095238095238095,0.7786259541984734,GPT4,mimiciii,radiology_report,PROMPT1_entailment
449,53,10,9,1,0.9,12,8,4,0.6666666666666666,0.7659574468085106,GPT4,mimiciii,radiology_report,PROMPT1_entailment
450,54,9,7,2,0.7777777777777778,10,8,2,0.8,0.7887323943661971,GPT4,mimiciii,radiology_report,PROMPT1_entailment
451,55,10,7,3,0.7,18,15,3,0.8333333333333334,0.7608695652173915,GPT4,mimiciii,radiology_report,PROMPT1_entailment
452,56,11,8,3,0.7272727272727273,21,16,5,0.7619047619047619,0.7441860465116279,GPT4,mimiciii,radiology_report,PROMPT1_entailment
453,57,8,7,1,0.875,10,5,5,0.5,0.6363636363636364,GPT4,mimiciii,radiology_report,PROMPT1_entailment
454,58,11,10,1,0.9090909090909092,16,14,2,0.875,0.8917197452229298,GPT4,mimiciii,radiology_report,PROMPT1_entailment
455,59,9,6,3,0.6666666666666666,16,12,4,0.75,0.7058823529411765,GPT4,mimiciii,radiology_report,PROMPT1_entailment
456,6,6,6,0,1.0,8,5,3,0.625,0.7692307692307693,GPT4,mimiciii,radiology_report,PROMPT1_entailment
457,60,12,10,2,0.8333333333333334,19,13,6,0.6842105263157895,0.7514450867052023,GPT4,mimiciii,radiology_report,PROMPT1_entailment
458,61,13,11,2,0.8461538461538461,22,15,7,0.6818181818181818,0.7551487414187643,GPT4,mimiciii,radiology_report,PROMPT1_entailment
459,62,9,7,2,0.7777777777777778,13,10,3,0.7692307692307693,0.7734806629834255,GPT4,mimiciii,radiology_report,PROMPT1_entailment
460,63,11,7,4,0.6363636363636364,15,12,3,0.8,0.7088607594936709,GPT4,mimiciii,radiology_report,PROMPT1_entailment
461,64,13,11,2,0.8461538461538461,20,15,5,0.75,0.7951807228915662,GPT4,mimiciii,radiology_report,PROMPT1_entailment
462,65,15,10,5,0.6666666666666666,18,14,4,0.7777777777777778,0.717948717948718,GPT4,mimiciii,radiology_report,PROMPT1_entailment
463,66,18,11,7,0.6111111111111112,34,30,4,0.8823529411764706,0.7221006564551423,GPT4,mimiciii,radiology_report,PROMPT1_entailment
464,67,13,11,2,0.8461538461538461,28,25,3,0.8928571428571429,0.8688783570300157,GPT4,mimiciii,radiology_report,PROMPT1_entailment
465,68,16,10,6,0.625,35,27,8,0.7714285714285715,0.690537084398977,GPT4,mimiciii,radiology_report,PROMPT1_entailment
466,69,19,12,7,0.631578947368421,31,21,10,0.6774193548387096,0.6536964980544746,GPT4,mimiciii,radiology_report,PROMPT1_entailment
467,7,12,8,4,0.6666666666666666,16,14,2,0.875,0.7567567567567567,GPT4,mimiciii,radiology_report,PROMPT1_entailment
468,70,11,9,2,0.8181818181818182,17,15,2,0.8823529411764706,0.8490566037735848,GPT4,mimiciii,radiology_report,PROMPT1_entailment
469,71,11,8,3,0.7272727272727273,18,15,3,0.8333333333333334,0.7766990291262137,GPT4,mimiciii,radiology_report,PROMPT1_entailment
470,72,8,8,0,1.0,13,11,2,0.8461538461538461,0.9166666666666666,GPT4,mimiciii,radiology_report,PROMPT1_entailment
471,73,18,15,3,0.8333333333333334,34,21,13,0.6176470588235294,0.7094594594594594,GPT4,mimiciii,radiology_report,PROMPT1_entailment
472,74,11,8,3,0.7272727272727273,18,14,4,0.7777777777777778,0.7516778523489932,GPT4,mimiciii,radiology_report,PROMPT1_entailment
473,75,14,7,7,0.5,12,11,1,0.9166666666666666,0.6470588235294118,GPT4,mimiciii,radiology_report,PROMPT1_entailment
474,76,9,7,2,0.7777777777777778,14,13,1,0.9285714285714286,0.8465116279069766,GPT4,mimiciii,radiology_report,PROMPT1_entailment
475,77,12,6,6,0.5,26,18,8,0.6923076923076923,0.5806451612903226,GPT4,mimiciii,radiology_report,PROMPT1_entailment
476,78,19,10,9,0.5263157894736842,33,25,8,0.7575757575757576,0.6211180124223601,GPT4,mimiciii,radiology_report,PROMPT1_entailment
477,79,12,12,0,1.0,17,14,3,0.8235294117647058,0.9032258064516128,GPT4,mimiciii,radiology_report,PROMPT1_entailment
478,8,13,10,3,0.7692307692307693,15,12,3,0.8,0.7843137254901961,GPT4,mimiciii,radiology_report,PROMPT1_entailment
479,80,15,10,5,0.6666666666666666,25,21,4,0.84,0.743362831858407,GPT4,mimiciii,radiology_report,PROMPT1_entailment
480,81,9,5,4,0.5555555555555556,15,9,6,0.6,0.576923076923077,GPT4,mimiciii,radiology_report,PROMPT1_entailment
481,82,10,7,3,0.7,14,12,2,0.8571428571428571,0.7706422018348624,GPT4,mimiciii,radiology_report,PROMPT1_entailment
482,83,13,5,8,0.3846153846153846,17,14,3,0.8235294117647058,0.5243445692883896,GPT4,mimiciii,radiology_report,PROMPT1_entailment
483,84,14,12,2,0.8571428571428571,20,15,5,0.75,0.7999999999999999,GPT4,mimiciii,radiology_report,PROMPT1_entailment
484,85,12,12,0,1.0,14,14,0,1.0,1.0,GPT4,mimiciii,radiology_report,PROMPT1_entailment
485,86,9,8,1,0.8888888888888888,10,9,1,0.9,0.8944099378881988,GPT4,mimiciii,radiology_report,PROMPT1_entailment
486,87,11,10,1,0.9090909090909092,14,13,1,0.9285714285714286,0.9187279151943464,GPT4,mimiciii,radiology_report,PROMPT1_entailment
487,88,13,12,1,0.9230769230769232,19,18,1,0.9473684210526316,0.935064935064935,GPT4,mimiciii,radiology_report,PROMPT1_entailment
488,89,12,10,2,0.8333333333333334,18,16,2,0.8888888888888888,0.8602150537634408,GPT4,mimiciii,radiology_report,PROMPT1_entailment
489,9,8,7,1,0.875,13,11,2,0.8461538461538461,0.8603351955307262,GPT4,mimiciii,radiology_report,PROMPT1_entailment
490,90,10,10,0,1.0,14,14,0,1.0,1.0,GPT4,mimiciii,radiology_report,PROMPT1_entailment
491,91,9,9,0,1.0,13,11,2,0.8461538461538461,0.9166666666666666,GPT4,mimiciii,radiology_report,PROMPT1_entailment
492,92,12,7,5,0.5833333333333334,21,15,6,0.7142857142857143,0.6422018348623854,GPT4,mimiciii,radiology_report,PROMPT1_entailment
493,93,11,7,4,0.6363636363636364,15,12,3,0.8,0.7088607594936709,GPT4,mimiciii,radiology_report,PROMPT1_entailment
494,94,18,11,7,0.6111111111111112,28,22,6,0.7857142857142857,0.6875000000000001,GPT4,mimiciii,radiology_report,PROMPT1_entailment
495,95,14,10,4,0.7142857142857143,18,9,9,0.5,0.588235294117647,GPT4,mimiciii,radiology_report,PROMPT1_entailment
496,96,13,9,4,0.6923076923076923,21,17,4,0.8095238095238095,0.7463414634146341,GPT4,mimiciii,radiology_report,PROMPT1_entailment
497,97,13,9,4,0.6923076923076923,23,17,6,0.7391304347826086,0.7149532710280374,GPT4,mimiciii,radiology_report,PROMPT1_entailment
498,98,13,10,3,0.7692307692307693,19,14,5,0.7368421052631579,0.7526881720430108,GPT4,mimiciii,radiology_report,PROMPT1_entailment
499,99,13,13,0,1.0,13,13,0,1.0,1.0,GPT4,mimiciii,radiology_report,PROMPT1_entailment
0,0,26,13,13,0.5,21,13,8,0.6190476190476191,0.5531914893617021,GPT4,mimiciii,radiology_report,PROMPT1_ICL_entailment
1,1,21,14,7,0.6666666666666666,15,10,5,0.6666666666666666,0.6666666666666666,GPT4,mimiciii,radiology_report,PROMPT1_ICL_entailment
2,10,11,8,3,0.7272727272727273,18,16,2,0.8888888888888888,0.7999999999999999,GPT4,mimiciii,radiology_report,PROMPT1_ICL_entailment
3,100,13,12,1,0.9230769230769232,9,9,0,1.0,0.96,GPT4,mimiciii,radiology_report,PROMPT1_ICL_entailment
4,101,17,11,6,0.6470588235294118,15,12,3,0.8,0.7154471544715447,GPT4,mimiciii,radiology_report,PROMPT1_ICL_entailment
5,102,13,10,3,0.7692307692307693,16,11,5,0.6875,0.7260726072607261,GPT4,mimiciii,radiology_report,PROMPT1_ICL_entailment
6,103,20,17,3,0.85,19,16,3,0.8421052631578947,0.8460342146189734,GPT4,mimiciii,radiology_report,PROMPT1_ICL_entailment
7,104,20,11,9,0.55,17,12,5,0.7058823529411765,0.6182669789227168,GPT4,mimiciii,radiology_report,PROMPT1_ICL_entailment
8,105,6,6,0,1.0,8,6,2,0.75,0.8571428571428571,GPT4,mimiciii,radiology_report,PROMPT1_ICL_entailment
9,106,10,9,1,0.9,12,10,2,0.8333333333333334,0.8653846153846153,GPT4,mimiciii,radiology_report,PROMPT1_ICL_entailment
10,107,17,11,6,0.6470588235294118,19,12,7,0.631578947368421,0.6392251815980629,GPT4,mimiciii,radiology_report,PROMPT1_ICL_entailment
11,108,17,16,1,0.9411764705882352,13,9,4,0.6923076923076923,0.7977839335180056,GPT4,mimiciii,radiology_report,PROMPT1_ICL_entailment
12,109,15,8,7,0.5333333333333333,20,16,4,0.8,0.64,GPT4,mimiciii,radiology_report,PROMPT1_ICL_entailment
13,11,21,19,2,0.9047619047619048,24,17,7,0.7083333333333334,0.7945879458794588,GPT4,mimiciii,radiology_report,PROMPT1_ICL_entailment
14,110,15,7,8,0.4666666666666667,17,13,4,0.7647058823529411,0.5796178343949044,GPT4,mimiciii,radiology_report,PROMPT1_ICL_entailment
15,111,14,12,2,0.8571428571428571,20,14,6,0.7,0.7706422018348624,GPT4,mimiciii,radiology_report,PROMPT1_ICL_entailment
16,112,12,12,0,1.0,14,13,1,0.9285714285714286,0.962962962962963,GPT4,mimiciii,radiology_report,PROMPT1_ICL_entailment
17,113,18,9,9,0.5,20,14,6,0.7,0.5833333333333334,GPT4,mimiciii,radiology_report,PROMPT1_ICL_entailment
18,114,18,6,12,0.3333333333333333,23,20,3,0.8695652173913043,0.4819277108433734,GPT4,mimiciii,radiology_report,PROMPT1_ICL_entailment
19,115,17,14,3,0.8235294117647058,20,16,4,0.8,0.8115942028985507,GPT4,mimiciii,radiology_report,PROMPT1_ICL_entailment
20,116,12,11,1,0.9166666666666666,13,10,3,0.7692307692307693,0.8365019011406845,GPT4,mimiciii,radiology_report,PROMPT1_ICL_entailment
21,117,16,12,4,0.75,16,13,3,0.8125,0.78,GPT4,mimiciii,radiology_report,PROMPT1_ICL_entailment
22,118,18,12,6,0.6666666666666666,24,20,4,0.8333333333333334,0.7407407407407408,GPT4,mimiciii,radiology_report,PROMPT1_ICL_entailment
23,119,17,15,2,0.8823529411764706,17,13,4,0.7647058823529411,0.8193277310924368,GPT4,mimiciii,radiology_report,PROMPT1_ICL_entailment
24,12,11,11,0,1.0,17,12,5,0.7058823529411765,0.8275862068965517,GPT4,mimiciii,radiology_report,PROMPT1_ICL_entailment
25,120,19,11,8,0.5789473684210527,16,9,7,0.5625,0.5706051873198847,GPT4,mimiciii,radiology_report,PROMPT1_ICL_entailment
26,121,28,23,5,0.8214285714285714,26,23,3,0.8846153846153846,0.8518518518518519,GPT4,mimiciii,radiology_report,PROMPT1_ICL_entailment
27,122,13,12,1,0.9230769230769232,20,16,4,0.8,0.8571428571428571,GPT4,mimiciii,radiology_report,PROMPT1_ICL_entailment
28,123,12,11,1,0.9166666666666666,13,10,3,0.7692307692307693,0.8365019011406845,GPT4,mimiciii,radiology_report,PROMPT1_ICL_entailment
29,124,11,7,4,0.6363636363636364,12,10,2,0.8333333333333334,0.7216494845360825,GPT4,mimiciii,radiology_report,PROMPT1_ICL_entailment
30,125,20,16,4,0.8,23,19,4,0.8260869565217391,0.8128342245989306,GPT4,mimiciii,radiology_report,PROMPT1_ICL_entailment
31,126,10,9,1,0.9,9,8,1,0.8888888888888888,0.8944099378881988,GPT4,mimiciii,radiology_report,PROMPT1_ICL_entailment
32,127,39,36,3,0.9230769230769232,50,28,22,0.56,0.6970954356846474,GPT4,mimiciii,radiology_report,PROMPT1_ICL_entailment
33,128,12,11,1,0.9166666666666666,14,10,4,0.7142857142857143,0.8029197080291971,GPT4,mimiciii,radiology_report,PROMPT1_ICL_entailment
34,129,10,6,4,0.6,16,11,5,0.6875,0.6407766990291262,GPT4,mimiciii,radiology_report,PROMPT1_ICL_entailment
35,13,11,10,1,0.9090909090909092,17,16,1,0.9411764705882352,0.92485549132948,GPT4,mimiciii,radiology_report,PROMPT1_ICL_entailment
36,130,19,18,1,0.9473684210526316,29,17,12,0.5862068965517241,0.7242603550295857,GPT4,mimiciii,radiology_report,PROMPT1_ICL_entailment
37,131,13,11,2,0.8461538461538461,45,35,10,0.7777777777777778,0.8105263157894737,GPT4,mimiciii,radiology_report,PROMPT1_ICL_entailment
38,132,19,7,12,0.3684210526315789,23,16,7,0.6956521739130435,0.4817204301075268,GPT4,mimiciii,radiology_report,PROMPT1_ICL_entailment
39,133,18,15,3,0.8333333333333334,21,17,4,0.8095238095238095,0.8212560386473431,GPT4,mimiciii,radiology_report,PROMPT1_ICL_entailment
40,134,16,11,5,0.6875,23,16,7,0.6956521739130435,0.6915520628683693,GPT4,mimiciii,radiology_report,PROMPT1_ICL_entailment
41,135,14,11,3,0.7857142857142857,20,17,3,0.85,0.8165938864628821,GPT4,mimiciii,radiology_report,PROMPT1_ICL_entailment
42,136,12,10,2,0.8333333333333334,14,9,5,0.6428571428571429,0.7258064516129034,GPT4,mimiciii,radiology_report,PROMPT1_ICL_entailment
43,137,9,9,0,1.0,10,8,2,0.8,0.888888888888889,GPT4,mimiciii,radiology_report,PROMPT1_ICL_entailment
44,138,14,11,3,0.7857142857142857,14,11,3,0.7857142857142857,0.7857142857142857,GPT4,mimiciii,radiology_report,PROMPT1_ICL_entailment
45,139,11,8,3,0.7272727272727273,13,8,5,0.6153846153846154,0.6666666666666667,GPT4,mimiciii,radiology_report,PROMPT1_ICL_entailment
46,14,9,9,0,1.0,12,10,2,0.8333333333333334,0.9090909090909092,GPT4,mimiciii,radiology_report,PROMPT1_ICL_entailment
47,140,15,11,4,0.7333333333333333,18,12,6,0.6666666666666666,0.6984126984126984,GPT4,mimiciii,radiology_report,PROMPT1_ICL_entailment
48,141,16,15,1,0.9375,16,10,6,0.625,0.75,GPT4,mimiciii,radiology_report,PROMPT1_ICL_entailment
49,142,14,12,2,0.8571428571428571,14,13,1,0.9285714285714286,0.8914285714285715,GPT4,mimiciii,radiology_report,PROMPT1_ICL_entailment
50,143,22,20,2,0.9090909090909092,32,22,10,0.6875,0.7829181494661921,GPT4,mimiciii,radiology_report,PROMPT1_ICL_entailment
51,144,17,15,2,0.8823529411764706,26,17,9,0.6538461538461539,0.7511045655375552,GPT4,mimiciii,radiology_report,PROMPT1_ICL_entailment
52,145,19,14,5,0.7368421052631579,18,17,1,0.9444444444444444,0.8278260869565217,GPT4,mimiciii,radiology_report,PROMPT1_ICL_entailment
53,146,8,8,0,1.0,11,8,3,0.7272727272727273,0.8421052631578948,GPT4,mimiciii,radiology_report,PROMPT1_ICL_entailment
54,147,10,8,2,0.8,10,8,2,0.8,0.8000000000000002,GPT4,mimiciii,radiology_report,PROMPT1_ICL_entailment
55,148,21,16,5,0.7619047619047619,32,18,14,0.5625,0.647191011235955,GPT4,mimiciii,radiology_report,PROMPT1_ICL_entailment
56,149,16,12,4,0.75,20,17,3,0.85,0.7968749999999999,GPT4,mimiciii,radiology_report,PROMPT1_ICL_entailment
57,15,24,15,9,0.625,29,23,6,0.7931034482758621,0.6990881458966566,GPT4,mimiciii,radiology_report,PROMPT1_ICL_entailment
58,150,18,8,10,0.4444444444444444,14,9,5,0.6428571428571429,0.5255474452554744,GPT4,mimiciii,radiology_report,PROMPT1_ICL_entailment
59,151,17,12,5,0.7058823529411765,15,10,5,0.6666666666666666,0.6857142857142857,GPT4,mimiciii,radiology_report,PROMPT1_ICL_entailment
60,152,16,13,3,0.8125,18,12,6,0.6666666666666666,0.7323943661971831,GPT4,mimiciii,radiology_report,PROMPT1_ICL_entailment
61,153,15,10,5,0.6666666666666666,16,12,4,0.75,0.7058823529411765,GPT4,mimiciii,radiology_report,PROMPT1_ICL_entailment
62,154,18,11,7,0.6111111111111112,23,19,4,0.8260869565217391,0.7025210084033613,GPT4,mimiciii,radiology_report,PROMPT1_ICL_entailment
63,155,32,31,1,0.96875,47,38,9,0.8085106382978723,0.881406659184437,GPT4,mimiciii,radiology_report,PROMPT1_ICL_entailment
64,156,18,9,9,0.5,20,17,3,0.85,0.6296296296296295,GPT4,mimiciii,radiology_report,PROMPT1_ICL_entailment
65,157,13,12,1,0.9230769230769232,12,9,3,0.75,0.8275862068965517,GPT4,mimiciii,radiology_report,PROMPT1_ICL_entailment
66,158,6,5,1,0.8333333333333334,6,5,1,0.8333333333333334,0.8333333333333334,GPT4,mimiciii,radiology_report,PROMPT1_ICL_entailment
67,159,13,9,4,0.6923076923076923,13,11,2,0.8461538461538461,0.7615384615384616,GPT4,mimiciii,radiology_report,PROMPT1_ICL_entailment
68,16,16,13,3,0.8125,17,11,6,0.6470588235294118,0.7204030226700252,GPT4,mimiciii,radiology_report,PROMPT1_ICL_entailment
69,160,15,12,3,0.8,12,11,1,0.9166666666666666,0.854368932038835,GPT4,mimiciii,radiology_report,PROMPT1_ICL_entailment
70,161,16,11,5,0.6875,13,10,3,0.7692307692307693,0.7260726072607261,GPT4,mimiciii,radiology_report,PROMPT1_ICL_entailment
71,162,16,16,0,1.0,11,8,3,0.7272727272727273,0.8421052631578948,GPT4,mimiciii,radiology_report,PROMPT1_ICL_entailment
72,163,10,10,0,1.0,8,5,3,0.625,0.7692307692307693,GPT4,mimiciii,radiology_report,PROMPT1_ICL_entailment
73,164,13,12,1,0.9230769230769232,10,9,1,0.9,0.9113924050632912,GPT4,mimiciii,radiology_report,PROMPT1_ICL_entailment
74,165,19,16,3,0.8421052631578947,31,21,10,0.6774193548387096,0.7508379888268156,GPT4,mimiciii,radiology_report,PROMPT1_ICL_entailment
75,166,18,10,8,0.5555555555555556,26,21,5,0.8076923076923077,0.658307210031348,GPT4,mimiciii,radiology_report,PROMPT1_ICL_entailment
76,167,7,7,0,1.0,10,9,1,0.9,0.9473684210526316,GPT4,mimiciii,radiology_report,PROMPT1_ICL_entailment
77,168,15,11,4,0.7333333333333333,13,7,6,0.5384615384615384,0.6209677419354838,GPT4,mimiciii,radiology_report,PROMPT1_ICL_entailment
78,169,16,12,4,0.75,22,20,2,0.9090909090909092,0.821917808219178,GPT4,mimiciii,radiology_report,PROMPT1_ICL_entailment
79,17,8,8,0,1.0,12,10,2,0.8333333333333334,0.9090909090909092,GPT4,mimiciii,radiology_report,PROMPT1_ICL_entailment
80,170,21,18,3,0.8571428571428571,24,19,5,0.7916666666666666,0.8231046931407942,GPT4,mimiciii,radiology_report,PROMPT1_ICL_entailment
81,171,9,9,0,1.0,7,6,1,0.8571428571428571,0.923076923076923,GPT4,mimiciii,radiology_report,PROMPT1_ICL_entailment
82,172,11,5,6,0.4545454545454545,14,11,3,0.7857142857142857,0.5759162303664922,GPT4,mimiciii,radiology_report,PROMPT1_ICL_entailment
83,173,15,13,2,0.8666666666666667,12,8,4,0.6666666666666666,0.7536231884057971,GPT4,mimiciii,radiology_report,PROMPT1_ICL_entailment
84,174,13,8,5,0.6153846153846154,20,14,6,0.7,0.6549707602339182,GPT4,mimiciii,radiology_report,PROMPT1_ICL_entailment
85,175,10,8,2,0.8,8,7,1,0.875,0.8358208955223881,GPT4,mimiciii,radiology_report,PROMPT1_ICL_entailment
86,176,18,9,9,0.5,19,16,3,0.8421052631578947,0.6274509803921569,GPT4,mimiciii,radiology_report,PROMPT1_ICL_entailment
87,177,17,12,5,0.7058823529411765,16,11,5,0.6875,0.6965699208443272,GPT4,mimiciii,radiology_report,PROMPT1_ICL_entailment
88,178,27,20,7,0.7407407407407407,25,20,5,0.8,0.7692307692307692,GPT4,mimiciii,radiology_report,PROMPT1_ICL_entailment
89,179,12,10,2,0.8333333333333334,20,11,9,0.55,0.6626506024096386,GPT4,mimiciii,radiology_report,PROMPT1_ICL_entailment
90,18,17,14,3,0.8235294117647058,17,13,4,0.7647058823529411,0.793028322440087,GPT4,mimiciii,radiology_report,PROMPT1_ICL_entailment
91,180,11,11,0,1.0,11,9,2,0.8181818181818182,0.9,GPT4,mimiciii,radiology_report,PROMPT1_ICL_entailment
92,181,18,9,9,0.5,26,19,7,0.7307692307692307,0.5937499999999999,GPT4,mimiciii,radiology_report,PROMPT1_ICL_entailment
93,182,19,16,3,0.8421052631578947,23,14,9,0.6086956521739131,0.7066246056782335,GPT4,mimiciii,radiology_report,PROMPT1_ICL_entailment
94,183,12,10,2,0.8333333333333334,17,14,3,0.8235294117647058,0.8284023668639053,GPT4,mimiciii,radiology_report,PROMPT1_ICL_entailment
95,184,12,12,0,1.0,15,13,2,0.8666666666666667,0.9285714285714286,GPT4,mimiciii,radiology_report,PROMPT1_ICL_entailment
96,185,7,7,0,1.0,6,5,1,0.8333333333333334,0.9090909090909092,GPT4,mimiciii,radiology_report,PROMPT1_ICL_entailment
97,186,20,16,4,0.8,26,21,5,0.8076923076923077,0.8038277511961722,GPT4,mimiciii,radiology_report,PROMPT1_ICL_entailment
98,187,19,17,2,0.8947368421052632,14,11,3,0.7857142857142857,0.83668903803132,GPT4,mimiciii,radiology_report,PROMPT1_ICL_entailment
99,188,20,17,3,0.85,22,17,5,0.7727272727272727,0.8095238095238095,GPT4,mimiciii,radiology_report,PROMPT1_ICL_entailment
100,189,14,12,2,0.8571428571428571,15,13,2,0.8666666666666667,0.861878453038674,GPT4,mimiciii,radiology_report,PROMPT1_ICL_entailment
101,19,12,11,1,0.9166666666666666,14,12,2,0.8571428571428571,0.8859060402684563,GPT4,mimiciii,radiology_report,PROMPT1_ICL_entailment
102,190,12,11,1,0.9166666666666666,17,15,2,0.8823529411764706,0.8991825613079019,GPT4,mimiciii,radiology_report,PROMPT1_ICL_entailment
103,191,21,14,7,0.6666666666666666,15,11,4,0.7333333333333333,0.6984126984126984,GPT4,mimiciii,radiology_report,PROMPT1_ICL_entailment
104,192,30,18,12,0.6,28,21,7,0.75,0.6666666666666665,GPT4,mimiciii,radiology_report,PROMPT1_ICL_entailment
105,193,17,15,2,0.8823529411764706,14,12,2,0.8571428571428571,0.8695652173913043,GPT4,mimiciii,radiology_report,PROMPT1_ICL_entailment
106,194,18,16,2,0.8888888888888888,49,21,28,0.4285714285714285,0.5783132530120482,GPT4,mimiciii,radiology_report,PROMPT1_ICL_entailment
107,195,18,13,5,0.7222222222222222,21,15,6,0.7142857142857143,0.7182320441988951,GPT4,mimiciii,radiology_report,PROMPT1_ICL_entailment
108,196,13,9,4,0.6923076923076923,18,13,5,0.7222222222222222,0.7069486404833838,GPT4,mimiciii,radiology_report,PROMPT1_ICL_entailment
109,197,11,10,1,0.9090909090909092,15,14,1,0.9333333333333332,0.9210526315789476,GPT4,mimiciii,radiology_report,PROMPT1_ICL_entailment
110,198,10,10,0,1.0,9,7,2,0.7777777777777778,0.8750000000000001,GPT4,mimiciii,radiology_report,PROMPT1_ICL_entailment
111,199,20,9,11,0.45,23,20,3,0.8695652173913043,0.5930807248764415,GPT4,mimiciii,radiology_report,PROMPT1_ICL_entailment
112,2,15,15,0,1.0,15,10,5,0.6666666666666666,0.8,GPT4,mimiciii,radiology_report,PROMPT1_ICL_entailment
113,20,18,18,0,1.0,42,36,6,0.8571428571428571,0.923076923076923,GPT4,mimiciii,radiology_report,PROMPT1_ICL_entailment
114,200,15,14,1,0.9333333333333332,14,11,3,0.7857142857142857,0.8531855955678669,GPT4,mimiciii,radiology_report,PROMPT1_ICL_entailment
115,201,17,13,4,0.7647058823529411,18,15,3,0.8333333333333334,0.7975460122699386,GPT4,mimiciii,radiology_report,PROMPT1_ICL_entailment
116,202,19,17,2,0.8947368421052632,25,18,7,0.72,0.7979139504563234,GPT4,mimiciii,radiology_report,PROMPT1_ICL_entailment
117,203,22,11,11,0.5,19,17,2,0.8947368421052632,0.6415094339622641,GPT4,mimiciii,radiology_report,PROMPT1_ICL_entailment
118,204,17,11,6,0.6470588235294118,23,21,2,0.9130434782608696,0.7573770491803278,GPT4,mimiciii,radiology_report,PROMPT1_ICL_entailment
119,205,19,18,1,0.9473684210526316,14,11,3,0.7857142857142857,0.8590021691973969,GPT4,mimiciii,radiology_report,PROMPT1_ICL_entailment
120,206,17,13,4,0.7647058823529411,13,11,2,0.8461538461538461,0.8033707865168538,GPT4,mimiciii,radiology_report,PROMPT1_ICL_entailment
121,207,7,7,0,1.0,9,8,1,0.8888888888888888,0.9411764705882352,GPT4,mimiciii,radiology_report,PROMPT1_ICL_entailment
122,208,15,11,4,0.7333333333333333,18,16,2,0.8888888888888888,0.8036529680365296,GPT4,mimiciii,radiology_report,PROMPT1_ICL_entailment
123,209,14,13,1,0.9285714285714286,16,14,2,0.875,0.900990099009901,GPT4,mimiciii,radiology_report,PROMPT1_ICL_entailment
124,21,27,24,3,0.8888888888888888,27,20,7,0.7407407407407407,0.808080808080808,GPT4,mimiciii,radiology_report,PROMPT1_ICL_entailment
125,210,11,10,1,0.9090909090909092,14,11,3,0.7857142857142857,0.842911877394636,GPT4,mimiciii,radiology_report,PROMPT1_ICL_entailment
126,211,9,9,0,1.0,13,12,1,0.9230769230769232,0.96,GPT4,mimiciii,radiology_report,PROMPT1_ICL_entailment
127,212,18,10,8,0.5555555555555556,19,19,0,1.0,0.7142857142857143,GPT4,mimiciii,radiology_report,PROMPT1_ICL_entailment
128,213,17,12,5,0.7058823529411765,22,17,5,0.7727272727272727,0.7377938517179025,GPT4,mimiciii,radiology_report,PROMPT1_ICL_entailment
129,214,28,14,14,0.5,23,17,6,0.7391304347826086,0.5964912280701754,GPT4,mimiciii,radiology_report,PROMPT1_ICL_entailment
130,215,14,9,5,0.6428571428571429,10,8,2,0.8,0.7128712871287128,GPT4,mimiciii,radiology_report,PROMPT1_ICL_entailment
131,216,17,13,4,0.7647058823529411,19,14,5,0.7368421052631579,0.7505154639175257,GPT4,mimiciii,radiology_report,PROMPT1_ICL_entailment
132,217,12,7,5,0.5833333333333334,20,14,6,0.7,0.6363636363636365,GPT4,mimiciii,radiology_report,PROMPT1_ICL_entailment
133,218,18,13,5,0.7222222222222222,15,12,3,0.8,0.759124087591241,GPT4,mimiciii,radiology_report,PROMPT1_ICL_entailment
134,219,15,10,5,0.6666666666666666,13,9,4,0.6923076923076923,0.6792452830188679,GPT4,mimiciii,radiology_report,PROMPT1_ICL_entailment
135,22,20,13,7,0.65,19,16,3,0.8421052631578947,0.7336860670194004,GPT4,mimiciii,radiology_report,PROMPT1_ICL_entailment
136,220,14,8,6,0.5714285714285714,19,17,2,0.8947368421052632,0.6974358974358975,GPT4,mimiciii,radiology_report,PROMPT1_ICL_entailment
137,221,19,13,6,0.6842105263157895,27,21,6,0.7777777777777778,0.728,GPT4,mimiciii,radiology_report,PROMPT1_ICL_entailment
138,222,18,15,3,0.8333333333333334,16,12,4,0.75,0.7894736842105262,GPT4,mimiciii,radiology_report,PROMPT1_ICL_entailment
139,223,21,13,8,0.6190476190476191,21,14,7,0.6666666666666666,0.6419753086419754,GPT4,mimiciii,radiology_report,PROMPT1_ICL_entailment
140,224,24,21,3,0.875,17,14,3,0.8235294117647058,0.8484848484848485,GPT4,mimiciii,radiology_report,PROMPT1_ICL_entailment
141,225,8,7,1,0.875,11,8,3,0.7272727272727273,0.7943262411347517,GPT4,mimiciii,radiology_report,PROMPT1_ICL_entailment
142,226,16,11,5,0.6875,18,16,2,0.8888888888888888,0.7753303964757708,GPT4,mimiciii,radiology_report,PROMPT1_ICL_entailment
143,227,18,17,1,0.9444444444444444,18,16,2,0.8888888888888888,0.9158249158249158,GPT4,mimiciii,radiology_report,PROMPT1_ICL_entailment
144,228,14,12,2,0.8571428571428571,17,15,2,0.8823529411764706,0.8695652173913043,GPT4,mimiciii,radiology_report,PROMPT1_ICL_entailment
145,229,31,29,2,0.935483870967742,49,34,15,0.6938775510204082,0.7967676767676768,GPT4,mimiciii,radiology_report,PROMPT1_ICL_entailment
146,23,18,14,4,0.7777777777777778,15,12,3,0.8,0.7887323943661971,GPT4,mimiciii,radiology_report,PROMPT1_ICL_entailment
147,230,12,9,3,0.75,17,17,0,1.0,0.8571428571428571,GPT4,mimiciii,radiology_report,PROMPT1_ICL_entailment
148,231,11,11,0,1.0,13,12,1,0.9230769230769232,0.96,GPT4,mimiciii,radiology_report,PROMPT1_ICL_entailment
149,232,19,14,5,0.7368421052631579,18,15,3,0.8333333333333334,0.782122905027933,GPT4,mimiciii,radiology_report,PROMPT1_ICL_entailment
150,233,21,17,4,0.8095238095238095,17,10,7,0.5882352941176471,0.6813627254509019,GPT4,mimiciii,radiology_report,PROMPT1_ICL_entailment
151,234,8,7,1,0.875,11,8,3,0.7272727272727273,0.7943262411347517,GPT4,mimiciii,radiology_report,PROMPT1_ICL_entailment
152,235,13,11,2,0.8461538461538461,14,11,3,0.7857142857142857,0.8148148148148148,GPT4,mimiciii,radiology_report,PROMPT1_ICL_entailment
153,236,17,14,3,0.8235294117647058,11,11,0,1.0,0.9032258064516128,GPT4,mimiciii,radiology_report,PROMPT1_ICL_entailment
154,237,17,8,9,0.4705882352941176,17,13,4,0.7647058823529411,0.5826330532212884,GPT4,mimiciii,radiology_report,PROMPT1_ICL_entailment
155,238,18,12,6,0.6666666666666666,20,15,5,0.75,0.7058823529411765,GPT4,mimiciii,radiology_report,PROMPT1_ICL_entailment
156,239,15,6,9,0.4,17,13,4,0.7647058823529411,0.5252525252525253,GPT4,mimiciii,radiology_report,PROMPT1_ICL_entailment
157,24,13,12,1,0.9230769230769232,18,14,4,0.7777777777777778,0.8442211055276381,GPT4,mimiciii,radiology_report,PROMPT1_ICL_entailment
158,240,10,8,2,0.8,13,11,2,0.8461538461538461,0.8224299065420562,GPT4,mimiciii,radiology_report,PROMPT1_ICL_entailment
159,241,15,12,3,0.8,16,13,3,0.8125,0.8062015503875969,GPT4,mimiciii,radiology_report,PROMPT1_ICL_entailment
160,242,20,17,3,0.85,18,14,4,0.7777777777777778,0.8122866894197952,GPT4,mimiciii,radiology_report,PROMPT1_ICL_entailment
161,243,14,14,0,1.0,13,10,3,0.7692307692307693,0.8695652173913044,GPT4,mimiciii,radiology_report,PROMPT1_ICL_entailment
162,244,14,10,4,0.7142857142857143,17,15,2,0.8823529411764706,0.7894736842105262,GPT4,mimiciii,radiology_report,PROMPT1_ICL_entailment
163,245,22,13,9,0.5909090909090909,28,26,2,0.9285714285714286,0.7222222222222223,GPT4,mimiciii,radiology_report,PROMPT1_ICL_entailment
164,246,9,9,0,1.0,12,9,3,0.75,0.8571428571428571,GPT4,mimiciii,radiology_report,PROMPT1_ICL_entailment
165,247,12,9,3,0.75,12,9,3,0.75,0.75,GPT4,mimiciii,radiology_report,PROMPT1_ICL_entailment
166,248,10,10,0,1.0,17,9,8,0.5294117647058824,0.6923076923076924,GPT4,mimiciii,radiology_report,PROMPT1_ICL_entailment
167,249,20,14,6,0.7,23,15,8,0.6521739130434783,0.6752411575562701,GPT4,mimiciii,radiology_report,PROMPT1_ICL_entailment
168,25,20,13,7,0.65,27,16,11,0.5925925925925926,0.6199701937406856,GPT4,mimiciii,radiology_report,PROMPT1_ICL_entailment
169,250,9,9,0,1.0,8,6,2,0.75,0.8571428571428571,GPT4,mimiciii,radiology_report,PROMPT1_ICL_entailment
170,251,30,20,10,0.6666666666666666,22,19,3,0.8636363636363636,0.7524752475247524,GPT4,mimiciii,radiology_report,PROMPT1_ICL_entailment
171,252,8,7,1,0.875,10,8,2,0.8,0.8358208955223881,GPT4,mimiciii,radiology_report,PROMPT1_ICL_entailment
172,253,25,13,12,0.52,24,22,2,0.9166666666666666,0.6635730858468678,GPT4,mimiciii,radiology_report,PROMPT1_ICL_entailment
173,254,12,10,2,0.8333333333333334,13,8,5,0.6153846153846154,0.7079646017699115,GPT4,mimiciii,radiology_report,PROMPT1_ICL_entailment
174,255,12,12,0,1.0,16,13,3,0.8125,0.896551724137931,GPT4,mimiciii,radiology_report,PROMPT1_ICL_entailment
175,256,16,10,6,0.625,19,14,5,0.7368421052631579,0.6763285024154588,GPT4,mimiciii,radiology_report,PROMPT1_ICL_entailment
176,257,16,11,5,0.6875,15,14,1,0.9333333333333332,0.7917737789203085,GPT4,mimiciii,radiology_report,PROMPT1_ICL_entailment
177,258,15,11,4,0.7333333333333333,20,14,6,0.7,0.7162790697674419,GPT4,mimiciii,radiology_report,PROMPT1_ICL_entailment
178,259,13,10,3,0.7692307692307693,17,14,3,0.8235294117647058,0.7954545454545454,GPT4,mimiciii,radiology_report,PROMPT1_ICL_entailment
179,26,21,18,3,0.8571428571428571,18,11,7,0.6111111111111112,0.7135135135135134,GPT4,mimiciii,radiology_report,PROMPT1_ICL_entailment
180,260,18,12,6,0.6666666666666666,20,13,7,0.65,0.6582278481012659,GPT4,mimiciii,radiology_report,PROMPT1_ICL_entailment
181,261,22,11,11,0.5,31,27,4,0.8709677419354839,0.6352941176470588,GPT4,mimiciii,radiology_report,PROMPT1_ICL_entailment
182,262,22,16,6,0.7272727272727273,23,20,3,0.8695652173913043,0.792079207920792,GPT4,mimiciii,radiology_report,PROMPT1_ICL_entailment
183,263,17,14,3,0.8235294117647058,27,24,3,0.8888888888888888,0.8549618320610687,GPT4,mimiciii,radiology_report,PROMPT1_ICL_entailment
184,264,18,12,6,0.6666666666666666,20,15,5,0.75,0.7058823529411765,GPT4,mimiciii,radiology_report,PROMPT1_ICL_entailment
185,265,10,8,2,0.8,9,8,1,0.8888888888888888,0.8421052631578948,GPT4,mimiciii,radiology_report,PROMPT1_ICL_entailment
186,266,14,12,2,0.8571428571428571,18,18,0,1.0,0.923076923076923,GPT4,mimiciii,radiology_report,PROMPT1_ICL_entailment
187,267,13,13,0,1.0,16,14,2,0.875,0.9333333333333332,GPT4,mimiciii,radiology_report,PROMPT1_ICL_entailment
188,268,16,11,5,0.6875,20,13,7,0.65,0.6682242990654207,GPT4,mimiciii,radiology_report,PROMPT1_ICL_entailment
189,269,15,13,2,0.8666666666666667,30,15,15,0.5,0.6341463414634146,GPT4,mimiciii,radiology_report,PROMPT1_ICL_entailment
190,27,14,13,1,0.9285714285714286,14,12,2,0.8571428571428571,0.8914285714285715,GPT4,mimiciii,radiology_report,PROMPT1_ICL_entailment
191,270,17,12,5,0.7058823529411765,17,13,4,0.7647058823529411,0.7341176470588234,GPT4,mimiciii,radiology_report,PROMPT1_ICL_entailment
192,271,18,17,1,0.9444444444444444,20,13,7,0.65,0.7700348432055749,GPT4,mimiciii,radiology_report,PROMPT1_ICL_entailment
193,272,21,16,5,0.7619047619047619,17,13,4,0.7647058823529411,0.7633027522935779,GPT4,mimiciii,radiology_report,PROMPT1_ICL_entailment
194,273,14,12,2,0.8571428571428571,12,9,3,0.75,0.7999999999999999,GPT4,mimiciii,radiology_report,PROMPT1_ICL_entailment
195,274,15,5,10,0.3333333333333333,20,15,5,0.75,0.4615384615384615,GPT4,mimiciii,radiology_report,PROMPT1_ICL_entailment
196,275,14,14,0,1.0,12,10,2,0.8333333333333334,0.9090909090909092,GPT4,mimiciii,radiology_report,PROMPT1_ICL_entailment
197,276,13,13,0,1.0,29,18,11,0.6206896551724138,0.7659574468085107,GPT4,mimiciii,radiology_report,PROMPT1_ICL_entailment
198,277,22,17,5,0.7727272727272727,25,20,5,0.8,0.7861271676300577,GPT4,mimiciii,radiology_report,PROMPT1_ICL_entailment
199,278,13,10,3,0.7692307692307693,16,13,3,0.8125,0.790273556231003,GPT4,mimiciii,radiology_report,PROMPT1_ICL_entailment
200,279,12,11,1,0.9166666666666666,10,7,3,0.7,0.7938144329896907,GPT4,mimiciii,radiology_report,PROMPT1_ICL_entailment
201,28,20,10,10,0.5,30,19,11,0.6333333333333333,0.5588235294117647,GPT4,mimiciii,radiology_report,PROMPT1_ICL_entailment
202,280,12,8,4,0.6666666666666666,12,10,2,0.8333333333333334,0.7407407407407408,GPT4,mimiciii,radiology_report,PROMPT1_ICL_entailment
203,281,20,15,5,0.75,24,16,8,0.6666666666666666,0.7058823529411765,GPT4,mimiciii,radiology_report,PROMPT1_ICL_entailment
204,282,15,13,2,0.8666666666666667,12,11,1,0.9166666666666666,0.8909657320872274,GPT4,mimiciii,radiology_report,PROMPT1_ICL_entailment
205,283,20,15,5,0.75,28,21,7,0.75,0.75,GPT4,mimiciii,radiology_report,PROMPT1_ICL_entailment
206,284,13,9,4,0.6923076923076923,14,10,4,0.7142857142857143,0.7031250000000001,GPT4,mimiciii,radiology_report,PROMPT1_ICL_entailment
207,285,15,12,3,0.8,18,17,1,0.9444444444444444,0.8662420382165604,GPT4,mimiciii,radiology_report,PROMPT1_ICL_entailment
208,286,7,7,0,1.0,6,5,1,0.8333333333333334,0.9090909090909092,GPT4,mimiciii,radiology_report,PROMPT1_ICL_entailment
209,287,17,15,2,0.8823529411764706,18,15,3,0.8333333333333334,0.8571428571428571,GPT4,mimiciii,radiology_report,PROMPT1_ICL_entailment
210,288,26,20,6,0.7692307692307693,32,28,4,0.875,0.8187134502923977,GPT4,mimiciii,radiology_report,PROMPT1_ICL_entailment
211,289,19,15,4,0.7894736842105263,20,15,5,0.75,0.7692307692307692,GPT4,mimiciii,radiology_report,PROMPT1_ICL_entailment
212,29,8,8,0,1.0,8,5,3,0.625,0.7692307692307693,GPT4,mimiciii,radiology_report,PROMPT1_ICL_entailment
213,290,11,11,0,1.0,11,8,3,0.7272727272727273,0.8421052631578948,GPT4,mimiciii,radiology_report,PROMPT1_ICL_entailment
214,291,24,12,12,0.5,24,15,9,0.625,0.5555555555555556,GPT4,mimiciii,radiology_report,PROMPT1_ICL_entailment
215,292,22,17,5,0.7727272727272727,21,17,4,0.8095238095238095,0.7906976744186046,GPT4,mimiciii,radiology_report,PROMPT1_ICL_entailment
216,293,15,10,5,0.6666666666666666,18,14,4,0.7777777777777778,0.717948717948718,GPT4,mimiciii,radiology_report,PROMPT1_ICL_entailment
217,294,22,16,6,0.7272727272727273,22,16,6,0.7272727272727273,0.7272727272727273,GPT4,mimiciii,radiology_report,PROMPT1_ICL_entailment
218,295,16,12,4,0.75,39,16,23,0.4102564102564102,0.5303867403314918,GPT4,mimiciii,radiology_report,PROMPT1_ICL_entailment
219,296,19,12,7,0.631578947368421,17,14,3,0.8235294117647058,0.7148936170212765,GPT4,mimiciii,radiology_report,PROMPT1_ICL_entailment
220,297,19,14,5,0.7368421052631579,24,20,4,0.8333333333333334,0.782122905027933,GPT4,mimiciii,radiology_report,PROMPT1_ICL_entailment
221,298,16,15,1,0.9375,20,14,6,0.7,0.8015267175572519,GPT4,mimiciii,radiology_report,PROMPT1_ICL_entailment
222,299,19,16,3,0.8421052631578947,32,21,11,0.65625,0.7376509330406147,GPT4,mimiciii,radiology_report,PROMPT1_ICL_entailment
223,3,17,10,7,0.5882352941176471,20,16,4,0.8,0.6779661016949153,GPT4,mimiciii,radiology_report,PROMPT1_ICL_entailment
224,30,14,10,4,0.7142857142857143,25,16,9,0.64,0.6751054852320676,GPT4,mimiciii,radiology_report,PROMPT1_ICL_entailment
225,300,15,13,2,0.8666666666666667,13,10,3,0.7692307692307693,0.8150470219435738,GPT4,mimiciii,radiology_report,PROMPT1_ICL_entailment
226,301,13,13,0,1.0,19,11,8,0.5789473684210527,0.7333333333333334,GPT4,mimiciii,radiology_report,PROMPT1_ICL_entailment
227,302,19,16,3,0.8421052631578947,15,13,2,0.8666666666666667,0.8542094455852155,GPT4,mimiciii,radiology_report,PROMPT1_ICL_entailment
228,303,26,13,13,0.5,24,18,6,0.75,0.6,GPT4,mimiciii,radiology_report,PROMPT1_ICL_entailment
229,304,14,14,0,1.0,21,16,5,0.7619047619047619,0.8648648648648648,GPT4,mimiciii,radiology_report,PROMPT1_ICL_entailment
230,305,18,10,8,0.5555555555555556,24,17,7,0.7083333333333334,0.6227106227106228,GPT4,mimiciii,radiology_report,PROMPT1_ICL_entailment
231,306,14,9,5,0.6428571428571429,14,10,4,0.7142857142857143,0.6766917293233083,GPT4,mimiciii,radiology_report,PROMPT1_ICL_entailment
232,307,17,14,3,0.8235294117647058,17,12,5,0.7058823529411765,0.7601809954751132,GPT4,mimiciii,radiology_report,PROMPT1_ICL_entailment
233,308,17,11,6,0.6470588235294118,15,11,4,0.7333333333333333,0.6875,GPT4,mimiciii,radiology_report,PROMPT1_ICL_entailment
234,309,21,16,5,0.7619047619047619,29,18,11,0.6206896551724138,0.6840855106888362,GPT4,mimiciii,radiology_report,PROMPT1_ICL_entailment
235,31,12,9,3,0.75,19,14,5,0.7368421052631579,0.743362831858407,GPT4,mimiciii,radiology_report,PROMPT1_ICL_entailment
236,310,19,15,4,0.7894736842105263,24,19,5,0.7916666666666666,0.7905686546463245,GPT4,mimiciii,radiology_report,PROMPT1_ICL_entailment
237,311,10,10,0,1.0,15,13,2,0.8666666666666667,0.9285714285714286,GPT4,mimiciii,radiology_report,PROMPT1_ICL_entailment
238,312,15,13,2,0.8666666666666667,18,15,3,0.8333333333333334,0.8496732026143791,GPT4,mimiciii,radiology_report,PROMPT1_ICL_entailment
239,313,15,12,3,0.8,17,13,4,0.7647058823529411,0.7819548872180452,GPT4,mimiciii,radiology_report,PROMPT1_ICL_entailment
240,314,20,12,8,0.6,15,10,5,0.6666666666666666,0.631578947368421,GPT4,mimiciii,radiology_report,PROMPT1_ICL_entailment
241,315,23,15,8,0.6521739130434783,25,16,9,0.64,0.6460296096904442,GPT4,mimiciii,radiology_report,PROMPT1_ICL_entailment
242,316,8,5,3,0.625,10,9,1,0.9,0.7377049180327869,GPT4,mimiciii,radiology_report,PROMPT1_ICL_entailment
243,317,22,11,11,0.5,26,21,5,0.8076923076923077,0.6176470588235294,GPT4,mimiciii,radiology_report,PROMPT1_ICL_entailment
244,318,17,15,2,0.8823529411764706,21,16,5,0.7619047619047619,0.817717206132879,GPT4,mimiciii,radiology_report,PROMPT1_ICL_entailment
245,319,15,14,1,0.9333333333333332,12,10,2,0.8333333333333334,0.8805031446540881,GPT4,mimiciii,radiology_report,PROMPT1_ICL_entailment
246,32,14,12,2,0.8571428571428571,15,9,6,0.6,0.7058823529411764,GPT4,mimiciii,radiology_report,PROMPT1_ICL_entailment
247,320,11,11,0,1.0,11,8,3,0.7272727272727273,0.8421052631578948,GPT4,mimiciii,radiology_report,PROMPT1_ICL_entailment
248,321,16,11,5,0.6875,21,16,5,0.7619047619047619,0.7227926078028747,GPT4,mimiciii,radiology_report,PROMPT1_ICL_entailment
249,322,8,8,0,1.0,8,6,2,0.75,0.8571428571428571,GPT4,mimiciii,radiology_report,PROMPT1_ICL_entailment
250,323,18,17,1,0.9444444444444444,29,18,11,0.6206896551724138,0.7490820073439411,GPT4,mimiciii,radiology_report,PROMPT1_ICL_entailment
251,324,21,13,8,0.6190476190476191,18,14,4,0.7777777777777778,0.6893939393939394,GPT4,mimiciii,radiology_report,PROMPT1_ICL_entailment
252,325,18,11,7,0.6111111111111112,22,18,4,0.8181818181818182,0.6996466431095407,GPT4,mimiciii,radiology_report,PROMPT1_ICL_entailment
253,326,14,9,5,0.6428571428571429,23,18,5,0.782608695652174,0.7058823529411765,GPT4,mimiciii,radiology_report,PROMPT1_ICL_entailment
254,327,8,8,0,1.0,9,7,2,0.7777777777777778,0.8750000000000001,GPT4,mimiciii,radiology_report,PROMPT1_ICL_entailment
255,328,17,13,4,0.7647058823529411,17,13,4,0.7647058823529411,0.7647058823529412,GPT4,mimiciii,radiology_report,PROMPT1_ICL_entailment
256,329,11,11,0,1.0,28,17,11,0.6071428571428571,0.7555555555555554,GPT4,mimiciii,radiology_report,PROMPT1_ICL_entailment
257,33,8,8,0,1.0,9,9,0,1.0,1.0,GPT4,mimiciii,radiology_report,PROMPT1_ICL_entailment
258,330,15,12,3,0.8,11,9,2,0.8181818181818182,0.8089887640449439,GPT4,mimiciii,radiology_report,PROMPT1_ICL_entailment
259,331,11,9,2,0.8181818181818182,15,12,3,0.8,0.8089887640449439,GPT4,mimiciii,radiology_report,PROMPT1_ICL_entailment
260,332,18,12,6,0.6666666666666666,20,17,3,0.85,0.7472527472527473,GPT4,mimiciii,radiology_report,PROMPT1_ICL_entailment
261,333,10,9,1,0.9,13,11,2,0.8461538461538461,0.8722466960352422,GPT4,mimiciii,radiology_report,PROMPT1_ICL_entailment
262,334,26,23,3,0.8846153846153846,20,18,2,0.9,0.8922413793103449,GPT4,mimiciii,radiology_report,PROMPT1_ICL_entailment
263,335,18,16,2,0.8888888888888888,17,15,2,0.8823529411764706,0.8856088560885608,GPT4,mimiciii,radiology_report,PROMPT1_ICL_entailment
264,336,21,12,9,0.5714285714285714,16,12,4,0.75,0.6486486486486486,GPT4,mimiciii,radiology_report,PROMPT1_ICL_entailment
265,337,20,19,1,0.95,16,13,3,0.8125,0.875886524822695,GPT4,mimiciii,radiology_report,PROMPT1_ICL_entailment
266,338,13,12,1,0.9230769230769232,13,9,4,0.6923076923076923,0.7912087912087913,GPT4,mimiciii,radiology_report,PROMPT1_ICL_entailment
267,339,25,13,12,0.52,28,22,6,0.7857142857142857,0.62582056892779,GPT4,mimiciii,radiology_report,PROMPT1_ICL_entailment
268,34,12,8,4,0.6666666666666666,14,13,1,0.9285714285714286,0.7761194029850746,GPT4,mimiciii,radiology_report,PROMPT1_ICL_entailment
269,340,22,12,10,0.5454545454545454,15,12,3,0.8,0.6486486486486486,GPT4,mimiciii,radiology_report,PROMPT1_ICL_entailment
270,341,7,7,0,1.0,6,5,1,0.8333333333333334,0.9090909090909092,GPT4,mimiciii,radiology_report,PROMPT1_ICL_entailment
271,342,15,14,1,0.9333333333333332,15,12,3,0.8,0.8615384615384616,GPT4,mimiciii,radiology_report,PROMPT1_ICL_entailment
272,343,17,15,2,0.8823529411764706,26,20,6,0.7692307692307693,0.8219178082191781,GPT4,mimiciii,radiology_report,PROMPT1_ICL_entailment
273,344,15,7,8,0.4666666666666667,19,14,5,0.7368421052631579,0.5714285714285714,GPT4,mimiciii,radiology_report,PROMPT1_ICL_entailment
274,345,20,17,3,0.85,22,19,3,0.8636363636363636,0.856763925729443,GPT4,mimiciii,radiology_report,PROMPT1_ICL_entailment
275,346,14,12,2,0.8571428571428571,15,9,6,0.6,0.7058823529411764,GPT4,mimiciii,radiology_report,PROMPT1_ICL_entailment
276,347,19,14,5,0.7368421052631579,15,13,2,0.8666666666666667,0.7964989059080962,GPT4,mimiciii,radiology_report,PROMPT1_ICL_entailment
277,348,13,9,4,0.6923076923076923,12,10,2,0.8333333333333334,0.7563025210084034,GPT4,mimiciii,radiology_report,PROMPT1_ICL_entailment
278,349,15,12,3,0.8,16,13,3,0.8125,0.8062015503875969,GPT4,mimiciii,radiology_report,PROMPT1_ICL_entailment
279,35,16,6,10,0.375,21,16,5,0.7619047619047619,0.5026178010471204,GPT4,mimiciii,radiology_report,PROMPT1_ICL_entailment
280,350,17,13,4,0.7647058823529411,21,16,5,0.7619047619047619,0.7633027522935779,GPT4,mimiciii,radiology_report,PROMPT1_ICL_entailment
281,351,22,13,9,0.5909090909090909,21,18,3,0.8571428571428571,0.6995515695067264,GPT4,mimiciii,radiology_report,PROMPT1_ICL_entailment
282,352,17,15,2,0.8823529411764706,22,14,8,0.6363636363636364,0.73943661971831,GPT4,mimiciii,radiology_report,PROMPT1_ICL_entailment
283,353,16,9,7,0.5625,26,17,9,0.6538461538461539,0.6047430830039526,GPT4,mimiciii,radiology_report,PROMPT1_ICL_entailment
284,354,22,14,8,0.6363636363636364,26,23,3,0.8846153846153846,0.7402298850574713,GPT4,mimiciii,radiology_report,PROMPT1_ICL_entailment
285,355,18,17,1,0.9444444444444444,18,17,1,0.9444444444444444,0.9444444444444444,GPT4,mimiciii,radiology_report,PROMPT1_ICL_entailment
286,356,18,13,5,0.7222222222222222,22,16,6,0.7272727272727273,0.7247386759581883,GPT4,mimiciii,radiology_report,PROMPT1_ICL_entailment
287,357,10,4,6,0.4,15,10,5,0.6666666666666666,0.5,GPT4,mimiciii,radiology_report,PROMPT1_ICL_entailment
288,358,18,12,6,0.6666666666666666,12,9,3,0.75,0.7058823529411765,GPT4,mimiciii,radiology_report,PROMPT1_ICL_entailment
289,359,14,13,1,0.9285714285714286,18,15,3,0.8333333333333334,0.8783783783783784,GPT4,mimiciii,radiology_report,PROMPT1_ICL_entailment
290,36,21,13,8,0.6190476190476191,22,20,2,0.9090909090909092,0.7365439093484419,GPT4,mimiciii,radiology_report,PROMPT1_ICL_entailment
291,360,19,12,7,0.631578947368421,15,11,4,0.7333333333333333,0.6786632390745502,GPT4,mimiciii,radiology_report,PROMPT1_ICL_entailment
292,361,19,14,5,0.7368421052631579,23,20,3,0.8695652173913043,0.7977207977207976,GPT4,mimiciii,radiology_report,PROMPT1_ICL_entailment
293,362,21,13,8,0.6190476190476191,24,18,6,0.75,0.6782608695652174,GPT4,mimiciii,radiology_report,PROMPT1_ICL_entailment
294,363,20,14,6,0.7,22,16,6,0.7272727272727273,0.7133757961783439,GPT4,mimiciii,radiology_report,PROMPT1_ICL_entailment
295,364,8,8,0,1.0,11,10,1,0.9090909090909092,0.9523809523809524,GPT4,mimiciii,radiology_report,PROMPT1_ICL_entailment
296,365,24,17,7,0.7083333333333334,29,19,10,0.6551724137931034,0.6807165437302425,GPT4,mimiciii,radiology_report,PROMPT1_ICL_entailment
297,366,13,12,1,0.9230769230769232,13,9,4,0.6923076923076923,0.7912087912087913,GPT4,mimiciii,radiology_report,PROMPT1_ICL_entailment
298,367,16,8,8,0.5,16,11,5,0.6875,0.5789473684210527,GPT4,mimiciii,radiology_report,PROMPT1_ICL_entailment
299,368,17,10,7,0.5882352941176471,20,12,8,0.6,0.5940594059405941,GPT4,mimiciii,radiology_report,PROMPT1_ICL_entailment
300,369,19,17,2,0.8947368421052632,20,17,3,0.85,0.8717948717948718,GPT4,mimiciii,radiology_report,PROMPT1_ICL_entailment
301,37,14,12,2,0.8571428571428571,21,16,5,0.7619047619047619,0.8067226890756302,GPT4,mimiciii,radiology_report,PROMPT1_ICL_entailment
302,370,18,12,6,0.6666666666666666,19,15,4,0.7894736842105263,0.7228915662650601,GPT4,mimiciii,radiology_report,PROMPT1_ICL_entailment
303,371,17,13,4,0.7647058823529411,17,14,3,0.8235294117647058,0.793028322440087,GPT4,mimiciii,radiology_report,PROMPT1_ICL_entailment
304,372,21,18,3,0.8571428571428571,31,24,7,0.7741935483870968,0.8135593220338982,GPT4,mimiciii,radiology_report,PROMPT1_ICL_entailment
305,373,19,15,4,0.7894736842105263,23,15,8,0.6521739130434783,0.7142857142857143,GPT4,mimiciii,radiology_report,PROMPT1_ICL_entailment
306,374,11,11,0,1.0,11,7,4,0.6363636363636364,0.7777777777777778,GPT4,mimiciii,radiology_report,PROMPT1_ICL_entailment
307,375,14,11,3,0.7857142857142857,16,11,5,0.6875,0.7333333333333334,GPT4,mimiciii,radiology_report,PROMPT1_ICL_entailment
308,376,24,13,11,0.5416666666666666,18,14,4,0.7777777777777778,0.6385964912280702,GPT4,mimiciii,radiology_report,PROMPT1_ICL_entailment
309,377,14,13,1,0.9285714285714286,10,8,2,0.8,0.859504132231405,GPT4,mimiciii,radiology_report,PROMPT1_ICL_entailment
310,378,22,12,10,0.5454545454545454,24,16,8,0.6666666666666666,0.6,GPT4,mimiciii,radiology_report,PROMPT1_ICL_entailment
311,379,19,13,6,0.6842105263157895,18,13,5,0.7222222222222222,0.7027027027027027,GPT4,mimiciii,radiology_report,PROMPT1_ICL_entailment
312,38,18,15,3,0.8333333333333334,19,13,6,0.6842105263157895,0.7514450867052023,GPT4,mimiciii,radiology_report,PROMPT1_ICL_entailment
313,380,12,12,0,1.0,8,7,1,0.875,0.9333333333333332,GPT4,mimiciii,radiology_report,PROMPT1_ICL_entailment
314,381,15,10,5,0.6666666666666666,14,11,3,0.7857142857142857,0.721311475409836,GPT4,mimiciii,radiology_report,PROMPT1_ICL_entailment
315,382,12,11,1,0.9166666666666666,16,8,8,0.5,0.6470588235294118,GPT4,mimiciii,radiology_report,PROMPT1_ICL_entailment
316,383,16,6,10,0.375,17,14,3,0.8235294117647058,0.5153374233128835,GPT4,mimiciii,radiology_report,PROMPT1_ICL_entailment
317,384,12,11,1,0.9166666666666666,13,12,1,0.9230769230769232,0.9198606271777002,GPT4,mimiciii,radiology_report,PROMPT1_ICL_entailment
318,385,23,14,9,0.6086956521739131,27,19,8,0.7037037037037037,0.652760736196319,GPT4,mimiciii,radiology_report,PROMPT1_ICL_entailment
319,386,16,14,2,0.875,18,15,3,0.8333333333333334,0.8536585365853658,GPT4,mimiciii,radiology_report,PROMPT1_ICL_entailment
320,387,17,16,1,0.9411764705882352,19,14,5,0.7368421052631579,0.8265682656826568,GPT4,mimiciii,radiology_report,PROMPT1_ICL_entailment
321,388,28,21,7,0.75,33,28,5,0.8484848484848485,0.7962085308056871,GPT4,mimiciii,radiology_report,PROMPT1_ICL_entailment
322,389,15,7,8,0.4666666666666667,12,9,3,0.75,0.5753424657534245,GPT4,mimiciii,radiology_report,PROMPT1_ICL_entailment
323,39,10,9,1,0.9,10,7,3,0.7,0.7875,GPT4,mimiciii,radiology_report,PROMPT1_ICL_entailment
324,390,12,11,1,0.9166666666666666,14,14,0,1.0,0.9565217391304348,GPT4,mimiciii,radiology_report,PROMPT1_ICL_entailment
325,391,11,11,0,1.0,13,8,5,0.6153846153846154,0.761904761904762,GPT4,mimiciii,radiology_report,PROMPT1_ICL_entailment
326,392,13,11,2,0.8461538461538461,15,8,7,0.5333333333333333,0.654275092936803,GPT4,mimiciii,radiology_report,PROMPT1_ICL_entailment
327,393,23,17,6,0.7391304347826086,19,14,5,0.7368421052631579,0.7379844961240309,GPT4,mimiciii,radiology_report,PROMPT1_ICL_entailment
328,394,14,14,0,1.0,18,17,1,0.9444444444444444,0.9714285714285714,GPT4,mimiciii,radiology_report,PROMPT1_ICL_entailment
329,395,14,11,3,0.7857142857142857,16,10,6,0.625,0.6962025316455697,GPT4,mimiciii,radiology_report,PROMPT1_ICL_entailment
330,396,17,15,2,0.8823529411764706,19,13,6,0.6842105263157895,0.7707509881422925,GPT4,mimiciii,radiology_report,PROMPT1_ICL_entailment
331,397,17,13,4,0.7647058823529411,18,13,5,0.7222222222222222,0.7428571428571428,GPT4,mimiciii,radiology_report,PROMPT1_ICL_entailment
332,398,25,14,11,0.56,21,16,5,0.7619047619047619,0.6455331412103746,GPT4,mimiciii,radiology_report,PROMPT1_ICL_entailment
333,399,17,13,4,0.7647058823529411,19,16,3,0.8421052631578947,0.8015414258188823,GPT4,mimiciii,radiology_report,PROMPT1_ICL_entailment
334,4,15,13,2,0.8666666666666667,16,15,1,0.9375,0.9006928406466512,GPT4,mimiciii,radiology_report,PROMPT1_ICL_entailment
335,40,17,14,3,0.8235294117647058,17,14,3,0.8235294117647058,0.8235294117647058,GPT4,mimiciii,radiology_report,PROMPT1_ICL_entailment
336,400,11,11,0,1.0,13,6,7,0.4615384615384615,0.631578947368421,GPT4,mimiciii,radiology_report,PROMPT1_ICL_entailment
337,401,9,8,1,0.8888888888888888,9,9,0,1.0,0.9411764705882352,GPT4,mimiciii,radiology_report,PROMPT1_ICL_entailment
338,402,22,10,12,0.4545454545454545,20,15,5,0.75,0.5660377358490566,GPT4,mimiciii,radiology_report,PROMPT1_ICL_entailment
339,403,19,16,3,0.8421052631578947,18,15,3,0.8333333333333334,0.8376963350785339,GPT4,mimiciii,radiology_report,PROMPT1_ICL_entailment
340,404,18,13,5,0.7222222222222222,19,15,4,0.7894736842105263,0.7543520309477757,GPT4,mimiciii,radiology_report,PROMPT1_ICL_entailment
341,405,16,10,6,0.625,14,10,4,0.7142857142857143,0.6666666666666666,GPT4,mimiciii,radiology_report,PROMPT1_ICL_entailment
342,406,24,14,10,0.5833333333333334,25,21,4,0.84,0.6885245901639344,GPT4,mimiciii,radiology_report,PROMPT1_ICL_entailment
343,407,26,19,7,0.7307692307692307,20,15,5,0.75,0.7402597402597402,GPT4,mimiciii,radiology_report,PROMPT1_ICL_entailment
344,408,16,13,3,0.8125,20,15,5,0.75,0.78,GPT4,mimiciii,radiology_report,PROMPT1_ICL_entailment
345,409,24,20,4,0.8333333333333334,21,19,2,0.9047619047619048,0.867579908675799,GPT4,mimiciii,radiology_report,PROMPT1_ICL_entailment
346,41,21,14,7,0.6666666666666666,26,14,12,0.5384615384615384,0.5957446808510638,GPT4,mimiciii,radiology_report,PROMPT1_ICL_entailment
347,410,20,17,3,0.85,20,15,5,0.75,0.7968749999999999,GPT4,mimiciii,radiology_report,PROMPT1_ICL_entailment
348,411,6,6,0,1.0,6,5,1,0.8333333333333334,0.9090909090909092,GPT4,mimiciii,radiology_report,PROMPT1_ICL_entailment
349,412,15,7,8,0.4666666666666667,26,20,6,0.7692307692307693,0.5809128630705394,GPT4,mimiciii,radiology_report,PROMPT1_ICL_entailment
350,413,14,11,3,0.7857142857142857,14,11,3,0.7857142857142857,0.7857142857142857,GPT4,mimiciii,radiology_report,PROMPT1_ICL_entailment
351,414,19,13,6,0.6842105263157895,28,18,10,0.6428571428571429,0.6628895184135978,GPT4,mimiciii,radiology_report,PROMPT1_ICL_entailment
352,415,19,14,5,0.7368421052631579,20,18,2,0.9,0.810289389067524,GPT4,mimiciii,radiology_report,PROMPT1_ICL_entailment
353,416,12,11,1,0.9166666666666666,19,11,8,0.5789473684210527,0.7096774193548387,GPT4,mimiciii,radiology_report,PROMPT1_ICL_entailment
354,417,23,15,8,0.6521739130434783,20,16,4,0.8,0.718562874251497,GPT4,mimiciii,radiology_report,PROMPT1_ICL_entailment
355,418,13,12,1,0.9230769230769232,14,9,5,0.6428571428571429,0.7578947368421053,GPT4,mimiciii,radiology_report,PROMPT1_ICL_entailment
356,419,20,8,12,0.4,16,13,3,0.8125,0.5360824742268042,GPT4,mimiciii,radiology_report,PROMPT1_ICL_entailment
357,42,14,12,2,0.8571428571428571,14,10,4,0.7142857142857143,0.7792207792207793,GPT4,mimiciii,radiology_report,PROMPT1_ICL_entailment
358,420,13,6,7,0.4615384615384615,15,11,4,0.7333333333333333,0.5665236051502146,GPT4,mimiciii,radiology_report,PROMPT1_ICL_entailment
359,421,26,14,12,0.5384615384615384,23,18,5,0.782608695652174,0.6379746835443038,GPT4,mimiciii,radiology_report,PROMPT1_ICL_entailment
360,422,15,9,6,0.6,20,17,3,0.85,0.703448275862069,GPT4,mimiciii,radiology_report,PROMPT1_ICL_entailment
361,423,13,13,0,1.0,12,10,2,0.8333333333333334,0.9090909090909092,GPT4,mimiciii,radiology_report,PROMPT1_ICL_entailment
362,424,10,7,3,0.7,9,7,2,0.7777777777777778,0.7368421052631577,GPT4,mimiciii,radiology_report,PROMPT1_ICL_entailment
363,425,19,14,5,0.7368421052631579,19,15,4,0.7894736842105263,0.7622504537205083,GPT4,mimiciii,radiology_report,PROMPT1_ICL_entailment
364,426,17,12,5,0.7058823529411765,16,13,3,0.8125,0.7554479418886199,GPT4,mimiciii,radiology_report,PROMPT1_ICL_entailment
365,427,13,10,3,0.7692307692307693,15,8,7,0.5333333333333333,0.6299212598425197,GPT4,mimiciii,radiology_report,PROMPT1_ICL_entailment
366,428,11,9,2,0.8181818181818182,15,13,2,0.8666666666666667,0.8417266187050358,GPT4,mimiciii,radiology_report,PROMPT1_ICL_entailment
367,429,16,15,1,0.9375,13,10,3,0.7692307692307693,0.8450704225352113,GPT4,mimiciii,radiology_report,PROMPT1_ICL_entailment
368,43,12,11,1,0.9166666666666666,7,6,1,0.8571428571428571,0.8859060402684563,GPT4,mimiciii,radiology_report,PROMPT1_ICL_entailment
369,430,7,7,0,1.0,7,6,1,0.8571428571428571,0.923076923076923,GPT4,mimiciii,radiology_report,PROMPT1_ICL_entailment
370,431,12,3,9,0.25,18,15,3,0.8333333333333334,0.3846153846153846,GPT4,mimiciii,radiology_report,PROMPT1_ICL_entailment
371,432,22,17,5,0.7727272727272727,13,8,5,0.6153846153846154,0.6851385390428212,GPT4,mimiciii,radiology_report,PROMPT1_ICL_entailment
372,433,16,14,2,0.875,18,12,6,0.6666666666666666,0.7567567567567567,GPT4,mimiciii,radiology_report,PROMPT1_ICL_entailment
373,434,24,17,7,0.7083333333333334,27,17,10,0.6296296296296297,0.6666666666666667,GPT4,mimiciii,radiology_report,PROMPT1_ICL_entailment
374,435,14,10,4,0.7142857142857143,13,13,0,1.0,0.8333333333333333,GPT4,mimiciii,radiology_report,PROMPT1_ICL_entailment
375,436,20,12,8,0.6,25,24,1,0.96,0.7384615384615384,GPT4,mimiciii,radiology_report,PROMPT1_ICL_entailment
376,437,7,7,0,1.0,7,5,2,0.7142857142857143,0.8333333333333333,GPT4,mimiciii,radiology_report,PROMPT1_ICL_entailment
377,438,17,15,2,0.8823529411764706,19,16,3,0.8421052631578947,0.8617594254937163,GPT4,mimiciii,radiology_report,PROMPT1_ICL_entailment
378,439,22,12,10,0.5454545454545454,22,16,6,0.7272727272727273,0.6233766233766234,GPT4,mimiciii,radiology_report,PROMPT1_ICL_entailment
379,44,11,11,0,1.0,16,12,4,0.75,0.8571428571428571,GPT4,mimiciii,radiology_report,PROMPT1_ICL_entailment
380,440,18,14,4,0.7777777777777778,19,13,6,0.6842105263157895,0.728,GPT4,mimiciii,radiology_report,PROMPT1_ICL_entailment
381,441,18,13,5,0.7222222222222222,17,15,2,0.8823529411764706,0.7942973523421588,GPT4,mimiciii,radiology_report,PROMPT1_ICL_entailment
382,442,11,11,0,1.0,12,10,2,0.8333333333333334,0.9090909090909092,GPT4,mimiciii,radiology_report,PROMPT1_ICL_entailment
383,443,17,12,5,0.7058823529411765,21,12,9,0.5714285714285714,0.6315789473684211,GPT4,mimiciii,radiology_report,PROMPT1_ICL_entailment
384,444,10,9,1,0.9,8,6,2,0.75,0.8181818181818182,GPT4,mimiciii,radiology_report,PROMPT1_ICL_entailment
385,445,19,14,5,0.7368421052631579,22,17,5,0.7727272727272727,0.7543581616481776,GPT4,mimiciii,radiology_report,PROMPT1_ICL_entailment
386,446,22,17,5,0.7727272727272727,22,17,5,0.7727272727272727,0.7727272727272727,GPT4,mimiciii,radiology_report,PROMPT1_ICL_entailment
387,447,15,12,3,0.8,14,12,2,0.8571428571428571,0.8275862068965518,GPT4,mimiciii,radiology_report,PROMPT1_ICL_entailment
388,448,29,22,7,0.7586206896551724,36,25,11,0.6944444444444444,0.7251153592617008,GPT4,mimiciii,radiology_report,PROMPT1_ICL_entailment
389,449,13,9,4,0.6923076923076923,9,9,0,1.0,0.8181818181818181,GPT4,mimiciii,radiology_report,PROMPT1_ICL_entailment
390,45,16,8,8,0.5,20,14,6,0.7,0.5833333333333334,GPT4,mimiciii,radiology_report,PROMPT1_ICL_entailment
391,450,24,18,6,0.75,21,19,2,0.9047619047619048,0.8201438848920864,GPT4,mimiciii,radiology_report,PROMPT1_ICL_entailment
392,451,10,9,1,0.9,10,8,2,0.8,0.8470588235294118,GPT4,mimiciii,radiology_report,PROMPT1_ICL_entailment
393,452,18,16,2,0.8888888888888888,16,13,3,0.8125,0.8489795918367347,GPT4,mimiciii,radiology_report,PROMPT1_ICL_entailment
394,453,12,10,2,0.8333333333333334,14,9,5,0.6428571428571429,0.7258064516129034,GPT4,mimiciii,radiology_report,PROMPT1_ICL_entailment
395,454,10,10,0,1.0,10,5,5,0.5,0.6666666666666666,GPT4,mimiciii,radiology_report,PROMPT1_ICL_entailment
396,455,15,13,2,0.8666666666666667,16,12,4,0.75,0.8041237113402062,GPT4,mimiciii,radiology_report,PROMPT1_ICL_entailment
397,456,15,10,5,0.6666666666666666,21,18,3,0.8571428571428571,0.75,GPT4,mimiciii,radiology_report,PROMPT1_ICL_entailment
398,457,13,13,0,1.0,12,10,2,0.8333333333333334,0.9090909090909092,GPT4,mimiciii,radiology_report,PROMPT1_ICL_entailment
399,458,18,16,2,0.8888888888888888,16,12,4,0.75,0.8135593220338982,GPT4,mimiciii,radiology_report,PROMPT1_ICL_entailment
400,459,13,11,2,0.8461538461538461,13,8,5,0.6153846153846154,0.7125506072874493,GPT4,mimiciii,radiology_report,PROMPT1_ICL_entailment
401,46,14,13,1,0.9285714285714286,26,16,10,0.6153846153846154,0.7402135231316727,GPT4,mimiciii,radiology_report,PROMPT1_ICL_entailment
402,460,20,17,3,0.85,20,16,4,0.8,0.8242424242424243,GPT4,mimiciii,radiology_report,PROMPT1_ICL_entailment
403,461,21,11,10,0.5238095238095238,22,14,8,0.6363636363636364,0.5746268656716419,GPT4,mimiciii,radiology_report,PROMPT1_ICL_entailment
404,462,21,15,6,0.7142857142857143,20,16,4,0.8,0.7547169811320756,GPT4,mimiciii,radiology_report,PROMPT1_ICL_entailment
405,463,10,9,1,0.9,12,9,3,0.75,0.8181818181818182,GPT4,mimiciii,radiology_report,PROMPT1_ICL_entailment
406,464,22,12,10,0.5454545454545454,25,16,9,0.64,0.5889570552147239,GPT4,mimiciii,radiology_report,PROMPT1_ICL_entailment
407,465,26,20,6,0.7692307692307693,33,28,5,0.8484848484848485,0.8069164265129684,GPT4,mimiciii,radiology_report,PROMPT1_ICL_entailment
408,466,15,7,8,0.4666666666666667,22,17,5,0.7727272727272727,0.5819070904645477,GPT4,mimiciii,radiology_report,PROMPT1_ICL_entailment
409,467,10,10,0,1.0,14,12,2,0.8571428571428571,0.923076923076923,GPT4,mimiciii,radiology_report,PROMPT1_ICL_entailment
410,468,20,18,2,0.9,18,13,5,0.7222222222222222,0.8013698630136986,GPT4,mimiciii,radiology_report,PROMPT1_ICL_entailment
411,469,19,14,5,0.7368421052631579,25,18,7,0.72,0.7283236994219653,GPT4,mimiciii,radiology_report,PROMPT1_ICL_entailment
412,47,14,13,1,0.9285714285714286,15,11,4,0.7333333333333333,0.8194842406876792,GPT4,mimiciii,radiology_report,PROMPT1_ICL_entailment
413,470,10,6,4,0.6,15,12,3,0.8,0.6857142857142857,GPT4,mimiciii,radiology_report,PROMPT1_ICL_entailment
414,471,20,12,8,0.6,18,16,2,0.8888888888888888,0.7164179104477612,GPT4,mimiciii,radiology_report,PROMPT1_ICL_entailment
415,472,13,12,1,0.9230769230769232,16,10,6,0.625,0.7453416149068324,GPT4,mimiciii,radiology_report,PROMPT1_ICL_entailment
416,473,11,11,0,1.0,11,11,0,1.0,1.0,GPT4,mimiciii,radiology_report,PROMPT1_ICL_entailment
417,474,22,18,4,0.8181818181818182,25,20,5,0.8,0.8089887640449439,GPT4,mimiciii,radiology_report,PROMPT1_ICL_entailment
418,475,6,6,0,1.0,7,4,3,0.5714285714285714,0.7272727272727273,GPT4,mimiciii,radiology_report,PROMPT1_ICL_entailment
419,476,20,16,4,0.8,12,11,1,0.9166666666666666,0.854368932038835,GPT4,mimiciii,radiology_report,PROMPT1_ICL_entailment
420,477,18,12,6,0.6666666666666666,16,12,4,0.75,0.7058823529411765,GPT4,mimiciii,radiology_report,PROMPT1_ICL_entailment
421,478,15,14,1,0.9333333333333332,21,17,4,0.8095238095238095,0.8670309653916211,GPT4,mimiciii,radiology_report,PROMPT1_ICL_entailment
422,479,14,10,4,0.7142857142857143,22,14,8,0.6363636363636364,0.673076923076923,GPT4,mimiciii,radiology_report,PROMPT1_ICL_entailment
423,48,14,12,2,0.8571428571428571,21,17,4,0.8095238095238095,0.8326530612244899,GPT4,mimiciii,radiology_report,PROMPT1_ICL_entailment
424,480,10,9,1,0.9,10,5,5,0.5,0.6428571428571429,GPT4,mimiciii,radiology_report,PROMPT1_ICL_entailment
425,481,18,12,6,0.6666666666666666,17,15,2,0.8823529411764706,0.7594936708860759,GPT4,mimiciii,radiology_report,PROMPT1_ICL_entailment
426,482,18,9,9,0.5,19,16,3,0.8421052631578947,0.6274509803921569,GPT4,mimiciii,radiology_report,PROMPT1_ICL_entailment
427,483,17,15,2,0.8823529411764706,27,22,5,0.8148148148148148,0.8472400513478817,GPT4,mimiciii,radiology_report,PROMPT1_ICL_entailment
428,484,10,10,0,1.0,13,7,6,0.5384615384615384,0.7000000000000001,GPT4,mimiciii,radiology_report,PROMPT1_ICL_entailment
429,485,19,18,1,0.9473684210526316,27,17,10,0.6296296296296297,0.7564894932014833,GPT4,mimiciii,radiology_report,PROMPT1_ICL_entailment
430,486,16,12,4,0.75,11,9,2,0.8181818181818182,0.7826086956521738,GPT4,mimiciii,radiology_report,PROMPT1_ICL_entailment
431,487,22,17,5,0.7727272727272727,20,14,6,0.7,0.7345679012345679,GPT4,mimiciii,radiology_report,PROMPT1_ICL_entailment
432,488,17,14,3,0.8235294117647058,15,13,2,0.8666666666666667,0.8445475638051044,GPT4,mimiciii,radiology_report,PROMPT1_ICL_entailment
433,489,19,16,3,0.8421052631578947,18,15,3,0.8333333333333334,0.8376963350785339,GPT4,mimiciii,radiology_report,PROMPT1_ICL_entailment
434,49,19,17,2,0.8947368421052632,24,19,5,0.7916666666666666,0.8400520156046813,GPT4,mimiciii,radiology_report,PROMPT1_ICL_entailment
435,490,6,6,0,1.0,8,3,5,0.375,0.5454545454545454,GPT4,mimiciii,radiology_report,PROMPT1_ICL_entailment
436,491,15,14,1,0.9333333333333332,17,12,5,0.7058823529411765,0.8038277511961724,GPT4,mimiciii,radiology_report,PROMPT1_ICL_entailment
437,492,15,10,5,0.6666666666666666,13,7,6,0.5384615384615384,0.5957446808510638,GPT4,mimiciii,radiology_report,PROMPT1_ICL_entailment
438,493,14,13,1,0.9285714285714286,9,7,2,0.7777777777777778,0.8465116279069766,GPT4,mimiciii,radiology_report,PROMPT1_ICL_entailment
439,494,9,9,0,1.0,8,5,3,0.625,0.7692307692307693,GPT4,mimiciii,radiology_report,PROMPT1_ICL_entailment
440,495,9,9,0,1.0,12,12,0,1.0,1.0,GPT4,mimiciii,radiology_report,PROMPT1_ICL_entailment
441,496,27,26,1,0.9629629629629628,36,19,17,0.5277777777777778,0.6818495514147688,GPT4,mimiciii,radiology_report,PROMPT1_ICL_entailment
442,497,16,15,1,0.9375,25,16,9,0.64,0.7606973058637083,GPT4,mimiciii,radiology_report,PROMPT1_ICL_entailment
443,498,22,15,7,0.6818181818181818,22,17,5,0.7727272727272727,0.7244318181818181,GPT4,mimiciii,radiology_report,PROMPT1_ICL_entailment
444,499,21,11,10,0.5238095238095238,17,12,5,0.7058823529411765,0.6013667425968109,GPT4,mimiciii,radiology_report,PROMPT1_ICL_entailment
445,5,18,17,1,0.9444444444444444,22,17,5,0.7727272727272727,0.85,GPT4,mimiciii,radiology_report,PROMPT1_ICL_entailment
446,50,15,10,5,0.6666666666666666,15,9,6,0.6,0.631578947368421,GPT4,mimiciii,radiology_report,PROMPT1_ICL_entailment
447,51,12,10,2,0.8333333333333334,13,9,4,0.6923076923076923,0.7563025210084034,GPT4,mimiciii,radiology_report,PROMPT1_ICL_entailment
448,52,18,6,12,0.3333333333333333,21,16,5,0.7619047619047619,0.463768115942029,GPT4,mimiciii,radiology_report,PROMPT1_ICL_entailment
449,53,10,9,1,0.9,12,8,4,0.6666666666666666,0.7659574468085106,GPT4,mimiciii,radiology_report,PROMPT1_ICL_entailment
450,54,10,8,2,0.8,10,6,4,0.6,0.6857142857142857,GPT4,mimiciii,radiology_report,PROMPT1_ICL_entailment
451,55,16,12,4,0.75,18,14,4,0.7777777777777778,0.7636363636363638,GPT4,mimiciii,radiology_report,PROMPT1_ICL_entailment
452,56,17,10,7,0.5882352941176471,21,16,5,0.7619047619047619,0.6639004149377593,GPT4,mimiciii,radiology_report,PROMPT1_ICL_entailment
453,57,10,9,1,0.9,10,7,3,0.7,0.7875,GPT4,mimiciii,radiology_report,PROMPT1_ICL_entailment
454,58,11,11,0,1.0,16,11,5,0.6875,0.8148148148148148,GPT4,mimiciii,radiology_report,PROMPT1_ICL_entailment
455,59,13,13,0,1.0,16,13,3,0.8125,0.896551724137931,GPT4,mimiciii,radiology_report,PROMPT1_ICL_entailment
456,6,8,8,0,1.0,8,6,2,0.75,0.8571428571428571,GPT4,mimiciii,radiology_report,PROMPT1_ICL_entailment
457,60,17,13,4,0.7647058823529411,19,13,6,0.6842105263157895,0.7222222222222222,GPT4,mimiciii,radiology_report,PROMPT1_ICL_entailment
458,61,16,11,5,0.6875,22,18,4,0.8181818181818182,0.7471698113207547,GPT4,mimiciii,radiology_report,PROMPT1_ICL_entailment
459,62,20,10,10,0.5,13,8,5,0.6153846153846154,0.5517241379310345,GPT4,mimiciii,radiology_report,PROMPT1_ICL_entailment
460,63,11,10,1,0.9090909090909092,15,10,5,0.6666666666666666,0.7692307692307692,GPT4,mimiciii,radiology_report,PROMPT1_ICL_entailment
461,64,23,18,5,0.782608695652174,20,15,5,0.75,0.7659574468085107,GPT4,mimiciii,radiology_report,PROMPT1_ICL_entailment
462,65,19,14,5,0.7368421052631579,18,16,2,0.8888888888888888,0.8057553956834532,GPT4,mimiciii,radiology_report,PROMPT1_ICL_entailment
463,66,24,18,6,0.75,34,24,10,0.7058823529411765,0.7272727272727272,GPT4,mimiciii,radiology_report,PROMPT1_ICL_entailment
464,67,18,16,2,0.8888888888888888,28,21,7,0.75,0.8135593220338982,GPT4,mimiciii,radiology_report,PROMPT1_ICL_entailment
465,68,20,16,4,0.8,35,21,14,0.6,0.6857142857142857,GPT4,mimiciii,radiology_report,PROMPT1_ICL_entailment
466,69,22,14,8,0.6363636363636364,31,24,7,0.7741935483870968,0.6985446985446985,GPT4,mimiciii,radiology_report,PROMPT1_ICL_entailment
467,7,14,12,2,0.8571428571428571,16,11,5,0.6875,0.7630057803468208,GPT4,mimiciii,radiology_report,PROMPT1_ICL_entailment
468,70,12,8,4,0.6666666666666666,17,17,0,1.0,0.8,GPT4,mimiciii,radiology_report,PROMPT1_ICL_entailment
469,71,18,12,6,0.6666666666666666,18,8,10,0.4444444444444444,0.5333333333333333,GPT4,mimiciii,radiology_report,PROMPT1_ICL_entailment
470,72,17,14,3,0.8235294117647058,13,12,1,0.9230769230769232,0.8704663212435233,GPT4,mimiciii,radiology_report,PROMPT1_ICL_entailment
471,73,20,18,2,0.9,34,19,15,0.5588235294117647,0.689516129032258,GPT4,mimiciii,radiology_report,PROMPT1_ICL_entailment
472,74,16,12,4,0.75,18,14,4,0.7777777777777778,0.7636363636363638,GPT4,mimiciii,radiology_report,PROMPT1_ICL_entailment
473,75,17,11,6,0.6470588235294118,12,12,0,1.0,0.7857142857142858,GPT4,mimiciii,radiology_report,PROMPT1_ICL_entailment
474,76,14,12,2,0.8571428571428571,14,11,3,0.7857142857142857,0.8198757763975155,GPT4,mimiciii,radiology_report,PROMPT1_ICL_entailment
475,77,19,15,4,0.7894736842105263,26,21,5,0.8076923076923077,0.7984790874524715,GPT4,mimiciii,radiology_report,PROMPT1_ICL_entailment
476,78,25,17,8,0.68,33,24,9,0.7272727272727273,0.7028423772609821,GPT4,mimiciii,radiology_report,PROMPT1_ICL_entailment
477,79,13,12,1,0.9230769230769232,17,14,3,0.8235294117647058,0.8704663212435233,GPT4,mimiciii,radiology_report,PROMPT1_ICL_entailment
478,8,24,21,3,0.875,15,13,2,0.8666666666666667,0.8708133971291866,GPT4,mimiciii,radiology_report,PROMPT1_ICL_entailment
479,80,15,12,3,0.8,25,18,7,0.72,0.7578947368421052,GPT4,mimiciii,radiology_report,PROMPT1_ICL_entailment
480,81,11,6,5,0.5454545454545454,15,14,1,0.9333333333333332,0.6885245901639344,GPT4,mimiciii,radiology_report,PROMPT1_ICL_entailment
481,82,16,11,5,0.6875,14,11,3,0.7857142857142857,0.7333333333333334,GPT4,mimiciii,radiology_report,PROMPT1_ICL_entailment
482,83,23,15,8,0.6521739130434783,17,15,2,0.8823529411764706,0.75,GPT4,mimiciii,radiology_report,PROMPT1_ICL_entailment
483,84,17,10,7,0.5882352941176471,20,13,7,0.65,0.6175771971496438,GPT4,mimiciii,radiology_report,PROMPT1_ICL_entailment
484,85,15,12,3,0.8,14,11,3,0.7857142857142857,0.7927927927927927,GPT4,mimiciii,radiology_report,PROMPT1_ICL_entailment
485,86,13,11,2,0.8461538461538461,10,8,2,0.8,0.8224299065420562,GPT4,mimiciii,radiology_report,PROMPT1_ICL_entailment
486,87,16,13,3,0.8125,14,10,4,0.7142857142857143,0.7602339181286549,GPT4,mimiciii,radiology_report,PROMPT1_ICL_entailment
487,88,16,13,3,0.8125,19,14,5,0.7368421052631579,0.7728237791932058,GPT4,mimiciii,radiology_report,PROMPT1_ICL_entailment
488,89,15,13,2,0.8666666666666667,18,16,2,0.8888888888888888,0.8776371308016878,GPT4,mimiciii,radiology_report,PROMPT1_ICL_entailment
489,9,11,11,0,1.0,13,10,3,0.7692307692307693,0.8695652173913044,GPT4,mimiciii,radiology_report,PROMPT1_ICL_entailment
490,90,14,14,0,1.0,14,12,2,0.8571428571428571,0.923076923076923,GPT4,mimiciii,radiology_report,PROMPT1_ICL_entailment
491,91,14,13,1,0.9285714285714286,13,10,3,0.7692307692307693,0.8414239482200646,GPT4,mimiciii,radiology_report,PROMPT1_ICL_entailment
492,92,19,14,5,0.7368421052631579,21,16,5,0.7619047619047619,0.7491638795986622,GPT4,mimiciii,radiology_report,PROMPT1_ICL_entailment
493,93,14,11,3,0.7857142857142857,15,10,5,0.6666666666666666,0.721311475409836,GPT4,mimiciii,radiology_report,PROMPT1_ICL_entailment
494,94,23,14,9,0.6086956521739131,28,23,5,0.8214285714285714,0.6992399565689468,GPT4,mimiciii,radiology_report,PROMPT1_ICL_entailment
495,95,19,17,2,0.8947368421052632,18,13,5,0.7222222222222222,0.7992766726943943,GPT4,mimiciii,radiology_report,PROMPT1_ICL_entailment
496,96,17,13,4,0.7647058823529411,21,16,5,0.7619047619047619,0.7633027522935779,GPT4,mimiciii,radiology_report,PROMPT1_ICL_entailment
497,97,14,11,3,0.7857142857142857,23,16,7,0.6956521739130435,0.7379454926624738,GPT4,mimiciii,radiology_report,PROMPT1_ICL_entailment
498,98,19,10,9,0.5263157894736842,19,17,2,0.8947368421052632,0.6627680311890838,GPT4,mimiciii,radiology_report,PROMPT1_ICL_entailment
499,99,15,13,2,0.8666666666666667,13,10,3,0.7692307692307693,0.8150470219435738,GPT4,mimiciii,radiology_report,PROMPT1_ICL_entailment
0,0,23,14,9,0.6086956521739131,21,13,8,0.6190476190476191,0.6138279932546375,GPT4,mimiciii,radiology_report,PROMPT2_ICL_entailment
1,1,16,14,2,0.875,15,11,4,0.7333333333333333,0.7979274611398963,GPT4,mimiciii,radiology_report,PROMPT2_ICL_entailment
2,10,15,9,6,0.6,18,15,3,0.8333333333333334,0.6976744186046512,GPT4,mimiciii,radiology_report,PROMPT2_ICL_entailment
3,100,14,13,1,0.9285714285714286,9,8,1,0.8888888888888888,0.9082969432314412,GPT4,mimiciii,radiology_report,PROMPT2_ICL_entailment
4,101,13,10,3,0.7692307692307693,15,13,2,0.8666666666666667,0.8150470219435738,GPT4,mimiciii,radiology_report,PROMPT2_ICL_entailment
5,102,16,16,0,1.0,16,11,5,0.6875,0.8148148148148148,GPT4,mimiciii,radiology_report,PROMPT2_ICL_entailment
6,103,21,15,6,0.7142857142857143,19,14,5,0.7368421052631579,0.7253886010362695,GPT4,mimiciii,radiology_report,PROMPT2_ICL_entailment
7,104,18,9,9,0.5,17,13,4,0.7647058823529411,0.6046511627906976,GPT4,mimiciii,radiology_report,PROMPT2_ICL_entailment
8,105,7,7,0,1.0,8,6,2,0.75,0.8571428571428571,GPT4,mimiciii,radiology_report,PROMPT2_ICL_entailment
9,106,13,13,0,1.0,12,10,2,0.8333333333333334,0.9090909090909092,GPT4,mimiciii,radiology_report,PROMPT2_ICL_entailment
10,107,23,19,4,0.8260869565217391,19,12,7,0.631578947368421,0.7158555729984302,GPT4,mimiciii,radiology_report,PROMPT2_ICL_entailment
11,108,15,15,0,1.0,13,10,3,0.7692307692307693,0.8695652173913044,GPT4,mimiciii,radiology_report,PROMPT2_ICL_entailment
12,109,20,9,11,0.45,20,17,3,0.85,0.5884615384615385,GPT4,mimiciii,radiology_report,PROMPT2_ICL_entailment
13,11,15,12,3,0.8,24,16,8,0.6666666666666666,0.7272727272727272,GPT4,mimiciii,radiology_report,PROMPT2_ICL_entailment
14,110,22,14,8,0.6363636363636364,17,16,1,0.9411764705882352,0.759322033898305,GPT4,mimiciii,radiology_report,PROMPT2_ICL_entailment
15,111,22,19,3,0.8636363636363636,20,16,4,0.8,0.8306010928961749,GPT4,mimiciii,radiology_report,PROMPT2_ICL_entailment
16,112,15,13,2,0.8666666666666667,14,14,0,1.0,0.9285714285714286,GPT4,mimiciii,radiology_report,PROMPT2_ICL_entailment
17,113,17,5,12,0.2941176470588235,20,15,5,0.75,0.4225352112676055,GPT4,mimiciii,radiology_report,PROMPT2_ICL_entailment
18,114,21,10,11,0.4761904761904761,23,19,4,0.8260869565217391,0.604133545310016,GPT4,mimiciii,radiology_report,PROMPT2_ICL_entailment
19,115,17,17,0,1.0,20,17,3,0.85,0.9189189189189187,GPT4,mimiciii,radiology_report,PROMPT2_ICL_entailment
20,116,11,11,0,1.0,13,11,2,0.8461538461538461,0.9166666666666666,GPT4,mimiciii,radiology_report,PROMPT2_ICL_entailment
21,117,15,9,6,0.6,16,12,4,0.75,0.6666666666666665,GPT4,mimiciii,radiology_report,PROMPT2_ICL_entailment
22,118,21,14,7,0.6666666666666666,24,19,5,0.7916666666666666,0.7238095238095237,GPT4,mimiciii,radiology_report,PROMPT2_ICL_entailment
23,119,19,18,1,0.9473684210526316,17,16,1,0.9411764705882352,0.9442622950819672,GPT4,mimiciii,radiology_report,PROMPT2_ICL_entailment
24,12,11,11,0,1.0,17,14,3,0.8235294117647058,0.9032258064516128,GPT4,mimiciii,radiology_report,PROMPT2_ICL_entailment
25,120,19,13,6,0.6842105263157895,16,10,6,0.625,0.6532663316582915,GPT4,mimiciii,radiology_report,PROMPT2_ICL_entailment
26,121,22,17,5,0.7727272727272727,26,21,5,0.8076923076923077,0.7898230088495576,GPT4,mimiciii,radiology_report,PROMPT2_ICL_entailment
27,122,13,10,3,0.7692307692307693,20,16,4,0.8,0.7843137254901961,GPT4,mimiciii,radiology_report,PROMPT2_ICL_entailment
28,123,13,12,1,0.9230769230769232,13,12,1,0.9230769230769232,0.9230769230769232,GPT4,mimiciii,radiology_report,PROMPT2_ICL_entailment
29,124,11,10,1,0.9090909090909092,12,6,6,0.5,0.6451612903225806,GPT4,mimiciii,radiology_report,PROMPT2_ICL_entailment
30,125,21,15,6,0.7142857142857143,23,14,9,0.6086956521739131,0.6572769953051643,GPT4,mimiciii,radiology_report,PROMPT2_ICL_entailment
31,126,10,10,0,1.0,9,7,2,0.7777777777777778,0.8750000000000001,GPT4,mimiciii,radiology_report,PROMPT2_ICL_entailment
32,127,38,35,3,0.9210526315789472,50,29,21,0.58,0.711781206171108,GPT4,mimiciii,radiology_report,PROMPT2_ICL_entailment
33,128,13,8,5,0.6153846153846154,14,9,5,0.6428571428571429,0.62882096069869,GPT4,mimiciii,radiology_report,PROMPT2_ICL_entailment
34,129,18,15,3,0.8333333333333334,16,13,3,0.8125,0.8227848101265822,GPT4,mimiciii,radiology_report,PROMPT2_ICL_entailment
35,13,13,8,5,0.6153846153846154,17,16,1,0.9411764705882352,0.744186046511628,GPT4,mimiciii,radiology_report,PROMPT2_ICL_entailment
36,130,19,18,1,0.9473684210526316,29,24,5,0.8275862068965517,0.8834355828220859,GPT4,mimiciii,radiology_report,PROMPT2_ICL_entailment
37,131,13,10,3,0.7692307692307693,45,41,4,0.9111111111111112,0.8341810783316379,GPT4,mimiciii,radiology_report,PROMPT2_ICL_entailment
38,132,19,11,8,0.5789473684210527,23,17,6,0.7391304347826086,0.6493055555555556,GPT4,mimiciii,radiology_report,PROMPT2_ICL_entailment
39,133,20,15,5,0.75,21,18,3,0.8571428571428571,0.7999999999999999,GPT4,mimiciii,radiology_report,PROMPT2_ICL_entailment
40,134,17,12,5,0.7058823529411765,23,18,5,0.782608695652174,0.7422680412371134,GPT4,mimiciii,radiology_report,PROMPT2_ICL_entailment
41,135,16,14,2,0.875,20,15,5,0.75,0.8076923076923077,GPT4,mimiciii,radiology_report,PROMPT2_ICL_entailment
42,136,12,11,1,0.9166666666666666,14,10,4,0.7142857142857143,0.8029197080291971,GPT4,mimiciii,radiology_report,PROMPT2_ICL_entailment
43,137,10,9,1,0.9,10,7,3,0.7,0.7875,GPT4,mimiciii,radiology_report,PROMPT2_ICL_entailment
44,138,15,14,1,0.9333333333333332,14,9,5,0.6428571428571429,0.7613293051359517,GPT4,mimiciii,radiology_report,PROMPT2_ICL_entailment
45,139,10,7,3,0.7,13,10,3,0.7692307692307693,0.7329842931937172,GPT4,mimiciii,radiology_report,PROMPT2_ICL_entailment
46,14,12,12,0,1.0,12,9,3,0.75,0.8571428571428571,GPT4,mimiciii,radiology_report,PROMPT2_ICL_entailment
47,140,15,10,5,0.6666666666666666,18,14,4,0.7777777777777778,0.717948717948718,GPT4,mimiciii,radiology_report,PROMPT2_ICL_entailment
48,141,15,12,3,0.8,16,9,7,0.5625,0.6605504587155964,GPT4,mimiciii,radiology_report,PROMPT2_ICL_entailment
49,142,16,15,1,0.9375,14,10,4,0.7142857142857143,0.8108108108108109,GPT4,mimiciii,radiology_report,PROMPT2_ICL_entailment
50,143,23,21,2,0.9130434782608696,32,19,13,0.59375,0.7195671776375112,GPT4,mimiciii,radiology_report,PROMPT2_ICL_entailment
51,144,16,11,5,0.6875,26,17,9,0.6538461538461539,0.6702508960573478,GPT4,mimiciii,radiology_report,PROMPT2_ICL_entailment
52,145,18,17,1,0.9444444444444444,18,14,4,0.7777777777777778,0.8530465949820788,GPT4,mimiciii,radiology_report,PROMPT2_ICL_entailment
53,146,8,6,2,0.75,11,7,4,0.6363636363636364,0.6885245901639345,GPT4,mimiciii,radiology_report,PROMPT2_ICL_entailment
54,147,11,9,2,0.8181818181818182,10,7,3,0.7,0.7544910179640719,GPT4,mimiciii,radiology_report,PROMPT2_ICL_entailment
55,148,22,18,4,0.8181818181818182,32,19,13,0.59375,0.6881287726358148,GPT4,mimiciii,radiology_report,PROMPT2_ICL_entailment
56,149,18,15,3,0.8333333333333334,20,16,4,0.8,0.816326530612245,GPT4,mimiciii,radiology_report,PROMPT2_ICL_entailment
57,15,27,16,11,0.5925925925925926,29,19,10,0.6551724137931034,0.6223132036847492,GPT4,mimiciii,radiology_report,PROMPT2_ICL_entailment
58,150,18,8,10,0.4444444444444444,14,11,3,0.7857142857142857,0.5677419354838709,GPT4,mimiciii,radiology_report,PROMPT2_ICL_entailment
59,151,15,13,2,0.8666666666666667,15,8,7,0.5333333333333333,0.6603174603174604,GPT4,mimiciii,radiology_report,PROMPT2_ICL_entailment
60,152,17,12,5,0.7058823529411765,18,13,5,0.7222222222222222,0.71395881006865,GPT4,mimiciii,radiology_report,PROMPT2_ICL_entailment
61,153,18,11,7,0.6111111111111112,16,11,5,0.6875,0.6470588235294118,GPT4,mimiciii,radiology_report,PROMPT2_ICL_entailment
62,154,19,14,5,0.7368421052631579,23,18,5,0.782608695652174,0.7590361445783133,GPT4,mimiciii,radiology_report,PROMPT2_ICL_entailment
63,155,39,36,3,0.9230769230769232,47,37,10,0.7872340425531915,0.8497607655502393,GPT4,mimiciii,radiology_report,PROMPT2_ICL_entailment
64,156,19,12,7,0.631578947368421,20,17,3,0.85,0.724689165186501,GPT4,mimiciii,radiology_report,PROMPT2_ICL_entailment
65,157,16,15,1,0.9375,12,10,2,0.8333333333333334,0.8823529411764706,GPT4,mimiciii,radiology_report,PROMPT2_ICL_entailment
66,158,8,8,0,1.0,6,5,1,0.8333333333333334,0.9090909090909092,GPT4,mimiciii,radiology_report,PROMPT2_ICL_entailment
67,159,14,12,2,0.8571428571428571,13,10,3,0.7692307692307693,0.8108108108108107,GPT4,mimiciii,radiology_report,PROMPT2_ICL_entailment
68,16,17,14,3,0.8235294117647058,17,11,6,0.6470588235294118,0.7247058823529411,GPT4,mimiciii,radiology_report,PROMPT2_ICL_entailment
69,160,16,13,3,0.8125,12,9,3,0.75,0.78,GPT4,mimiciii,radiology_report,PROMPT2_ICL_entailment
70,161,15,12,3,0.8,13,10,3,0.7692307692307693,0.7843137254901961,GPT4,mimiciii,radiology_report,PROMPT2_ICL_entailment
71,162,14,13,1,0.9285714285714286,11,9,2,0.8181818181818182,0.8698884758364314,GPT4,mimiciii,radiology_report,PROMPT2_ICL_entailment
72,163,10,10,0,1.0,8,5,3,0.625,0.7692307692307693,GPT4,mimiciii,radiology_report,PROMPT2_ICL_entailment
73,164,14,12,2,0.8571428571428571,10,9,1,0.9,0.8780487804878048,GPT4,mimiciii,radiology_report,PROMPT2_ICL_entailment
74,165,25,18,7,0.72,31,20,11,0.6451612903225806,0.6805293005671077,GPT4,mimiciii,radiology_report,PROMPT2_ICL_entailment
75,166,23,17,6,0.7391304347826086,26,21,5,0.8076923076923077,0.7718918918918918,GPT4,mimiciii,radiology_report,PROMPT2_ICL_entailment
76,167,8,7,1,0.875,10,7,3,0.7,0.7777777777777777,GPT4,mimiciii,radiology_report,PROMPT2_ICL_entailment
77,168,17,13,4,0.7647058823529411,13,7,6,0.5384615384615384,0.6319444444444444,GPT4,mimiciii,radiology_report,PROMPT2_ICL_entailment
78,169,19,9,10,0.4736842105263157,22,17,5,0.7727272727272727,0.5873320537428023,GPT4,mimiciii,radiology_report,PROMPT2_ICL_entailment
79,17,9,7,2,0.7777777777777778,12,10,2,0.8333333333333334,0.8045977011494253,GPT4,mimiciii,radiology_report,PROMPT2_ICL_entailment
80,170,25,20,5,0.8,24,19,5,0.7916666666666666,0.7958115183246073,GPT4,mimiciii,radiology_report,PROMPT2_ICL_entailment
81,171,10,10,0,1.0,7,6,1,0.8571428571428571,0.923076923076923,GPT4,mimiciii,radiology_report,PROMPT2_ICL_entailment
82,172,12,10,2,0.8333333333333334,14,12,2,0.8571428571428571,0.8450704225352113,GPT4,mimiciii,radiology_report,PROMPT2_ICL_entailment
83,173,20,19,1,0.95,12,7,5,0.5833333333333334,0.7228260869565218,GPT4,mimiciii,radiology_report,PROMPT2_ICL_entailment
84,174,13,11,2,0.8461538461538461,20,14,6,0.7,0.7661691542288558,GPT4,mimiciii,radiology_report,PROMPT2_ICL_entailment
85,175,10,10,0,1.0,8,6,2,0.75,0.8571428571428571,GPT4,mimiciii,radiology_report,PROMPT2_ICL_entailment
86,176,23,11,12,0.4782608695652174,19,16,3,0.8421052631578947,0.6100519930675911,GPT4,mimiciii,radiology_report,PROMPT2_ICL_entailment
87,177,20,18,2,0.9,16,12,4,0.75,0.8181818181818182,GPT4,mimiciii,radiology_report,PROMPT2_ICL_entailment
88,178,26,20,6,0.7692307692307693,25,17,8,0.68,0.721868365180467,GPT4,mimiciii,radiology_report,PROMPT2_ICL_entailment
89,179,11,9,2,0.8181818181818182,20,9,11,0.45,0.5806451612903226,GPT4,mimiciii,radiology_report,PROMPT2_ICL_entailment
90,18,16,13,3,0.8125,17,14,3,0.8235294117647058,0.8179775280898876,GPT4,mimiciii,radiology_report,PROMPT2_ICL_entailment
91,180,11,9,2,0.8181818181818182,11,10,1,0.9090909090909092,0.861244019138756,GPT4,mimiciii,radiology_report,PROMPT2_ICL_entailment
92,181,28,14,14,0.5,26,18,8,0.6923076923076923,0.5806451612903226,GPT4,mimiciii,radiology_report,PROMPT2_ICL_entailment
93,182,22,14,8,0.6363636363636364,23,17,6,0.7391304347826086,0.6839080459770114,GPT4,mimiciii,radiology_report,PROMPT2_ICL_entailment
94,183,17,12,5,0.7058823529411765,17,14,3,0.8235294117647058,0.7601809954751132,GPT4,mimiciii,radiology_report,PROMPT2_ICL_entailment
95,184,15,15,0,1.0,15,13,2,0.8666666666666667,0.9285714285714286,GPT4,mimiciii,radiology_report,PROMPT2_ICL_entailment
96,185,7,7,0,1.0,6,4,2,0.6666666666666666,0.8,GPT4,mimiciii,radiology_report,PROMPT2_ICL_entailment
97,186,18,15,3,0.8333333333333334,26,22,4,0.8461538461538461,0.8396946564885497,GPT4,mimiciii,radiology_report,PROMPT2_ICL_entailment
98,187,20,19,1,0.95,14,10,4,0.7142857142857143,0.8154506437768242,GPT4,mimiciii,radiology_report,PROMPT2_ICL_entailment
99,188,23,17,6,0.7391304347826086,22,17,5,0.7727272727272727,0.7555555555555555,GPT4,mimiciii,radiology_report,PROMPT2_ICL_entailment
100,189,14,11,3,0.7857142857142857,15,13,2,0.8666666666666667,0.8242074927953891,GPT4,mimiciii,radiology_report,PROMPT2_ICL_entailment
101,19,11,11,0,1.0,14,11,3,0.7857142857142857,0.88,GPT4,mimiciii,radiology_report,PROMPT2_ICL_entailment
102,190,12,9,3,0.75,17,13,4,0.7647058823529411,0.7572815533980582,GPT4,mimiciii,radiology_report,PROMPT2_ICL_entailment
103,191,20,15,5,0.75,15,10,5,0.6666666666666666,0.7058823529411765,GPT4,mimiciii,radiology_report,PROMPT2_ICL_entailment
104,192,31,16,15,0.5161290322580645,28,20,8,0.7142857142857143,0.599250936329588,GPT4,mimiciii,radiology_report,PROMPT2_ICL_entailment
105,193,15,15,0,1.0,14,13,1,0.9285714285714286,0.962962962962963,GPT4,mimiciii,radiology_report,PROMPT2_ICL_entailment
106,194,27,25,2,0.925925925925926,49,24,25,0.4897959183673469,0.6406833956219967,GPT4,mimiciii,radiology_report,PROMPT2_ICL_entailment
107,195,18,13,5,0.7222222222222222,21,15,6,0.7142857142857143,0.7182320441988951,GPT4,mimiciii,radiology_report,PROMPT2_ICL_entailment
108,196,16,11,5,0.6875,18,13,5,0.7222222222222222,0.7044334975369457,GPT4,mimiciii,radiology_report,PROMPT2_ICL_entailment
109,197,14,10,4,0.7142857142857143,15,12,3,0.8,0.7547169811320756,GPT4,mimiciii,radiology_report,PROMPT2_ICL_entailment
110,198,10,8,2,0.8,9,8,1,0.8888888888888888,0.8421052631578948,GPT4,mimiciii,radiology_report,PROMPT2_ICL_entailment
111,199,22,11,11,0.5,23,19,4,0.8260869565217391,0.6229508196721311,GPT4,mimiciii,radiology_report,PROMPT2_ICL_entailment
112,2,16,15,1,0.9375,15,10,5,0.6666666666666666,0.7792207792207793,GPT4,mimiciii,radiology_report,PROMPT2_ICL_entailment
113,20,18,16,2,0.8888888888888888,42,35,7,0.8333333333333334,0.8602150537634408,GPT4,mimiciii,radiology_report,PROMPT2_ICL_entailment
114,200,17,12,5,0.7058823529411765,14,12,2,0.8571428571428571,0.7741935483870968,GPT4,mimiciii,radiology_report,PROMPT2_ICL_entailment
115,201,18,13,5,0.7222222222222222,18,14,4,0.7777777777777778,0.7489711934156379,GPT4,mimiciii,radiology_report,PROMPT2_ICL_entailment
116,202,22,20,2,0.9090909090909092,25,20,5,0.8,0.8510638297872342,GPT4,mimiciii,radiology_report,PROMPT2_ICL_entailment
117,203,21,13,8,0.6190476190476191,19,14,5,0.7368421052631579,0.6728280961182994,GPT4,mimiciii,radiology_report,PROMPT2_ICL_entailment
118,204,18,15,3,0.8333333333333334,23,18,5,0.782608695652174,0.8071748878923767,GPT4,mimiciii,radiology_report,PROMPT2_ICL_entailment
119,205,18,15,3,0.8333333333333334,14,12,2,0.8571428571428571,0.8450704225352113,GPT4,mimiciii,radiology_report,PROMPT2_ICL_entailment
120,206,17,14,3,0.8235294117647058,13,13,0,1.0,0.9032258064516128,GPT4,mimiciii,radiology_report,PROMPT2_ICL_entailment
121,207,9,9,0,1.0,9,7,2,0.7777777777777778,0.8750000000000001,GPT4,mimiciii,radiology_report,PROMPT2_ICL_entailment
122,208,27,20,7,0.7407407407407407,18,15,3,0.8333333333333334,0.7843137254901961,GPT4,mimiciii,radiology_report,PROMPT2_ICL_entailment
123,209,16,10,6,0.625,16,14,2,0.875,0.7291666666666666,GPT4,mimiciii,radiology_report,PROMPT2_ICL_entailment
124,21,27,22,5,0.8148148148148148,27,21,6,0.7777777777777778,0.7958656330749354,GPT4,mimiciii,radiology_report,PROMPT2_ICL_entailment
125,210,12,10,2,0.8333333333333334,14,8,6,0.5714285714285714,0.6779661016949152,GPT4,mimiciii,radiology_report,PROMPT2_ICL_entailment
126,211,13,13,0,1.0,13,12,1,0.9230769230769232,0.96,GPT4,mimiciii,radiology_report,PROMPT2_ICL_entailment
127,212,23,14,9,0.6086956521739131,19,15,4,0.7894736842105263,0.6873977086743045,GPT4,mimiciii,radiology_report,PROMPT2_ICL_entailment
128,213,17,12,5,0.7058823529411765,22,15,7,0.6818181818181818,0.6936416184971098,GPT4,mimiciii,radiology_report,PROMPT2_ICL_entailment
129,214,28,14,14,0.5,23,18,5,0.782608695652174,0.6101694915254238,GPT4,mimiciii,radiology_report,PROMPT2_ICL_entailment
130,215,11,9,2,0.8181818181818182,10,8,2,0.8,0.8089887640449439,GPT4,mimiciii,radiology_report,PROMPT2_ICL_entailment
131,216,14,11,3,0.7857142857142857,19,14,5,0.7368421052631579,0.7604938271604937,GPT4,mimiciii,radiology_report,PROMPT2_ICL_entailment
132,217,15,12,3,0.8,20,14,6,0.7,0.7466666666666666,GPT4,mimiciii,radiology_report,PROMPT2_ICL_entailment
133,218,19,13,6,0.6842105263157895,15,12,3,0.8,0.7375886524822695,GPT4,mimiciii,radiology_report,PROMPT2_ICL_entailment
134,219,15,8,7,0.5333333333333333,13,9,4,0.6923076923076923,0.6025104602510459,GPT4,mimiciii,radiology_report,PROMPT2_ICL_entailment
135,22,18,13,5,0.7222222222222222,19,17,2,0.8947368421052632,0.7992766726943943,GPT4,mimiciii,radiology_report,PROMPT2_ICL_entailment
136,220,16,10,6,0.625,19,15,4,0.7894736842105263,0.6976744186046512,GPT4,mimiciii,radiology_report,PROMPT2_ICL_entailment
137,221,22,17,5,0.7727272727272727,27,23,4,0.8518518518518519,0.8103626943005181,GPT4,mimiciii,radiology_report,PROMPT2_ICL_entailment
138,222,17,15,2,0.8823529411764706,16,10,6,0.625,0.7317073170731708,GPT4,mimiciii,radiology_report,PROMPT2_ICL_entailment
139,223,22,13,9,0.5909090909090909,21,15,6,0.7142857142857143,0.6467661691542289,GPT4,mimiciii,radiology_report,PROMPT2_ICL_entailment
140,224,25,20,5,0.8,17,14,3,0.8235294117647058,0.8115942028985507,GPT4,mimiciii,radiology_report,PROMPT2_ICL_entailment
141,225,10,9,1,0.9,11,9,2,0.8181818181818182,0.8571428571428572,GPT4,mimiciii,radiology_report,PROMPT2_ICL_entailment
142,226,15,8,7,0.5333333333333333,18,16,2,0.8888888888888888,0.6666666666666667,GPT4,mimiciii,radiology_report,PROMPT2_ICL_entailment
143,227,18,15,3,0.8333333333333334,18,13,5,0.7222222222222222,0.7738095238095238,GPT4,mimiciii,radiology_report,PROMPT2_ICL_entailment
144,228,17,12,5,0.7058823529411765,17,13,4,0.7647058823529411,0.7341176470588234,GPT4,mimiciii,radiology_report,PROMPT2_ICL_entailment
145,229,33,32,1,0.9696969696969696,49,34,15,0.6938775510204082,0.8089219330855019,GPT4,mimiciii,radiology_report,PROMPT2_ICL_entailment
146,23,17,13,4,0.7647058823529411,15,13,2,0.8666666666666667,0.8125,GPT4,mimiciii,radiology_report,PROMPT2_ICL_entailment
147,230,17,14,3,0.8235294117647058,17,16,1,0.9411764705882352,0.8784313725490196,GPT4,mimiciii,radiology_report,PROMPT2_ICL_entailment
148,231,11,10,1,0.9090909090909092,13,12,1,0.9230769230769232,0.9160305343511452,GPT4,mimiciii,radiology_report,PROMPT2_ICL_entailment
149,232,16,13,3,0.8125,18,15,3,0.8333333333333334,0.8227848101265822,GPT4,mimiciii,radiology_report,PROMPT2_ICL_entailment
150,233,21,12,9,0.5714285714285714,17,12,5,0.7058823529411765,0.6315789473684211,GPT4,mimiciii,radiology_report,PROMPT2_ICL_entailment
151,234,8,8,0,1.0,11,9,2,0.8181818181818182,0.9,GPT4,mimiciii,radiology_report,PROMPT2_ICL_entailment
152,235,13,10,3,0.7692307692307693,14,11,3,0.7857142857142857,0.7773851590106008,GPT4,mimiciii,radiology_report,PROMPT2_ICL_entailment
153,236,16,14,2,0.875,11,9,2,0.8181818181818182,0.8456375838926175,GPT4,mimiciii,radiology_report,PROMPT2_ICL_entailment
154,237,18,10,8,0.5555555555555556,17,13,4,0.7647058823529411,0.6435643564356436,GPT4,mimiciii,radiology_report,PROMPT2_ICL_entailment
155,238,15,10,5,0.6666666666666666,20,14,6,0.7,0.6829268292682926,GPT4,mimiciii,radiology_report,PROMPT2_ICL_entailment
156,239,15,7,8,0.4666666666666667,17,11,6,0.6470588235294118,0.5422535211267606,GPT4,mimiciii,radiology_report,PROMPT2_ICL_entailment
157,24,14,13,1,0.9285714285714286,18,14,4,0.7777777777777778,0.8465116279069766,GPT4,mimiciii,radiology_report,PROMPT2_ICL_entailment
158,240,10,9,1,0.9,13,11,2,0.8461538461538461,0.8722466960352422,GPT4,mimiciii,radiology_report,PROMPT2_ICL_entailment
159,241,14,13,1,0.9285714285714286,16,13,3,0.8125,0.8666666666666666,GPT4,mimiciii,radiology_report,PROMPT2_ICL_entailment
160,242,28,24,4,0.8571428571428571,18,13,5,0.7222222222222222,0.7839195979899497,GPT4,mimiciii,radiology_report,PROMPT2_ICL_entailment
161,243,15,14,1,0.9333333333333332,13,10,3,0.7692307692307693,0.8433734939759036,GPT4,mimiciii,radiology_report,PROMPT2_ICL_entailment
162,244,14,8,6,0.5714285714285714,17,15,2,0.8823529411764706,0.6936416184971098,GPT4,mimiciii,radiology_report,PROMPT2_ICL_entailment
163,245,23,17,6,0.7391304347826086,28,24,4,0.8571428571428571,0.7937743190661479,GPT4,mimiciii,radiology_report,PROMPT2_ICL_entailment
164,246,9,8,1,0.8888888888888888,12,7,5,0.5833333333333334,0.7044025157232704,GPT4,mimiciii,radiology_report,PROMPT2_ICL_entailment
165,247,12,8,4,0.6666666666666666,12,8,4,0.6666666666666666,0.6666666666666666,GPT4,mimiciii,radiology_report,PROMPT2_ICL_entailment
166,248,18,15,3,0.8333333333333334,17,13,4,0.7647058823529411,0.7975460122699386,GPT4,mimiciii,radiology_report,PROMPT2_ICL_entailment
167,249,22,18,4,0.8181818181818182,23,14,9,0.6086956521739131,0.6980609418282548,GPT4,mimiciii,radiology_report,PROMPT2_ICL_entailment
168,25,27,19,8,0.7037037037037037,27,22,5,0.8148148148148148,0.7551942186088527,GPT4,mimiciii,radiology_report,PROMPT2_ICL_entailment
169,250,9,9,0,1.0,8,6,2,0.75,0.8571428571428571,GPT4,mimiciii,radiology_report,PROMPT2_ICL_entailment
170,251,27,17,10,0.6296296296296297,22,21,1,0.9545454545454546,0.7587672688629118,GPT4,mimiciii,radiology_report,PROMPT2_ICL_entailment
171,252,9,8,1,0.8888888888888888,10,6,4,0.6,0.7164179104477612,GPT4,mimiciii,radiology_report,PROMPT2_ICL_entailment
172,253,30,20,10,0.6666666666666666,24,20,4,0.8333333333333334,0.7407407407407408,GPT4,mimiciii,radiology_report,PROMPT2_ICL_entailment
173,254,14,11,3,0.7857142857142857,13,8,5,0.6153846153846154,0.6901960784313727,GPT4,mimiciii,radiology_report,PROMPT2_ICL_entailment
174,255,14,13,1,0.9285714285714286,16,13,3,0.8125,0.8666666666666666,GPT4,mimiciii,radiology_report,PROMPT2_ICL_entailment
175,256,19,13,6,0.6842105263157895,19,15,4,0.7894736842105263,0.7330827067669173,GPT4,mimiciii,radiology_report,PROMPT2_ICL_entailment
176,257,17,12,5,0.7058823529411765,15,13,2,0.8666666666666667,0.7780548628428927,GPT4,mimiciii,radiology_report,PROMPT2_ICL_entailment
177,258,15,11,4,0.7333333333333333,20,15,5,0.75,0.7415730337078651,GPT4,mimiciii,radiology_report,PROMPT2_ICL_entailment
178,259,20,11,9,0.55,17,13,4,0.7647058823529411,0.639821029082774,GPT4,mimiciii,radiology_report,PROMPT2_ICL_entailment
179,26,24,20,4,0.8333333333333334,18,11,7,0.6111111111111112,0.7051282051282051,GPT4,mimiciii,radiology_report,PROMPT2_ICL_entailment
180,260,21,14,7,0.6666666666666666,20,11,9,0.55,0.6027397260273972,GPT4,mimiciii,radiology_report,PROMPT2_ICL_entailment
181,261,24,13,11,0.5416666666666666,31,26,5,0.8387096774193549,0.6582278481012658,GPT4,mimiciii,radiology_report,PROMPT2_ICL_entailment
182,262,23,17,6,0.7391304347826086,23,16,7,0.6956521739130435,0.7167325428194993,GPT4,mimiciii,radiology_report,PROMPT2_ICL_entailment
183,263,18,14,4,0.7777777777777778,27,24,3,0.8888888888888888,0.8296296296296296,GPT4,mimiciii,radiology_report,PROMPT2_ICL_entailment
184,264,20,14,6,0.7,20,16,4,0.8,0.7466666666666666,GPT4,mimiciii,radiology_report,PROMPT2_ICL_entailment
185,265,10,8,2,0.8,9,7,2,0.7777777777777778,0.7887323943661971,GPT4,mimiciii,radiology_report,PROMPT2_ICL_entailment
186,266,14,8,6,0.5714285714285714,18,13,5,0.7222222222222222,0.638036809815951,GPT4,mimiciii,radiology_report,PROMPT2_ICL_entailment
187,267,12,11,1,0.9166666666666666,16,12,4,0.75,0.8250000000000001,GPT4,mimiciii,radiology_report,PROMPT2_ICL_entailment
188,268,21,14,7,0.6666666666666666,20,16,4,0.8,0.7272727272727272,GPT4,mimiciii,radiology_report,PROMPT2_ICL_entailment
189,269,18,18,0,1.0,30,18,12,0.6,0.7499999999999999,GPT4,mimiciii,radiology_report,PROMPT2_ICL_entailment
190,27,15,13,2,0.8666666666666667,14,11,3,0.7857142857142857,0.8242074927953891,GPT4,mimiciii,radiology_report,PROMPT2_ICL_entailment
191,270,18,12,6,0.6666666666666666,17,12,5,0.7058823529411765,0.6857142857142857,GPT4,mimiciii,radiology_report,PROMPT2_ICL_entailment
192,271,15,13,2,0.8666666666666667,20,13,7,0.65,0.7428571428571429,GPT4,mimiciii,radiology_report,PROMPT2_ICL_entailment
193,272,23,17,6,0.7391304347826086,17,14,3,0.8235294117647058,0.779050736497545,GPT4,mimiciii,radiology_report,PROMPT2_ICL_entailment
194,273,15,11,4,0.7333333333333333,12,7,5,0.5833333333333334,0.6497890295358649,GPT4,mimiciii,radiology_report,PROMPT2_ICL_entailment
195,274,16,7,9,0.4375,20,15,5,0.75,0.5526315789473685,GPT4,mimiciii,radiology_report,PROMPT2_ICL_entailment
196,275,13,13,0,1.0,12,10,2,0.8333333333333334,0.9090909090909092,GPT4,mimiciii,radiology_report,PROMPT2_ICL_entailment
197,276,18,17,1,0.9444444444444444,29,25,4,0.8620689655172413,0.9013785790031812,GPT4,mimiciii,radiology_report,PROMPT2_ICL_entailment
198,277,21,15,6,0.7142857142857143,25,20,5,0.8,0.7547169811320756,GPT4,mimiciii,radiology_report,PROMPT2_ICL_entailment
199,278,16,15,1,0.9375,16,13,3,0.8125,0.8705357142857143,GPT4,mimiciii,radiology_report,PROMPT2_ICL_entailment
200,279,13,13,0,1.0,10,7,3,0.7,0.8235294117647058,GPT4,mimiciii,radiology_report,PROMPT2_ICL_entailment
201,28,34,21,13,0.6176470588235294,30,23,7,0.7666666666666667,0.6841359773371105,GPT4,mimiciii,radiology_report,PROMPT2_ICL_entailment
202,280,13,10,3,0.7692307692307693,12,9,3,0.75,0.7594936708860761,GPT4,mimiciii,radiology_report,PROMPT2_ICL_entailment
203,281,21,17,4,0.8095238095238095,24,16,8,0.6666666666666666,0.7311827956989246,GPT4,mimiciii,radiology_report,PROMPT2_ICL_entailment
204,282,20,19,1,0.95,12,11,1,0.9166666666666666,0.9330357142857142,GPT4,mimiciii,radiology_report,PROMPT2_ICL_entailment
205,283,19,15,4,0.7894736842105263,28,21,7,0.75,0.7692307692307692,GPT4,mimiciii,radiology_report,PROMPT2_ICL_entailment
206,284,14,10,4,0.7142857142857143,14,10,4,0.7142857142857143,0.7142857142857143,GPT4,mimiciii,radiology_report,PROMPT2_ICL_entailment
207,285,15,13,2,0.8666666666666667,18,17,1,0.9444444444444444,0.9038854805725972,GPT4,mimiciii,radiology_report,PROMPT2_ICL_entailment
208,286,7,7,0,1.0,6,5,1,0.8333333333333334,0.9090909090909092,GPT4,mimiciii,radiology_report,PROMPT2_ICL_entailment
209,287,19,17,2,0.8947368421052632,18,16,2,0.8888888888888888,0.8918032786885245,GPT4,mimiciii,radiology_report,PROMPT2_ICL_entailment
210,288,24,17,7,0.7083333333333334,32,25,7,0.78125,0.743006993006993,GPT4,mimiciii,radiology_report,PROMPT2_ICL_entailment
211,289,22,14,8,0.6363636363636364,20,13,7,0.65,0.6431095406360424,GPT4,mimiciii,radiology_report,PROMPT2_ICL_entailment
212,29,10,10,0,1.0,8,6,2,0.75,0.8571428571428571,GPT4,mimiciii,radiology_report,PROMPT2_ICL_entailment
213,290,13,11,2,0.8461538461538461,11,8,3,0.7272727272727273,0.7822222222222223,GPT4,mimiciii,radiology_report,PROMPT2_ICL_entailment
214,291,23,15,8,0.6521739130434783,24,15,9,0.625,0.6382978723404256,GPT4,mimiciii,radiology_report,PROMPT2_ICL_entailment
215,292,23,19,4,0.8260869565217391,21,16,5,0.7619047619047619,0.7926988265971316,GPT4,mimiciii,radiology_report,PROMPT2_ICL_entailment
216,293,16,11,5,0.6875,18,12,6,0.6666666666666666,0.676923076923077,GPT4,mimiciii,radiology_report,PROMPT2_ICL_entailment
217,294,21,15,6,0.7142857142857143,22,13,9,0.5909090909090909,0.6467661691542289,GPT4,mimiciii,radiology_report,PROMPT2_ICL_entailment
218,295,15,11,4,0.7333333333333333,39,24,15,0.6153846153846154,0.6692015209125475,GPT4,mimiciii,radiology_report,PROMPT2_ICL_entailment
219,296,18,9,9,0.5,17,12,5,0.7058823529411765,0.5853658536585366,GPT4,mimiciii,radiology_report,PROMPT2_ICL_entailment
220,297,24,19,5,0.7916666666666666,24,19,5,0.7916666666666666,0.7916666666666666,GPT4,mimiciii,radiology_report,PROMPT2_ICL_entailment
221,298,20,15,5,0.75,20,15,5,0.75,0.75,GPT4,mimiciii,radiology_report,PROMPT2_ICL_entailment
222,299,20,16,4,0.8,32,25,7,0.78125,0.7905138339920948,GPT4,mimiciii,radiology_report,PROMPT2_ICL_entailment
223,3,15,9,6,0.6,20,13,7,0.65,0.624,GPT4,mimiciii,radiology_report,PROMPT2_ICL_entailment
224,30,17,13,4,0.7647058823529411,25,17,8,0.68,0.7198697068403909,GPT4,mimiciii,radiology_report,PROMPT2_ICL_entailment
225,300,15,12,3,0.8,13,9,4,0.6923076923076923,0.7422680412371134,GPT4,mimiciii,radiology_report,PROMPT2_ICL_entailment
226,301,13,12,1,0.9230769230769232,19,11,8,0.5789473684210527,0.711590296495957,GPT4,mimiciii,radiology_report,PROMPT2_ICL_entailment
227,302,17,17,0,1.0,15,13,2,0.8666666666666667,0.9285714285714286,GPT4,mimiciii,radiology_report,PROMPT2_ICL_entailment
228,303,26,11,15,0.4230769230769231,24,17,7,0.7083333333333334,0.5297450424929179,GPT4,mimiciii,radiology_report,PROMPT2_ICL_entailment
229,304,16,15,1,0.9375,21,13,8,0.6190476190476191,0.745697896749522,GPT4,mimiciii,radiology_report,PROMPT2_ICL_entailment
230,305,19,8,11,0.4210526315789473,24,16,8,0.6666666666666666,0.5161290322580646,GPT4,mimiciii,radiology_report,PROMPT2_ICL_entailment
231,306,14,12,2,0.8571428571428571,14,12,2,0.8571428571428571,0.8571428571428571,GPT4,mimiciii,radiology_report,PROMPT2_ICL_entailment
232,307,16,14,2,0.875,17,12,5,0.7058823529411765,0.7813953488372093,GPT4,mimiciii,radiology_report,PROMPT2_ICL_entailment
233,308,13,9,4,0.6923076923076923,15,10,5,0.6666666666666666,0.6792452830188679,GPT4,mimiciii,radiology_report,PROMPT2_ICL_entailment
234,309,16,15,1,0.9375,29,14,15,0.4827586206896552,0.6373292867981791,GPT4,mimiciii,radiology_report,PROMPT2_ICL_entailment
235,31,15,12,3,0.8,19,14,5,0.7368421052631579,0.7671232876712328,GPT4,mimiciii,radiology_report,PROMPT2_ICL_entailment
236,310,18,16,2,0.8888888888888888,24,17,7,0.7083333333333334,0.7884057971014492,GPT4,mimiciii,radiology_report,PROMPT2_ICL_entailment
237,311,13,13,0,1.0,15,10,5,0.6666666666666666,0.8,GPT4,mimiciii,radiology_report,PROMPT2_ICL_entailment
238,312,19,17,2,0.8947368421052632,18,16,2,0.8888888888888888,0.8918032786885245,GPT4,mimiciii,radiology_report,PROMPT2_ICL_entailment
239,313,16,12,4,0.75,17,15,2,0.8823529411764706,0.8108108108108107,GPT4,mimiciii,radiology_report,PROMPT2_ICL_entailment
240,314,18,11,7,0.6111111111111112,15,12,3,0.8,0.6929133858267716,GPT4,mimiciii,radiology_report,PROMPT2_ICL_entailment
241,315,32,18,14,0.5625,25,17,8,0.68,0.6156941649899396,GPT4,mimiciii,radiology_report,PROMPT2_ICL_entailment
242,316,10,9,1,0.9,10,8,2,0.8,0.8470588235294118,GPT4,mimiciii,radiology_report,PROMPT2_ICL_entailment
243,317,24,11,13,0.4583333333333333,26,22,4,0.8461538461538461,0.5945945945945945,GPT4,mimiciii,radiology_report,PROMPT2_ICL_entailment
244,318,17,15,2,0.8823529411764706,21,15,6,0.7142857142857143,0.7894736842105262,GPT4,mimiciii,radiology_report,PROMPT2_ICL_entailment
245,319,18,15,3,0.8333333333333334,12,11,1,0.9166666666666666,0.8730158730158729,GPT4,mimiciii,radiology_report,PROMPT2_ICL_entailment
246,32,14,13,1,0.9285714285714286,15,10,5,0.6666666666666666,0.7761194029850746,GPT4,mimiciii,radiology_report,PROMPT2_ICL_entailment
247,320,12,12,0,1.0,11,9,2,0.8181818181818182,0.9,GPT4,mimiciii,radiology_report,PROMPT2_ICL_entailment
248,321,17,11,6,0.6470588235294118,21,16,5,0.7619047619047619,0.6998011928429424,GPT4,mimiciii,radiology_report,PROMPT2_ICL_entailment
249,322,9,9,0,1.0,8,6,2,0.75,0.8571428571428571,GPT4,mimiciii,radiology_report,PROMPT2_ICL_entailment
250,323,18,14,4,0.7777777777777778,29,19,10,0.6551724137931034,0.7112299465240641,GPT4,mimiciii,radiology_report,PROMPT2_ICL_entailment
251,324,20,15,5,0.75,18,13,5,0.7222222222222222,0.7358490566037735,GPT4,mimiciii,radiology_report,PROMPT2_ICL_entailment
252,325,18,10,8,0.5555555555555556,22,17,5,0.7727272727272727,0.6463878326996197,GPT4,mimiciii,radiology_report,PROMPT2_ICL_entailment
253,326,26,13,13,0.5,23,19,4,0.8260869565217391,0.6229508196721311,GPT4,mimiciii,radiology_report,PROMPT2_ICL_entailment
254,327,9,9,0,1.0,9,7,2,0.7777777777777778,0.8750000000000001,GPT4,mimiciii,radiology_report,PROMPT2_ICL_entailment
255,328,18,14,4,0.7777777777777778,17,12,5,0.7058823529411765,0.7400881057268723,GPT4,mimiciii,radiology_report,PROMPT2_ICL_entailment
256,329,11,10,1,0.9090909090909092,28,14,14,0.5,0.6451612903225806,GPT4,mimiciii,radiology_report,PROMPT2_ICL_entailment
257,33,10,10,0,1.0,9,8,1,0.8888888888888888,0.9411764705882352,GPT4,mimiciii,radiology_report,PROMPT2_ICL_entailment
258,330,15,12,3,0.8,11,6,5,0.5454545454545454,0.6486486486486486,GPT4,mimiciii,radiology_report,PROMPT2_ICL_entailment
259,331,12,9,3,0.75,15,13,2,0.8666666666666667,0.8041237113402062,GPT4,mimiciii,radiology_report,PROMPT2_ICL_entailment
260,332,18,13,5,0.7222222222222222,20,16,4,0.8,0.759124087591241,GPT4,mimiciii,radiology_report,PROMPT2_ICL_entailment
261,333,13,12,1,0.9230769230769232,13,10,3,0.7692307692307693,0.8391608391608392,GPT4,mimiciii,radiology_report,PROMPT2_ICL_entailment
262,334,24,19,5,0.7916666666666666,20,18,2,0.9,0.8423645320197045,GPT4,mimiciii,radiology_report,PROMPT2_ICL_entailment
263,335,19,18,1,0.9473684210526316,17,12,5,0.7058823529411765,0.8089887640449439,GPT4,mimiciii,radiology_report,PROMPT2_ICL_entailment
264,336,20,15,5,0.75,16,14,2,0.875,0.8076923076923077,GPT4,mimiciii,radiology_report,PROMPT2_ICL_entailment
265,337,23,21,2,0.9130434782608696,16,14,2,0.875,0.8936170212765957,GPT4,mimiciii,radiology_report,PROMPT2_ICL_entailment
266,338,18,16,2,0.8888888888888888,13,9,4,0.6923076923076923,0.7783783783783783,GPT4,mimiciii,radiology_report,PROMPT2_ICL_entailment
267,339,22,15,7,0.6818181818181818,28,20,8,0.7142857142857143,0.6976744186046512,GPT4,mimiciii,radiology_report,PROMPT2_ICL_entailment
268,34,15,10,5,0.6666666666666666,14,12,2,0.8571428571428571,0.75,GPT4,mimiciii,radiology_report,PROMPT2_ICL_entailment
269,340,22,12,10,0.5454545454545454,15,13,2,0.8666666666666667,0.6695278969957081,GPT4,mimiciii,radiology_report,PROMPT2_ICL_entailment
270,341,8,8,0,1.0,6,5,1,0.8333333333333334,0.9090909090909092,GPT4,mimiciii,radiology_report,PROMPT2_ICL_entailment
271,342,15,14,1,0.9333333333333332,15,12,3,0.8,0.8615384615384616,GPT4,mimiciii,radiology_report,PROMPT2_ICL_entailment
272,343,20,16,4,0.8,26,23,3,0.8846153846153846,0.8401826484018265,GPT4,mimiciii,radiology_report,PROMPT2_ICL_entailment
273,344,15,9,6,0.6,19,14,5,0.7368421052631579,0.6614173228346457,GPT4,mimiciii,radiology_report,PROMPT2_ICL_entailment
274,345,22,15,7,0.6818181818181818,22,17,5,0.7727272727272727,0.7244318181818181,GPT4,mimiciii,radiology_report,PROMPT2_ICL_entailment
275,346,16,14,2,0.875,15,12,3,0.8,0.8358208955223881,GPT4,mimiciii,radiology_report,PROMPT2_ICL_entailment
276,347,16,12,4,0.75,15,13,2,0.8666666666666667,0.8041237113402062,GPT4,mimiciii,radiology_report,PROMPT2_ICL_entailment
277,348,14,11,3,0.7857142857142857,12,9,3,0.75,0.7674418604651163,GPT4,mimiciii,radiology_report,PROMPT2_ICL_entailment
278,349,16,14,2,0.875,16,13,3,0.8125,0.8425925925925926,GPT4,mimiciii,radiology_report,PROMPT2_ICL_entailment
279,35,18,8,10,0.4444444444444444,21,16,5,0.7619047619047619,0.5614035087719298,GPT4,mimiciii,radiology_report,PROMPT2_ICL_entailment
280,350,17,13,4,0.7647058823529411,21,16,5,0.7619047619047619,0.7633027522935779,GPT4,mimiciii,radiology_report,PROMPT2_ICL_entailment
281,351,22,12,10,0.5454545454545454,21,16,5,0.7619047619047619,0.6357615894039735,GPT4,mimiciii,radiology_report,PROMPT2_ICL_entailment
282,352,16,12,4,0.75,22,16,6,0.7272727272727273,0.7384615384615384,GPT4,mimiciii,radiology_report,PROMPT2_ICL_entailment
283,353,18,8,10,0.4444444444444444,26,15,11,0.5769230769230769,0.502092050209205,GPT4,mimiciii,radiology_report,PROMPT2_ICL_entailment
284,354,23,17,6,0.7391304347826086,26,22,4,0.8461538461538461,0.7890295358649789,GPT4,mimiciii,radiology_report,PROMPT2_ICL_entailment
285,355,17,14,3,0.8235294117647058,18,14,4,0.7777777777777778,0.7999999999999999,GPT4,mimiciii,radiology_report,PROMPT2_ICL_entailment
286,356,18,12,6,0.6666666666666666,22,16,6,0.7272727272727273,0.6956521739130435,GPT4,mimiciii,radiology_report,PROMPT2_ICL_entailment
287,357,11,10,1,0.9090909090909092,15,11,4,0.7333333333333333,0.8118081180811808,GPT4,mimiciii,radiology_report,PROMPT2_ICL_entailment
288,358,16,13,3,0.8125,12,8,4,0.6666666666666666,0.7323943661971831,GPT4,mimiciii,radiology_report,PROMPT2_ICL_entailment
289,359,15,11,4,0.7333333333333333,18,14,4,0.7777777777777778,0.7549019607843137,GPT4,mimiciii,radiology_report,PROMPT2_ICL_entailment
290,36,19,12,7,0.631578947368421,22,17,5,0.7727272727272727,0.6950596252129472,GPT4,mimiciii,radiology_report,PROMPT2_ICL_entailment
291,360,19,13,6,0.6842105263157895,15,12,3,0.8,0.7375886524822695,GPT4,mimiciii,radiology_report,PROMPT2_ICL_entailment
292,361,19,13,6,0.6842105263157895,23,19,4,0.8260869565217391,0.7484848484848485,GPT4,mimiciii,radiology_report,PROMPT2_ICL_entailment
293,362,20,11,9,0.55,24,13,11,0.5416666666666666,0.5458015267175572,GPT4,mimiciii,radiology_report,PROMPT2_ICL_entailment
294,363,22,12,10,0.5454545454545454,22,16,6,0.7272727272727273,0.6233766233766234,GPT4,mimiciii,radiology_report,PROMPT2_ICL_entailment
295,364,9,9,0,1.0,11,8,3,0.7272727272727273,0.8421052631578948,GPT4,mimiciii,radiology_report,PROMPT2_ICL_entailment
296,365,29,22,7,0.7586206896551724,29,17,12,0.5862068965517241,0.6613616268788682,GPT4,mimiciii,radiology_report,PROMPT2_ICL_entailment
297,366,11,11,0,1.0,13,7,6,0.5384615384615384,0.7000000000000001,GPT4,mimiciii,radiology_report,PROMPT2_ICL_entailment
298,367,17,8,9,0.4705882352941176,16,13,3,0.8125,0.5959885386819483,GPT4,mimiciii,radiology_report,PROMPT2_ICL_entailment
299,368,18,12,6,0.6666666666666666,20,11,9,0.55,0.6027397260273972,GPT4,mimiciii,radiology_report,PROMPT2_ICL_entailment
300,369,20,17,3,0.85,20,19,1,0.95,0.8972222222222223,GPT4,mimiciii,radiology_report,PROMPT2_ICL_entailment
301,37,15,13,2,0.8666666666666667,21,14,7,0.6666666666666666,0.7536231884057971,GPT4,mimiciii,radiology_report,PROMPT2_ICL_entailment
302,370,16,9,7,0.5625,19,12,7,0.631578947368421,0.5950413223140496,GPT4,mimiciii,radiology_report,PROMPT2_ICL_entailment
303,371,15,9,6,0.6,17,14,3,0.8235294117647058,0.6942148760330579,GPT4,mimiciii,radiology_report,PROMPT2_ICL_entailment
304,372,16,14,2,0.875,31,23,8,0.7419354838709677,0.8029925187032418,GPT4,mimiciii,radiology_report,PROMPT2_ICL_entailment
305,373,20,17,3,0.85,23,12,11,0.5217391304347826,0.6465927099841522,GPT4,mimiciii,radiology_report,PROMPT2_ICL_entailment
306,374,12,12,0,1.0,11,7,4,0.6363636363636364,0.7777777777777778,GPT4,mimiciii,radiology_report,PROMPT2_ICL_entailment
307,375,12,10,2,0.8333333333333334,16,12,4,0.75,0.7894736842105262,GPT4,mimiciii,radiology_report,PROMPT2_ICL_entailment
308,376,22,15,7,0.6818181818181818,18,15,3,0.8333333333333334,0.7499999999999999,GPT4,mimiciii,radiology_report,PROMPT2_ICL_entailment
309,377,16,16,0,1.0,10,7,3,0.7,0.8235294117647058,GPT4,mimiciii,radiology_report,PROMPT2_ICL_entailment
310,378,21,13,8,0.6190476190476191,24,13,11,0.5416666666666666,0.5777777777777778,GPT4,mimiciii,radiology_report,PROMPT2_ICL_entailment
311,379,23,12,11,0.5217391304347826,18,13,5,0.7222222222222222,0.6058252427184466,GPT4,mimiciii,radiology_report,PROMPT2_ICL_entailment
312,38,22,16,6,0.7272727272727273,19,16,3,0.8421052631578947,0.7804878048780488,GPT4,mimiciii,radiology_report,PROMPT2_ICL_entailment
313,380,12,12,0,1.0,8,7,1,0.875,0.9333333333333332,GPT4,mimiciii,radiology_report,PROMPT2_ICL_entailment
314,381,15,11,4,0.7333333333333333,14,11,3,0.7857142857142857,0.7586206896551724,GPT4,mimiciii,radiology_report,PROMPT2_ICL_entailment
315,382,14,12,2,0.8571428571428571,16,9,7,0.5625,0.6792452830188678,GPT4,mimiciii,radiology_report,PROMPT2_ICL_entailment
316,383,16,7,9,0.4375,17,13,4,0.7647058823529411,0.5565749235474006,GPT4,mimiciii,radiology_report,PROMPT2_ICL_entailment
317,384,14,14,0,1.0,13,12,1,0.9230769230769232,0.96,GPT4,mimiciii,radiology_report,PROMPT2_ICL_entailment
318,385,20,15,5,0.75,27,20,7,0.7407407407407407,0.7453416149068324,GPT4,mimiciii,radiology_report,PROMPT2_ICL_entailment
319,386,23,19,4,0.8260869565217391,18,17,1,0.9444444444444444,0.8813096862210097,GPT4,mimiciii,radiology_report,PROMPT2_ICL_entailment
320,387,20,18,2,0.9,19,12,7,0.631578947368421,0.7422680412371133,GPT4,mimiciii,radiology_report,PROMPT2_ICL_entailment
321,388,24,19,5,0.7916666666666666,33,29,4,0.8787878787878788,0.8329554043839759,GPT4,mimiciii,radiology_report,PROMPT2_ICL_entailment
322,389,16,13,3,0.8125,12,6,6,0.5,0.6190476190476191,GPT4,mimiciii,radiology_report,PROMPT2_ICL_entailment
323,39,14,13,1,0.9285714285714286,10,7,3,0.7,0.7982456140350878,GPT4,mimiciii,radiology_report,PROMPT2_ICL_entailment
324,390,14,12,2,0.8571428571428571,14,14,0,1.0,0.923076923076923,GPT4,mimiciii,radiology_report,PROMPT2_ICL_entailment
325,391,11,11,0,1.0,13,8,5,0.6153846153846154,0.761904761904762,GPT4,mimiciii,radiology_report,PROMPT2_ICL_entailment
326,392,15,11,4,0.7333333333333333,15,8,7,0.5333333333333333,0.6175438596491227,GPT4,mimiciii,radiology_report,PROMPT2_ICL_entailment
327,393,22,15,7,0.6818181818181818,19,14,5,0.7368421052631579,0.7082630691399663,GPT4,mimiciii,radiology_report,PROMPT2_ICL_entailment
328,394,20,19,1,0.95,18,17,1,0.9444444444444444,0.9472140762463342,GPT4,mimiciii,radiology_report,PROMPT2_ICL_entailment
329,395,16,14,2,0.875,16,14,2,0.875,0.875,GPT4,mimiciii,radiology_report,PROMPT2_ICL_entailment
330,396,16,14,2,0.875,19,14,5,0.7368421052631579,0.7999999999999999,GPT4,mimiciii,radiology_report,PROMPT2_ICL_entailment
331,397,25,16,9,0.64,18,13,5,0.7222222222222222,0.6786296900489396,GPT4,mimiciii,radiology_report,PROMPT2_ICL_entailment
332,398,29,22,7,0.7586206896551724,21,16,5,0.7619047619047619,0.7602591792656588,GPT4,mimiciii,radiology_report,PROMPT2_ICL_entailment
333,399,16,12,4,0.75,19,14,5,0.7368421052631579,0.743362831858407,GPT4,mimiciii,radiology_report,PROMPT2_ICL_entailment
334,4,17,16,1,0.9411764705882352,16,13,3,0.8125,0.8721174004192872,GPT4,mimiciii,radiology_report,PROMPT2_ICL_entailment
335,40,16,14,2,0.875,17,11,6,0.6470588235294118,0.7439613526570048,GPT4,mimiciii,radiology_report,PROMPT2_ICL_entailment
336,400,11,10,1,0.9090909090909092,13,7,6,0.5384615384615384,0.6763285024154589,GPT4,mimiciii,radiology_report,PROMPT2_ICL_entailment
337,401,10,8,2,0.8,9,9,0,1.0,0.888888888888889,GPT4,mimiciii,radiology_report,PROMPT2_ICL_entailment
338,402,21,10,11,0.4761904761904761,20,15,5,0.75,0.58252427184466,GPT4,mimiciii,radiology_report,PROMPT2_ICL_entailment
339,403,16,16,0,1.0,18,13,5,0.7222222222222222,0.8387096774193548,GPT4,mimiciii,radiology_report,PROMPT2_ICL_entailment
340,404,18,16,2,0.8888888888888888,19,16,3,0.8421052631578947,0.8648648648648649,GPT4,mimiciii,radiology_report,PROMPT2_ICL_entailment
341,405,16,11,5,0.6875,14,11,3,0.7857142857142857,0.7333333333333334,GPT4,mimiciii,radiology_report,PROMPT2_ICL_entailment
342,406,22,14,8,0.6363636363636364,25,20,5,0.8,0.7088607594936709,GPT4,mimiciii,radiology_report,PROMPT2_ICL_entailment
343,407,23,16,7,0.6956521739130435,20,11,9,0.55,0.6143106457242583,GPT4,mimiciii,radiology_report,PROMPT2_ICL_entailment
344,408,19,16,3,0.8421052631578947,20,15,5,0.75,0.7933884297520661,GPT4,mimiciii,radiology_report,PROMPT2_ICL_entailment
345,409,19,14,5,0.7368421052631579,21,15,6,0.7142857142857143,0.7253886010362695,GPT4,mimiciii,radiology_report,PROMPT2_ICL_entailment
346,41,22,16,6,0.7272727272727273,26,18,8,0.6923076923076923,0.7093596059113301,GPT4,mimiciii,radiology_report,PROMPT2_ICL_entailment
347,410,19,19,0,1.0,20,14,6,0.7,0.8235294117647058,GPT4,mimiciii,radiology_report,PROMPT2_ICL_entailment
348,411,8,8,0,1.0,6,5,1,0.8333333333333334,0.9090909090909092,GPT4,mimiciii,radiology_report,PROMPT2_ICL_entailment
349,412,22,16,6,0.7272727272727273,26,21,5,0.8076923076923077,0.765375854214123,GPT4,mimiciii,radiology_report,PROMPT2_ICL_entailment
350,413,15,13,2,0.8666666666666667,14,11,3,0.7857142857142857,0.8242074927953891,GPT4,mimiciii,radiology_report,PROMPT2_ICL_entailment
351,414,25,18,7,0.72,28,23,5,0.8214285714285714,0.7673772011121409,GPT4,mimiciii,radiology_report,PROMPT2_ICL_entailment
352,415,18,15,3,0.8333333333333334,20,17,3,0.85,0.8415841584158417,GPT4,mimiciii,radiology_report,PROMPT2_ICL_entailment
353,416,18,17,1,0.9444444444444444,19,13,6,0.6842105263157895,0.7935368043087971,GPT4,mimiciii,radiology_report,PROMPT2_ICL_entailment
354,417,24,14,10,0.5833333333333334,20,15,5,0.75,0.6562499999999999,GPT4,mimiciii,radiology_report,PROMPT2_ICL_entailment
355,418,14,12,2,0.8571428571428571,14,9,5,0.6428571428571429,0.7346938775510204,GPT4,mimiciii,radiology_report,PROMPT2_ICL_entailment
356,419,20,14,6,0.7,16,13,3,0.8125,0.7520661157024793,GPT4,mimiciii,radiology_report,PROMPT2_ICL_entailment
357,42,16,13,3,0.8125,14,10,4,0.7142857142857143,0.7602339181286549,GPT4,mimiciii,radiology_report,PROMPT2_ICL_entailment
358,420,13,7,6,0.5384615384615384,15,9,6,0.6,0.5675675675675675,GPT4,mimiciii,radiology_report,PROMPT2_ICL_entailment
359,421,23,14,9,0.6086956521739131,23,18,5,0.782608695652174,0.6847826086956522,GPT4,mimiciii,radiology_report,PROMPT2_ICL_entailment
360,422,21,13,8,0.6190476190476191,20,15,5,0.75,0.6782608695652174,GPT4,mimiciii,radiology_report,PROMPT2_ICL_entailment
361,423,13,13,0,1.0,12,10,2,0.8333333333333334,0.9090909090909092,GPT4,mimiciii,radiology_report,PROMPT2_ICL_entailment
362,424,9,7,2,0.7777777777777778,9,6,3,0.6666666666666666,0.717948717948718,GPT4,mimiciii,radiology_report,PROMPT2_ICL_entailment
363,425,19,12,7,0.631578947368421,19,12,7,0.631578947368421,0.631578947368421,GPT4,mimiciii,radiology_report,PROMPT2_ICL_entailment
364,426,18,17,1,0.9444444444444444,16,12,4,0.75,0.8360655737704917,GPT4,mimiciii,radiology_report,PROMPT2_ICL_entailment
365,427,14,14,0,1.0,15,13,2,0.8666666666666667,0.9285714285714286,GPT4,mimiciii,radiology_report,PROMPT2_ICL_entailment
366,428,11,8,3,0.7272727272727273,15,14,1,0.9333333333333332,0.8175182481751825,GPT4,mimiciii,radiology_report,PROMPT2_ICL_entailment
367,429,13,10,3,0.7692307692307693,13,9,4,0.6923076923076923,0.728744939271255,GPT4,mimiciii,radiology_report,PROMPT2_ICL_entailment
368,43,10,10,0,1.0,7,5,2,0.7142857142857143,0.8333333333333333,GPT4,mimiciii,radiology_report,PROMPT2_ICL_entailment
369,430,9,9,0,1.0,7,5,2,0.7142857142857143,0.8333333333333333,GPT4,mimiciii,radiology_report,PROMPT2_ICL_entailment
370,431,15,4,11,0.2666666666666666,18,14,4,0.7777777777777778,0.3971631205673758,GPT4,mimiciii,radiology_report,PROMPT2_ICL_entailment
371,432,19,17,2,0.8947368421052632,13,10,3,0.7692307692307693,0.8272506082725061,GPT4,mimiciii,radiology_report,PROMPT2_ICL_entailment
372,433,17,14,3,0.8235294117647058,18,13,5,0.7222222222222222,0.7695560253699789,GPT4,mimiciii,radiology_report,PROMPT2_ICL_entailment
373,434,24,19,5,0.7916666666666666,27,18,9,0.6666666666666666,0.7238095238095237,GPT4,mimiciii,radiology_report,PROMPT2_ICL_entailment
374,435,11,7,4,0.6363636363636364,13,11,2,0.8461538461538461,0.7264150943396226,GPT4,mimiciii,radiology_report,PROMPT2_ICL_entailment
375,436,22,18,4,0.8181818181818182,25,21,4,0.84,0.8289473684210527,GPT4,mimiciii,radiology_report,PROMPT2_ICL_entailment
376,437,9,7,2,0.7777777777777778,7,5,2,0.7142857142857143,0.7446808510638298,GPT4,mimiciii,radiology_report,PROMPT2_ICL_entailment
377,438,21,16,5,0.7619047619047619,19,13,6,0.6842105263157895,0.7209705372616985,GPT4,mimiciii,radiology_report,PROMPT2_ICL_entailment
378,439,19,11,8,0.5789473684210527,22,21,1,0.9545454545454546,0.7207488299531981,GPT4,mimiciii,radiology_report,PROMPT2_ICL_entailment
379,44,11,10,1,0.9090909090909092,16,12,4,0.75,0.821917808219178,GPT4,mimiciii,radiology_report,PROMPT2_ICL_entailment
380,440,18,14,4,0.7777777777777778,19,14,5,0.7368421052631579,0.7567567567567567,GPT4,mimiciii,radiology_report,PROMPT2_ICL_entailment
381,441,20,14,6,0.7,17,15,2,0.8823529411764706,0.7806691449814126,GPT4,mimiciii,radiology_report,PROMPT2_ICL_entailment
382,442,11,10,1,0.9090909090909092,12,9,3,0.75,0.821917808219178,GPT4,mimiciii,radiology_report,PROMPT2_ICL_entailment
383,443,17,11,6,0.6470588235294118,21,13,8,0.6190476190476191,0.6327433628318585,GPT4,mimiciii,radiology_report,PROMPT2_ICL_entailment
384,444,11,11,0,1.0,8,5,3,0.625,0.7692307692307693,GPT4,mimiciii,radiology_report,PROMPT2_ICL_entailment
385,445,19,13,6,0.6842105263157895,22,18,4,0.8181818181818182,0.7452229299363058,GPT4,mimiciii,radiology_report,PROMPT2_ICL_entailment
386,446,23,14,9,0.6086956521739131,22,16,6,0.7272727272727273,0.6627218934911243,GPT4,mimiciii,radiology_report,PROMPT2_ICL_entailment
387,447,19,15,4,0.7894736842105263,14,11,3,0.7857142857142857,0.7875894988066825,GPT4,mimiciii,radiology_report,PROMPT2_ICL_entailment
388,448,26,24,2,0.9230769230769232,36,24,12,0.6666666666666666,0.7741935483870968,GPT4,mimiciii,radiology_report,PROMPT2_ICL_entailment
389,449,14,11,3,0.7857142857142857,9,8,1,0.8888888888888888,0.8341232227488152,GPT4,mimiciii,radiology_report,PROMPT2_ICL_entailment
390,45,16,7,9,0.4375,20,16,4,0.8,0.5656565656565656,GPT4,mimiciii,radiology_report,PROMPT2_ICL_entailment
391,450,22,17,5,0.7727272727272727,21,16,5,0.7619047619047619,0.7672778561354019,GPT4,mimiciii,radiology_report,PROMPT2_ICL_entailment
392,451,11,9,2,0.8181818181818182,10,8,2,0.8,0.8089887640449439,GPT4,mimiciii,radiology_report,PROMPT2_ICL_entailment
393,452,24,21,3,0.875,16,14,2,0.875,0.875,GPT4,mimiciii,radiology_report,PROMPT2_ICL_entailment
394,453,15,13,2,0.8666666666666667,14,12,2,0.8571428571428571,0.861878453038674,GPT4,mimiciii,radiology_report,PROMPT2_ICL_entailment
395,454,11,7,4,0.6363636363636364,10,5,5,0.5,0.56,GPT4,mimiciii,radiology_report,PROMPT2_ICL_entailment
396,455,16,14,2,0.875,16,11,5,0.6875,0.77,GPT4,mimiciii,radiology_report,PROMPT2_ICL_entailment
397,456,15,10,5,0.6666666666666666,21,18,3,0.8571428571428571,0.75,GPT4,mimiciii,radiology_report,PROMPT2_ICL_entailment
398,457,14,13,1,0.9285714285714286,12,8,4,0.6666666666666666,0.7761194029850746,GPT4,mimiciii,radiology_report,PROMPT2_ICL_entailment
399,458,18,15,3,0.8333333333333334,16,15,1,0.9375,0.8823529411764706,GPT4,mimiciii,radiology_report,PROMPT2_ICL_entailment
400,459,14,11,3,0.7857142857142857,13,9,4,0.6923076923076923,0.7360594795539033,GPT4,mimiciii,radiology_report,PROMPT2_ICL_entailment
401,46,17,15,2,0.8823529411764706,26,20,6,0.7692307692307693,0.8219178082191781,GPT4,mimiciii,radiology_report,PROMPT2_ICL_entailment
402,460,20,13,7,0.65,20,13,7,0.65,0.65,GPT4,mimiciii,radiology_report,PROMPT2_ICL_entailment
403,461,21,12,9,0.5714285714285714,22,15,7,0.6818181818181818,0.621761658031088,GPT4,mimiciii,radiology_report,PROMPT2_ICL_entailment
404,462,20,13,7,0.65,20,16,4,0.8,0.7172413793103448,GPT4,mimiciii,radiology_report,PROMPT2_ICL_entailment
405,463,13,12,1,0.9230769230769232,12,10,2,0.8333333333333334,0.8759124087591241,GPT4,mimiciii,radiology_report,PROMPT2_ICL_entailment
406,464,22,14,8,0.6363636363636364,25,17,8,0.68,0.6574585635359116,GPT4,mimiciii,radiology_report,PROMPT2_ICL_entailment
407,465,22,18,4,0.8181818181818182,33,24,9,0.7272727272727273,0.770053475935829,GPT4,mimiciii,radiology_report,PROMPT2_ICL_entailment
408,466,17,14,3,0.8235294117647058,22,20,2,0.9090909090909092,0.8641975308641976,GPT4,mimiciii,radiology_report,PROMPT2_ICL_entailment
409,467,15,15,0,1.0,14,12,2,0.8571428571428571,0.923076923076923,GPT4,mimiciii,radiology_report,PROMPT2_ICL_entailment
410,468,15,14,1,0.9333333333333332,18,15,3,0.8333333333333334,0.8805031446540881,GPT4,mimiciii,radiology_report,PROMPT2_ICL_entailment
411,469,21,15,6,0.7142857142857143,25,17,8,0.68,0.6967213114754098,GPT4,mimiciii,radiology_report,PROMPT2_ICL_entailment
412,47,19,19,0,1.0,15,11,4,0.7333333333333333,0.846153846153846,GPT4,mimiciii,radiology_report,PROMPT2_ICL_entailment
413,470,11,9,2,0.8181818181818182,15,13,2,0.8666666666666667,0.8417266187050358,GPT4,mimiciii,radiology_report,PROMPT2_ICL_entailment
414,471,24,16,8,0.6666666666666666,18,11,7,0.6111111111111112,0.6376811594202899,GPT4,mimiciii,radiology_report,PROMPT2_ICL_entailment
415,472,14,12,2,0.8571428571428571,16,10,6,0.625,0.7228915662650602,GPT4,mimiciii,radiology_report,PROMPT2_ICL_entailment
416,473,13,11,2,0.8461538461538461,11,8,3,0.7272727272727273,0.7822222222222223,GPT4,mimiciii,radiology_report,PROMPT2_ICL_entailment
417,474,23,21,2,0.9130434782608696,25,21,4,0.84,0.8749999999999999,GPT4,mimiciii,radiology_report,PROMPT2_ICL_entailment
418,475,7,7,0,1.0,7,5,2,0.7142857142857143,0.8333333333333333,GPT4,mimiciii,radiology_report,PROMPT2_ICL_entailment
419,476,20,15,5,0.75,12,11,1,0.9166666666666666,0.8250000000000001,GPT4,mimiciii,radiology_report,PROMPT2_ICL_entailment
420,477,19,14,5,0.7368421052631579,16,11,5,0.6875,0.7113163972286374,GPT4,mimiciii,radiology_report,PROMPT2_ICL_entailment
421,478,19,18,1,0.9473684210526316,21,17,4,0.8095238095238095,0.8730385164051354,GPT4,mimiciii,radiology_report,PROMPT2_ICL_entailment
422,479,19,17,2,0.8947368421052632,22,16,6,0.7272727272727273,0.8023598820058998,GPT4,mimiciii,radiology_report,PROMPT2_ICL_entailment
423,48,15,11,4,0.7333333333333333,21,15,6,0.7142857142857143,0.7236842105263158,GPT4,mimiciii,radiology_report,PROMPT2_ICL_entailment
424,480,12,8,4,0.6666666666666666,10,6,4,0.6,0.631578947368421,GPT4,mimiciii,radiology_report,PROMPT2_ICL_entailment
425,481,20,11,9,0.55,17,13,4,0.7647058823529411,0.639821029082774,GPT4,mimiciii,radiology_report,PROMPT2_ICL_entailment
426,482,21,10,11,0.4761904761904761,19,15,4,0.7894736842105263,0.594059405940594,GPT4,mimiciii,radiology_report,PROMPT2_ICL_entailment
427,483,18,18,0,1.0,27,19,8,0.7037037037037037,0.8260869565217391,GPT4,mimiciii,radiology_report,PROMPT2_ICL_entailment
428,484,10,10,0,1.0,13,8,5,0.6153846153846154,0.761904761904762,GPT4,mimiciii,radiology_report,PROMPT2_ICL_entailment
429,485,21,20,1,0.9523809523809524,27,18,9,0.6666666666666666,0.7843137254901961,GPT4,mimiciii,radiology_report,PROMPT2_ICL_entailment
430,486,15,12,3,0.8,11,8,3,0.7272727272727273,0.761904761904762,GPT4,mimiciii,radiology_report,PROMPT2_ICL_entailment
431,487,22,14,8,0.6363636363636364,20,15,5,0.75,0.6885245901639345,GPT4,mimiciii,radiology_report,PROMPT2_ICL_entailment
432,488,17,16,1,0.9411764705882352,15,12,3,0.8,0.8648648648648648,GPT4,mimiciii,radiology_report,PROMPT2_ICL_entailment
433,489,19,16,3,0.8421052631578947,18,12,6,0.6666666666666666,0.744186046511628,GPT4,mimiciii,radiology_report,PROMPT2_ICL_entailment
434,49,24,21,3,0.875,24,19,5,0.7916666666666666,0.8312499999999999,GPT4,mimiciii,radiology_report,PROMPT2_ICL_entailment
435,490,8,7,1,0.875,8,4,4,0.5,0.6363636363636364,GPT4,mimiciii,radiology_report,PROMPT2_ICL_entailment
436,491,18,16,2,0.8888888888888888,17,9,8,0.5294117647058824,0.663594470046083,GPT4,mimiciii,radiology_report,PROMPT2_ICL_entailment
437,492,15,12,3,0.8,13,8,5,0.6153846153846154,0.6956521739130435,GPT4,mimiciii,radiology_report,PROMPT2_ICL_entailment
438,493,14,13,1,0.9285714285714286,9,7,2,0.7777777777777778,0.8465116279069766,GPT4,mimiciii,radiology_report,PROMPT2_ICL_entailment
439,494,11,11,0,1.0,8,5,3,0.625,0.7692307692307693,GPT4,mimiciii,radiology_report,PROMPT2_ICL_entailment
440,495,10,10,0,1.0,12,10,2,0.8333333333333334,0.9090909090909092,GPT4,mimiciii,radiology_report,PROMPT2_ICL_entailment
441,496,21,21,0,1.0,36,21,15,0.5833333333333334,0.7368421052631579,GPT4,mimiciii,radiology_report,PROMPT2_ICL_entailment
442,497,17,14,3,0.8235294117647058,25,14,11,0.56,0.6666666666666666,GPT4,mimiciii,radiology_report,PROMPT2_ICL_entailment
443,498,22,16,6,0.7272727272727273,22,17,5,0.7727272727272727,0.7493112947658402,GPT4,mimiciii,radiology_report,PROMPT2_ICL_entailment
444,499,19,12,7,0.631578947368421,17,13,4,0.7647058823529411,0.6917960088691795,GPT4,mimiciii,radiology_report,PROMPT2_ICL_entailment
445,5,18,14,4,0.7777777777777778,22,16,6,0.7272727272727273,0.7516778523489932,GPT4,mimiciii,radiology_report,PROMPT2_ICL_entailment
446,50,15,12,3,0.8,15,10,5,0.6666666666666666,0.7272727272727272,GPT4,mimiciii,radiology_report,PROMPT2_ICL_entailment
447,51,11,10,1,0.9090909090909092,13,9,4,0.6923076923076923,0.7860262008733625,GPT4,mimiciii,radiology_report,PROMPT2_ICL_entailment
448,52,17,11,6,0.6470588235294118,21,17,4,0.8095238095238095,0.7192307692307692,GPT4,mimiciii,radiology_report,PROMPT2_ICL_entailment
449,53,17,16,1,0.9411764705882352,12,9,3,0.75,0.8347826086956521,GPT4,mimiciii,radiology_report,PROMPT2_ICL_entailment
450,54,12,10,2,0.8333333333333334,10,4,6,0.4,0.5405405405405406,GPT4,mimiciii,radiology_report,PROMPT2_ICL_entailment
451,55,20,13,7,0.65,18,14,4,0.7777777777777778,0.7081712062256809,GPT4,mimiciii,radiology_report,PROMPT2_ICL_entailment
452,56,17,12,5,0.7058823529411765,21,16,5,0.7619047619047619,0.7328244274809159,GPT4,mimiciii,radiology_report,PROMPT2_ICL_entailment
453,57,10,8,2,0.8,10,7,3,0.7,0.7466666666666666,GPT4,mimiciii,radiology_report,PROMPT2_ICL_entailment
454,58,17,17,0,1.0,16,12,4,0.75,0.8571428571428571,GPT4,mimiciii,radiology_report,PROMPT2_ICL_entailment
455,59,15,15,0,1.0,16,12,4,0.75,0.8571428571428571,GPT4,mimiciii,radiology_report,PROMPT2_ICL_entailment
456,6,9,9,0,1.0,8,5,3,0.625,0.7692307692307693,GPT4,mimiciii,radiology_report,PROMPT2_ICL_entailment
457,60,17,15,2,0.8823529411764706,19,13,6,0.6842105263157895,0.7707509881422925,GPT4,mimiciii,radiology_report,PROMPT2_ICL_entailment
458,61,18,15,3,0.8333333333333334,22,17,5,0.7727272727272727,0.8018867924528302,GPT4,mimiciii,radiology_report,PROMPT2_ICL_entailment
459,62,18,12,6,0.6666666666666666,13,8,5,0.6153846153846154,0.64,GPT4,mimiciii,radiology_report,PROMPT2_ICL_entailment
460,63,13,13,0,1.0,15,11,4,0.7333333333333333,0.846153846153846,GPT4,mimiciii,radiology_report,PROMPT2_ICL_entailment
461,64,24,19,5,0.7916666666666666,20,15,5,0.75,0.7702702702702704,GPT4,mimiciii,radiology_report,PROMPT2_ICL_entailment
462,65,20,15,5,0.75,18,14,4,0.7777777777777778,0.7636363636363638,GPT4,mimiciii,radiology_report,PROMPT2_ICL_entailment
463,66,22,19,3,0.8636363636363636,34,27,7,0.7941176470588235,0.8274193548387097,GPT4,mimiciii,radiology_report,PROMPT2_ICL_entailment
464,67,24,21,3,0.875,28,25,3,0.8928571428571429,0.8838383838383839,GPT4,mimiciii,radiology_report,PROMPT2_ICL_entailment
465,68,23,19,4,0.8260869565217391,35,27,8,0.7714285714285715,0.7978227060653189,GPT4,mimiciii,radiology_report,PROMPT2_ICL_entailment
466,69,23,15,8,0.6521739130434783,31,25,6,0.8064516129032258,0.7211538461538461,GPT4,mimiciii,radiology_report,PROMPT2_ICL_entailment
467,7,14,11,3,0.7857142857142857,16,12,4,0.75,0.7674418604651163,GPT4,mimiciii,radiology_report,PROMPT2_ICL_entailment
468,70,19,12,7,0.631578947368421,17,16,1,0.9411764705882352,0.7559055118110236,GPT4,mimiciii,radiology_report,PROMPT2_ICL_entailment
469,71,13,11,2,0.8461538461538461,18,10,8,0.5555555555555556,0.6707317073170732,GPT4,mimiciii,radiology_report,PROMPT2_ICL_entailment
470,72,18,15,3,0.8333333333333334,13,11,2,0.8461538461538461,0.8396946564885497,GPT4,mimiciii,radiology_report,PROMPT2_ICL_entailment
471,73,23,15,8,0.6521739130434783,34,21,13,0.6176470588235294,0.6344410876132931,GPT4,mimiciii,radiology_report,PROMPT2_ICL_entailment
472,74,19,14,5,0.7368421052631579,18,13,5,0.7222222222222222,0.7294589178356713,GPT4,mimiciii,radiology_report,PROMPT2_ICL_entailment
473,75,18,14,4,0.7777777777777778,12,9,3,0.75,0.7636363636363638,GPT4,mimiciii,radiology_report,PROMPT2_ICL_entailment
474,76,15,13,2,0.8666666666666667,14,12,2,0.8571428571428571,0.861878453038674,GPT4,mimiciii,radiology_report,PROMPT2_ICL_entailment
475,77,24,17,7,0.7083333333333334,26,18,8,0.6923076923076923,0.7002288329519452,GPT4,mimiciii,radiology_report,PROMPT2_ICL_entailment
476,78,25,15,10,0.6,33,26,7,0.7878787878787878,0.6812227074235808,GPT4,mimiciii,radiology_report,PROMPT2_ICL_entailment
477,79,17,17,0,1.0,17,13,4,0.7647058823529411,0.8666666666666666,GPT4,mimiciii,radiology_report,PROMPT2_ICL_entailment
478,8,22,21,1,0.9545454545454546,15,13,2,0.8666666666666667,0.9084858569051582,GPT4,mimiciii,radiology_report,PROMPT2_ICL_entailment
479,80,18,11,7,0.6111111111111112,25,17,8,0.68,0.6437177280550774,GPT4,mimiciii,radiology_report,PROMPT2_ICL_entailment
480,81,15,12,3,0.8,15,11,4,0.7333333333333333,0.7652173913043478,GPT4,mimiciii,radiology_report,PROMPT2_ICL_entailment
481,82,14,10,4,0.7142857142857143,14,12,2,0.8571428571428571,0.7792207792207793,GPT4,mimiciii,radiology_report,PROMPT2_ICL_entailment
482,83,18,10,8,0.5555555555555556,17,12,5,0.7058823529411765,0.6217616580310882,GPT4,mimiciii,radiology_report,PROMPT2_ICL_entailment
483,84,17,10,7,0.5882352941176471,20,16,4,0.8,0.6779661016949153,GPT4,mimiciii,radiology_report,PROMPT2_ICL_entailment
484,85,18,15,3,0.8333333333333334,14,11,3,0.7857142857142857,0.8088235294117647,GPT4,mimiciii,radiology_report,PROMPT2_ICL_entailment
485,86,15,12,3,0.8,10,7,3,0.7,0.7466666666666666,GPT4,mimiciii,radiology_report,PROMPT2_ICL_entailment
486,87,16,14,2,0.875,14,10,4,0.7142857142857143,0.7865168539325842,GPT4,mimiciii,radiology_report,PROMPT2_ICL_entailment
487,88,14,13,1,0.9285714285714286,19,14,5,0.7368421052631579,0.8216704288939053,GPT4,mimiciii,radiology_report,PROMPT2_ICL_entailment
488,89,21,18,3,0.8571428571428571,18,15,3,0.8333333333333334,0.8450704225352113,GPT4,mimiciii,radiology_report,PROMPT2_ICL_entailment
489,9,12,11,1,0.9166666666666666,13,9,4,0.6923076923076923,0.7888446215139442,GPT4,mimiciii,radiology_report,PROMPT2_ICL_entailment
490,90,14,13,1,0.9285714285714286,14,11,3,0.7857142857142857,0.851190476190476,GPT4,mimiciii,radiology_report,PROMPT2_ICL_entailment
491,91,14,14,0,1.0,13,9,4,0.6923076923076923,0.8181818181818181,GPT4,mimiciii,radiology_report,PROMPT2_ICL_entailment
492,92,20,16,4,0.8,21,16,5,0.7619047619047619,0.7804878048780488,GPT4,mimiciii,radiology_report,PROMPT2_ICL_entailment
493,93,15,14,1,0.9333333333333332,15,10,5,0.6666666666666666,0.7777777777777778,GPT4,mimiciii,radiology_report,PROMPT2_ICL_entailment
494,94,23,14,9,0.6086956521739131,28,22,6,0.7857142857142857,0.6859688195991092,GPT4,mimiciii,radiology_report,PROMPT2_ICL_entailment
495,95,17,14,3,0.8235294117647058,18,9,9,0.5,0.6222222222222222,GPT4,mimiciii,radiology_report,PROMPT2_ICL_entailment
496,96,16,12,4,0.75,21,16,5,0.7619047619047619,0.7559055118110236,GPT4,mimiciii,radiology_report,PROMPT2_ICL_entailment
497,97,14,11,3,0.7857142857142857,23,18,5,0.782608695652174,0.7841584158415842,GPT4,mimiciii,radiology_report,PROMPT2_ICL_entailment
498,98,22,15,7,0.6818181818181818,19,14,5,0.7368421052631579,0.7082630691399663,GPT4,mimiciii,radiology_report,PROMPT2_ICL_entailment
499,99,17,15,2,0.8823529411764706,13,11,2,0.8461538461538461,0.8638743455497382,GPT4,mimiciii,radiology_report,PROMPT2_ICL_entailment
0,0,23,14,9,0.6086956521739131,21,15,6,0.7142857142857143,0.6572769953051643,GPT4,mimiciii,radiology_report,PROMPT2_entailment
1,1,13,12,1,0.9230769230769232,15,10,5,0.6666666666666666,0.7741935483870968,GPT4,mimiciii,radiology_report,PROMPT2_entailment
2,10,13,11,2,0.8461538461538461,18,15,3,0.8333333333333334,0.8396946564885497,GPT4,mimiciii,radiology_report,PROMPT2_entailment
3,100,12,11,1,0.9166666666666666,9,9,0,1.0,0.9565217391304348,GPT4,mimiciii,radiology_report,PROMPT2_entailment
4,101,15,13,2,0.8666666666666667,15,13,2,0.8666666666666667,0.8666666666666667,GPT4,mimiciii,radiology_report,PROMPT2_entailment
5,102,13,11,2,0.8461538461538461,16,10,6,0.625,0.7189542483660131,GPT4,mimiciii,radiology_report,PROMPT2_entailment
6,103,17,12,5,0.7058823529411765,19,15,4,0.7894736842105263,0.7453416149068324,GPT4,mimiciii,radiology_report,PROMPT2_entailment
7,104,17,9,8,0.5294117647058824,17,11,6,0.6470588235294118,0.5823529411764706,GPT4,mimiciii,radiology_report,PROMPT2_entailment
8,105,6,6,0,1.0,8,6,2,0.75,0.8571428571428571,GPT4,mimiciii,radiology_report,PROMPT2_entailment
9,106,12,9,3,0.75,12,10,2,0.8333333333333334,0.7894736842105262,GPT4,mimiciii,radiology_report,PROMPT2_entailment
10,107,16,13,3,0.8125,19,12,7,0.631578947368421,0.7107061503416856,GPT4,mimiciii,radiology_report,PROMPT2_entailment
11,108,11,9,2,0.8181818181818182,13,10,3,0.7692307692307693,0.7929515418502203,GPT4,mimiciii,radiology_report,PROMPT2_entailment
12,109,18,9,9,0.5,20,18,2,0.9,0.6428571428571429,GPT4,mimiciii,radiology_report,PROMPT2_entailment
13,11,16,14,2,0.875,24,16,8,0.6666666666666666,0.7567567567567567,GPT4,mimiciii,radiology_report,PROMPT2_entailment
14,110,14,8,6,0.5714285714285714,17,11,6,0.6470588235294118,0.6068965517241379,GPT4,mimiciii,radiology_report,PROMPT2_entailment
15,111,14,9,5,0.6428571428571429,20,14,6,0.7,0.6702127659574467,GPT4,mimiciii,radiology_report,PROMPT2_entailment
16,112,14,12,2,0.8571428571428571,14,8,6,0.5714285714285714,0.6857142857142857,GPT4,mimiciii,radiology_report,PROMPT2_entailment
17,113,16,5,11,0.3125,20,16,4,0.8,0.449438202247191,GPT4,mimiciii,radiology_report,PROMPT2_entailment
18,114,19,7,12,0.3684210526315789,23,19,4,0.8260869565217391,0.5095785440613027,GPT4,mimiciii,radiology_report,PROMPT2_entailment
19,115,15,14,1,0.9333333333333332,20,9,11,0.45,0.6072289156626507,GPT4,mimiciii,radiology_report,PROMPT2_entailment
20,116,11,9,2,0.8181818181818182,13,10,3,0.7692307692307693,0.7929515418502203,GPT4,mimiciii,radiology_report,PROMPT2_entailment
21,117,12,7,5,0.5833333333333334,16,12,4,0.75,0.6562499999999999,GPT4,mimiciii,radiology_report,PROMPT2_entailment
22,118,21,11,10,0.5238095238095238,24,20,4,0.8333333333333334,0.6432748538011697,GPT4,mimiciii,radiology_report,PROMPT2_entailment
23,119,16,14,2,0.875,17,11,6,0.6470588235294118,0.7439613526570048,GPT4,mimiciii,radiology_report,PROMPT2_entailment
24,12,11,11,0,1.0,17,14,3,0.8235294117647058,0.9032258064516128,GPT4,mimiciii,radiology_report,PROMPT2_entailment
25,120,16,10,6,0.625,16,11,5,0.6875,0.6547619047619048,GPT4,mimiciii,radiology_report,PROMPT2_entailment
26,121,20,13,7,0.65,26,18,8,0.6923076923076923,0.670487106017192,GPT4,mimiciii,radiology_report,PROMPT2_entailment
27,122,13,11,2,0.8461538461538461,20,17,3,0.85,0.8480725623582767,GPT4,mimiciii,radiology_report,PROMPT2_entailment
28,123,11,8,3,0.7272727272727273,13,10,3,0.7692307692307693,0.7476635514018691,GPT4,mimiciii,radiology_report,PROMPT2_entailment
29,124,11,9,2,0.8181818181818182,12,7,5,0.5833333333333334,0.6810810810810811,GPT4,mimiciii,radiology_report,PROMPT2_entailment
30,125,19,13,6,0.6842105263157895,23,17,6,0.7391304347826086,0.7106109324758841,GPT4,mimiciii,radiology_report,PROMPT2_entailment
31,126,10,8,2,0.8,9,7,2,0.7777777777777778,0.7887323943661971,GPT4,mimiciii,radiology_report,PROMPT2_entailment
32,127,34,33,1,0.9705882352941176,50,30,20,0.6,0.7415730337078651,GPT4,mimiciii,radiology_report,PROMPT2_entailment
33,128,10,6,4,0.6,14,10,4,0.7142857142857143,0.6521739130434783,GPT4,mimiciii,radiology_report,PROMPT2_entailment
34,129,10,8,2,0.8,16,10,6,0.625,0.7017543859649122,GPT4,mimiciii,radiology_report,PROMPT2_entailment
35,13,13,9,4,0.6923076923076923,17,16,1,0.9411764705882352,0.7977839335180056,GPT4,mimiciii,radiology_report,PROMPT2_entailment
36,130,22,21,1,0.9545454545454546,29,16,13,0.5517241379310345,0.6992715920915712,GPT4,mimiciii,radiology_report,PROMPT2_entailment
37,131,13,12,1,0.9230769230769232,45,39,6,0.8666666666666667,0.8939828080229226,GPT4,mimiciii,radiology_report,PROMPT2_entailment
38,132,17,6,11,0.3529411764705882,23,12,11,0.5217391304347826,0.4210526315789474,GPT4,mimiciii,radiology_report,PROMPT2_entailment
39,133,17,12,5,0.7058823529411765,21,18,3,0.8571428571428571,0.7741935483870968,GPT4,mimiciii,radiology_report,PROMPT2_entailment
40,134,14,9,5,0.6428571428571429,23,18,5,0.782608695652174,0.7058823529411765,GPT4,mimiciii,radiology_report,PROMPT2_entailment
41,135,15,14,1,0.9333333333333332,20,16,4,0.8,0.8615384615384616,GPT4,mimiciii,radiology_report,PROMPT2_entailment
42,136,10,9,1,0.9,14,9,5,0.6428571428571429,0.75,GPT4,mimiciii,radiology_report,PROMPT2_entailment
43,137,10,10,0,1.0,10,8,2,0.8,0.888888888888889,GPT4,mimiciii,radiology_report,PROMPT2_entailment
44,138,15,13,2,0.8666666666666667,14,9,5,0.6428571428571429,0.7381703470031546,GPT4,mimiciii,radiology_report,PROMPT2_entailment
45,139,9,7,2,0.7777777777777778,13,10,3,0.7692307692307693,0.7734806629834255,GPT4,mimiciii,radiology_report,PROMPT2_entailment
46,14,9,9,0,1.0,12,10,2,0.8333333333333334,0.9090909090909092,GPT4,mimiciii,radiology_report,PROMPT2_entailment
47,140,13,9,4,0.6923076923076923,18,15,3,0.8333333333333334,0.7563025210084034,GPT4,mimiciii,radiology_report,PROMPT2_entailment
48,141,15,11,4,0.7333333333333333,16,9,7,0.5625,0.6366559485530546,GPT4,mimiciii,radiology_report,PROMPT2_entailment
49,142,11,8,3,0.7272727272727273,14,13,1,0.9285714285714286,0.8156862745098039,GPT4,mimiciii,radiology_report,PROMPT2_entailment
50,143,19,17,2,0.8947368421052632,32,21,11,0.65625,0.7571580063626723,GPT4,mimiciii,radiology_report,PROMPT2_entailment
51,144,13,12,1,0.9230769230769232,26,18,8,0.6923076923076923,0.7912087912087913,GPT4,mimiciii,radiology_report,PROMPT2_entailment
52,145,15,13,2,0.8666666666666667,18,13,5,0.7222222222222222,0.7878787878787877,GPT4,mimiciii,radiology_report,PROMPT2_entailment
53,146,9,9,0,1.0,11,7,4,0.6363636363636364,0.7777777777777778,GPT4,mimiciii,radiology_report,PROMPT2_entailment
54,147,10,9,1,0.9,10,9,1,0.9,0.9,GPT4,mimiciii,radiology_report,PROMPT2_entailment
55,148,17,15,2,0.8823529411764706,32,21,11,0.65625,0.7526881720430106,GPT4,mimiciii,radiology_report,PROMPT2_entailment
56,149,19,11,8,0.5789473684210527,20,15,5,0.75,0.6534653465346535,GPT4,mimiciii,radiology_report,PROMPT2_entailment
57,15,22,17,5,0.7727272727272727,29,24,5,0.8275862068965517,0.7992164544564152,GPT4,mimiciii,radiology_report,PROMPT2_entailment
58,150,16,7,9,0.4375,14,12,2,0.8571428571428571,0.5793103448275861,GPT4,mimiciii,radiology_report,PROMPT2_entailment
59,151,11,8,3,0.7272727272727273,15,10,5,0.6666666666666666,0.6956521739130435,GPT4,mimiciii,radiology_report,PROMPT2_entailment
60,152,18,11,7,0.6111111111111112,18,12,6,0.6666666666666666,0.6376811594202899,GPT4,mimiciii,radiology_report,PROMPT2_entailment
61,153,12,12,0,1.0,16,12,4,0.75,0.8571428571428571,GPT4,mimiciii,radiology_report,PROMPT2_entailment
62,154,18,13,5,0.7222222222222222,23,19,4,0.8260869565217391,0.7706708268330733,GPT4,mimiciii,radiology_report,PROMPT2_entailment
63,155,28,28,0,1.0,47,40,7,0.851063829787234,0.9195402298850576,GPT4,mimiciii,radiology_report,PROMPT2_entailment
64,156,17,11,6,0.6470588235294118,20,14,6,0.7,0.6724890829694322,GPT4,mimiciii,radiology_report,PROMPT2_entailment
65,157,11,9,2,0.8181818181818182,12,10,2,0.8333333333333334,0.8256880733944955,GPT4,mimiciii,radiology_report,PROMPT2_entailment
66,158,6,5,1,0.8333333333333334,6,4,2,0.6666666666666666,0.7407407407407408,GPT4,mimiciii,radiology_report,PROMPT2_entailment
67,159,11,9,2,0.8181818181818182,13,11,2,0.8461538461538461,0.8319327731092436,GPT4,mimiciii,radiology_report,PROMPT2_entailment
68,16,16,14,2,0.875,17,12,5,0.7058823529411765,0.7813953488372093,GPT4,mimiciii,radiology_report,PROMPT2_entailment
69,160,15,10,5,0.6666666666666666,12,10,2,0.8333333333333334,0.7407407407407408,GPT4,mimiciii,radiology_report,PROMPT2_entailment
70,161,14,11,3,0.7857142857142857,13,11,2,0.8461538461538461,0.8148148148148148,GPT4,mimiciii,radiology_report,PROMPT2_entailment
71,162,13,12,1,0.9230769230769232,11,9,2,0.8181818181818182,0.8674698795180724,GPT4,mimiciii,radiology_report,PROMPT2_entailment
72,163,10,10,0,1.0,8,5,3,0.625,0.7692307692307693,GPT4,mimiciii,radiology_report,PROMPT2_entailment
73,164,11,9,2,0.8181818181818182,10,8,2,0.8,0.8089887640449439,GPT4,mimiciii,radiology_report,PROMPT2_entailment
74,165,22,15,7,0.6818181818181818,31,22,9,0.7096774193548387,0.6954689146469968,GPT4,mimiciii,radiology_report,PROMPT2_entailment
75,166,20,15,5,0.75,26,21,5,0.8076923076923077,0.7777777777777779,GPT4,mimiciii,radiology_report,PROMPT2_entailment
76,167,8,7,1,0.875,10,7,3,0.7,0.7777777777777777,GPT4,mimiciii,radiology_report,PROMPT2_entailment
77,168,10,8,2,0.8,13,7,6,0.5384615384615384,0.6436781609195402,GPT4,mimiciii,radiology_report,PROMPT2_entailment
78,169,16,11,5,0.6875,22,19,3,0.8636363636363636,0.7655677655677655,GPT4,mimiciii,radiology_report,PROMPT2_entailment
79,17,6,6,0,1.0,12,10,2,0.8333333333333334,0.9090909090909092,GPT4,mimiciii,radiology_report,PROMPT2_entailment
80,170,15,13,2,0.8666666666666667,24,18,6,0.75,0.8041237113402062,GPT4,mimiciii,radiology_report,PROMPT2_entailment
81,171,7,6,1,0.8571428571428571,7,6,1,0.8571428571428571,0.8571428571428571,GPT4,mimiciii,radiology_report,PROMPT2_entailment
82,172,9,6,3,0.6666666666666666,14,10,4,0.7142857142857143,0.689655172413793,GPT4,mimiciii,radiology_report,PROMPT2_entailment
83,173,12,10,2,0.8333333333333334,12,10,2,0.8333333333333334,0.8333333333333334,GPT4,mimiciii,radiology_report,PROMPT2_entailment
84,174,12,11,1,0.9166666666666666,20,15,5,0.75,0.8250000000000001,GPT4,mimiciii,radiology_report,PROMPT2_entailment
85,175,9,9,0,1.0,8,6,2,0.75,0.8571428571428571,GPT4,mimiciii,radiology_report,PROMPT2_entailment
86,176,16,13,3,0.8125,19,15,4,0.7894736842105263,0.8008213552361396,GPT4,mimiciii,radiology_report,PROMPT2_entailment
87,177,18,15,3,0.8333333333333334,16,12,4,0.75,0.7894736842105262,GPT4,mimiciii,radiology_report,PROMPT2_entailment
88,178,19,15,4,0.7894736842105263,25,21,4,0.84,0.8139534883720929,GPT4,mimiciii,radiology_report,PROMPT2_entailment
89,179,10,10,0,1.0,20,10,10,0.5,0.6666666666666666,GPT4,mimiciii,radiology_report,PROMPT2_entailment
90,18,15,14,1,0.9333333333333332,17,11,6,0.6470588235294118,0.7642679900744417,GPT4,mimiciii,radiology_report,PROMPT2_entailment
91,180,11,10,1,0.9090909090909092,11,10,1,0.9090909090909092,0.9090909090909092,GPT4,mimiciii,radiology_report,PROMPT2_entailment
92,181,15,7,8,0.4666666666666667,26,17,9,0.6538461538461539,0.5446224256292906,GPT4,mimiciii,radiology_report,PROMPT2_entailment
93,182,15,13,2,0.8666666666666667,23,14,9,0.6086956521739131,0.7151277013752457,GPT4,mimiciii,radiology_report,PROMPT2_entailment
94,183,10,8,2,0.8,17,13,4,0.7647058823529411,0.7819548872180452,GPT4,mimiciii,radiology_report,PROMPT2_entailment
95,184,11,11,0,1.0,15,14,1,0.9333333333333332,0.9655172413793104,GPT4,mimiciii,radiology_report,PROMPT2_entailment
96,185,6,6,0,1.0,6,4,2,0.6666666666666666,0.8,GPT4,mimiciii,radiology_report,PROMPT2_entailment
97,186,21,19,2,0.9047619047619048,26,20,6,0.7692307692307693,0.8315098468271336,GPT4,mimiciii,radiology_report,PROMPT2_entailment
98,187,18,15,3,0.8333333333333334,14,11,3,0.7857142857142857,0.8088235294117647,GPT4,mimiciii,radiology_report,PROMPT2_entailment
99,188,23,18,5,0.782608695652174,22,17,5,0.7727272727272727,0.7776365946632783,GPT4,mimiciii,radiology_report,PROMPT2_entailment
100,189,12,11,1,0.9166666666666666,15,12,3,0.8,0.854368932038835,GPT4,mimiciii,radiology_report,PROMPT2_entailment
101,19,10,9,1,0.9,14,12,2,0.8571428571428571,0.8780487804878048,GPT4,mimiciii,radiology_report,PROMPT2_entailment
102,190,12,11,1,0.9166666666666666,17,13,4,0.7647058823529411,0.8338192419825073,GPT4,mimiciii,radiology_report,PROMPT2_entailment
103,191,19,10,9,0.5263157894736842,15,12,3,0.8,0.6349206349206348,GPT4,mimiciii,radiology_report,PROMPT2_entailment
104,192,25,19,6,0.76,28,20,8,0.7142857142857143,0.7364341085271319,GPT4,mimiciii,radiology_report,PROMPT2_entailment
105,193,16,14,2,0.875,14,11,3,0.7857142857142857,0.8279569892473119,GPT4,mimiciii,radiology_report,PROMPT2_entailment
106,194,24,23,1,0.9583333333333334,49,23,26,0.4693877551020408,0.6301369863013699,GPT4,mimiciii,radiology_report,PROMPT2_entailment
107,195,18,12,6,0.6666666666666666,21,15,6,0.7142857142857143,0.689655172413793,GPT4,mimiciii,radiology_report,PROMPT2_entailment
108,196,13,8,5,0.6153846153846154,18,13,5,0.7222222222222222,0.6645367412140575,GPT4,mimiciii,radiology_report,PROMPT2_entailment
109,197,9,8,1,0.8888888888888888,15,13,2,0.8666666666666667,0.8776371308016878,GPT4,mimiciii,radiology_report,PROMPT2_entailment
110,198,10,9,1,0.9,9,7,2,0.7777777777777778,0.8344370860927153,GPT4,mimiciii,radiology_report,PROMPT2_entailment
111,199,24,18,6,0.75,23,18,5,0.782608695652174,0.7659574468085107,GPT4,mimiciii,radiology_report,PROMPT2_entailment
112,2,12,10,2,0.8333333333333334,15,9,6,0.6,0.6976744186046512,GPT4,mimiciii,radiology_report,PROMPT2_entailment
113,20,18,18,0,1.0,42,31,11,0.7380952380952381,0.8493150684931507,GPT4,mimiciii,radiology_report,PROMPT2_entailment
114,200,15,13,2,0.8666666666666667,14,12,2,0.8571428571428571,0.861878453038674,GPT4,mimiciii,radiology_report,PROMPT2_entailment
115,201,15,11,4,0.7333333333333333,18,15,3,0.8333333333333334,0.7801418439716311,GPT4,mimiciii,radiology_report,PROMPT2_entailment
116,202,18,16,2,0.8888888888888888,25,19,6,0.76,0.8194070080862534,GPT4,mimiciii,radiology_report,PROMPT2_entailment
117,203,21,9,12,0.4285714285714285,19,15,4,0.7894736842105263,0.5555555555555555,GPT4,mimiciii,radiology_report,PROMPT2_entailment
118,204,16,13,3,0.8125,23,21,2,0.9130434782608696,0.8598425196850392,GPT4,mimiciii,radiology_report,PROMPT2_entailment
119,205,15,12,3,0.8,14,11,3,0.7857142857142857,0.7927927927927927,GPT4,mimiciii,radiology_report,PROMPT2_entailment
120,206,17,13,4,0.7647058823529411,13,11,2,0.8461538461538461,0.8033707865168538,GPT4,mimiciii,radiology_report,PROMPT2_entailment
121,207,9,9,0,1.0,9,7,2,0.7777777777777778,0.8750000000000001,GPT4,mimiciii,radiology_report,PROMPT2_entailment
122,208,17,13,4,0.7647058823529411,18,16,2,0.8888888888888888,0.8221343873517786,GPT4,mimiciii,radiology_report,PROMPT2_entailment
123,209,16,13,3,0.8125,16,12,4,0.75,0.78,GPT4,mimiciii,radiology_report,PROMPT2_entailment
124,21,26,21,5,0.8076923076923077,27,12,15,0.4444444444444444,0.5733788395904437,GPT4,mimiciii,radiology_report,PROMPT2_entailment
125,210,11,10,1,0.9090909090909092,14,10,4,0.7142857142857143,0.8,GPT4,mimiciii,radiology_report,PROMPT2_entailment
126,211,11,9,2,0.8181818181818182,13,9,4,0.6923076923076923,0.7500000000000001,GPT4,mimiciii,radiology_report,PROMPT2_entailment
127,212,18,9,9,0.5,19,18,1,0.9473684210526316,0.6545454545454545,GPT4,mimiciii,radiology_report,PROMPT2_entailment
128,213,14,12,2,0.8571428571428571,22,17,5,0.7727272727272727,0.8127490039840638,GPT4,mimiciii,radiology_report,PROMPT2_entailment
129,214,26,11,15,0.4230769230769231,23,18,5,0.782608695652174,0.5492371705963939,GPT4,mimiciii,radiology_report,PROMPT2_entailment
130,215,9,7,2,0.7777777777777778,10,9,1,0.9,0.8344370860927153,GPT4,mimiciii,radiology_report,PROMPT2_entailment
131,216,12,6,6,0.5,19,10,9,0.5263157894736842,0.5128205128205129,GPT4,mimiciii,radiology_report,PROMPT2_entailment
132,217,14,11,3,0.7857142857142857,20,11,9,0.55,0.6470588235294117,GPT4,mimiciii,radiology_report,PROMPT2_entailment
133,218,18,11,7,0.6111111111111112,15,13,2,0.8666666666666667,0.7167919799498748,GPT4,mimiciii,radiology_report,PROMPT2_entailment
134,219,15,10,5,0.6666666666666666,13,11,2,0.8461538461538461,0.7457627118644068,GPT4,mimiciii,radiology_report,PROMPT2_entailment
135,22,17,12,5,0.7058823529411765,19,16,3,0.8421052631578947,0.7679999999999999,GPT4,mimiciii,radiology_report,PROMPT2_entailment
136,220,12,7,5,0.5833333333333334,19,13,6,0.6842105263157895,0.629757785467128,GPT4,mimiciii,radiology_report,PROMPT2_entailment
137,221,17,12,5,0.7058823529411765,27,23,4,0.8518518518518519,0.7720279720279721,GPT4,mimiciii,radiology_report,PROMPT2_entailment
138,222,12,9,3,0.75,16,10,6,0.625,0.6818181818181818,GPT4,mimiciii,radiology_report,PROMPT2_entailment
139,223,17,15,2,0.8823529411764706,21,18,3,0.8571428571428571,0.8695652173913043,GPT4,mimiciii,radiology_report,PROMPT2_entailment
140,224,25,21,4,0.84,17,16,1,0.9411764705882352,0.8877146631439894,GPT4,mimiciii,radiology_report,PROMPT2_entailment
141,225,11,9,2,0.8181818181818182,11,8,3,0.7272727272727273,0.770053475935829,GPT4,mimiciii,radiology_report,PROMPT2_entailment
142,226,13,8,5,0.6153846153846154,18,16,2,0.8888888888888888,0.7272727272727274,GPT4,mimiciii,radiology_report,PROMPT2_entailment
143,227,15,13,2,0.8666666666666667,18,17,1,0.9444444444444444,0.9038854805725972,GPT4,mimiciii,radiology_report,PROMPT2_entailment
144,228,13,10,3,0.7692307692307693,17,15,2,0.8823529411764706,0.8219178082191781,GPT4,mimiciii,radiology_report,PROMPT2_entailment
145,229,22,21,1,0.9545454545454546,49,33,16,0.673469387755102,0.7897435897435897,GPT4,mimiciii,radiology_report,PROMPT2_entailment
146,23,17,12,5,0.7058823529411765,15,11,4,0.7333333333333333,0.7193460490463216,GPT4,mimiciii,radiology_report,PROMPT2_entailment
147,230,11,7,4,0.6363636363636364,17,16,1,0.9411764705882352,0.759322033898305,GPT4,mimiciii,radiology_report,PROMPT2_entailment
148,231,11,10,1,0.9090909090909092,13,10,3,0.7692307692307693,0.8333333333333333,GPT4,mimiciii,radiology_report,PROMPT2_entailment
149,232,10,7,3,0.7,18,12,6,0.6666666666666666,0.6829268292682926,GPT4,mimiciii,radiology_report,PROMPT2_entailment
150,233,16,12,4,0.75,17,10,7,0.5882352941176471,0.6593406593406592,GPT4,mimiciii,radiology_report,PROMPT2_entailment
151,234,7,6,1,0.8571428571428571,11,8,3,0.7272727272727273,0.7868852459016394,GPT4,mimiciii,radiology_report,PROMPT2_entailment
152,235,11,10,1,0.9090909090909092,14,11,3,0.7857142857142857,0.842911877394636,GPT4,mimiciii,radiology_report,PROMPT2_entailment
153,236,15,12,3,0.8,11,7,4,0.6363636363636364,0.7088607594936709,GPT4,mimiciii,radiology_report,PROMPT2_entailment
154,237,17,10,7,0.5882352941176471,17,11,6,0.6470588235294118,0.6162464985994398,GPT4,mimiciii,radiology_report,PROMPT2_entailment
155,238,13,10,3,0.7692307692307693,20,15,5,0.75,0.7594936708860761,GPT4,mimiciii,radiology_report,PROMPT2_entailment
156,239,13,4,9,0.3076923076923077,17,12,5,0.7058823529411765,0.4285714285714286,GPT4,mimiciii,radiology_report,PROMPT2_entailment
157,24,13,9,4,0.6923076923076923,18,13,5,0.7222222222222222,0.7069486404833838,GPT4,mimiciii,radiology_report,PROMPT2_entailment
158,240,10,9,1,0.9,13,10,3,0.7692307692307693,0.8294930875576038,GPT4,mimiciii,radiology_report,PROMPT2_entailment
159,241,13,11,2,0.8461538461538461,16,13,3,0.8125,0.8289855072463768,GPT4,mimiciii,radiology_report,PROMPT2_entailment
160,242,14,11,3,0.7857142857142857,18,15,3,0.8333333333333334,0.8088235294117647,GPT4,mimiciii,radiology_report,PROMPT2_entailment
161,243,12,10,2,0.8333333333333334,13,7,6,0.5384615384615384,0.6542056074766356,GPT4,mimiciii,radiology_report,PROMPT2_entailment
162,244,11,7,4,0.6363636363636364,17,15,2,0.8823529411764706,0.73943661971831,GPT4,mimiciii,radiology_report,PROMPT2_entailment
163,245,20,12,8,0.6,28,24,4,0.8571428571428571,0.7058823529411764,GPT4,mimiciii,radiology_report,PROMPT2_entailment
164,246,9,8,1,0.8888888888888888,12,7,5,0.5833333333333334,0.7044025157232704,GPT4,mimiciii,radiology_report,PROMPT2_entailment
165,247,12,8,4,0.6666666666666666,12,9,3,0.75,0.7058823529411765,GPT4,mimiciii,radiology_report,PROMPT2_entailment
166,248,13,11,2,0.8461538461538461,17,13,4,0.7647058823529411,0.8033707865168538,GPT4,mimiciii,radiology_report,PROMPT2_entailment
167,249,19,13,6,0.6842105263157895,23,16,7,0.6956521739130435,0.6898839137645109,GPT4,mimiciii,radiology_report,PROMPT2_entailment
168,25,20,13,7,0.65,27,17,10,0.6296296296296297,0.6396526772793053,GPT4,mimiciii,radiology_report,PROMPT2_entailment
169,250,9,9,0,1.0,8,6,2,0.75,0.8571428571428571,GPT4,mimiciii,radiology_report,PROMPT2_entailment
170,251,27,16,11,0.5925925925925926,22,19,3,0.8636363636363636,0.7028901734104046,GPT4,mimiciii,radiology_report,PROMPT2_entailment
171,252,8,6,2,0.75,10,7,3,0.7,0.7241379310344827,GPT4,mimiciii,radiology_report,PROMPT2_entailment
172,253,29,20,9,0.6896551724137931,24,20,4,0.8333333333333334,0.7547169811320755,GPT4,mimiciii,radiology_report,PROMPT2_entailment
173,254,11,9,2,0.8181818181818182,13,7,6,0.5384615384615384,0.6494845360824743,GPT4,mimiciii,radiology_report,PROMPT2_entailment
174,255,11,11,0,1.0,16,12,4,0.75,0.8571428571428571,GPT4,mimiciii,radiology_report,PROMPT2_entailment
175,256,19,14,5,0.7368421052631579,19,15,4,0.7894736842105263,0.7622504537205083,GPT4,mimiciii,radiology_report,PROMPT2_entailment
176,257,13,10,3,0.7692307692307693,15,13,2,0.8666666666666667,0.8150470219435738,GPT4,mimiciii,radiology_report,PROMPT2_entailment
177,258,15,13,2,0.8666666666666667,20,12,8,0.6,0.7090909090909091,GPT4,mimiciii,radiology_report,PROMPT2_entailment
178,259,11,8,3,0.7272727272727273,17,14,3,0.8235294117647058,0.7724137931034483,GPT4,mimiciii,radiology_report,PROMPT2_entailment
179,26,20,20,0,1.0,18,14,4,0.7777777777777778,0.8750000000000001,GPT4,mimiciii,radiology_report,PROMPT2_entailment
180,260,20,13,7,0.65,20,11,9,0.55,0.5958333333333333,GPT4,mimiciii,radiology_report,PROMPT2_entailment
181,261,20,11,9,0.55,31,25,6,0.8064516129032258,0.6539833531510107,GPT4,mimiciii,radiology_report,PROMPT2_entailment
182,262,13,7,6,0.5384615384615384,23,17,6,0.7391304347826086,0.6230366492146596,GPT4,mimiciii,radiology_report,PROMPT2_entailment
183,263,20,15,5,0.75,27,21,6,0.7777777777777778,0.7636363636363638,GPT4,mimiciii,radiology_report,PROMPT2_entailment
184,264,15,11,4,0.7333333333333333,20,16,4,0.8,0.7652173913043478,GPT4,mimiciii,radiology_report,PROMPT2_entailment
185,265,9,8,1,0.8888888888888888,9,8,1,0.8888888888888888,0.8888888888888888,GPT4,mimiciii,radiology_report,PROMPT2_entailment
186,266,14,13,1,0.9285714285714286,18,18,0,1.0,0.962962962962963,GPT4,mimiciii,radiology_report,PROMPT2_entailment
187,267,10,9,1,0.9,16,12,4,0.75,0.8181818181818182,GPT4,mimiciii,radiology_report,PROMPT2_entailment
188,268,16,12,4,0.75,20,14,6,0.7,0.7241379310344827,GPT4,mimiciii,radiology_report,PROMPT2_entailment
189,269,21,21,0,1.0,30,25,5,0.8333333333333334,0.9090909090909092,GPT4,mimiciii,radiology_report,PROMPT2_entailment
190,27,15,13,2,0.8666666666666667,14,12,2,0.8571428571428571,0.861878453038674,GPT4,mimiciii,radiology_report,PROMPT2_entailment
191,270,14,12,2,0.8571428571428571,17,13,4,0.7647058823529411,0.8082901554404144,GPT4,mimiciii,radiology_report,PROMPT2_entailment
192,271,15,13,2,0.8666666666666667,20,16,4,0.8,0.832,GPT4,mimiciii,radiology_report,PROMPT2_entailment
193,272,19,13,6,0.6842105263157895,17,16,1,0.9411764705882352,0.7923809523809523,GPT4,mimiciii,radiology_report,PROMPT2_entailment
194,273,12,11,1,0.9166666666666666,12,7,5,0.5833333333333334,0.7129629629629629,GPT4,mimiciii,radiology_report,PROMPT2_entailment
195,274,17,11,6,0.6470588235294118,20,12,8,0.6,0.6226415094339622,GPT4,mimiciii,radiology_report,PROMPT2_entailment
196,275,11,11,0,1.0,12,8,4,0.6666666666666666,0.8,GPT4,mimiciii,radiology_report,PROMPT2_entailment
197,276,12,10,2,0.8333333333333334,29,18,11,0.6206896551724138,0.7114624505928854,GPT4,mimiciii,radiology_report,PROMPT2_entailment
198,277,21,18,3,0.8571428571428571,25,20,5,0.8,0.8275862068965518,GPT4,mimiciii,radiology_report,PROMPT2_entailment
199,278,13,11,2,0.8461538461538461,16,12,4,0.75,0.7951807228915662,GPT4,mimiciii,radiology_report,PROMPT2_entailment
200,279,11,11,0,1.0,10,7,3,0.7,0.8235294117647058,GPT4,mimiciii,radiology_report,PROMPT2_entailment
201,28,18,10,8,0.5555555555555556,30,24,6,0.8,0.6557377049180328,GPT4,mimiciii,radiology_report,PROMPT2_entailment
202,280,10,7,3,0.7,12,9,3,0.75,0.7241379310344827,GPT4,mimiciii,radiology_report,PROMPT2_entailment
203,281,18,13,5,0.7222222222222222,24,16,8,0.6666666666666666,0.6933333333333334,GPT4,mimiciii,radiology_report,PROMPT2_entailment
204,282,16,14,2,0.875,12,11,1,0.9166666666666666,0.8953488372093024,GPT4,mimiciii,radiology_report,PROMPT2_entailment
205,283,20,18,2,0.9,28,20,8,0.7142857142857143,0.7964601769911505,GPT4,mimiciii,radiology_report,PROMPT2_entailment
206,284,14,10,4,0.7142857142857143,14,10,4,0.7142857142857143,0.7142857142857143,GPT4,mimiciii,radiology_report,PROMPT2_entailment
207,285,13,7,6,0.5384615384615384,18,15,3,0.8333333333333334,0.6542056074766356,GPT4,mimiciii,radiology_report,PROMPT2_entailment
208,286,6,6,0,1.0,6,5,1,0.8333333333333334,0.9090909090909092,GPT4,mimiciii,radiology_report,PROMPT2_entailment
209,287,14,12,2,0.8571428571428571,18,14,4,0.7777777777777778,0.8155339805825242,GPT4,mimiciii,radiology_report,PROMPT2_entailment
210,288,20,13,7,0.65,32,24,8,0.75,0.6964285714285715,GPT4,mimiciii,radiology_report,PROMPT2_entailment
211,289,19,16,3,0.8421052631578947,20,14,6,0.7,0.7645051194539249,GPT4,mimiciii,radiology_report,PROMPT2_entailment
212,29,8,7,1,0.875,8,6,2,0.75,0.8076923076923077,GPT4,mimiciii,radiology_report,PROMPT2_entailment
213,290,12,8,4,0.6666666666666666,11,8,3,0.7272727272727273,0.6956521739130435,GPT4,mimiciii,radiology_report,PROMPT2_entailment
214,291,19,11,8,0.5789473684210527,24,14,10,0.5833333333333334,0.5811320754716981,GPT4,mimiciii,radiology_report,PROMPT2_entailment
215,292,18,15,3,0.8333333333333334,21,16,5,0.7619047619047619,0.7960199004975124,GPT4,mimiciii,radiology_report,PROMPT2_entailment
216,293,15,12,3,0.8,18,15,3,0.8333333333333334,0.816326530612245,GPT4,mimiciii,radiology_report,PROMPT2_entailment
217,294,20,14,6,0.7,22,16,6,0.7272727272727273,0.7133757961783439,GPT4,mimiciii,radiology_report,PROMPT2_entailment
218,295,13,10,3,0.7692307692307693,39,24,15,0.6153846153846154,0.6837606837606838,GPT4,mimiciii,radiology_report,PROMPT2_entailment
219,296,15,9,6,0.6,17,13,4,0.7647058823529411,0.6724137931034482,GPT4,mimiciii,radiology_report,PROMPT2_entailment
220,297,17,11,6,0.6470588235294118,24,18,6,0.75,0.6947368421052633,GPT4,mimiciii,radiology_report,PROMPT2_entailment
221,298,15,11,4,0.7333333333333333,20,13,7,0.65,0.689156626506024,GPT4,mimiciii,radiology_report,PROMPT2_entailment
222,299,22,18,4,0.8181818181818182,32,22,10,0.6875,0.7471698113207547,GPT4,mimiciii,radiology_report,PROMPT2_entailment
223,3,13,8,5,0.6153846153846154,20,16,4,0.8,0.6956521739130435,GPT4,mimiciii,radiology_report,PROMPT2_entailment
224,30,14,11,3,0.7857142857142857,25,23,2,0.92,0.847571189279732,GPT4,mimiciii,radiology_report,PROMPT2_entailment
225,300,15,11,4,0.7333333333333333,13,10,3,0.7692307692307693,0.7508532423208191,GPT4,mimiciii,radiology_report,PROMPT2_entailment
226,301,10,10,0,1.0,19,16,3,0.8421052631578947,0.9142857142857144,GPT4,mimiciii,radiology_report,PROMPT2_entailment
227,302,17,13,4,0.7647058823529411,15,13,2,0.8666666666666667,0.8125,GPT4,mimiciii,radiology_report,PROMPT2_entailment
228,303,18,16,2,0.8888888888888888,24,17,7,0.7083333333333334,0.7884057971014492,GPT4,mimiciii,radiology_report,PROMPT2_entailment
229,304,17,15,2,0.8823529411764706,21,19,2,0.9047619047619048,0.8934169278996865,GPT4,mimiciii,radiology_report,PROMPT2_entailment
230,305,19,10,9,0.5263157894736842,24,15,9,0.625,0.5714285714285714,GPT4,mimiciii,radiology_report,PROMPT2_entailment
231,306,12,9,3,0.75,14,11,3,0.7857142857142857,0.7674418604651163,GPT4,mimiciii,radiology_report,PROMPT2_entailment
232,307,14,12,2,0.8571428571428571,17,12,5,0.7058823529411765,0.7741935483870968,GPT4,mimiciii,radiology_report,PROMPT2_entailment
233,308,13,9,4,0.6923076923076923,15,10,5,0.6666666666666666,0.6792452830188679,GPT4,mimiciii,radiology_report,PROMPT2_entailment
234,309,14,12,2,0.8571428571428571,29,16,13,0.5517241379310345,0.6713286713286714,GPT4,mimiciii,radiology_report,PROMPT2_entailment
235,31,12,6,6,0.5,19,14,5,0.7368421052631579,0.5957446808510638,GPT4,mimiciii,radiology_report,PROMPT2_entailment
236,310,14,9,5,0.6428571428571429,24,21,3,0.875,0.7411764705882353,GPT4,mimiciii,radiology_report,PROMPT2_entailment
237,311,13,12,1,0.9230769230769232,15,10,5,0.6666666666666666,0.7741935483870968,GPT4,mimiciii,radiology_report,PROMPT2_entailment
238,312,16,10,6,0.625,18,10,8,0.5555555555555556,0.5882352941176471,GPT4,mimiciii,radiology_report,PROMPT2_entailment
239,313,12,9,3,0.75,17,13,4,0.7647058823529411,0.7572815533980582,GPT4,mimiciii,radiology_report,PROMPT2_entailment
240,314,17,11,6,0.6470588235294118,15,12,3,0.8,0.7154471544715447,GPT4,mimiciii,radiology_report,PROMPT2_entailment
241,315,27,20,7,0.7407407407407407,25,18,7,0.72,0.7302231237322515,GPT4,mimiciii,radiology_report,PROMPT2_entailment
242,316,9,7,2,0.7777777777777778,10,8,2,0.8,0.7887323943661971,GPT4,mimiciii,radiology_report,PROMPT2_entailment
243,317,22,12,10,0.5454545454545454,26,23,3,0.8846153846153846,0.6748166259168703,GPT4,mimiciii,radiology_report,PROMPT2_entailment
244,318,15,11,4,0.7333333333333333,21,16,5,0.7619047619047619,0.7473460721868364,GPT4,mimiciii,radiology_report,PROMPT2_entailment
245,319,16,15,1,0.9375,12,11,1,0.9166666666666666,0.9269662921348316,GPT4,mimiciii,radiology_report,PROMPT2_entailment
246,32,13,12,1,0.9230769230769232,15,11,4,0.7333333333333333,0.8173374613003097,GPT4,mimiciii,radiology_report,PROMPT2_entailment
247,320,11,10,1,0.9090909090909092,11,7,4,0.6363636363636364,0.7486631016042781,GPT4,mimiciii,radiology_report,PROMPT2_entailment
248,321,14,8,6,0.5714285714285714,21,17,4,0.8095238095238095,0.6699507389162561,GPT4,mimiciii,radiology_report,PROMPT2_entailment
249,322,8,7,1,0.875,8,7,1,0.875,0.875,GPT4,mimiciii,radiology_report,PROMPT2_entailment
250,323,16,14,2,0.875,29,19,10,0.6551724137931034,0.7492957746478873,GPT4,mimiciii,radiology_report,PROMPT2_entailment
251,324,16,13,3,0.8125,18,12,6,0.6666666666666666,0.7323943661971831,GPT4,mimiciii,radiology_report,PROMPT2_entailment
252,325,18,12,6,0.6666666666666666,22,15,7,0.6818181818181818,0.6741573033707865,GPT4,mimiciii,radiology_report,PROMPT2_entailment
253,326,12,6,6,0.5,23,19,4,0.8260869565217391,0.6229508196721311,GPT4,mimiciii,radiology_report,PROMPT2_entailment
254,327,9,9,0,1.0,9,8,1,0.8888888888888888,0.9411764705882352,GPT4,mimiciii,radiology_report,PROMPT2_entailment
255,328,14,11,3,0.7857142857142857,17,11,6,0.6470588235294118,0.7096774193548386,GPT4,mimiciii,radiology_report,PROMPT2_entailment
256,329,11,11,0,1.0,28,18,10,0.6428571428571429,0.782608695652174,GPT4,mimiciii,radiology_report,PROMPT2_entailment
257,33,7,7,0,1.0,9,7,2,0.7777777777777778,0.8750000000000001,GPT4,mimiciii,radiology_report,PROMPT2_entailment
258,330,12,11,1,0.9166666666666666,11,8,3,0.7272727272727273,0.8110599078341013,GPT4,mimiciii,radiology_report,PROMPT2_entailment
259,331,11,9,2,0.8181818181818182,15,13,2,0.8666666666666667,0.8417266187050358,GPT4,mimiciii,radiology_report,PROMPT2_entailment
260,332,18,17,1,0.9444444444444444,20,15,5,0.75,0.8360655737704917,GPT4,mimiciii,radiology_report,PROMPT2_entailment
261,333,10,10,0,1.0,13,11,2,0.8461538461538461,0.9166666666666666,GPT4,mimiciii,radiology_report,PROMPT2_entailment
262,334,23,18,5,0.782608695652174,20,18,2,0.9,0.8372093023255814,GPT4,mimiciii,radiology_report,PROMPT2_entailment
263,335,20,19,1,0.95,17,12,5,0.7058823529411765,0.8099467140319717,GPT4,mimiciii,radiology_report,PROMPT2_entailment
264,336,18,8,10,0.4444444444444444,16,11,5,0.6875,0.5398773006134969,GPT4,mimiciii,radiology_report,PROMPT2_entailment
265,337,20,19,1,0.95,16,13,3,0.8125,0.875886524822695,GPT4,mimiciii,radiology_report,PROMPT2_entailment
266,338,15,12,3,0.8,13,7,6,0.5384615384615384,0.6436781609195402,GPT4,mimiciii,radiology_report,PROMPT2_entailment
267,339,21,14,7,0.6666666666666666,28,23,5,0.8214285714285714,0.7359999999999999,GPT4,mimiciii,radiology_report,PROMPT2_entailment
268,34,11,6,5,0.5454545454545454,14,12,2,0.8571428571428571,0.6666666666666665,GPT4,mimiciii,radiology_report,PROMPT2_entailment
269,340,18,14,4,0.7777777777777778,15,12,3,0.8,0.7887323943661971,GPT4,mimiciii,radiology_report,PROMPT2_entailment
270,341,7,7,0,1.0,6,5,1,0.8333333333333334,0.9090909090909092,GPT4,mimiciii,radiology_report,PROMPT2_entailment
271,342,14,12,2,0.8571428571428571,15,13,2,0.8666666666666667,0.861878453038674,GPT4,mimiciii,radiology_report,PROMPT2_entailment
272,343,16,14,2,0.875,26,17,9,0.6538461538461539,0.7484276729559749,GPT4,mimiciii,radiology_report,PROMPT2_entailment
273,344,15,11,4,0.7333333333333333,19,14,5,0.7368421052631579,0.7350835322195703,GPT4,mimiciii,radiology_report,PROMPT2_entailment
274,345,20,14,6,0.7,22,15,7,0.6818181818181818,0.6907894736842104,GPT4,mimiciii,radiology_report,PROMPT2_entailment
275,346,13,11,2,0.8461538461538461,15,12,3,0.8,0.8224299065420562,GPT4,mimiciii,radiology_report,PROMPT2_entailment
276,347,17,12,5,0.7058823529411765,15,14,1,0.9333333333333332,0.8038277511961724,GPT4,mimiciii,radiology_report,PROMPT2_entailment
277,348,11,7,4,0.6363636363636364,12,9,3,0.75,0.6885245901639345,GPT4,mimiciii,radiology_report,PROMPT2_entailment
278,349,13,12,1,0.9230769230769232,16,13,3,0.8125,0.8642659279778393,GPT4,mimiciii,radiology_report,PROMPT2_entailment
279,35,15,8,7,0.5333333333333333,21,15,6,0.7142857142857143,0.6106870229007633,GPT4,mimiciii,radiology_report,PROMPT2_entailment
280,350,16,11,5,0.6875,21,17,4,0.8095238095238095,0.7435387673956263,GPT4,mimiciii,radiology_report,PROMPT2_entailment
281,351,21,15,6,0.7142857142857143,21,17,4,0.8095238095238095,0.7589285714285714,GPT4,mimiciii,radiology_report,PROMPT2_entailment
282,352,13,10,3,0.7692307692307693,22,15,7,0.6818181818181818,0.7228915662650602,GPT4,mimiciii,radiology_report,PROMPT2_entailment
283,353,18,10,8,0.5555555555555556,26,15,11,0.5769230769230769,0.5660377358490566,GPT4,mimiciii,radiology_report,PROMPT2_entailment
284,354,20,13,7,0.65,26,20,6,0.7692307692307693,0.7046070460704607,GPT4,mimiciii,radiology_report,PROMPT2_entailment
285,355,15,13,2,0.8666666666666667,18,14,4,0.7777777777777778,0.81981981981982,GPT4,mimiciii,radiology_report,PROMPT2_entailment
286,356,15,13,2,0.8666666666666667,22,18,4,0.8181818181818182,0.8417266187050358,GPT4,mimiciii,radiology_report,PROMPT2_entailment
287,357,9,7,2,0.7777777777777778,15,10,5,0.6666666666666666,0.717948717948718,GPT4,mimiciii,radiology_report,PROMPT2_entailment
288,358,16,12,4,0.75,12,9,3,0.75,0.75,GPT4,mimiciii,radiology_report,PROMPT2_entailment
289,359,10,9,1,0.9,18,15,3,0.8333333333333334,0.8653846153846153,GPT4,mimiciii,radiology_report,PROMPT2_entailment
290,36,17,9,8,0.5294117647058824,22,15,7,0.6818181818181818,0.5960264900662252,GPT4,mimiciii,radiology_report,PROMPT2_entailment
291,360,15,14,1,0.9333333333333332,15,13,2,0.8666666666666667,0.8987654320987654,GPT4,mimiciii,radiology_report,PROMPT2_entailment
292,361,16,11,5,0.6875,23,18,5,0.782608695652174,0.7319778188539743,GPT4,mimiciii,radiology_report,PROMPT2_entailment
293,362,19,10,9,0.5263157894736842,24,16,8,0.6666666666666666,0.5882352941176471,GPT4,mimiciii,radiology_report,PROMPT2_entailment
294,363,22,11,11,0.5,22,16,6,0.7272727272727273,0.5925925925925926,GPT4,mimiciii,radiology_report,PROMPT2_entailment
295,364,6,6,0,1.0,11,8,3,0.7272727272727273,0.8421052631578948,GPT4,mimiciii,radiology_report,PROMPT2_entailment
296,365,21,15,6,0.7142857142857143,29,17,12,0.5862068965517241,0.6439393939393939,GPT4,mimiciii,radiology_report,PROMPT2_entailment
297,366,10,9,1,0.9,13,9,4,0.6923076923076923,0.7826086956521738,GPT4,mimiciii,radiology_report,PROMPT2_entailment
298,367,16,11,5,0.6875,16,12,4,0.75,0.717391304347826,GPT4,mimiciii,radiology_report,PROMPT2_entailment
299,368,16,10,6,0.625,20,9,11,0.45,0.5232558139534884,GPT4,mimiciii,radiology_report,PROMPT2_entailment
300,369,20,16,4,0.8,20,15,5,0.75,0.7741935483870969,GPT4,mimiciii,radiology_report,PROMPT2_entailment
301,37,13,11,2,0.8461538461538461,21,15,6,0.7142857142857143,0.7746478873239436,GPT4,mimiciii,radiology_report,PROMPT2_entailment
302,370,17,10,7,0.5882352941176471,19,11,8,0.5789473684210527,0.583554376657825,GPT4,mimiciii,radiology_report,PROMPT2_entailment
303,371,13,12,1,0.9230769230769232,17,13,4,0.7647058823529411,0.8364611260053619,GPT4,mimiciii,radiology_report,PROMPT2_entailment
304,372,11,9,2,0.8181818181818182,31,26,5,0.8387096774193549,0.8283185840707965,GPT4,mimiciii,radiology_report,PROMPT2_entailment
305,373,18,15,3,0.8333333333333334,23,15,8,0.6521739130434783,0.7317073170731708,GPT4,mimiciii,radiology_report,PROMPT2_entailment
306,374,10,10,0,1.0,11,7,4,0.6363636363636364,0.7777777777777778,GPT4,mimiciii,radiology_report,PROMPT2_entailment
307,375,13,13,0,1.0,16,12,4,0.75,0.8571428571428571,GPT4,mimiciii,radiology_report,PROMPT2_entailment
308,376,19,14,5,0.7368421052631579,18,16,2,0.8888888888888888,0.8057553956834532,GPT4,mimiciii,radiology_report,PROMPT2_entailment
309,377,10,9,1,0.9,10,8,2,0.8,0.8470588235294118,GPT4,mimiciii,radiology_report,PROMPT2_entailment
310,378,19,12,7,0.631578947368421,24,15,9,0.625,0.6282722513089005,GPT4,mimiciii,radiology_report,PROMPT2_entailment
311,379,21,11,10,0.5238095238095238,18,14,4,0.7777777777777778,0.6260162601626017,GPT4,mimiciii,radiology_report,PROMPT2_entailment
312,38,15,11,4,0.7333333333333333,19,14,5,0.7368421052631579,0.7350835322195703,GPT4,mimiciii,radiology_report,PROMPT2_entailment
313,380,10,10,0,1.0,8,6,2,0.75,0.8571428571428571,GPT4,mimiciii,radiology_report,PROMPT2_entailment
314,381,11,6,5,0.5454545454545454,14,11,3,0.7857142857142857,0.6439024390243903,GPT4,mimiciii,radiology_report,PROMPT2_entailment
315,382,14,13,1,0.9285714285714286,16,9,7,0.5625,0.7005988023952097,GPT4,mimiciii,radiology_report,PROMPT2_entailment
316,383,13,5,8,0.3846153846153846,17,14,3,0.8235294117647058,0.5243445692883896,GPT4,mimiciii,radiology_report,PROMPT2_entailment
317,384,11,10,1,0.9090909090909092,13,12,1,0.9230769230769232,0.9160305343511452,GPT4,mimiciii,radiology_report,PROMPT2_entailment
318,385,18,11,7,0.6111111111111112,27,21,6,0.7777777777777778,0.6844444444444445,GPT4,mimiciii,radiology_report,PROMPT2_entailment
319,386,13,10,3,0.7692307692307693,18,15,3,0.8333333333333334,0.8,GPT4,mimiciii,radiology_report,PROMPT2_entailment
320,387,15,12,3,0.8,19,11,8,0.5789473684210527,0.6717557251908397,GPT4,mimiciii,radiology_report,PROMPT2_entailment
321,388,24,17,7,0.7083333333333334,33,28,5,0.8484848484848485,0.7721005677210058,GPT4,mimiciii,radiology_report,PROMPT2_entailment
322,389,13,7,6,0.5384615384615384,12,8,4,0.6666666666666666,0.5957446808510638,GPT4,mimiciii,radiology_report,PROMPT2_entailment
323,39,10,10,0,1.0,10,9,1,0.9,0.9473684210526316,GPT4,mimiciii,radiology_report,PROMPT2_entailment
324,390,10,9,1,0.9,14,14,0,1.0,0.9473684210526316,GPT4,mimiciii,radiology_report,PROMPT2_entailment
325,391,11,10,1,0.9090909090909092,13,8,5,0.6153846153846154,0.7339449541284404,GPT4,mimiciii,radiology_report,PROMPT2_entailment
326,392,12,9,3,0.75,15,11,4,0.7333333333333333,0.7415730337078651,GPT4,mimiciii,radiology_report,PROMPT2_entailment
327,393,22,14,8,0.6363636363636364,19,14,5,0.7368421052631579,0.6829268292682926,GPT4,mimiciii,radiology_report,PROMPT2_entailment
328,394,14,13,1,0.9285714285714286,18,16,2,0.8888888888888888,0.9082969432314412,GPT4,mimiciii,radiology_report,PROMPT2_entailment
329,395,12,12,0,1.0,16,13,3,0.8125,0.896551724137931,GPT4,mimiciii,radiology_report,PROMPT2_entailment
330,396,13,10,3,0.7692307692307693,19,16,3,0.8421052631578947,0.8040201005025126,GPT4,mimiciii,radiology_report,PROMPT2_entailment
331,397,14,11,3,0.7857142857142857,18,12,6,0.6666666666666666,0.721311475409836,GPT4,mimiciii,radiology_report,PROMPT2_entailment
332,398,26,18,8,0.6923076923076923,21,18,3,0.8571428571428571,0.7659574468085107,GPT4,mimiciii,radiology_report,PROMPT2_entailment
333,399,16,13,3,0.8125,19,14,5,0.7368421052631579,0.7728237791932058,GPT4,mimiciii,radiology_report,PROMPT2_entailment
334,4,15,14,1,0.9333333333333332,16,13,3,0.8125,0.8687350835322195,GPT4,mimiciii,radiology_report,PROMPT2_entailment
335,40,13,10,3,0.7692307692307693,17,14,3,0.8235294117647058,0.7954545454545454,GPT4,mimiciii,radiology_report,PROMPT2_entailment
336,400,10,10,0,1.0,13,6,7,0.4615384615384615,0.631578947368421,GPT4,mimiciii,radiology_report,PROMPT2_entailment
337,401,10,8,2,0.8,9,9,0,1.0,0.888888888888889,GPT4,mimiciii,radiology_report,PROMPT2_entailment
338,402,20,11,9,0.55,20,14,6,0.7,0.616,GPT4,mimiciii,radiology_report,PROMPT2_entailment
339,403,12,10,2,0.8333333333333334,18,15,3,0.8333333333333334,0.8333333333333334,GPT4,mimiciii,radiology_report,PROMPT2_entailment
340,404,17,15,2,0.8823529411764706,19,15,4,0.7894736842105263,0.8333333333333333,GPT4,mimiciii,radiology_report,PROMPT2_entailment
341,405,15,9,6,0.6,14,9,5,0.6428571428571429,0.6206896551724138,GPT4,mimiciii,radiology_report,PROMPT2_entailment
342,406,24,15,9,0.625,25,20,5,0.8,0.7017543859649122,GPT4,mimiciii,radiology_report,PROMPT2_entailment
343,407,24,20,4,0.8333333333333334,20,15,5,0.75,0.7894736842105262,GPT4,mimiciii,radiology_report,PROMPT2_entailment
344,408,16,14,2,0.875,20,11,9,0.55,0.6754385964912282,GPT4,mimiciii,radiology_report,PROMPT2_entailment
345,409,17,17,0,1.0,21,17,4,0.8095238095238095,0.8947368421052632,GPT4,mimiciii,radiology_report,PROMPT2_entailment
346,41,19,14,5,0.7368421052631579,26,18,8,0.6923076923076923,0.7138810198300283,GPT4,mimiciii,radiology_report,PROMPT2_entailment
347,410,15,14,1,0.9333333333333332,20,14,6,0.7,0.8,GPT4,mimiciii,radiology_report,PROMPT2_entailment
348,411,7,7,0,1.0,6,5,1,0.8333333333333334,0.9090909090909092,GPT4,mimiciii,radiology_report,PROMPT2_entailment
349,412,16,12,4,0.75,26,19,7,0.7307692307692307,0.7402597402597402,GPT4,mimiciii,radiology_report,PROMPT2_entailment
350,413,12,12,0,1.0,14,11,3,0.7857142857142857,0.88,GPT4,mimiciii,radiology_report,PROMPT2_entailment
351,414,21,13,8,0.6190476190476191,28,23,5,0.8214285714285714,0.7060212514757969,GPT4,mimiciii,radiology_report,PROMPT2_entailment
352,415,15,10,5,0.6666666666666666,20,16,4,0.8,0.7272727272727272,GPT4,mimiciii,radiology_report,PROMPT2_entailment
353,416,13,13,0,1.0,19,12,7,0.631578947368421,0.7741935483870968,GPT4,mimiciii,radiology_report,PROMPT2_entailment
354,417,19,9,10,0.4736842105263157,20,15,5,0.75,0.5806451612903226,GPT4,mimiciii,radiology_report,PROMPT2_entailment
355,418,11,10,1,0.9090909090909092,14,11,3,0.7857142857142857,0.842911877394636,GPT4,mimiciii,radiology_report,PROMPT2_entailment
356,419,19,12,7,0.631578947368421,16,13,3,0.8125,0.7107061503416856,GPT4,mimiciii,radiology_report,PROMPT2_entailment
357,42,14,11,3,0.7857142857142857,14,8,6,0.5714285714285714,0.6616541353383457,GPT4,mimiciii,radiology_report,PROMPT2_entailment
358,420,12,7,5,0.5833333333333334,15,11,4,0.7333333333333333,0.6497890295358649,GPT4,mimiciii,radiology_report,PROMPT2_entailment
359,421,18,9,9,0.5,23,21,2,0.9130434782608696,0.6461538461538461,GPT4,mimiciii,radiology_report,PROMPT2_entailment
360,422,15,13,2,0.8666666666666667,20,15,5,0.75,0.8041237113402062,GPT4,mimiciii,radiology_report,PROMPT2_entailment
361,423,11,10,1,0.9090909090909092,12,9,3,0.75,0.821917808219178,GPT4,mimiciii,radiology_report,PROMPT2_entailment
362,424,8,5,3,0.625,9,7,2,0.7777777777777778,0.6930693069306931,GPT4,mimiciii,radiology_report,PROMPT2_entailment
363,425,18,13,5,0.7222222222222222,19,13,6,0.6842105263157895,0.7027027027027027,GPT4,mimiciii,radiology_report,PROMPT2_entailment
364,426,15,9,6,0.6,16,12,4,0.75,0.6666666666666665,GPT4,mimiciii,radiology_report,PROMPT2_entailment
365,427,10,9,1,0.9,15,11,4,0.7333333333333333,0.8081632653061224,GPT4,mimiciii,radiology_report,PROMPT2_entailment
366,428,11,7,4,0.6363636363636364,15,12,3,0.8,0.7088607594936709,GPT4,mimiciii,radiology_report,PROMPT2_entailment
367,429,13,11,2,0.8461538461538461,13,9,4,0.6923076923076923,0.7615384615384616,GPT4,mimiciii,radiology_report,PROMPT2_entailment
368,43,11,9,2,0.8181818181818182,7,5,2,0.7142857142857143,0.7627118644067797,GPT4,mimiciii,radiology_report,PROMPT2_entailment
369,430,6,6,0,1.0,7,5,2,0.7142857142857143,0.8333333333333333,GPT4,mimiciii,radiology_report,PROMPT2_entailment
370,431,14,7,7,0.5,18,15,3,0.8333333333333334,0.625,GPT4,mimiciii,radiology_report,PROMPT2_entailment
371,432,13,10,3,0.7692307692307693,13,8,5,0.6153846153846154,0.6837606837606838,GPT4,mimiciii,radiology_report,PROMPT2_entailment
372,433,14,12,2,0.8571428571428571,18,11,7,0.6111111111111112,0.7135135135135134,GPT4,mimiciii,radiology_report,PROMPT2_entailment
373,434,23,17,6,0.7391304347826086,27,15,12,0.5555555555555556,0.6343283582089552,GPT4,mimiciii,radiology_report,PROMPT2_entailment
374,435,11,7,4,0.6363636363636364,13,10,3,0.7692307692307693,0.6965174129353234,GPT4,mimiciii,radiology_report,PROMPT2_entailment
375,436,21,14,7,0.6666666666666666,25,20,5,0.8,0.7272727272727272,GPT4,mimiciii,radiology_report,PROMPT2_entailment
376,437,6,5,1,0.8333333333333334,7,5,2,0.7142857142857143,0.7692307692307692,GPT4,mimiciii,radiology_report,PROMPT2_entailment
377,438,12,11,1,0.9166666666666666,19,17,2,0.8947368421052632,0.9055690072639224,GPT4,mimiciii,radiology_report,PROMPT2_entailment
378,439,15,7,8,0.4666666666666667,22,17,5,0.7727272727272727,0.5819070904645477,GPT4,mimiciii,radiology_report,PROMPT2_entailment
379,44,10,10,0,1.0,16,10,6,0.625,0.7692307692307693,GPT4,mimiciii,radiology_report,PROMPT2_entailment
380,440,18,10,8,0.5555555555555556,19,12,7,0.631578947368421,0.5911330049261083,GPT4,mimiciii,radiology_report,PROMPT2_entailment
381,441,15,9,6,0.6,17,15,2,0.8823529411764706,0.7142857142857143,GPT4,mimiciii,radiology_report,PROMPT2_entailment
382,442,10,9,1,0.9,12,8,4,0.6666666666666666,0.7659574468085106,GPT4,mimiciii,radiology_report,PROMPT2_entailment
383,443,15,12,3,0.8,21,12,9,0.5714285714285714,0.6666666666666666,GPT4,mimiciii,radiology_report,PROMPT2_entailment
384,444,9,8,1,0.8888888888888888,8,6,2,0.75,0.8135593220338982,GPT4,mimiciii,radiology_report,PROMPT2_entailment
385,445,18,15,3,0.8333333333333334,22,16,6,0.7272727272727273,0.7766990291262137,GPT4,mimiciii,radiology_report,PROMPT2_entailment
386,446,19,14,5,0.7368421052631579,22,14,8,0.6363636363636364,0.6829268292682926,GPT4,mimiciii,radiology_report,PROMPT2_entailment
387,447,16,16,0,1.0,14,9,5,0.6428571428571429,0.782608695652174,GPT4,mimiciii,radiology_report,PROMPT2_entailment
388,448,19,14,5,0.7368421052631579,36,25,11,0.6944444444444444,0.7150153217568949,GPT4,mimiciii,radiology_report,PROMPT2_entailment
389,449,13,10,3,0.7692307692307693,9,6,3,0.6666666666666666,0.7142857142857142,GPT4,mimiciii,radiology_report,PROMPT2_entailment
390,45,15,9,6,0.6,20,14,6,0.7,0.6461538461538462,GPT4,mimiciii,radiology_report,PROMPT2_entailment
391,450,19,14,5,0.7368421052631579,21,17,4,0.8095238095238095,0.7714748784440844,GPT4,mimiciii,radiology_report,PROMPT2_entailment
392,451,9,8,1,0.8888888888888888,10,7,3,0.7,0.7832167832167831,GPT4,mimiciii,radiology_report,PROMPT2_entailment
393,452,20,19,1,0.95,16,14,2,0.875,0.910958904109589,GPT4,mimiciii,radiology_report,PROMPT2_entailment
394,453,10,7,3,0.7,14,10,4,0.7142857142857143,0.7070707070707072,GPT4,mimiciii,radiology_report,PROMPT2_entailment
395,454,10,9,1,0.9,10,6,4,0.6,0.7200000000000001,GPT4,mimiciii,radiology_report,PROMPT2_entailment
396,455,15,12,3,0.8,16,13,3,0.8125,0.8062015503875969,GPT4,mimiciii,radiology_report,PROMPT2_entailment
397,456,16,14,2,0.875,21,17,4,0.8095238095238095,0.8409893992932863,GPT4,mimiciii,radiology_report,PROMPT2_entailment
398,457,13,12,1,0.9230769230769232,12,8,4,0.6666666666666666,0.7741935483870968,GPT4,mimiciii,radiology_report,PROMPT2_entailment
399,458,13,12,1,0.9230769230769232,16,12,4,0.75,0.8275862068965517,GPT4,mimiciii,radiology_report,PROMPT2_entailment
400,459,14,11,3,0.7857142857142857,13,8,5,0.6153846153846154,0.6901960784313727,GPT4,mimiciii,radiology_report,PROMPT2_entailment
401,46,15,14,1,0.9333333333333332,26,16,10,0.6153846153846154,0.7417218543046358,GPT4,mimiciii,radiology_report,PROMPT2_entailment
402,460,19,14,5,0.7368421052631579,20,15,5,0.75,0.743362831858407,GPT4,mimiciii,radiology_report,PROMPT2_entailment
403,461,19,10,9,0.5263157894736842,22,10,12,0.4545454545454545,0.4878048780487805,GPT4,mimiciii,radiology_report,PROMPT2_entailment
404,462,22,14,8,0.6363636363636364,20,16,4,0.8,0.7088607594936709,GPT4,mimiciii,radiology_report,PROMPT2_entailment
405,463,8,7,1,0.875,12,9,3,0.75,0.8076923076923077,GPT4,mimiciii,radiology_report,PROMPT2_entailment
406,464,18,14,4,0.7777777777777778,25,21,4,0.84,0.8076923076923077,GPT4,mimiciii,radiology_report,PROMPT2_entailment
407,465,23,20,3,0.8695652173913043,33,28,5,0.8484848484848485,0.8588957055214724,GPT4,mimiciii,radiology_report,PROMPT2_entailment
408,466,17,12,5,0.7058823529411765,22,18,4,0.8181818181818182,0.7578947368421053,GPT4,mimiciii,radiology_report,PROMPT2_entailment
409,467,10,10,0,1.0,14,12,2,0.8571428571428571,0.923076923076923,GPT4,mimiciii,radiology_report,PROMPT2_entailment
410,468,18,12,6,0.6666666666666666,18,12,6,0.6666666666666666,0.6666666666666666,GPT4,mimiciii,radiology_report,PROMPT2_entailment
411,469,20,16,4,0.8,25,16,9,0.64,0.7111111111111111,GPT4,mimiciii,radiology_report,PROMPT2_entailment
412,47,15,12,3,0.8,15,9,6,0.6,0.6857142857142857,GPT4,mimiciii,radiology_report,PROMPT2_entailment
413,470,11,7,4,0.6363636363636364,15,15,0,1.0,0.7777777777777778,GPT4,mimiciii,radiology_report,PROMPT2_entailment
414,471,18,14,4,0.7777777777777778,18,15,3,0.8333333333333334,0.8045977011494253,GPT4,mimiciii,radiology_report,PROMPT2_entailment
415,472,13,10,3,0.7692307692307693,16,10,6,0.625,0.6896551724137931,GPT4,mimiciii,radiology_report,PROMPT2_entailment
416,473,9,8,1,0.8888888888888888,11,8,3,0.7272727272727273,0.7999999999999999,GPT4,mimiciii,radiology_report,PROMPT2_entailment
417,474,18,14,4,0.7777777777777778,25,22,3,0.88,0.8257372654155496,GPT4,mimiciii,radiology_report,PROMPT2_entailment
418,475,6,6,0,1.0,7,4,3,0.5714285714285714,0.7272727272727273,GPT4,mimiciii,radiology_report,PROMPT2_entailment
419,476,15,14,1,0.9333333333333332,12,11,1,0.9166666666666666,0.9249249249249248,GPT4,mimiciii,radiology_report,PROMPT2_entailment
420,477,18,14,4,0.7777777777777778,16,14,2,0.875,0.823529411764706,GPT4,mimiciii,radiology_report,PROMPT2_entailment
421,478,12,11,1,0.9166666666666666,21,16,5,0.7619047619047619,0.8321513002364067,GPT4,mimiciii,radiology_report,PROMPT2_entailment
422,479,12,10,2,0.8333333333333334,22,13,9,0.5909090909090909,0.6914893617021277,GPT4,mimiciii,radiology_report,PROMPT2_entailment
423,48,12,10,2,0.8333333333333334,21,16,5,0.7619047619047619,0.7960199004975124,GPT4,mimiciii,radiology_report,PROMPT2_entailment
424,480,10,10,0,1.0,10,6,4,0.6,0.7499999999999999,GPT4,mimiciii,radiology_report,PROMPT2_entailment
425,481,17,10,7,0.5882352941176471,17,11,6,0.6470588235294118,0.6162464985994398,GPT4,mimiciii,radiology_report,PROMPT2_entailment
426,482,18,11,7,0.6111111111111112,19,14,5,0.7368421052631579,0.6681127982646421,GPT4,mimiciii,radiology_report,PROMPT2_entailment
427,483,17,16,1,0.9411764705882352,27,19,8,0.7037037037037037,0.8052980132450331,GPT4,mimiciii,radiology_report,PROMPT2_entailment
428,484,8,6,2,0.75,13,7,6,0.5384615384615384,0.6268656716417911,GPT4,mimiciii,radiology_report,PROMPT2_entailment
429,485,18,16,2,0.8888888888888888,27,18,9,0.6666666666666666,0.761904761904762,GPT4,mimiciii,radiology_report,PROMPT2_entailment
430,486,13,10,3,0.7692307692307693,11,11,0,1.0,0.8695652173913044,GPT4,mimiciii,radiology_report,PROMPT2_entailment
431,487,18,12,6,0.6666666666666666,20,13,7,0.65,0.6582278481012659,GPT4,mimiciii,radiology_report,PROMPT2_entailment
432,488,9,7,2,0.7777777777777778,15,11,4,0.7333333333333333,0.7549019607843137,GPT4,mimiciii,radiology_report,PROMPT2_entailment
433,489,17,13,4,0.7647058823529411,18,14,4,0.7777777777777778,0.7711864406779662,GPT4,mimiciii,radiology_report,PROMPT2_entailment
434,49,23,19,4,0.8260869565217391,24,19,5,0.7916666666666666,0.8085106382978724,GPT4,mimiciii,radiology_report,PROMPT2_entailment
435,490,6,6,0,1.0,8,3,5,0.375,0.5454545454545454,GPT4,mimiciii,radiology_report,PROMPT2_entailment
436,491,15,13,2,0.8666666666666667,17,10,7,0.5882352941176471,0.7008086253369272,GPT4,mimiciii,radiology_report,PROMPT2_entailment
437,492,14,11,3,0.7857142857142857,13,9,4,0.6923076923076923,0.7360594795539033,GPT4,mimiciii,radiology_report,PROMPT2_entailment
438,493,14,12,2,0.8571428571428571,9,5,4,0.5555555555555556,0.6741573033707865,GPT4,mimiciii,radiology_report,PROMPT2_entailment
439,494,9,9,0,1.0,8,5,3,0.625,0.7692307692307693,GPT4,mimiciii,radiology_report,PROMPT2_entailment
440,495,10,10,0,1.0,12,10,2,0.8333333333333334,0.9090909090909092,GPT4,mimiciii,radiology_report,PROMPT2_entailment
441,496,20,19,1,0.95,36,22,14,0.6111111111111112,0.7437722419928826,GPT4,mimiciii,radiology_report,PROMPT2_entailment
442,497,15,13,2,0.8666666666666667,25,13,12,0.52,0.65,GPT4,mimiciii,radiology_report,PROMPT2_entailment
443,498,21,13,8,0.6190476190476191,22,15,7,0.6818181818181818,0.64891846921797,GPT4,mimiciii,radiology_report,PROMPT2_entailment
444,499,17,13,4,0.7647058823529411,17,13,4,0.7647058823529411,0.7647058823529412,GPT4,mimiciii,radiology_report,PROMPT2_entailment
445,5,16,11,5,0.6875,22,17,5,0.7727272727272727,0.7276264591439688,GPT4,mimiciii,radiology_report,PROMPT2_entailment
446,50,14,12,2,0.8571428571428571,15,10,5,0.6666666666666666,0.75,GPT4,mimiciii,radiology_report,PROMPT2_entailment
447,51,12,10,2,0.8333333333333334,13,10,3,0.7692307692307693,0.8,GPT4,mimiciii,radiology_report,PROMPT2_entailment
448,52,16,8,8,0.5,21,18,3,0.8571428571428571,0.631578947368421,GPT4,mimiciii,radiology_report,PROMPT2_entailment
449,53,11,10,1,0.9090909090909092,12,8,4,0.6666666666666666,0.7692307692307692,GPT4,mimiciii,radiology_report,PROMPT2_entailment
450,54,11,9,2,0.8181818181818182,10,6,4,0.6,0.6923076923076923,GPT4,mimiciii,radiology_report,PROMPT2_entailment
451,55,16,12,4,0.75,18,14,4,0.7777777777777778,0.7636363636363638,GPT4,mimiciii,radiology_report,PROMPT2_entailment
452,56,15,9,6,0.6,21,14,7,0.6666666666666666,0.631578947368421,GPT4,mimiciii,radiology_report,PROMPT2_entailment
453,57,10,8,2,0.8,10,7,3,0.7,0.7466666666666666,GPT4,mimiciii,radiology_report,PROMPT2_entailment
454,58,14,13,1,0.9285714285714286,16,13,3,0.8125,0.8666666666666666,GPT4,mimiciii,radiology_report,PROMPT2_entailment
455,59,12,12,0,1.0,16,10,6,0.625,0.7692307692307693,GPT4,mimiciii,radiology_report,PROMPT2_entailment
456,6,7,7,0,1.0,8,5,3,0.625,0.7692307692307693,GPT4,mimiciii,radiology_report,PROMPT2_entailment
457,60,17,15,2,0.8823529411764706,19,16,3,0.8421052631578947,0.8617594254937163,GPT4,mimiciii,radiology_report,PROMPT2_entailment
458,61,17,13,4,0.7647058823529411,22,16,6,0.7272727272727273,0.7455197132616488,GPT4,mimiciii,radiology_report,PROMPT2_entailment
459,62,17,11,6,0.6470588235294118,13,9,4,0.6923076923076923,0.6689189189189189,GPT4,mimiciii,radiology_report,PROMPT2_entailment
460,63,9,8,1,0.8888888888888888,15,9,6,0.6,0.7164179104477612,GPT4,mimiciii,radiology_report,PROMPT2_entailment
461,64,20,15,5,0.75,20,13,7,0.65,0.6964285714285715,GPT4,mimiciii,radiology_report,PROMPT2_entailment
462,65,17,12,5,0.7058823529411765,18,16,2,0.8888888888888888,0.7868852459016393,GPT4,mimiciii,radiology_report,PROMPT2_entailment
463,66,15,12,3,0.8,34,17,17,0.5,0.6153846153846154,GPT4,mimiciii,radiology_report,PROMPT2_entailment
464,67,18,15,3,0.8333333333333334,28,21,7,0.75,0.7894736842105262,GPT4,mimiciii,radiology_report,PROMPT2_entailment
465,68,20,18,2,0.9,35,22,13,0.6285714285714286,0.7401869158878506,GPT4,mimiciii,radiology_report,PROMPT2_entailment
466,69,22,14,8,0.6363636363636364,31,24,7,0.7741935483870968,0.6985446985446985,GPT4,mimiciii,radiology_report,PROMPT2_entailment
467,7,11,9,2,0.8181818181818182,16,11,5,0.6875,0.7471698113207547,GPT4,mimiciii,radiology_report,PROMPT2_entailment
468,70,11,7,4,0.6363636363636364,17,17,0,1.0,0.7777777777777778,GPT4,mimiciii,radiology_report,PROMPT2_entailment
469,71,15,13,2,0.8666666666666667,18,11,7,0.6111111111111112,0.7167919799498748,GPT4,mimiciii,radiology_report,PROMPT2_entailment
470,72,14,12,2,0.8571428571428571,13,12,1,0.9230769230769232,0.888888888888889,GPT4,mimiciii,radiology_report,PROMPT2_entailment
471,73,20,11,9,0.55,34,17,17,0.5,0.5238095238095238,GPT4,mimiciii,radiology_report,PROMPT2_entailment
472,74,13,9,4,0.6923076923076923,18,13,5,0.7222222222222222,0.7069486404833838,GPT4,mimiciii,radiology_report,PROMPT2_entailment
473,75,16,13,3,0.8125,12,10,2,0.8333333333333334,0.8227848101265822,GPT4,mimiciii,radiology_report,PROMPT2_entailment
474,76,10,8,2,0.8,14,11,3,0.7857142857142857,0.7927927927927927,GPT4,mimiciii,radiology_report,PROMPT2_entailment
475,77,17,7,10,0.4117647058823529,26,22,4,0.8461538461538461,0.5539568345323741,GPT4,mimiciii,radiology_report,PROMPT2_entailment
476,78,20,11,9,0.55,33,23,10,0.696969696969697,0.6148238153098421,GPT4,mimiciii,radiology_report,PROMPT2_entailment
477,79,12,11,1,0.9166666666666666,17,14,3,0.8235294117647058,0.8676056338028169,GPT4,mimiciii,radiology_report,PROMPT2_entailment
478,8,17,16,1,0.9411764705882352,15,10,5,0.6666666666666666,0.7804878048780487,GPT4,mimiciii,radiology_report,PROMPT2_entailment
479,80,18,12,6,0.6666666666666666,25,20,5,0.8,0.7272727272727272,GPT4,mimiciii,radiology_report,PROMPT2_entailment
480,81,15,11,4,0.7333333333333333,15,10,5,0.6666666666666666,0.6984126984126984,GPT4,mimiciii,radiology_report,PROMPT2_entailment
481,82,16,13,3,0.8125,14,12,2,0.8571428571428571,0.8342245989304812,GPT4,mimiciii,radiology_report,PROMPT2_entailment
482,83,20,12,8,0.6,17,14,3,0.8235294117647058,0.6942148760330579,GPT4,mimiciii,radiology_report,PROMPT2_entailment
483,84,15,12,3,0.8,20,14,6,0.7,0.7466666666666666,GPT4,mimiciii,radiology_report,PROMPT2_entailment
484,85,17,15,2,0.8823529411764706,14,10,4,0.7142857142857143,0.7894736842105262,GPT4,mimiciii,radiology_report,PROMPT2_entailment
485,86,14,10,4,0.7142857142857143,10,7,3,0.7,0.7070707070707072,GPT4,mimiciii,radiology_report,PROMPT2_entailment
486,87,13,12,1,0.9230769230769232,14,10,4,0.7142857142857143,0.8053691275167787,GPT4,mimiciii,radiology_report,PROMPT2_entailment
487,88,14,12,2,0.8571428571428571,19,14,5,0.7368421052631579,0.7924528301886793,GPT4,mimiciii,radiology_report,PROMPT2_entailment
488,89,18,11,7,0.6111111111111112,18,16,2,0.8888888888888888,0.7242798353909464,GPT4,mimiciii,radiology_report,PROMPT2_entailment
489,9,9,8,1,0.8888888888888888,13,11,2,0.8461538461538461,0.8669950738916256,GPT4,mimiciii,radiology_report,PROMPT2_entailment
490,90,13,12,1,0.9230769230769232,14,13,1,0.9285714285714286,0.9258160237388724,GPT4,mimiciii,radiology_report,PROMPT2_entailment
491,91,13,11,2,0.8461538461538461,13,9,4,0.6923076923076923,0.7615384615384616,GPT4,mimiciii,radiology_report,PROMPT2_entailment
492,92,18,14,4,0.7777777777777778,21,15,6,0.7142857142857143,0.7446808510638298,GPT4,mimiciii,radiology_report,PROMPT2_entailment
493,93,16,13,3,0.8125,15,12,3,0.8,0.8062015503875969,GPT4,mimiciii,radiology_report,PROMPT2_entailment
494,94,19,9,10,0.4736842105263157,28,20,8,0.7142857142857143,0.5696202531645569,GPT4,mimiciii,radiology_report,PROMPT2_entailment
495,95,16,15,1,0.9375,18,9,9,0.5,0.6521739130434783,GPT4,mimiciii,radiology_report,PROMPT2_entailment
496,96,16,14,2,0.875,21,13,8,0.6190476190476191,0.7250996015936256,GPT4,mimiciii,radiology_report,PROMPT2_entailment
497,97,12,8,4,0.6666666666666666,23,14,9,0.6086956521739131,0.6363636363636365,GPT4,mimiciii,radiology_report,PROMPT2_entailment
498,98,20,11,9,0.55,19,12,7,0.631578947368421,0.5879732739420935,GPT4,mimiciii,radiology_report,PROMPT2_entailment
499,99,14,14,0,1.0,13,11,2,0.8461538461538461,0.9166666666666666,GPT4,mimiciii,radiology_report,PROMPT2_entailment
0,0,28,20,8,0.7142857142857143,78,60,18,0.7692307692307693,0.7407407407407408,GPT4,mimiciii,progress_note,PROMPT1_entailment
1,1,20,20,0,1.0,8,6,2,0.75,0.8571428571428571,GPT4,mimiciii,progress_note,PROMPT1_entailment
2,10,28,24,4,0.8571428571428571,75,36,39,0.48,0.6153846153846153,GPT4,mimiciii,progress_note,PROMPT1_entailment
3,100,38,31,7,0.8157894736842105,77,63,14,0.8181818181818182,0.8169838945827232,GPT4,mimiciii,progress_note,PROMPT1_entailment
4,101,20,17,3,0.85,36,23,13,0.6388888888888888,0.7294776119402985,GPT4,mimiciii,progress_note,PROMPT1_entailment
5,102,22,19,3,0.8636363636363636,42,36,6,0.8571428571428571,0.860377358490566,GPT4,mimiciii,progress_note,PROMPT1_entailment
6,103,24,21,3,0.875,80,22,58,0.275,0.4184782608695653,GPT4,mimiciii,progress_note,PROMPT1_entailment
7,104,20,15,5,0.75,39,28,11,0.717948717948718,0.7336244541484715,GPT4,mimiciii,progress_note,PROMPT1_entailment
8,105,12,12,0,1.0,17,15,2,0.8823529411764706,0.9375,GPT4,mimiciii,progress_note,PROMPT1_entailment
9,106,16,15,1,0.9375,40,29,11,0.725,0.8176691729323308,GPT4,mimiciii,progress_note,PROMPT1_entailment
10,107,23,20,3,0.8695652173913043,31,24,7,0.7741935483870968,0.8191126279863481,GPT4,mimiciii,progress_note,PROMPT1_entailment
11,108,32,24,8,0.75,68,42,26,0.6176470588235294,0.6774193548387097,GPT4,mimiciii,progress_note,PROMPT1_entailment
12,109,35,32,3,0.9142857142857144,80,42,38,0.525,0.6669975186104218,GPT4,mimiciii,progress_note,PROMPT1_entailment
13,11,27,21,6,0.7777777777777778,75,36,39,0.48,0.5936395759717316,GPT4,mimiciii,progress_note,PROMPT1_entailment
14,110,20,17,3,0.85,80,26,54,0.325,0.4702127659574467,GPT4,mimiciii,progress_note,PROMPT1_entailment
15,111,30,23,7,0.7666666666666667,80,39,41,0.4875,0.5960132890365449,GPT4,mimiciii,progress_note,PROMPT1_entailment
16,112,25,21,4,0.84,80,21,59,0.2625,0.3999999999999999,GPT4,mimiciii,progress_note,PROMPT1_entailment
17,113,46,38,8,0.8260869565217391,80,52,28,0.65,0.727540500736377,GPT4,mimiciii,progress_note,PROMPT1_entailment
18,114,31,20,11,0.6451612903225806,80,39,41,0.4875,0.5553577785688858,GPT4,mimiciii,progress_note,PROMPT1_entailment
19,115,24,18,6,0.75,80,30,50,0.375,0.5,GPT4,mimiciii,progress_note,PROMPT1_entailment
20,116,15,10,5,0.6666666666666666,35,28,7,0.8,0.7272727272727272,GPT4,mimiciii,progress_note,PROMPT1_entailment
21,117,11,10,1,0.9090909090909092,20,17,3,0.85,0.8785529715762274,GPT4,mimiciii,progress_note,PROMPT1_entailment
22,118,19,18,1,0.9473684210526316,23,18,5,0.782608695652174,0.8571428571428571,GPT4,mimiciii,progress_note,PROMPT1_entailment
23,119,14,12,2,0.8571428571428571,14,11,3,0.7857142857142857,0.8198757763975155,GPT4,mimiciii,progress_note,PROMPT1_entailment
24,12,21,17,4,0.8095238095238095,75,21,54,0.28,0.4160839160839161,GPT4,mimiciii,progress_note,PROMPT1_entailment
25,120,31,30,1,0.967741935483871,64,38,26,0.59375,0.7359586830213041,GPT4,mimiciii,progress_note,PROMPT1_entailment
26,121,13,12,1,0.9230769230769232,14,11,3,0.7857142857142857,0.8488745980707394,GPT4,mimiciii,progress_note,PROMPT1_entailment
27,122,19,14,5,0.7368421052631579,47,41,6,0.8723404255319149,0.7988865692414753,GPT4,mimiciii,progress_note,PROMPT1_entailment
28,123,21,20,1,0.9523809523809524,50,34,16,0.68,0.7934655775962661,GPT4,mimiciii,progress_note,PROMPT1_entailment
29,124,27,23,4,0.8518518518518519,65,55,10,0.8461538461538461,0.8489932885906041,GPT4,mimiciii,progress_note,PROMPT1_entailment
30,125,18,13,5,0.7222222222222222,50,35,15,0.7,0.7109375000000001,GPT4,mimiciii,progress_note,PROMPT1_entailment
31,126,14,10,4,0.7142857142857143,27,27,0,1.0,0.8333333333333333,GPT4,mimiciii,progress_note,PROMPT1_entailment
32,127,15,12,3,0.8,27,26,1,0.9629629629629628,0.8739495798319328,GPT4,mimiciii,progress_note,PROMPT1_entailment
33,128,19,18,1,0.9473684210526316,37,31,6,0.8378378378378378,0.8892430278884462,GPT4,mimiciii,progress_note,PROMPT1_entailment
34,129,27,15,12,0.5555555555555556,66,45,21,0.6818181818181818,0.6122448979591836,GPT4,mimiciii,progress_note,PROMPT1_entailment
35,13,33,26,7,0.7878787878787878,73,53,20,0.726027397260274,0.7556896078969016,GPT4,mimiciii,progress_note,PROMPT1_entailment
36,130,19,9,10,0.4736842105263157,44,28,16,0.6363636363636364,0.543103448275862,GPT4,mimiciii,progress_note,PROMPT1_entailment
37,131,28,22,6,0.7857142857142857,80,38,42,0.475,0.5920679886685551,GPT4,mimiciii,progress_note,PROMPT1_entailment
38,132,25,22,3,0.88,80,35,45,0.4375,0.5844402277039848,GPT4,mimiciii,progress_note,PROMPT1_entailment
39,133,20,16,4,0.8,80,31,49,0.3875,0.5221052631578948,GPT4,mimiciii,progress_note,PROMPT1_entailment
40,134,10,9,1,0.9,18,8,10,0.4444444444444444,0.5950413223140495,GPT4,mimiciii,progress_note,PROMPT1_entailment
41,135,21,17,4,0.8095238095238095,35,22,13,0.6285714285714286,0.707663197729423,GPT4,mimiciii,progress_note,PROMPT1_entailment
42,136,22,18,4,0.8181818181818182,43,37,6,0.8604651162790697,0.8387909319899245,GPT4,mimiciii,progress_note,PROMPT1_entailment
43,137,13,11,2,0.8461538461538461,26,21,5,0.8076923076923077,0.8264758497316638,GPT4,mimiciii,progress_note,PROMPT1_entailment
44,138,12,11,1,0.9166666666666666,45,24,21,0.5333333333333333,0.6743295019157088,GPT4,mimiciii,progress_note,PROMPT1_entailment
45,139,22,20,2,0.9090909090909092,45,38,7,0.8444444444444444,0.8755760368663594,GPT4,mimiciii,progress_note,PROMPT1_entailment
46,14,30,17,13,0.5666666666666667,43,40,3,0.9302325581395348,0.7042982910409114,GPT4,mimiciii,progress_note,PROMPT1_entailment
47,140,13,7,6,0.5384615384615384,25,23,2,0.92,0.6793248945147679,GPT4,mimiciii,progress_note,PROMPT1_entailment
48,141,22,21,1,0.9545454545454546,45,39,6,0.8666666666666667,0.9084858569051582,GPT4,mimiciii,progress_note,PROMPT1_entailment
49,142,14,13,1,0.9285714285714286,50,36,14,0.72,0.8110918544194108,GPT4,mimiciii,progress_note,PROMPT1_entailment
50,143,7,6,1,0.8571428571428571,11,10,1,0.9090909090909092,0.8823529411764706,GPT4,mimiciii,progress_note,PROMPT1_entailment
51,144,21,21,0,1.0,50,42,8,0.84,0.9130434782608696,GPT4,mimiciii,progress_note,PROMPT1_entailment
52,145,21,17,4,0.8095238095238095,43,28,15,0.6511627906976745,0.7217589082638363,GPT4,mimiciii,progress_note,PROMPT1_entailment
53,146,18,14,4,0.7777777777777778,32,30,2,0.9375,0.8502024291497976,GPT4,mimiciii,progress_note,PROMPT1_entailment
54,147,25,23,2,0.92,56,38,18,0.6785714285714286,0.7810545129579982,GPT4,mimiciii,progress_note,PROMPT1_entailment
55,148,7,6,1,0.8571428571428571,4,3,1,0.75,0.7999999999999999,GPT4,mimiciii,progress_note,PROMPT1_entailment
56,149,15,11,4,0.7333333333333333,29,25,4,0.8620689655172413,0.792507204610951,GPT4,mimiciii,progress_note,PROMPT1_entailment
57,15,28,23,5,0.8214285714285714,75,42,33,0.56,0.6659772492244054,GPT4,mimiciii,progress_note,PROMPT1_entailment
58,150,21,13,8,0.6190476190476191,80,56,24,0.7,0.6570397111913358,GPT4,mimiciii,progress_note,PROMPT1_entailment
59,151,21,21,0,1.0,80,51,29,0.6375,0.7786259541984732,GPT4,mimiciii,progress_note,PROMPT1_entailment
60,152,32,22,10,0.6875,45,41,4,0.9111111111111112,0.7836663770634231,GPT4,mimiciii,progress_note,PROMPT1_entailment
61,153,32,31,1,0.96875,80,30,50,0.375,0.5406976744186046,GPT4,mimiciii,progress_note,PROMPT1_entailment
62,154,10,9,1,0.9,15,14,1,0.9333333333333332,0.9163636363636364,GPT4,mimiciii,progress_note,PROMPT1_entailment
63,155,19,15,4,0.7894736842105263,32,26,6,0.8125,0.8008213552361396,GPT4,mimiciii,progress_note,PROMPT1_entailment
64,156,20,15,5,0.75,32,26,6,0.8125,0.78,GPT4,mimiciii,progress_note,PROMPT1_entailment
65,157,13,11,2,0.8461538461538461,29,24,5,0.8275862068965517,0.8367670364500792,GPT4,mimiciii,progress_note,PROMPT1_entailment
66,158,22,14,8,0.6363636363636364,80,28,52,0.35,0.4516129032258064,GPT4,mimiciii,progress_note,PROMPT1_entailment
67,159,12,10,2,0.8333333333333334,22,15,7,0.6818181818181818,0.7499999999999999,GPT4,mimiciii,progress_note,PROMPT1_entailment
68,16,17,16,1,0.9411764705882352,28,25,3,0.8928571428571429,0.9163802978235968,GPT4,mimiciii,progress_note,PROMPT1_entailment
69,160,24,23,1,0.9583333333333334,65,53,12,0.8153846153846154,0.8810986628117095,GPT4,mimiciii,progress_note,PROMPT1_entailment
70,161,31,27,4,0.8709677419354839,80,52,28,0.65,0.7444326617179216,GPT4,mimiciii,progress_note,PROMPT1_entailment
71,162,26,24,2,0.9230769230769232,80,22,58,0.275,0.4237560192616372,GPT4,mimiciii,progress_note,PROMPT1_entailment
72,163,16,12,4,0.75,28,16,12,0.5714285714285714,0.6486486486486486,GPT4,mimiciii,progress_note,PROMPT1_entailment
73,164,25,13,12,0.52,57,47,10,0.8245614035087719,0.6377870563674322,GPT4,mimiciii,progress_note,PROMPT1_entailment
74,165,9,9,0,1.0,25,16,9,0.64,0.7804878048780487,GPT4,mimiciii,progress_note,PROMPT1_entailment
75,166,24,21,3,0.875,42,27,15,0.6428571428571429,0.7411764705882353,GPT4,mimiciii,progress_note,PROMPT1_entailment
76,167,17,14,3,0.8235294117647058,52,38,14,0.7307692307692307,0.7743813682678312,GPT4,mimiciii,progress_note,PROMPT1_entailment
77,168,34,30,4,0.8823529411764706,80,33,47,0.4125,0.5621805792163543,GPT4,mimiciii,progress_note,PROMPT1_entailment
78,169,16,14,2,0.875,80,26,54,0.325,0.4739583333333333,GPT4,mimiciii,progress_note,PROMPT1_entailment
79,17,7,5,2,0.7142857142857143,15,14,1,0.9333333333333332,0.809248554913295,GPT4,mimiciii,progress_note,PROMPT1_entailment
80,170,24,20,4,0.8333333333333334,80,37,43,0.4625,0.594855305466238,GPT4,mimiciii,progress_note,PROMPT1_entailment
81,171,20,18,2,0.9,80,32,48,0.4,0.5538461538461539,GPT4,mimiciii,progress_note,PROMPT1_entailment
82,172,21,18,3,0.8571428571428571,80,21,59,0.2625,0.4019138755980861,GPT4,mimiciii,progress_note,PROMPT1_entailment
83,173,49,40,9,0.8163265306122449,80,54,26,0.675,0.7389668149161821,GPT4,mimiciii,progress_note,PROMPT1_entailment
84,174,26,25,1,0.9615384615384616,80,27,53,0.3375,0.4996299037749815,GPT4,mimiciii,progress_note,PROMPT1_entailment
85,175,20,20,0,1.0,80,46,34,0.575,0.7301587301587301,GPT4,mimiciii,progress_note,PROMPT1_entailment
86,176,23,19,4,0.8260869565217391,80,28,52,0.35,0.4916820702402957,GPT4,mimiciii,progress_note,PROMPT1_entailment
87,177,30,27,3,0.9,80,31,49,0.3875,0.541747572815534,GPT4,mimiciii,progress_note,PROMPT1_entailment
88,178,15,13,2,0.8666666666666667,17,13,4,0.7647058823529411,0.8125,GPT4,mimiciii,progress_note,PROMPT1_entailment
89,179,22,16,6,0.7272727272727273,80,26,54,0.325,0.449244060475162,GPT4,mimiciii,progress_note,PROMPT1_entailment
90,18,19,11,8,0.5789473684210527,18,16,2,0.8888888888888888,0.7011952191235059,GPT4,mimiciii,progress_note,PROMPT1_entailment
91,180,43,36,7,0.8372093023255814,80,50,30,0.625,0.7157057654075547,GPT4,mimiciii,progress_note,PROMPT1_entailment
92,181,27,22,5,0.8148148148148148,80,27,53,0.3375,0.4773001205303335,GPT4,mimiciii,progress_note,PROMPT1_entailment
93,182,26,24,2,0.9230769230769232,80,38,42,0.475,0.6272352132049519,GPT4,mimiciii,progress_note,PROMPT1_entailment
94,183,30,25,5,0.8333333333333334,80,37,43,0.4625,0.594855305466238,GPT4,mimiciii,progress_note,PROMPT1_entailment
95,184,23,23,0,1.0,80,46,34,0.575,0.7301587301587301,GPT4,mimiciii,progress_note,PROMPT1_entailment
96,185,19,17,2,0.8947368421052632,48,28,20,0.5833333333333334,0.7062314540059348,GPT4,mimiciii,progress_note,PROMPT1_entailment
97,186,17,12,5,0.7058823529411765,80,26,54,0.325,0.4450784593437946,GPT4,mimiciii,progress_note,PROMPT1_entailment
98,187,24,19,5,0.7916666666666666,80,33,47,0.4125,0.5423875432525952,GPT4,mimiciii,progress_note,PROMPT1_entailment
99,188,24,19,5,0.7916666666666666,80,30,50,0.375,0.5089285714285715,GPT4,mimiciii,progress_note,PROMPT1_entailment
100,189,21,19,2,0.9047619047619048,80,34,46,0.425,0.5783348254252462,GPT4,mimiciii,progress_note,PROMPT1_entailment
101,19,16,14,2,0.875,38,33,5,0.868421052631579,0.8716981132075472,GPT4,mimiciii,progress_note,PROMPT1_entailment
102,190,22,15,7,0.6818181818181818,80,34,46,0.425,0.5236139630390144,GPT4,mimiciii,progress_note,PROMPT1_entailment
103,191,23,19,4,0.8260869565217391,80,28,52,0.35,0.4916820702402957,GPT4,mimiciii,progress_note,PROMPT1_entailment
104,192,24,22,2,0.9166666666666666,80,45,35,0.5625,0.6971830985915494,GPT4,mimiciii,progress_note,PROMPT1_entailment
105,193,17,16,1,0.9411764705882352,80,42,38,0.525,0.6740220661985957,GPT4,mimiciii,progress_note,PROMPT1_entailment
106,194,24,16,8,0.6666666666666666,80,23,57,0.2875,0.4017467248908297,GPT4,mimiciii,progress_note,PROMPT1_entailment
107,195,21,20,1,0.9523809523809524,44,33,11,0.75,0.8391608391608391,GPT4,mimiciii,progress_note,PROMPT1_entailment
108,196,22,18,4,0.8181818181818182,42,28,14,0.6666666666666666,0.7346938775510203,GPT4,mimiciii,progress_note,PROMPT1_entailment
109,197,33,29,4,0.8787878787878788,80,64,16,0.8,0.8375451263537907,GPT4,mimiciii,progress_note,PROMPT1_entailment
110,198,23,21,2,0.9130434782608696,34,31,3,0.9117647058823528,0.9124036440084092,GPT4,mimiciii,progress_note,PROMPT1_entailment
111,199,24,18,6,0.75,52,31,21,0.5961538461538461,0.6642857142857141,GPT4,mimiciii,progress_note,PROMPT1_entailment
112,2,19,17,2,0.8947368421052632,75,25,50,0.3333333333333333,0.4857142857142856,GPT4,mimiciii,progress_note,PROMPT1_entailment
113,20,10,9,1,0.9,33,21,12,0.6363636363636364,0.7455621301775148,GPT4,mimiciii,progress_note,PROMPT1_entailment
114,200,35,22,13,0.6285714285714286,80,35,45,0.4375,0.5159128978224456,GPT4,mimiciii,progress_note,PROMPT1_entailment
115,201,24,22,2,0.9166666666666666,80,41,39,0.5125,0.6574344023323614,GPT4,mimiciii,progress_note,PROMPT1_entailment
116,202,32,29,3,0.90625,80,38,42,0.475,0.6233031674208144,GPT4,mimiciii,progress_note,PROMPT1_entailment
117,203,18,17,1,0.9444444444444444,80,19,61,0.2375,0.3795534665099882,GPT4,mimiciii,progress_note,PROMPT1_entailment
118,204,35,29,6,0.8285714285714286,80,42,38,0.525,0.6427440633245383,GPT4,mimiciii,progress_note,PROMPT1_entailment
119,205,37,35,2,0.945945945945946,80,33,47,0.4125,0.5744839592141259,GPT4,mimiciii,progress_note,PROMPT1_entailment
120,206,33,27,6,0.8181818181818182,80,51,29,0.6375,0.7166276346604216,GPT4,mimiciii,progress_note,PROMPT1_entailment
121,207,35,31,4,0.8857142857142857,80,34,46,0.425,0.5743869209809264,GPT4,mimiciii,progress_note,PROMPT1_entailment
122,208,30,29,1,0.9666666666666668,80,40,40,0.5,0.6590909090909091,GPT4,mimiciii,progress_note,PROMPT1_entailment
123,209,22,18,4,0.8181818181818182,80,38,42,0.475,0.6010544815465729,GPT4,mimiciii,progress_note,PROMPT1_entailment
124,21,22,21,1,0.9545454545454546,75,23,52,0.3066666666666666,0.4641999038923594,GPT4,mimiciii,progress_note,PROMPT1_entailment
125,210,17,13,4,0.7647058823529411,28,25,3,0.8928571428571429,0.8238276299112802,GPT4,mimiciii,progress_note,PROMPT1_entailment
126,211,29,26,3,0.896551724137931,54,46,8,0.8518518518518519,0.8736303871439007,GPT4,mimiciii,progress_note,PROMPT1_entailment
127,212,13,9,4,0.6923076923076923,14,13,1,0.9285714285714286,0.7932203389830509,GPT4,mimiciii,progress_note,PROMPT1_entailment
128,213,25,21,4,0.84,41,34,7,0.8292682926829268,0.8345996493278784,GPT4,mimiciii,progress_note,PROMPT1_entailment
129,214,12,12,0,1.0,27,20,7,0.7407407407407407,0.851063829787234,GPT4,mimiciii,progress_note,PROMPT1_entailment
130,215,38,23,15,0.6052631578947368,66,40,26,0.6060606060606061,0.6056616194865042,GPT4,mimiciii,progress_note,PROMPT1_entailment
131,216,25,20,5,0.8,67,34,33,0.5074626865671642,0.6210045662100457,GPT4,mimiciii,progress_note,PROMPT1_entailment
132,217,28,21,7,0.75,73,56,17,0.7671232876712328,0.7584650112866816,GPT4,mimiciii,progress_note,PROMPT1_entailment
133,218,16,14,2,0.875,27,22,5,0.8148148148148148,0.843835616438356,GPT4,mimiciii,progress_note,PROMPT1_entailment
134,219,7,6,1,0.8571428571428571,17,7,10,0.4117647058823529,0.5562913907284768,GPT4,mimiciii,progress_note,PROMPT1_entailment
135,22,13,13,0,1.0,38,29,9,0.7631578947368421,0.8656716417910448,GPT4,mimiciii,progress_note,PROMPT1_entailment
136,220,14,11,3,0.7857142857142857,34,33,1,0.9705882352941176,0.8684210526315789,GPT4,mimiciii,progress_note,PROMPT1_entailment
137,221,18,17,1,0.9444444444444444,80,33,47,0.4125,0.5742067553735927,GPT4,mimiciii,progress_note,PROMPT1_entailment
138,222,24,23,1,0.9583333333333334,80,28,52,0.35,0.5127388535031847,GPT4,mimiciii,progress_note,PROMPT1_entailment
139,223,11,9,2,0.8181818181818182,30,25,5,0.8333333333333334,0.8256880733944955,GPT4,mimiciii,progress_note,PROMPT1_entailment
140,224,14,11,3,0.7857142857142857,33,30,3,0.9090909090909092,0.842911877394636,GPT4,mimiciii,progress_note,PROMPT1_entailment
141,225,23,21,2,0.9130434782608696,37,28,9,0.7567567567567568,0.8275862068965518,GPT4,mimiciii,progress_note,PROMPT1_entailment
142,226,19,18,1,0.9473684210526316,33,24,9,0.7272727272727273,0.8228571428571427,GPT4,mimiciii,progress_note,PROMPT1_entailment
143,227,9,8,1,0.8888888888888888,15,12,3,0.8,0.8421052631578948,GPT4,mimiciii,progress_note,PROMPT1_entailment
144,228,15,15,0,1.0,15,12,3,0.8,0.888888888888889,GPT4,mimiciii,progress_note,PROMPT1_entailment
145,229,15,15,0,1.0,15,12,3,0.8,0.888888888888889,GPT4,mimiciii,progress_note,PROMPT1_entailment
146,23,19,15,4,0.7894736842105263,37,26,11,0.7027027027027027,0.7435653002859867,GPT4,mimiciii,progress_note,PROMPT1_entailment
147,230,16,15,1,0.9375,26,17,9,0.6538461538461539,0.7703927492447131,GPT4,mimiciii,progress_note,PROMPT1_entailment
148,231,31,30,1,0.967741935483871,79,55,24,0.6962025316455697,0.8098159509202454,GPT4,mimiciii,progress_note,PROMPT1_entailment
149,232,46,37,9,0.8043478260869565,72,49,23,0.6805555555555556,0.7372915819438797,GPT4,mimiciii,progress_note,PROMPT1_entailment
150,233,30,21,9,0.7,80,61,19,0.7625,0.7299145299145299,GPT4,mimiciii,progress_note,PROMPT1_entailment
151,234,23,18,5,0.782608695652174,42,27,15,0.6428571428571429,0.7058823529411765,GPT4,mimiciii,progress_note,PROMPT1_entailment
152,24,17,9,8,0.5294117647058824,22,14,8,0.6363636363636364,0.5779816513761468,GPT4,mimiciii,progress_note,PROMPT1_entailment
153,25,11,6,5,0.5454545454545454,22,12,10,0.5454545454545454,0.5454545454545454,GPT4,mimiciii,progress_note,PROMPT1_entailment
154,26,13,9,4,0.6923076923076923,22,12,10,0.5454545454545454,0.6101694915254238,GPT4,mimiciii,progress_note,PROMPT1_entailment
155,27,22,11,11,0.5,19,17,2,0.8947368421052632,0.6415094339622641,GPT4,mimiciii,progress_note,PROMPT1_entailment
156,28,35,27,8,0.7714285714285715,50,35,15,0.7,0.7339805825242719,GPT4,mimiciii,progress_note,PROMPT1_entailment
157,29,26,26,0,1.0,52,34,18,0.6538461538461539,0.7906976744186047,GPT4,mimiciii,progress_note,PROMPT1_entailment
158,3,27,21,6,0.7777777777777778,75,35,40,0.4666666666666667,0.5833333333333334,GPT4,mimiciii,progress_note,PROMPT1_entailment
159,30,20,19,1,0.95,18,12,6,0.6666666666666666,0.7835051546391752,GPT4,mimiciii,progress_note,PROMPT1_entailment
160,31,17,16,1,0.9411764705882352,17,16,1,0.9411764705882352,0.9411764705882352,GPT4,mimiciii,progress_note,PROMPT1_entailment
161,32,25,19,6,0.76,72,33,39,0.4583333333333333,0.5718194254445965,GPT4,mimiciii,progress_note,PROMPT1_entailment
162,33,26,21,5,0.8076923076923077,65,49,16,0.7538461538461538,0.7798408488063661,GPT4,mimiciii,progress_note,PROMPT1_entailment
163,34,23,18,5,0.782608695652174,71,48,23,0.676056338028169,0.7254408060453401,GPT4,mimiciii,progress_note,PROMPT1_entailment
164,35,5,4,1,0.8,20,7,13,0.35,0.4869565217391304,GPT4,mimiciii,progress_note,PROMPT1_entailment
165,36,18,14,4,0.7777777777777778,40,21,19,0.525,0.6268656716417911,GPT4,mimiciii,progress_note,PROMPT1_entailment
166,37,24,19,5,0.7916666666666666,75,32,43,0.4266666666666667,0.5544915640674875,GPT4,mimiciii,progress_note,PROMPT1_entailment
167,38,36,31,5,0.8611111111111112,75,43,32,0.5733333333333334,0.6883552801445908,GPT4,mimiciii,progress_note,PROMPT1_entailment
168,39,24,24,0,1.0,75,55,20,0.7333333333333333,0.846153846153846,GPT4,mimiciii,progress_note,PROMPT1_entailment
169,4,30,24,6,0.8,75,40,35,0.5333333333333333,0.64,GPT4,mimiciii,progress_note,PROMPT1_entailment
170,40,23,22,1,0.9565217391304348,75,49,26,0.6533333333333333,0.776377385667987,GPT4,mimiciii,progress_note,PROMPT1_entailment
171,41,32,27,5,0.84375,75,62,13,0.8266666666666667,0.8351209777999501,GPT4,mimiciii,progress_note,PROMPT1_entailment
172,42,28,22,6,0.7857142857142857,75,61,14,0.8133333333333334,0.7992852888624181,GPT4,mimiciii,progress_note,PROMPT1_entailment
173,43,30,21,9,0.7,74,49,25,0.6621621621621622,0.6805555555555556,GPT4,mimiciii,progress_note,PROMPT1_entailment
174,44,24,21,3,0.875,75,41,34,0.5466666666666666,0.6729191090269636,GPT4,mimiciii,progress_note,PROMPT1_entailment
175,45,27,23,4,0.8518518518518519,75,54,21,0.72,0.7803958529688972,GPT4,mimiciii,progress_note,PROMPT1_entailment
176,46,19,13,6,0.6842105263157895,36,25,11,0.6944444444444444,0.689289501590668,GPT4,mimiciii,progress_note,PROMPT1_entailment
177,47,11,8,3,0.7272727272727273,10,10,0,1.0,0.8421052631578948,GPT4,mimiciii,progress_note,PROMPT1_entailment
178,48,40,39,1,0.975,30,21,9,0.7,0.8149253731343284,GPT4,mimiciii,progress_note,PROMPT1_entailment
179,49,31,27,4,0.8709677419354839,57,39,18,0.6842105263157895,0.7663755458515285,GPT4,mimiciii,progress_note,PROMPT1_entailment
180,5,50,45,5,0.9,75,51,24,0.68,0.7746835443037976,GPT4,mimiciii,progress_note,PROMPT1_entailment
181,50,47,44,3,0.9361702127659576,75,62,13,0.8266666666666667,0.8780173801094304,GPT4,mimiciii,progress_note,PROMPT1_entailment
182,51,20,15,5,0.75,75,28,47,0.3733333333333333,0.4985163204747775,GPT4,mimiciii,progress_note,PROMPT1_entailment
183,52,26,22,4,0.8461538461538461,75,25,50,0.3333333333333333,0.4782608695652173,GPT4,mimiciii,progress_note,PROMPT1_entailment
184,53,21,16,5,0.7619047619047619,75,21,54,0.28,0.4095063985374771,GPT4,mimiciii,progress_note,PROMPT1_entailment
185,54,35,24,11,0.6857142857142857,75,39,36,0.52,0.5914691943127962,GPT4,mimiciii,progress_note,PROMPT1_entailment
186,55,25,24,1,0.96,75,27,48,0.36,0.5236363636363637,GPT4,mimiciii,progress_note,PROMPT1_entailment
187,56,16,15,1,0.9375,40,40,0,1.0,0.967741935483871,GPT4,mimiciii,progress_note,PROMPT1_entailment
188,57,13,10,3,0.7692307692307693,28,22,6,0.7857142857142857,0.7773851590106008,GPT4,mimiciii,progress_note,PROMPT1_entailment
189,58,13,8,5,0.6153846153846154,25,17,8,0.68,0.6460807600950118,GPT4,mimiciii,progress_note,PROMPT1_entailment
190,59,14,10,4,0.7142857142857143,25,17,8,0.68,0.6967213114754098,GPT4,mimiciii,progress_note,PROMPT1_entailment
191,6,55,49,6,0.8909090909090909,75,52,23,0.6933333333333334,0.7798010711553176,GPT4,mimiciii,progress_note,PROMPT1_entailment
192,60,18,14,4,0.7777777777777778,75,35,40,0.4666666666666667,0.5833333333333334,GPT4,mimiciii,progress_note,PROMPT1_entailment
193,61,21,15,6,0.7142857142857143,37,30,7,0.8108108108108109,0.759493670886076,GPT4,mimiciii,progress_note,PROMPT1_entailment
194,62,19,12,7,0.631578947368421,37,31,6,0.8378378378378378,0.7202323330106485,GPT4,mimiciii,progress_note,PROMPT1_entailment
195,63,21,17,4,0.8095238095238095,75,62,13,0.8266666666666667,0.8180054326736516,GPT4,mimiciii,progress_note,PROMPT1_entailment
196,64,2,1,1,0.5,1,0,1,0.0,0.0,GPT4,mimiciii,progress_note,PROMPT1_entailment
197,65,15,14,1,0.9333333333333332,8,8,0,1.0,0.9655172413793104,GPT4,mimiciii,progress_note,PROMPT1_entailment
198,66,23,20,3,0.8695652173913043,48,36,12,0.75,0.8053691275167786,GPT4,mimiciii,progress_note,PROMPT1_entailment
199,67,20,17,3,0.85,75,35,40,0.4666666666666667,0.6025316455696202,GPT4,mimiciii,progress_note,PROMPT1_entailment
200,68,25,18,7,0.72,75,29,46,0.3866666666666666,0.5031325301204819,GPT4,mimiciii,progress_note,PROMPT1_entailment
201,69,28,28,0,1.0,75,29,46,0.3866666666666666,0.5576923076923077,GPT4,mimiciii,progress_note,PROMPT1_entailment
202,7,45,42,3,0.9333333333333332,75,50,25,0.6666666666666666,0.7777777777777778,GPT4,mimiciii,progress_note,PROMPT1_entailment
203,70,31,25,6,0.8064516129032258,75,15,60,0.2,0.3205128205128205,GPT4,mimiciii,progress_note,PROMPT1_entailment
204,71,24,21,3,0.875,75,36,39,0.48,0.6199261992619925,GPT4,mimiciii,progress_note,PROMPT1_entailment
205,72,9,9,0,1.0,15,10,5,0.6666666666666666,0.8,GPT4,mimiciii,progress_note,PROMPT1_entailment
206,73,20,16,4,0.8,75,22,53,0.2933333333333333,0.4292682926829269,GPT4,mimiciii,progress_note,PROMPT1_entailment
207,74,22,19,3,0.8636363636363636,75,32,43,0.4266666666666667,0.5711601690934712,GPT4,mimiciii,progress_note,PROMPT1_entailment
208,75,32,29,3,0.90625,40,21,19,0.525,0.6648471615720525,GPT4,mimiciii,progress_note,PROMPT1_entailment
209,76,25,16,9,0.64,58,49,9,0.8448275862068966,0.7282861124013006,GPT4,mimiciii,progress_note,PROMPT1_entailment
210,77,13,12,1,0.9230769230769232,27,21,6,0.7777777777777778,0.8442211055276381,GPT4,mimiciii,progress_note,PROMPT1_entailment
211,78,18,17,1,0.9444444444444444,20,16,4,0.8,0.8662420382165604,GPT4,mimiciii,progress_note,PROMPT1_entailment
212,79,18,15,3,0.8333333333333334,43,25,18,0.5813953488372093,0.684931506849315,GPT4,mimiciii,progress_note,PROMPT1_entailment
213,8,27,23,4,0.8518518518518519,75,63,12,0.84,0.8458844133099824,GPT4,mimiciii,progress_note,PROMPT1_entailment
214,80,19,15,4,0.7894736842105263,21,17,4,0.8095238095238095,0.7993730407523512,GPT4,mimiciii,progress_note,PROMPT1_entailment
215,81,27,19,8,0.7037037037037037,32,28,4,0.875,0.7800586510263929,GPT4,mimiciii,progress_note,PROMPT1_entailment
216,82,8,8,0,1.0,15,15,0,1.0,1.0,GPT4,mimiciii,progress_note,PROMPT1_entailment
217,83,25,23,2,0.92,43,34,9,0.7906976744186046,0.8504622077215878,GPT4,mimiciii,progress_note,PROMPT1_entailment
218,84,18,16,2,0.8888888888888888,35,20,15,0.5714285714285714,0.6956521739130435,GPT4,mimiciii,progress_note,PROMPT1_entailment
219,85,19,16,3,0.8421052631578947,50,42,8,0.84,0.8410513141426784,GPT4,mimiciii,progress_note,PROMPT1_entailment
220,86,38,38,0,1.0,32,24,8,0.75,0.8571428571428571,GPT4,mimiciii,progress_note,PROMPT1_entailment
221,87,5,4,1,0.8,12,5,7,0.4166666666666667,0.547945205479452,GPT4,mimiciii,progress_note,PROMPT1_entailment
222,88,33,29,4,0.8787878787878788,67,45,22,0.6716417910447762,0.7613768961493583,GPT4,mimiciii,progress_note,PROMPT1_entailment
223,89,25,20,5,0.8,75,31,44,0.4133333333333333,0.545054945054945,GPT4,mimiciii,progress_note,PROMPT1_entailment
224,9,24,22,2,0.9166666666666666,42,30,12,0.7142857142857143,0.8029197080291971,GPT4,mimiciii,progress_note,PROMPT1_entailment
225,90,6,6,0,1.0,3,3,0,1.0,1.0,GPT4,mimiciii,progress_note,PROMPT1_entailment
226,91,30,30,0,1.0,75,52,23,0.6933333333333334,0.8188976377952756,GPT4,mimiciii,progress_note,PROMPT1_entailment
227,92,43,33,10,0.7674418604651163,75,51,24,0.68,0.7210796915167095,GPT4,mimiciii,progress_note,PROMPT1_entailment
228,93,17,15,2,0.8823529411764706,27,11,16,0.4074074074074074,0.5574324324324323,GPT4,mimiciii,progress_note,PROMPT1_entailment
229,94,30,24,6,0.8,24,14,10,0.5833333333333334,0.674698795180723,GPT4,mimiciii,progress_note,PROMPT1_entailment
230,95,20,9,11,0.45,6,4,2,0.6666666666666666,0.5373134328358209,GPT4,mimiciii,progress_note,PROMPT1_entailment
231,96,10,8,2,0.8,8,6,2,0.75,0.7741935483870969,GPT4,mimiciii,progress_note,PROMPT1_entailment
232,97,10,10,0,1.0,14,14,0,1.0,1.0,GPT4,mimiciii,progress_note,PROMPT1_entailment
233,98,16,13,3,0.8125,24,23,1,0.9583333333333334,0.8794117647058823,GPT4,mimiciii,progress_note,PROMPT1_entailment
234,99,25,21,4,0.84,70,38,32,0.5428571428571428,0.6595041322314049,GPT4,mimiciii,progress_note,PROMPT1_entailment
0,0,58,48,10,0.8275862068965517,78,65,13,0.8333333333333334,0.8304498269896194,GPT4,mimiciii,progress_note,PROMPT1_ICL_entailment
1,1,45,41,4,0.9111111111111112,80,35,45,0.4375,0.5911431513903193,GPT4,mimiciii,progress_note,PROMPT1_ICL_entailment
2,10,57,46,11,0.8070175438596491,80,37,43,0.4625,0.5880117464156158,GPT4,mimiciii,progress_note,PROMPT1_ICL_entailment
3,100,62,51,11,0.8225806451612904,77,57,20,0.7402597402597403,0.7792521109770809,GPT4,mimiciii,progress_note,PROMPT1_ICL_entailment
4,101,28,23,5,0.8214285714285714,36,24,12,0.6666666666666666,0.7359999999999999,GPT4,mimiciii,progress_note,PROMPT1_ICL_entailment
5,102,50,40,10,0.8,42,35,7,0.8333333333333334,0.816326530612245,GPT4,mimiciii,progress_note,PROMPT1_ICL_entailment
6,103,42,31,11,0.7380952380952381,80,30,50,0.375,0.4973262032085561,GPT4,mimiciii,progress_note,PROMPT1_ICL_entailment
7,104,22,13,9,0.5909090909090909,39,26,13,0.6666666666666666,0.6265060240963856,GPT4,mimiciii,progress_note,PROMPT1_ICL_entailment
8,105,29,24,5,0.8275862068965517,17,15,2,0.8823529411764706,0.8540925266903915,GPT4,mimiciii,progress_note,PROMPT1_ICL_entailment
9,106,24,20,4,0.8333333333333334,40,22,18,0.55,0.6626506024096386,GPT4,mimiciii,progress_note,PROMPT1_ICL_entailment
10,107,26,22,4,0.8461538461538461,31,27,4,0.8709677419354839,0.8583815028901733,GPT4,mimiciii,progress_note,PROMPT1_ICL_entailment
11,108,41,29,12,0.7073170731707317,68,44,24,0.6470588235294118,0.6758474576271186,GPT4,mimiciii,progress_note,PROMPT1_ICL_entailment
12,109,57,52,5,0.912280701754386,80,43,37,0.5375,0.6764483436696416,GPT4,mimiciii,progress_note,PROMPT1_ICL_entailment
13,11,24,19,5,0.7916666666666666,80,38,42,0.475,0.5937499999999999,GPT4,mimiciii,progress_note,PROMPT1_ICL_entailment
14,110,54,44,10,0.8148148148148148,80,37,43,0.4625,0.5900688655309895,GPT4,mimiciii,progress_note,PROMPT1_ICL_entailment
15,111,51,30,21,0.5882352941176471,80,39,41,0.4875,0.5331510594668489,GPT4,mimiciii,progress_note,PROMPT1_ICL_entailment
16,112,43,40,3,0.9302325581395348,80,33,47,0.4125,0.5715522840441654,GPT4,mimiciii,progress_note,PROMPT1_ICL_entailment
17,113,71,58,13,0.8169014084507042,80,48,32,0.6,0.6918489065606362,GPT4,mimiciii,progress_note,PROMPT1_ICL_entailment
18,114,38,29,9,0.7631578947368421,80,35,45,0.4375,0.5561643835616439,GPT4,mimiciii,progress_note,PROMPT1_ICL_entailment
19,115,44,31,13,0.7045454545454546,80,28,52,0.35,0.4676724137931033,GPT4,mimiciii,progress_note,PROMPT1_ICL_entailment
20,116,21,14,7,0.6666666666666666,35,25,10,0.7142857142857143,0.689655172413793,GPT4,mimiciii,progress_note,PROMPT1_ICL_entailment
21,117,19,16,3,0.8421052631578947,20,18,2,0.9,0.8700906344410877,GPT4,mimiciii,progress_note,PROMPT1_ICL_entailment
22,118,25,21,4,0.84,23,20,3,0.8695652173913043,0.8545269582909462,GPT4,mimiciii,progress_note,PROMPT1_ICL_entailment
23,119,16,16,0,1.0,14,13,1,0.9285714285714286,0.962962962962963,GPT4,mimiciii,progress_note,PROMPT1_ICL_entailment
24,12,59,44,15,0.7457627118644068,80,45,35,0.5625,0.6412955465587045,GPT4,mimiciii,progress_note,PROMPT1_ICL_entailment
25,120,45,38,7,0.8444444444444444,64,35,29,0.546875,0.6638382830047417,GPT4,mimiciii,progress_note,PROMPT1_ICL_entailment
26,121,19,18,1,0.9473684210526316,14,8,6,0.5714285714285714,0.7128712871287128,GPT4,mimiciii,progress_note,PROMPT1_ICL_entailment
27,122,22,14,8,0.6363636363636364,47,30,17,0.6382978723404256,0.637329286798179,GPT4,mimiciii,progress_note,PROMPT1_ICL_entailment
28,123,24,21,3,0.875,50,29,21,0.58,0.6975945017182129,GPT4,mimiciii,progress_note,PROMPT1_ICL_entailment
29,124,32,30,2,0.9375,65,61,4,0.9384615384615383,0.937980522808816,GPT4,mimiciii,progress_note,PROMPT1_ICL_entailment
30,125,31,27,4,0.8709677419354839,50,34,16,0.68,0.7637271214642263,GPT4,mimiciii,progress_note,PROMPT1_ICL_entailment
31,126,24,19,5,0.7916666666666666,27,14,13,0.5185185185185185,0.6266195524146053,GPT4,mimiciii,progress_note,PROMPT1_ICL_entailment
32,127,19,17,2,0.8947368421052632,27,26,1,0.9629629629629628,0.9275970619097588,GPT4,mimiciii,progress_note,PROMPT1_ICL_entailment
33,128,40,34,6,0.85,37,32,5,0.8648648648648649,0.8573680063041765,GPT4,mimiciii,progress_note,PROMPT1_ICL_entailment
34,129,46,27,19,0.5869565217391305,66,52,14,0.7878787878787878,0.672735984666986,GPT4,mimiciii,progress_note,PROMPT1_ICL_entailment
35,13,40,32,8,0.8,73,49,24,0.6712328767123288,0.7299813780260708,GPT4,mimiciii,progress_note,PROMPT1_ICL_entailment
36,130,30,22,8,0.7333333333333333,44,35,9,0.7954545454545454,0.7631318136769077,GPT4,mimiciii,progress_note,PROMPT1_ICL_entailment
37,131,95,90,5,0.9473684210526316,80,56,24,0.7,0.8051118210862619,GPT4,mimiciii,progress_note,PROMPT1_ICL_entailment
38,132,71,55,16,0.7746478873239436,80,55,25,0.6875,0.728476821192053,GPT4,mimiciii,progress_note,PROMPT1_ICL_entailment
39,133,23,22,1,0.9565217391304348,80,35,45,0.4375,0.6003898635477584,GPT4,mimiciii,progress_note,PROMPT1_ICL_entailment
40,134,14,11,3,0.7857142857142857,18,9,9,0.5,0.6111111111111112,GPT4,mimiciii,progress_note,PROMPT1_ICL_entailment
41,135,41,35,6,0.8536585365853658,35,24,11,0.6857142857142857,0.7605251244907197,GPT4,mimiciii,progress_note,PROMPT1_ICL_entailment
42,136,36,34,2,0.9444444444444444,43,31,12,0.7209302325581395,0.8176881303335919,GPT4,mimiciii,progress_note,PROMPT1_ICL_entailment
43,137,23,19,4,0.8260869565217391,26,17,9,0.6538461538461539,0.7299435028248588,GPT4,mimiciii,progress_note,PROMPT1_ICL_entailment
44,138,36,34,2,0.9444444444444444,45,25,20,0.5555555555555556,0.6995884773662552,GPT4,mimiciii,progress_note,PROMPT1_ICL_entailment
45,139,39,35,4,0.8974358974358975,45,29,16,0.6444444444444445,0.7501847745750185,GPT4,mimiciii,progress_note,PROMPT1_ICL_entailment
46,14,42,40,2,0.9523809523809524,43,37,6,0.8604651162790697,0.9040928527794746,GPT4,mimiciii,progress_note,PROMPT1_ICL_entailment
47,140,24,16,8,0.6666666666666666,25,15,10,0.6,0.631578947368421,GPT4,mimiciii,progress_note,PROMPT1_ICL_entailment
48,141,39,35,4,0.8974358974358975,45,40,5,0.8888888888888888,0.8931419457735248,GPT4,mimiciii,progress_note,PROMPT1_ICL_entailment
49,142,52,50,2,0.9615384615384616,50,46,4,0.92,0.9403107113654948,GPT4,mimiciii,progress_note,PROMPT1_ICL_entailment
50,143,12,11,1,0.9166666666666666,11,10,1,0.9090909090909092,0.9128630705394192,GPT4,mimiciii,progress_note,PROMPT1_ICL_entailment
51,144,46,43,3,0.9347826086956522,50,45,5,0.9,0.9170616113744076,GPT4,mimiciii,progress_note,PROMPT1_ICL_entailment
52,145,24,18,6,0.75,43,31,12,0.7209302325581395,0.7351778656126482,GPT4,mimiciii,progress_note,PROMPT1_ICL_entailment
53,146,43,31,12,0.7209302325581395,32,24,8,0.75,0.7351778656126482,GPT4,mimiciii,progress_note,PROMPT1_ICL_entailment
54,147,39,34,5,0.8717948717948718,56,35,21,0.625,0.7280513918629551,GPT4,mimiciii,progress_note,PROMPT1_ICL_entailment
55,148,9,7,2,0.7777777777777778,4,3,1,0.75,0.7636363636363638,GPT4,mimiciii,progress_note,PROMPT1_ICL_entailment
56,149,31,28,3,0.9032258064516128,29,26,3,0.896551724137931,0.8998763906056859,GPT4,mimiciii,progress_note,PROMPT1_ICL_entailment
57,15,35,27,8,0.7714285714285715,80,33,47,0.4125,0.5375565610859728,GPT4,mimiciii,progress_note,PROMPT1_ICL_entailment
58,150,46,40,6,0.8695652173913043,80,64,16,0.8,0.8333333333333333,GPT4,mimiciii,progress_note,PROMPT1_ICL_entailment
59,151,53,49,4,0.9245283018867924,80,53,27,0.6625,0.7718828949323823,GPT4,mimiciii,progress_note,PROMPT1_ICL_entailment
60,152,44,41,3,0.9318181818181818,45,41,4,0.9111111111111112,0.9213483146067416,GPT4,mimiciii,progress_note,PROMPT1_ICL_entailment
61,153,60,58,2,0.9666666666666668,80,45,35,0.5625,0.7111716621253404,GPT4,mimiciii,progress_note,PROMPT1_ICL_entailment
62,154,16,16,0,1.0,15,15,0,1.0,1.0,GPT4,mimiciii,progress_note,PROMPT1_ICL_entailment
63,155,23,21,2,0.9130434782608696,32,27,5,0.84375,0.8770301624129929,GPT4,mimiciii,progress_note,PROMPT1_ICL_entailment
64,156,22,17,5,0.7727272727272727,32,27,5,0.84375,0.8066783831282952,GPT4,mimiciii,progress_note,PROMPT1_ICL_entailment
65,157,24,17,7,0.7083333333333334,29,20,9,0.6896551724137931,0.6988694758478932,GPT4,mimiciii,progress_note,PROMPT1_ICL_entailment
66,158,43,38,5,0.8837209302325582,80,45,35,0.5625,0.6874371859296482,GPT4,mimiciii,progress_note,PROMPT1_ICL_entailment
67,159,17,14,3,0.8235294117647058,22,14,8,0.6363636363636364,0.717948717948718,GPT4,mimiciii,progress_note,PROMPT1_ICL_entailment
68,16,22,19,3,0.8636363636363636,28,19,9,0.6785714285714286,0.76,GPT4,mimiciii,progress_note,PROMPT1_ICL_entailment
69,160,37,33,4,0.8918918918918919,65,42,23,0.6461538461538462,0.7493917274939172,GPT4,mimiciii,progress_note,PROMPT1_ICL_entailment
70,161,53,45,8,0.8490566037735849,80,38,42,0.475,0.6091913074456715,GPT4,mimiciii,progress_note,PROMPT1_ICL_entailment
71,162,46,39,7,0.8478260869565217,80,39,41,0.4875,0.619047619047619,GPT4,mimiciii,progress_note,PROMPT1_ICL_entailment
72,163,20,17,3,0.85,28,17,11,0.6071428571428571,0.7083333333333333,GPT4,mimiciii,progress_note,PROMPT1_ICL_entailment
73,164,24,19,5,0.7916666666666666,57,45,12,0.7894736842105263,0.7905686546463245,GPT4,mimiciii,progress_note,PROMPT1_ICL_entailment
74,165,12,12,0,1.0,25,15,10,0.6,0.7499999999999999,GPT4,mimiciii,progress_note,PROMPT1_ICL_entailment
75,166,30,24,6,0.8,42,28,14,0.6666666666666666,0.7272727272727272,GPT4,mimiciii,progress_note,PROMPT1_ICL_entailment
76,167,34,31,3,0.9117647058823528,52,37,15,0.7115384615384616,0.7993031358885018,GPT4,mimiciii,progress_note,PROMPT1_ICL_entailment
77,168,59,49,10,0.8305084745762712,80,50,30,0.625,0.7132459970887919,GPT4,mimiciii,progress_note,PROMPT1_ICL_entailment
78,169,33,28,5,0.8484848484848485,80,41,39,0.5125,0.639020317283607,GPT4,mimiciii,progress_note,PROMPT1_ICL_entailment
79,17,8,8,0,1.0,15,14,1,0.9333333333333332,0.9655172413793104,GPT4,mimiciii,progress_note,PROMPT1_ICL_entailment
80,170,58,52,6,0.896551724137931,80,50,30,0.625,0.7365439093484418,GPT4,mimiciii,progress_note,PROMPT1_ICL_entailment
81,171,35,33,2,0.9428571428571428,80,46,34,0.575,0.7143529411764705,GPT4,mimiciii,progress_note,PROMPT1_ICL_entailment
82,172,73,68,5,0.9315068493150684,80,44,36,0.55,0.6916319926028665,GPT4,mimiciii,progress_note,PROMPT1_ICL_entailment
83,173,64,50,14,0.78125,80,44,36,0.55,0.6455399061032865,GPT4,mimiciii,progress_note,PROMPT1_ICL_entailment
84,174,39,36,3,0.9230769230769232,80,35,45,0.4375,0.5936395759717314,GPT4,mimiciii,progress_note,PROMPT1_ICL_entailment
85,175,83,80,3,0.963855421686747,80,52,28,0.65,0.7764091078760732,GPT4,mimiciii,progress_note,PROMPT1_ICL_entailment
86,176,57,52,5,0.912280701754386,80,57,23,0.7125,0.8001079767849912,GPT4,mimiciii,progress_note,PROMPT1_ICL_entailment
87,177,51,46,5,0.9019607843137256,80,43,37,0.5375,0.6735910097054316,GPT4,mimiciii,progress_note,PROMPT1_ICL_entailment
88,178,17,17,0,1.0,17,13,4,0.7647058823529411,0.8666666666666666,GPT4,mimiciii,progress_note,PROMPT1_ICL_entailment
89,179,45,40,5,0.8888888888888888,80,46,34,0.575,0.698292220113852,GPT4,mimiciii,progress_note,PROMPT1_ICL_entailment
90,18,27,17,10,0.6296296296296297,18,14,4,0.7777777777777778,0.695906432748538,GPT4,mimiciii,progress_note,PROMPT1_ICL_entailment
91,180,66,54,12,0.8181818181818182,80,47,33,0.5875,0.6839126919967664,GPT4,mimiciii,progress_note,PROMPT1_ICL_entailment
92,181,77,62,15,0.8051948051948052,80,47,33,0.5875,0.6793332556241988,GPT4,mimiciii,progress_note,PROMPT1_ICL_entailment
93,182,55,49,6,0.8909090909090909,80,41,39,0.5125,0.6506882591093117,GPT4,mimiciii,progress_note,PROMPT1_ICL_entailment
94,183,81,62,19,0.7654320987654321,80,45,35,0.5625,0.6484601975595584,GPT4,mimiciii,progress_note,PROMPT1_ICL_entailment
95,184,59,56,3,0.9491525423728814,80,45,35,0.5625,0.7063770147161877,GPT4,mimiciii,progress_note,PROMPT1_ICL_entailment
96,185,29,21,8,0.7241379310344828,48,26,22,0.5416666666666666,0.619750283768445,GPT4,mimiciii,progress_note,PROMPT1_ICL_entailment
97,186,27,23,4,0.8518518518518519,80,23,57,0.2875,0.4299065420560747,GPT4,mimiciii,progress_note,PROMPT1_ICL_entailment
98,187,50,41,9,0.82,80,53,27,0.6625,0.7328836424957841,GPT4,mimiciii,progress_note,PROMPT1_ICL_entailment
99,188,25,23,2,0.92,80,28,52,0.35,0.5070866141732283,GPT4,mimiciii,progress_note,PROMPT1_ICL_entailment
100,189,52,46,6,0.8846153846153846,80,42,38,0.525,0.6589358799454298,GPT4,mimiciii,progress_note,PROMPT1_ICL_entailment
101,19,28,22,6,0.7857142857142857,38,27,11,0.7105263157894737,0.7462311557788943,GPT4,mimiciii,progress_note,PROMPT1_ICL_entailment
102,190,27,25,2,0.925925925925926,80,22,58,0.275,0.4240555127216654,GPT4,mimiciii,progress_note,PROMPT1_ICL_entailment
103,191,50,45,5,0.9,80,29,51,0.3625,0.5168316831683168,GPT4,mimiciii,progress_note,PROMPT1_ICL_entailment
104,192,57,56,1,0.9824561403508772,80,41,39,0.5125,0.6736100924160187,GPT4,mimiciii,progress_note,PROMPT1_ICL_entailment
105,193,65,56,9,0.8615384615384616,80,44,36,0.55,0.6713896457765668,GPT4,mimiciii,progress_note,PROMPT1_ICL_entailment
106,194,54,41,13,0.7592592592592593,80,25,55,0.3125,0.4427645788336933,GPT4,mimiciii,progress_note,PROMPT1_ICL_entailment
107,195,33,32,1,0.9696969696969696,44,32,12,0.7272727272727273,0.8311688311688312,GPT4,mimiciii,progress_note,PROMPT1_ICL_entailment
108,196,42,38,4,0.9047619047619048,42,25,17,0.5952380952380952,0.7180650037792895,GPT4,mimiciii,progress_note,PROMPT1_ICL_entailment
109,197,88,80,8,0.9090909090909092,80,48,32,0.6,0.7228915662650602,GPT4,mimiciii,progress_note,PROMPT1_ICL_entailment
110,198,36,35,1,0.9722222222222222,34,31,3,0.9117647058823528,0.9410234171725932,GPT4,mimiciii,progress_note,PROMPT1_ICL_entailment
111,199,45,37,8,0.8222222222222222,52,34,18,0.6538461538461539,0.7284308048639259,GPT4,mimiciii,progress_note,PROMPT1_ICL_entailment
112,2,55,45,10,0.8181818181818182,80,55,25,0.6875,0.7471698113207547,GPT4,mimiciii,progress_note,PROMPT1_ICL_entailment
113,20,29,22,7,0.7586206896551724,33,20,13,0.6060606060606061,0.673813169984686,GPT4,mimiciii,progress_note,PROMPT1_ICL_entailment
114,200,38,27,11,0.7105263157894737,80,36,44,0.45,0.5510204081632654,GPT4,mimiciii,progress_note,PROMPT1_ICL_entailment
115,201,35,35,0,1.0,80,35,45,0.4375,0.6086956521739131,GPT4,mimiciii,progress_note,PROMPT1_ICL_entailment
116,202,45,43,2,0.9555555555555556,80,37,43,0.4625,0.6233104799216455,GPT4,mimiciii,progress_note,PROMPT1_ICL_entailment
117,203,46,40,6,0.8695652173913043,80,39,41,0.4875,0.6247496996395675,GPT4,mimiciii,progress_note,PROMPT1_ICL_entailment
118,204,75,64,11,0.8533333333333334,80,48,32,0.6,0.7045871559633028,GPT4,mimiciii,progress_note,PROMPT1_ICL_entailment
119,205,58,56,2,0.9655172413793104,80,32,48,0.4,0.5656565656565657,GPT4,mimiciii,progress_note,PROMPT1_ICL_entailment
120,206,99,83,16,0.8383838383838383,80,49,31,0.6125,0.7078583239056652,GPT4,mimiciii,progress_note,PROMPT1_ICL_entailment
121,207,70,67,3,0.9571428571428572,80,43,37,0.5375,0.6884109916367981,GPT4,mimiciii,progress_note,PROMPT1_ICL_entailment
122,208,33,27,6,0.8181818181818182,80,30,50,0.375,0.5142857142857142,GPT4,mimiciii,progress_note,PROMPT1_ICL_entailment
123,209,45,34,11,0.7555555555555555,80,48,32,0.6,0.6688524590163933,GPT4,mimiciii,progress_note,PROMPT1_ICL_entailment
124,21,59,47,12,0.7966101694915254,80,41,39,0.5125,0.6237255219291147,GPT4,mimiciii,progress_note,PROMPT1_ICL_entailment
125,210,32,27,5,0.84375,28,26,2,0.9285714285714286,0.8841309823677582,GPT4,mimiciii,progress_note,PROMPT1_ICL_entailment
126,211,46,36,10,0.782608695652174,54,44,10,0.8148148148148148,0.7983870967741935,GPT4,mimiciii,progress_note,PROMPT1_ICL_entailment
127,212,20,14,6,0.7,14,13,1,0.9285714285714286,0.7982456140350878,GPT4,mimiciii,progress_note,PROMPT1_ICL_entailment
128,213,32,32,0,1.0,41,30,11,0.7317073170731707,0.8450704225352113,GPT4,mimiciii,progress_note,PROMPT1_ICL_entailment
129,214,15,14,1,0.9333333333333332,27,22,5,0.8148148148148148,0.8700564971751413,GPT4,mimiciii,progress_note,PROMPT1_ICL_entailment
130,215,41,25,16,0.6097560975609756,66,38,28,0.5757575757575758,0.5922693266832918,GPT4,mimiciii,progress_note,PROMPT1_ICL_entailment
131,216,32,21,11,0.65625,67,52,15,0.7761194029850746,0.7111690003256269,GPT4,mimiciii,progress_note,PROMPT1_ICL_entailment
132,217,44,36,8,0.8181818181818182,73,47,26,0.6438356164383562,0.7206132879045997,GPT4,mimiciii,progress_note,PROMPT1_ICL_entailment
133,218,24,17,7,0.7083333333333334,27,24,3,0.8888888888888888,0.7884057971014492,GPT4,mimiciii,progress_note,PROMPT1_ICL_entailment
134,219,22,21,1,0.9545454545454546,17,16,1,0.9411764705882352,0.9478138222849084,GPT4,mimiciii,progress_note,PROMPT1_ICL_entailment
135,22,29,23,6,0.7931034482758621,38,30,8,0.7894736842105263,0.7912844036697249,GPT4,mimiciii,progress_note,PROMPT1_ICL_entailment
136,220,43,32,11,0.7441860465116279,34,27,7,0.7941176470588235,0.768341485104491,GPT4,mimiciii,progress_note,PROMPT1_ICL_entailment
137,221,53,51,2,0.9622641509433962,80,30,50,0.375,0.5396825396825397,GPT4,mimiciii,progress_note,PROMPT1_ICL_entailment
138,222,25,21,4,0.84,80,26,54,0.325,0.4686695278969957,GPT4,mimiciii,progress_note,PROMPT1_ICL_entailment
139,223,21,18,3,0.8571428571428571,30,24,6,0.8,0.8275862068965518,GPT4,mimiciii,progress_note,PROMPT1_ICL_entailment
140,224,24,21,3,0.875,33,28,5,0.8484848484848485,0.8615384615384615,GPT4,mimiciii,progress_note,PROMPT1_ICL_entailment
141,225,23,19,4,0.8260869565217391,37,28,9,0.7567567567567568,0.7899034892353379,GPT4,mimiciii,progress_note,PROMPT1_ICL_entailment
142,226,28,26,2,0.9285714285714286,33,20,13,0.6060606060606061,0.7334273624823695,GPT4,mimiciii,progress_note,PROMPT1_ICL_entailment
143,227,6,6,0,1.0,15,3,12,0.2,0.3333333333333333,GPT4,mimiciii,progress_note,PROMPT1_ICL_entailment
144,228,6,6,0,1.0,15,3,12,0.2,0.3333333333333333,GPT4,mimiciii,progress_note,PROMPT1_ICL_entailment
145,229,7,7,0,1.0,15,3,12,0.2,0.3333333333333333,GPT4,mimiciii,progress_note,PROMPT1_ICL_entailment
146,23,19,16,3,0.8421052631578947,37,27,10,0.7297297297297297,0.7819004524886878,GPT4,mimiciii,progress_note,PROMPT1_ICL_entailment
147,230,22,17,5,0.7727272727272727,26,22,4,0.8461538461538461,0.8077753779697625,GPT4,mimiciii,progress_note,PROMPT1_ICL_entailment
148,231,58,58,0,1.0,79,59,20,0.7468354430379747,0.855072463768116,GPT4,mimiciii,progress_note,PROMPT1_ICL_entailment
149,232,62,54,8,0.8709677419354839,72,47,25,0.6527777777777778,0.7462511026168774,GPT4,mimiciii,progress_note,PROMPT1_ICL_entailment
150,233,44,30,14,0.6818181818181818,80,63,17,0.7875,0.7308584686774942,GPT4,mimiciii,progress_note,PROMPT1_ICL_entailment
151,234,31,28,3,0.9032258064516128,42,37,5,0.8809523809523809,0.8919500645716745,GPT4,mimiciii,progress_note,PROMPT1_ICL_entailment
152,24,19,14,5,0.7368421052631579,22,16,6,0.7272727272727273,0.7320261437908497,GPT4,mimiciii,progress_note,PROMPT1_ICL_entailment
153,25,25,15,10,0.6,22,14,8,0.6363636363636364,0.6176470588235293,GPT4,mimiciii,progress_note,PROMPT1_ICL_entailment
154,26,19,14,5,0.7368421052631579,22,12,10,0.5454545454545454,0.626865671641791,GPT4,mimiciii,progress_note,PROMPT1_ICL_entailment
155,27,21,10,11,0.4761904761904761,19,15,4,0.7894736842105263,0.594059405940594,GPT4,mimiciii,progress_note,PROMPT1_ICL_entailment
156,28,39,33,6,0.8461538461538461,50,37,13,0.74,0.7895247332686712,GPT4,mimiciii,progress_note,PROMPT1_ICL_entailment
157,29,29,28,1,0.9655172413793104,52,35,17,0.6730769230769231,0.793201133144476,GPT4,mimiciii,progress_note,PROMPT1_ICL_entailment
158,3,52,38,14,0.7307692307692307,80,35,45,0.4375,0.5473251028806584,GPT4,mimiciii,progress_note,PROMPT1_ICL_entailment
159,30,23,20,3,0.8695652173913043,18,14,4,0.7777777777777778,0.8211143695014663,GPT4,mimiciii,progress_note,PROMPT1_ICL_entailment
160,31,24,21,3,0.875,17,14,3,0.8235294117647058,0.8484848484848485,GPT4,mimiciii,progress_note,PROMPT1_ICL_entailment
161,32,45,42,3,0.9333333333333332,77,50,27,0.6493506493506493,0.7658643326039387,GPT4,mimiciii,progress_note,PROMPT1_ICL_entailment
162,33,59,52,7,0.8813559322033898,65,53,12,0.8153846153846154,0.847087751652067,GPT4,mimiciii,progress_note,PROMPT1_ICL_entailment
163,34,42,37,5,0.8809523809523809,71,44,27,0.6197183098591549,0.7275977653631284,GPT4,mimiciii,progress_note,PROMPT1_ICL_entailment
164,35,18,17,1,0.9444444444444444,20,5,15,0.25,0.3953488372093023,GPT4,mimiciii,progress_note,PROMPT1_ICL_entailment
165,36,21,12,9,0.5714285714285714,40,26,14,0.65,0.6081871345029239,GPT4,mimiciii,progress_note,PROMPT1_ICL_entailment
166,37,102,93,9,0.9117647058823528,80,51,29,0.6375,0.7503559563360227,GPT4,mimiciii,progress_note,PROMPT1_ICL_entailment
167,38,40,34,6,0.85,80,37,43,0.4625,0.599047619047619,GPT4,mimiciii,progress_note,PROMPT1_ICL_entailment
168,39,44,41,3,0.9318181818181818,76,53,23,0.6973684210526315,0.7977239353891336,GPT4,mimiciii,progress_note,PROMPT1_ICL_entailment
169,4,57,48,9,0.8421052631578947,80,30,50,0.375,0.518918918918919,GPT4,mimiciii,progress_note,PROMPT1_ICL_entailment
170,40,43,43,0,1.0,76,56,20,0.7368421052631579,0.8484848484848484,GPT4,mimiciii,progress_note,PROMPT1_ICL_entailment
171,41,61,55,6,0.9016393442622952,78,63,15,0.8076923076923077,0.8520841018074511,GPT4,mimiciii,progress_note,PROMPT1_ICL_entailment
172,42,65,59,6,0.9076923076923076,78,55,23,0.7051282051282052,0.793689617219029,GPT4,mimiciii,progress_note,PROMPT1_ICL_entailment
173,43,67,42,25,0.6268656716417911,79,48,31,0.6075949367088608,0.6170798898071624,GPT4,mimiciii,progress_note,PROMPT1_ICL_entailment
174,44,56,53,3,0.9464285714285714,80,50,30,0.625,0.7528409090909091,GPT4,mimiciii,progress_note,PROMPT1_ICL_entailment
175,45,66,56,10,0.8484848484848485,80,62,18,0.775,0.810079328044797,GPT4,mimiciii,progress_note,PROMPT1_ICL_entailment
176,46,27,26,1,0.9629629629629628,36,30,6,0.8333333333333334,0.8934707903780069,GPT4,mimiciii,progress_note,PROMPT1_ICL_entailment
177,47,10,10,0,1.0,10,10,0,1.0,1.0,GPT4,mimiciii,progress_note,PROMPT1_ICL_entailment
178,48,52,51,1,0.9807692307692308,30,25,5,0.8333333333333334,0.901060070671378,GPT4,mimiciii,progress_note,PROMPT1_ICL_entailment
179,49,47,41,6,0.8723404255319149,57,48,9,0.8421052631578947,0.8569562377531025,GPT4,mimiciii,progress_note,PROMPT1_ICL_entailment
180,5,48,44,4,0.9166666666666666,80,53,27,0.6625,0.7691292875989446,GPT4,mimiciii,progress_note,PROMPT1_ICL_entailment
181,50,99,89,10,0.898989898989899,80,72,8,0.9,0.8994946659180235,GPT4,mimiciii,progress_note,PROMPT1_ICL_entailment
182,51,38,32,6,0.8421052631578947,80,54,26,0.675,0.7493495229835212,GPT4,mimiciii,progress_note,PROMPT1_ICL_entailment
183,52,58,48,10,0.8275862068965517,80,48,32,0.6,0.6956521739130435,GPT4,mimiciii,progress_note,PROMPT1_ICL_entailment
184,53,56,47,9,0.8392857142857143,80,33,47,0.4125,0.5531383737517831,GPT4,mimiciii,progress_note,PROMPT1_ICL_entailment
185,54,46,32,14,0.6956521739130435,80,43,37,0.5375,0.6064345526663727,GPT4,mimiciii,progress_note,PROMPT1_ICL_entailment
186,55,54,38,16,0.7037037037037037,80,50,30,0.625,0.662020905923345,GPT4,mimiciii,progress_note,PROMPT1_ICL_entailment
187,56,16,16,0,1.0,40,8,32,0.2,0.3333333333333333,GPT4,mimiciii,progress_note,PROMPT1_ICL_entailment
188,57,26,23,3,0.8846153846153846,28,23,5,0.8214285714285714,0.8518518518518519,GPT4,mimiciii,progress_note,PROMPT1_ICL_entailment
189,58,24,17,7,0.7083333333333334,25,17,8,0.68,0.6938775510204083,GPT4,mimiciii,progress_note,PROMPT1_ICL_entailment
190,59,19,14,5,0.7368421052631579,25,17,8,0.68,0.7072808320950966,GPT4,mimiciii,progress_note,PROMPT1_ICL_entailment
191,6,71,65,6,0.9154929577464788,80,54,26,0.675,0.7770644232897942,GPT4,mimiciii,progress_note,PROMPT1_ICL_entailment
192,60,58,44,14,0.7586206896551724,80,47,33,0.5875,0.6621837976304834,GPT4,mimiciii,progress_note,PROMPT1_ICL_entailment
193,61,22,18,4,0.8181818181818182,37,27,10,0.7297297297297297,0.7714285714285715,GPT4,mimiciii,progress_note,PROMPT1_ICL_entailment
194,62,22,20,2,0.9090909090909092,37,34,3,0.918918918918919,0.913978494623656,GPT4,mimiciii,progress_note,PROMPT1_ICL_entailment
195,63,45,36,9,0.8,80,60,20,0.75,0.7741935483870969,GPT4,mimiciii,progress_note,PROMPT1_ICL_entailment
196,64,11,1,10,0.0909090909090909,1,0,1,0.0,0.0,GPT4,mimiciii,progress_note,PROMPT1_ICL_entailment
197,65,18,18,0,1.0,8,8,0,1.0,1.0,GPT4,mimiciii,progress_note,PROMPT1_ICL_entailment
198,66,34,31,3,0.9117647058823528,48,39,9,0.8125,0.8592750533049042,GPT4,mimiciii,progress_note,PROMPT1_ICL_entailment
199,67,72,42,30,0.5833333333333334,80,48,32,0.6,0.591549295774648,GPT4,mimiciii,progress_note,PROMPT1_ICL_entailment
200,68,63,51,12,0.8095238095238095,80,52,28,0.65,0.7210440456769983,GPT4,mimiciii,progress_note,PROMPT1_ICL_entailment
201,69,30,28,2,0.9333333333333332,80,41,39,0.5125,0.661671469740634,GPT4,mimiciii,progress_note,PROMPT1_ICL_entailment
202,7,68,55,13,0.8088235294117647,80,46,34,0.575,0.6721572794899043,GPT4,mimiciii,progress_note,PROMPT1_ICL_entailment
203,70,42,39,3,0.9285714285714286,80,46,34,0.575,0.7102137767220903,GPT4,mimiciii,progress_note,PROMPT1_ICL_entailment
204,71,68,61,7,0.8970588235294118,80,41,39,0.5125,0.6523213354199269,GPT4,mimiciii,progress_note,PROMPT1_ICL_entailment
205,72,9,9,0,1.0,15,11,4,0.7333333333333333,0.846153846153846,GPT4,mimiciii,progress_note,PROMPT1_ICL_entailment
206,73,133,93,40,0.6992481203007519,80,29,51,0.3625,0.4774718951934142,GPT4,mimiciii,progress_note,PROMPT1_ICL_entailment
207,74,40,36,4,0.9,80,51,29,0.6375,0.746341463414634,GPT4,mimiciii,progress_note,PROMPT1_ICL_entailment
208,75,50,44,6,0.88,40,26,14,0.65,0.7477124183006537,GPT4,mimiciii,progress_note,PROMPT1_ICL_entailment
209,76,42,38,4,0.9047619047619048,58,30,28,0.5172413793103449,0.6581986143187067,GPT4,mimiciii,progress_note,PROMPT1_ICL_entailment
210,77,20,20,0,1.0,27,19,8,0.7037037037037037,0.8260869565217391,GPT4,mimiciii,progress_note,PROMPT1_ICL_entailment
211,78,26,25,1,0.9615384615384616,20,16,4,0.8,0.8733624454148472,GPT4,mimiciii,progress_note,PROMPT1_ICL_entailment
212,79,25,22,3,0.88,43,24,19,0.5581395348837209,0.6830530401034929,GPT4,mimiciii,progress_note,PROMPT1_ICL_entailment
213,8,59,45,14,0.7627118644067796,78,70,8,0.8974358974358975,0.824607329842932,GPT4,mimiciii,progress_note,PROMPT1_ICL_entailment
214,80,19,16,3,0.8421052631578947,21,19,2,0.9047619047619048,0.8723098995695839,GPT4,mimiciii,progress_note,PROMPT1_ICL_entailment
215,81,35,27,8,0.7714285714285715,32,25,7,0.78125,0.7763082231167339,GPT4,mimiciii,progress_note,PROMPT1_ICL_entailment
216,82,6,6,0,1.0,15,3,12,0.2,0.3333333333333333,GPT4,mimiciii,progress_note,PROMPT1_ICL_entailment
217,83,31,27,4,0.8709677419354839,43,28,15,0.6511627906976745,0.7451946771808774,GPT4,mimiciii,progress_note,PROMPT1_ICL_entailment
218,84,25,24,1,0.96,35,23,12,0.6571428571428571,0.7802120141342755,GPT4,mimiciii,progress_note,PROMPT1_ICL_entailment
219,85,38,33,5,0.868421052631579,50,44,6,0.88,0.8741721854304636,GPT4,mimiciii,progress_note,PROMPT1_ICL_entailment
220,86,59,55,4,0.9322033898305084,32,29,3,0.90625,0.9190435033131662,GPT4,mimiciii,progress_note,PROMPT1_ICL_entailment
221,87,7,7,0,1.0,12,3,9,0.25,0.4,GPT4,mimiciii,progress_note,PROMPT1_ICL_entailment
222,88,49,45,4,0.9183673469387756,67,49,18,0.7313432835820896,0.8142540620384048,GPT4,mimiciii,progress_note,PROMPT1_ICL_entailment
223,89,61,49,12,0.8032786885245902,80,50,30,0.625,0.703012912482066,GPT4,mimiciii,progress_note,PROMPT1_ICL_entailment
224,9,31,31,0,1.0,42,30,12,0.7142857142857143,0.8333333333333333,GPT4,mimiciii,progress_note,PROMPT1_ICL_entailment
225,90,6,6,0,1.0,3,3,0,1.0,1.0,GPT4,mimiciii,progress_note,PROMPT1_ICL_entailment
226,91,36,34,2,0.9444444444444444,79,55,24,0.6962025316455697,0.8015430775825119,GPT4,mimiciii,progress_note,PROMPT1_ICL_entailment
227,92,62,50,12,0.8064516129032258,80,48,32,0.6,0.6880733944954128,GPT4,mimiciii,progress_note,PROMPT1_ICL_entailment
228,93,18,14,4,0.7777777777777778,27,12,15,0.4444444444444444,0.5656565656565655,GPT4,mimiciii,progress_note,PROMPT1_ICL_entailment
229,94,53,45,8,0.8490566037735849,79,56,23,0.7088607594936709,0.7726506208799633,GPT4,mimiciii,progress_note,PROMPT1_ICL_entailment
230,95,31,20,11,0.6451612903225806,32,17,15,0.53125,0.5826906598114825,GPT4,mimiciii,progress_note,PROMPT1_ICL_entailment
231,96,8,8,0,1.0,11,3,8,0.2727272727272727,0.4285714285714285,GPT4,mimiciii,progress_note,PROMPT1_ICL_entailment
232,97,13,12,1,0.9230769230769232,14,13,1,0.9285714285714286,0.9258160237388724,GPT4,mimiciii,progress_note,PROMPT1_ICL_entailment
233,98,20,15,5,0.75,24,22,2,0.9166666666666666,0.8250000000000001,GPT4,mimiciii,progress_note,PROMPT1_ICL_entailment
234,99,29,23,6,0.7931034482758621,70,36,34,0.5142857142857142,0.6239638281838734,GPT4,mimiciii,progress_note,PROMPT1_ICL_entailment
0,0,57,49,8,0.8596491228070176,78,65,13,0.8333333333333334,0.846286701208981,GPT4,mimiciii,progress_note,PROMPT2_ICL_entailment
1,1,47,45,2,0.9574468085106383,80,50,30,0.625,0.7563025210084033,GPT4,mimiciii,progress_note,PROMPT2_ICL_entailment
2,10,49,39,10,0.7959183673469388,80,43,37,0.5375,0.6416682609527454,GPT4,mimiciii,progress_note,PROMPT2_ICL_entailment
3,100,58,43,15,0.7413793103448276,77,64,13,0.8311688311688312,0.7837106649579952,GPT4,mimiciii,progress_note,PROMPT2_ICL_entailment
4,101,28,23,5,0.8214285714285714,36,23,13,0.6388888888888888,0.7187499999999999,GPT4,mimiciii,progress_note,PROMPT2_ICL_entailment
5,102,38,31,7,0.8157894736842105,42,32,10,0.7619047619047619,0.7879269261318506,GPT4,mimiciii,progress_note,PROMPT2_ICL_entailment
6,103,72,58,14,0.8055555555555556,80,32,48,0.4,0.5345622119815668,GPT4,mimiciii,progress_note,PROMPT2_ICL_entailment
7,104,34,24,10,0.7058823529411765,39,19,20,0.4871794871794871,0.5764854614412137,GPT4,mimiciii,progress_note,PROMPT2_ICL_entailment
8,105,26,25,1,0.9615384615384616,17,15,2,0.8823529411764706,0.920245398773006,GPT4,mimiciii,progress_note,PROMPT2_ICL_entailment
9,106,27,23,4,0.8518518518518519,40,22,18,0.55,0.6684280052840159,GPT4,mimiciii,progress_note,PROMPT2_ICL_entailment
10,107,28,26,2,0.9285714285714286,31,26,5,0.8387096774193549,0.8813559322033899,GPT4,mimiciii,progress_note,PROMPT2_ICL_entailment
11,108,42,35,7,0.8333333333333334,68,42,26,0.6176470588235294,0.7094594594594594,GPT4,mimiciii,progress_note,PROMPT2_ICL_entailment
12,109,58,52,6,0.896551724137931,80,49,31,0.6125,0.7277920594115967,GPT4,mimiciii,progress_note,PROMPT2_ICL_entailment
13,11,59,44,15,0.7457627118644068,80,46,34,0.575,0.6493423163298042,GPT4,mimiciii,progress_note,PROMPT2_ICL_entailment
14,110,50,47,3,0.94,80,37,43,0.4625,0.6199643493761141,GPT4,mimiciii,progress_note,PROMPT2_ICL_entailment
15,111,50,41,9,0.82,80,38,42,0.475,0.6015444015444015,GPT4,mimiciii,progress_note,PROMPT2_ICL_entailment
16,112,82,74,8,0.902439024390244,80,50,30,0.625,0.7385229540918165,GPT4,mimiciii,progress_note,PROMPT2_ICL_entailment
17,113,66,52,14,0.7878787878787878,80,48,32,0.6,0.6812227074235808,GPT4,mimiciii,progress_note,PROMPT2_ICL_entailment
18,114,54,45,9,0.8333333333333334,80,41,39,0.5125,0.6346749226006192,GPT4,mimiciii,progress_note,PROMPT2_ICL_entailment
19,115,61,47,14,0.7704918032786885,80,38,42,0.475,0.5876933201711089,GPT4,mimiciii,progress_note,PROMPT2_ICL_entailment
20,116,27,21,6,0.7777777777777778,35,24,11,0.6857142857142857,0.7288503253796095,GPT4,mimiciii,progress_note,PROMPT2_ICL_entailment
21,117,25,21,4,0.84,20,18,2,0.9,0.8689655172413793,GPT4,mimiciii,progress_note,PROMPT2_ICL_entailment
22,118,37,35,2,0.945945945945946,23,17,6,0.7391304347826086,0.8298465829846583,GPT4,mimiciii,progress_note,PROMPT2_ICL_entailment
23,119,17,16,1,0.9411764705882352,14,10,4,0.7142857142857143,0.8121827411167514,GPT4,mimiciii,progress_note,PROMPT2_ICL_entailment
24,12,71,55,16,0.7746478873239436,80,27,53,0.3375,0.4701598860218458,GPT4,mimiciii,progress_note,PROMPT2_ICL_entailment
25,120,46,39,7,0.8478260869565217,64,35,29,0.546875,0.6648806624452022,GPT4,mimiciii,progress_note,PROMPT2_ICL_entailment
26,121,19,19,0,1.0,14,9,5,0.6428571428571429,0.782608695652174,GPT4,mimiciii,progress_note,PROMPT2_ICL_entailment
27,122,48,26,22,0.5416666666666666,47,30,17,0.6382978723404256,0.5860255447032305,GPT4,mimiciii,progress_note,PROMPT2_ICL_entailment
28,123,34,30,4,0.8823529411764706,50,23,27,0.46,0.6047326906222612,GPT4,mimiciii,progress_note,PROMPT2_ICL_entailment
29,124,39,34,5,0.8717948717948718,65,54,11,0.8307692307692308,0.850787766450417,GPT4,mimiciii,progress_note,PROMPT2_ICL_entailment
30,125,42,34,8,0.8095238095238095,50,24,26,0.48,0.6026587887740029,GPT4,mimiciii,progress_note,PROMPT2_ICL_entailment
31,126,24,23,1,0.9583333333333334,27,20,7,0.7407407407407407,0.8356039963669392,GPT4,mimiciii,progress_note,PROMPT2_ICL_entailment
32,127,24,21,3,0.875,27,23,4,0.8518518518518519,0.8632707774798928,GPT4,mimiciii,progress_note,PROMPT2_ICL_entailment
33,128,44,42,2,0.9545454545454546,37,32,5,0.8648648648648649,0.9074949358541526,GPT4,mimiciii,progress_note,PROMPT2_ICL_entailment
34,129,60,39,21,0.65,66,53,13,0.803030303030303,0.7184567257559958,GPT4,mimiciii,progress_note,PROMPT2_ICL_entailment
35,13,45,35,10,0.7777777777777778,73,51,22,0.6986301369863014,0.7360824742268042,GPT4,mimiciii,progress_note,PROMPT2_ICL_entailment
36,130,38,27,11,0.7105263157894737,44,18,26,0.4090909090909091,0.5192307692307692,GPT4,mimiciii,progress_note,PROMPT2_ICL_entailment
37,131,63,56,7,0.8888888888888888,80,48,32,0.6,0.7164179104477612,GPT4,mimiciii,progress_note,PROMPT2_ICL_entailment
38,132,71,59,12,0.8309859154929577,80,44,36,0.55,0.6619071902090771,GPT4,mimiciii,progress_note,PROMPT2_ICL_entailment
39,133,47,41,6,0.8723404255319149,80,39,41,0.4875,0.6254645022491687,GPT4,mimiciii,progress_note,PROMPT2_ICL_entailment
40,134,15,14,1,0.9333333333333332,18,8,10,0.4444444444444444,0.6021505376344086,GPT4,mimiciii,progress_note,PROMPT2_ICL_entailment
41,135,32,26,6,0.8125,35,15,20,0.4285714285714285,0.5611510791366906,GPT4,mimiciii,progress_note,PROMPT2_ICL_entailment
42,136,30,27,3,0.9,43,34,9,0.7906976744186046,0.8418156808803301,GPT4,mimiciii,progress_note,PROMPT2_ICL_entailment
43,137,26,24,2,0.9230769230769232,26,17,9,0.6538461538461539,0.7654784240150094,GPT4,mimiciii,progress_note,PROMPT2_ICL_entailment
44,138,32,30,2,0.9375,45,16,29,0.3555555555555555,0.5155746509129968,GPT4,mimiciii,progress_note,PROMPT2_ICL_entailment
45,139,38,34,4,0.8947368421052632,45,36,9,0.8,0.84472049689441,GPT4,mimiciii,progress_note,PROMPT2_ICL_entailment
46,14,37,26,11,0.7027027027027027,43,30,13,0.6976744186046512,0.7001795332136446,GPT4,mimiciii,progress_note,PROMPT2_ICL_entailment
47,140,26,17,9,0.6538461538461539,25,15,10,0.6,0.6257668711656442,GPT4,mimiciii,progress_note,PROMPT2_ICL_entailment
48,141,38,34,4,0.8947368421052632,45,34,11,0.7555555555555555,0.8192771084337349,GPT4,mimiciii,progress_note,PROMPT2_ICL_entailment
49,142,56,52,4,0.9285714285714286,50,23,27,0.46,0.6152263374485597,GPT4,mimiciii,progress_note,PROMPT2_ICL_entailment
50,143,11,11,0,1.0,11,6,5,0.5454545454545454,0.7058823529411764,GPT4,mimiciii,progress_note,PROMPT2_ICL_entailment
51,144,59,54,5,0.9152542372881356,50,19,31,0.38,0.5370321905260402,GPT4,mimiciii,progress_note,PROMPT2_ICL_entailment
52,145,35,26,9,0.7428571428571429,43,27,16,0.627906976744186,0.6805622879301988,GPT4,mimiciii,progress_note,PROMPT2_ICL_entailment
53,146,43,29,14,0.6744186046511628,32,22,10,0.6875,0.680896478121665,GPT4,mimiciii,progress_note,PROMPT2_ICL_entailment
54,147,45,38,7,0.8444444444444444,56,45,11,0.8035714285714286,0.8235010835540574,GPT4,mimiciii,progress_note,PROMPT2_ICL_entailment
55,148,9,7,2,0.7777777777777778,4,3,1,0.75,0.7636363636363638,GPT4,mimiciii,progress_note,PROMPT2_ICL_entailment
56,149,33,29,4,0.8787878787878788,29,26,3,0.896551724137931,0.8875809299587992,GPT4,mimiciii,progress_note,PROMPT2_ICL_entailment
57,15,57,46,11,0.8070175438596491,80,44,36,0.55,0.6541693600517129,GPT4,mimiciii,progress_note,PROMPT2_ICL_entailment
58,150,57,43,14,0.7543859649122807,80,69,11,0.8625,0.8048284280482843,GPT4,mimiciii,progress_note,PROMPT2_ICL_entailment
59,151,50,48,2,0.96,80,44,36,0.55,0.6993377483443709,GPT4,mimiciii,progress_note,PROMPT2_ICL_entailment
60,152,49,4,45,0.0816326530612244,45,29,16,0.6444444444444445,0.1449094316052467,GPT4,mimiciii,progress_note,PROMPT2_ICL_entailment
61,153,57,51,6,0.8947368421052632,80,31,49,0.3875,0.5407901487942535,GPT4,mimiciii,progress_note,PROMPT2_ICL_entailment
62,154,17,16,1,0.9411764705882352,15,14,1,0.9333333333333332,0.9372384937238494,GPT4,mimiciii,progress_note,PROMPT2_ICL_entailment
63,155,21,18,3,0.8571428571428571,32,25,7,0.78125,0.8174386920980925,GPT4,mimiciii,progress_note,PROMPT2_ICL_entailment
64,156,22,15,7,0.6818181818181818,32,29,3,0.90625,0.778175313059034,GPT4,mimiciii,progress_note,PROMPT2_ICL_entailment
65,157,26,21,5,0.8076923076923077,29,20,9,0.6896551724137931,0.7440212577502215,GPT4,mimiciii,progress_note,PROMPT2_ICL_entailment
66,158,40,34,6,0.85,80,39,41,0.4875,0.6196261682242991,GPT4,mimiciii,progress_note,PROMPT2_ICL_entailment
67,159,22,19,3,0.8636363636363636,22,9,13,0.4090909090909091,0.5551948051948052,GPT4,mimiciii,progress_note,PROMPT2_ICL_entailment
68,16,24,23,1,0.9583333333333334,28,21,7,0.75,0.8414634146341463,GPT4,mimiciii,progress_note,PROMPT2_ICL_entailment
69,160,32,28,4,0.875,65,42,23,0.6461538461538462,0.7433628318584071,GPT4,mimiciii,progress_note,PROMPT2_ICL_entailment
70,161,61,53,8,0.8688524590163934,80,45,35,0.5625,0.682891911238368,GPT4,mimiciii,progress_note,PROMPT2_ICL_entailment
71,162,40,38,2,0.95,80,27,53,0.3375,0.4980582524271844,GPT4,mimiciii,progress_note,PROMPT2_ICL_entailment
72,163,22,19,3,0.8636363636363636,28,16,12,0.5714285714285714,0.6877828054298644,GPT4,mimiciii,progress_note,PROMPT2_ICL_entailment
73,164,49,41,8,0.8367346938775511,57,45,12,0.7894736842105263,0.8124174372523117,GPT4,mimiciii,progress_note,PROMPT2_ICL_entailment
74,165,14,14,0,1.0,25,18,7,0.72,0.8372093023255813,GPT4,mimiciii,progress_note,PROMPT2_ICL_entailment
75,166,29,24,5,0.8275862068965517,42,36,6,0.8571428571428571,0.8421052631578947,GPT4,mimiciii,progress_note,PROMPT2_ICL_entailment
76,167,40,38,2,0.95,52,30,22,0.5769230769230769,0.7178841309823677,GPT4,mimiciii,progress_note,PROMPT2_ICL_entailment
77,168,58,51,7,0.8793103448275862,80,52,28,0.65,0.7474633596392335,GPT4,mimiciii,progress_note,PROMPT2_ICL_entailment
78,169,67,62,5,0.9253731343283582,80,36,44,0.45,0.6055344546934347,GPT4,mimiciii,progress_note,PROMPT2_ICL_entailment
79,17,8,7,1,0.875,15,14,1,0.9333333333333332,0.9032258064516128,GPT4,mimiciii,progress_note,PROMPT2_ICL_entailment
80,170,77,73,4,0.948051948051948,80,43,37,0.5375,0.6860452409572724,GPT4,mimiciii,progress_note,PROMPT2_ICL_entailment
81,171,50,45,5,0.9,80,40,40,0.5,0.6428571428571429,GPT4,mimiciii,progress_note,PROMPT2_ICL_entailment
82,172,96,85,11,0.8854166666666666,80,45,35,0.5625,0.6879496402877698,GPT4,mimiciii,progress_note,PROMPT2_ICL_entailment
83,173,60,49,11,0.8166666666666667,80,49,31,0.6125,0.7000000000000001,GPT4,mimiciii,progress_note,PROMPT2_ICL_entailment
84,174,55,52,3,0.9454545454545454,80,46,34,0.575,0.7150971599402092,GPT4,mimiciii,progress_note,PROMPT2_ICL_entailment
85,175,94,83,11,0.8829787234042553,80,46,34,0.575,0.6964611455673111,GPT4,mimiciii,progress_note,PROMPT2_ICL_entailment
86,176,74,62,12,0.8378378378378378,80,48,32,0.6,0.6992481203007519,GPT4,mimiciii,progress_note,PROMPT2_ICL_entailment
87,177,72,57,15,0.7916666666666666,80,52,28,0.65,0.7138728323699421,GPT4,mimiciii,progress_note,PROMPT2_ICL_entailment
88,178,18,17,1,0.9444444444444444,17,16,1,0.9411764705882352,0.9428076256499132,GPT4,mimiciii,progress_note,PROMPT2_ICL_entailment
89,179,59,51,8,0.864406779661017,80,50,30,0.625,0.7254623044096729,GPT4,mimiciii,progress_note,PROMPT2_ICL_entailment
90,18,27,22,5,0.8148148148148148,18,15,3,0.8333333333333334,0.8239700374531835,GPT4,mimiciii,progress_note,PROMPT2_ICL_entailment
91,180,60,53,7,0.8833333333333333,80,40,40,0.5,0.6385542168674698,GPT4,mimiciii,progress_note,PROMPT2_ICL_entailment
92,181,65,52,13,0.8,80,43,37,0.5375,0.6429906542056075,GPT4,mimiciii,progress_note,PROMPT2_ICL_entailment
93,182,61,53,8,0.8688524590163934,80,42,38,0.525,0.6545133784181123,GPT4,mimiciii,progress_note,PROMPT2_ICL_entailment
94,183,55,44,11,0.8,80,44,36,0.55,0.6518518518518519,GPT4,mimiciii,progress_note,PROMPT2_ICL_entailment
95,184,41,40,1,0.975609756097561,80,41,39,0.5125,0.6719934439664003,GPT4,mimiciii,progress_note,PROMPT2_ICL_entailment
96,185,34,28,6,0.8235294117647058,48,28,20,0.5833333333333334,0.6829268292682927,GPT4,mimiciii,progress_note,PROMPT2_ICL_entailment
97,186,70,60,10,0.8571428571428571,80,44,36,0.55,0.6700507614213198,GPT4,mimiciii,progress_note,PROMPT2_ICL_entailment
98,187,43,30,13,0.6976744186046512,80,40,40,0.5,0.5825242718446603,GPT4,mimiciii,progress_note,PROMPT2_ICL_entailment
99,188,33,30,3,0.9090909090909092,80,40,40,0.5,0.6451612903225806,GPT4,mimiciii,progress_note,PROMPT2_ICL_entailment
100,189,74,60,14,0.8108108108108109,80,37,43,0.4625,0.589015654019634,GPT4,mimiciii,progress_note,PROMPT2_ICL_entailment
101,19,40,39,1,0.975,38,18,20,0.4736842105263157,0.6376021798365121,GPT4,mimiciii,progress_note,PROMPT2_ICL_entailment
102,190,48,42,6,0.875,80,46,34,0.575,0.6939655172413792,GPT4,mimiciii,progress_note,PROMPT2_ICL_entailment
103,191,64,62,2,0.96875,80,45,35,0.5625,0.7117346938775511,GPT4,mimiciii,progress_note,PROMPT2_ICL_entailment
104,192,68,62,6,0.9117647058823528,80,50,30,0.625,0.7416267942583732,GPT4,mimiciii,progress_note,PROMPT2_ICL_entailment
105,193,88,74,14,0.8409090909090909,80,54,26,0.675,0.7488755622188905,GPT4,mimiciii,progress_note,PROMPT2_ICL_entailment
106,194,80,59,21,0.7375,80,35,45,0.4375,0.5492021276595745,GPT4,mimiciii,progress_note,PROMPT2_ICL_entailment
107,195,36,30,6,0.8333333333333334,44,31,13,0.7045454545454546,0.7635467980295566,GPT4,mimiciii,progress_note,PROMPT2_ICL_entailment
108,196,39,31,8,0.7948717948717948,42,26,16,0.6190476190476191,0.696027633851468,GPT4,mimiciii,progress_note,PROMPT2_ICL_entailment
109,197,83,76,7,0.9156626506024096,80,61,19,0.7625,0.8320918962577403,GPT4,mimiciii,progress_note,PROMPT2_ICL_entailment
110,198,40,37,3,0.925,34,30,4,0.8823529411764706,0.903173311635476,GPT4,mimiciii,progress_note,PROMPT2_ICL_entailment
111,199,43,39,4,0.9069767441860463,52,39,13,0.75,0.8210526315789475,GPT4,mimiciii,progress_note,PROMPT2_ICL_entailment
112,2,57,50,7,0.8771929824561403,80,47,33,0.5875,0.7036981584069472,GPT4,mimiciii,progress_note,PROMPT2_ICL_entailment
113,20,28,20,8,0.7142857142857143,33,22,11,0.6666666666666666,0.689655172413793,GPT4,mimiciii,progress_note,PROMPT2_ICL_entailment
114,200,47,38,9,0.8085106382978723,80,45,35,0.5625,0.6634335596508244,GPT4,mimiciii,progress_note,PROMPT2_ICL_entailment
115,201,66,63,3,0.9545454545454546,80,48,32,0.6,0.7368421052631579,GPT4,mimiciii,progress_note,PROMPT2_ICL_entailment
116,202,60,52,8,0.8666666666666667,80,38,42,0.475,0.6136645962732918,GPT4,mimiciii,progress_note,PROMPT2_ICL_entailment
117,203,37,31,6,0.8378378378378378,80,25,55,0.3125,0.4552129221732747,GPT4,mimiciii,progress_note,PROMPT2_ICL_entailment
118,204,94,80,14,0.851063829787234,80,43,37,0.5375,0.6588776096533231,GPT4,mimiciii,progress_note,PROMPT2_ICL_entailment
119,205,52,48,4,0.9230769230769232,80,36,44,0.45,0.6050420168067228,GPT4,mimiciii,progress_note,PROMPT2_ICL_entailment
120,206,75,62,13,0.8266666666666667,80,45,35,0.5625,0.6694661067786443,GPT4,mimiciii,progress_note,PROMPT2_ICL_entailment
121,207,79,74,5,0.9367088607594936,80,49,31,0.6125,0.7406802165253805,GPT4,mimiciii,progress_note,PROMPT2_ICL_entailment
122,208,73,63,10,0.863013698630137,80,41,39,0.5125,0.6430972239512012,GPT4,mimiciii,progress_note,PROMPT2_ICL_entailment
123,209,57,43,14,0.7543859649122807,80,44,36,0.55,0.6361802286482853,GPT4,mimiciii,progress_note,PROMPT2_ICL_entailment
124,21,63,48,15,0.7619047619047619,80,39,41,0.4875,0.5945688423058598,GPT4,mimiciii,progress_note,PROMPT2_ICL_entailment
125,210,32,27,5,0.84375,28,25,3,0.8928571428571429,0.8676092544987147,GPT4,mimiciii,progress_note,PROMPT2_ICL_entailment
126,211,45,40,5,0.8888888888888888,54,42,12,0.7777777777777778,0.8296296296296296,GPT4,mimiciii,progress_note,PROMPT2_ICL_entailment
127,212,23,21,2,0.9130434782608696,14,13,1,0.9285714285714286,0.9207419898819562,GPT4,mimiciii,progress_note,PROMPT2_ICL_entailment
128,213,45,39,6,0.8666666666666667,41,23,18,0.5609756097560976,0.6810933940774488,GPT4,mimiciii,progress_note,PROMPT2_ICL_entailment
129,214,24,22,2,0.9166666666666666,27,20,7,0.7407407407407407,0.8193668528864059,GPT4,mimiciii,progress_note,PROMPT2_ICL_entailment
130,215,61,34,27,0.5573770491803278,66,47,19,0.7121212121212122,0.6253179416943846,GPT4,mimiciii,progress_note,PROMPT2_ICL_entailment
131,216,55,37,18,0.6727272727272727,67,56,11,0.835820895522388,0.7454578161539845,GPT4,mimiciii,progress_note,PROMPT2_ICL_entailment
132,217,57,53,4,0.9298245614035088,73,41,32,0.5616438356164384,0.7002900418949404,GPT4,mimiciii,progress_note,PROMPT2_ICL_entailment
133,218,35,31,4,0.8857142857142857,27,19,8,0.7037037037037037,0.7842876165113183,GPT4,mimiciii,progress_note,PROMPT2_ICL_entailment
134,219,22,21,1,0.9545454545454546,17,11,6,0.6470588235294118,0.7712854757929883,GPT4,mimiciii,progress_note,PROMPT2_ICL_entailment
135,22,32,24,8,0.75,38,29,9,0.7631578947368421,0.7565217391304349,GPT4,mimiciii,progress_note,PROMPT2_ICL_entailment
136,220,44,35,9,0.7954545454545454,34,29,5,0.8529411764705882,0.8231954582319545,GPT4,mimiciii,progress_note,PROMPT2_ICL_entailment
137,221,82,76,6,0.926829268292683,80,31,49,0.3875,0.5465089306425424,GPT4,mimiciii,progress_note,PROMPT2_ICL_entailment
138,222,73,60,13,0.821917808219178,80,44,36,0.55,0.6590114827758363,GPT4,mimiciii,progress_note,PROMPT2_ICL_entailment
139,223,23,19,4,0.8260869565217391,30,22,8,0.7333333333333333,0.7769516728624535,GPT4,mimiciii,progress_note,PROMPT2_ICL_entailment
140,224,20,17,3,0.85,33,27,6,0.8181818181818182,0.8337874659400545,GPT4,mimiciii,progress_note,PROMPT2_ICL_entailment
141,225,24,20,4,0.8333333333333334,37,26,11,0.7027027027027027,0.7624633431085044,GPT4,mimiciii,progress_note,PROMPT2_ICL_entailment
142,226,31,27,4,0.8709677419354839,33,19,14,0.5757575757575758,0.6932432432432433,GPT4,mimiciii,progress_note,PROMPT2_ICL_entailment
143,227,18,18,0,1.0,15,15,0,1.0,1.0,GPT4,mimiciii,progress_note,PROMPT2_ICL_entailment
144,228,6,6,0,1.0,15,3,12,0.2,0.3333333333333333,GPT4,mimiciii,progress_note,PROMPT2_ICL_entailment
145,229,6,6,0,1.0,15,3,12,0.2,0.3333333333333333,GPT4,mimiciii,progress_note,PROMPT2_ICL_entailment
146,23,26,18,8,0.6923076923076923,37,30,7,0.8108108108108109,0.7468879668049794,GPT4,mimiciii,progress_note,PROMPT2_ICL_entailment
147,230,22,18,4,0.8181818181818182,26,23,3,0.8846153846153846,0.8501026694045174,GPT4,mimiciii,progress_note,PROMPT2_ICL_entailment
148,231,55,53,2,0.9636363636363636,79,57,22,0.7215189873417721,0.8251843758535918,GPT4,mimiciii,progress_note,PROMPT2_ICL_entailment
149,232,63,52,11,0.8253968253968254,72,57,15,0.7916666666666666,0.8081799591002045,GPT4,mimiciii,progress_note,PROMPT2_ICL_entailment
150,233,55,33,22,0.6,80,67,13,0.8375,0.6991304347826086,GPT4,mimiciii,progress_note,PROMPT2_ICL_entailment
151,234,30,25,5,0.8333333333333334,42,36,6,0.8571428571428571,0.8450704225352113,GPT4,mimiciii,progress_note,PROMPT2_ICL_entailment
152,24,21,15,6,0.7142857142857143,22,12,10,0.5454545454545454,0.6185567010309277,GPT4,mimiciii,progress_note,PROMPT2_ICL_entailment
153,25,19,15,4,0.7894736842105263,22,12,10,0.5454545454545454,0.6451612903225806,GPT4,mimiciii,progress_note,PROMPT2_ICL_entailment
154,26,22,16,6,0.7272727272727273,22,12,10,0.5454545454545454,0.6233766233766234,GPT4,mimiciii,progress_note,PROMPT2_ICL_entailment
155,27,24,10,14,0.4166666666666667,19,14,5,0.7368421052631579,0.5323193916349811,GPT4,mimiciii,progress_note,PROMPT2_ICL_entailment
156,28,40,37,3,0.925,50,40,10,0.8,0.8579710144927537,GPT4,mimiciii,progress_note,PROMPT2_ICL_entailment
157,29,33,30,3,0.9090909090909092,52,35,17,0.6730769230769231,0.7734806629834254,GPT4,mimiciii,progress_note,PROMPT2_ICL_entailment
158,3,66,53,13,0.803030303030303,80,40,40,0.5,0.6162790697674418,GPT4,mimiciii,progress_note,PROMPT2_ICL_entailment
159,30,28,24,4,0.8571428571428571,18,15,3,0.8333333333333334,0.8450704225352113,GPT4,mimiciii,progress_note,PROMPT2_ICL_entailment
160,31,23,23,0,1.0,17,16,1,0.9411764705882352,0.9696969696969696,GPT4,mimiciii,progress_note,PROMPT2_ICL_entailment
161,32,61,53,8,0.8688524590163934,77,52,25,0.6753246753246753,0.7599613952847097,GPT4,mimiciii,progress_note,PROMPT2_ICL_entailment
162,33,58,49,9,0.8448275862068966,65,50,15,0.7692307692307693,0.8052588331963846,GPT4,mimiciii,progress_note,PROMPT2_ICL_entailment
163,34,46,38,8,0.8260869565217391,71,39,32,0.5492957746478874,0.659839715048976,GPT4,mimiciii,progress_note,PROMPT2_ICL_entailment
164,35,16,14,2,0.875,20,6,14,0.3,0.4468085106382978,GPT4,mimiciii,progress_note,PROMPT2_ICL_entailment
165,36,26,18,8,0.6923076923076923,40,26,14,0.65,0.670487106017192,GPT4,mimiciii,progress_note,PROMPT2_ICL_entailment
166,37,84,79,5,0.9404761904761904,80,58,22,0.725,0.8187991422444604,GPT4,mimiciii,progress_note,PROMPT2_ICL_entailment
167,38,48,38,10,0.7916666666666666,80,42,38,0.525,0.6313291139240507,GPT4,mimiciii,progress_note,PROMPT2_ICL_entailment
168,39,39,39,0,1.0,76,50,26,0.6578947368421053,0.7936507936507937,GPT4,mimiciii,progress_note,PROMPT2_ICL_entailment
169,4,70,61,9,0.8714285714285714,80,44,36,0.55,0.6743718592964825,GPT4,mimiciii,progress_note,PROMPT2_ICL_entailment
170,40,39,36,3,0.9230769230769232,76,48,28,0.631578947368421,0.7499999999999999,GPT4,mimiciii,progress_note,PROMPT2_ICL_entailment
171,41,61,55,6,0.9016393442622952,78,58,20,0.7435897435897436,0.8150229943791519,GPT4,mimiciii,progress_note,PROMPT2_ICL_entailment
172,42,69,63,6,0.9130434782608696,78,68,10,0.8717948717948718,0.891942535915053,GPT4,mimiciii,progress_note,PROMPT2_ICL_entailment
173,43,68,49,19,0.7205882352941176,79,52,27,0.6582278481012658,0.6879978398811933,GPT4,mimiciii,progress_note,PROMPT2_ICL_entailment
174,44,43,42,1,0.9767441860465116,80,55,25,0.6875,0.8069868995633188,GPT4,mimiciii,progress_note,PROMPT2_ICL_entailment
175,45,62,60,2,0.967741935483871,80,70,10,0.875,0.9190371991247264,GPT4,mimiciii,progress_note,PROMPT2_ICL_entailment
176,46,34,28,6,0.8235294117647058,36,22,14,0.6111111111111112,0.7015945330296127,GPT4,mimiciii,progress_note,PROMPT2_ICL_entailment
177,47,12,12,0,1.0,10,10,0,1.0,1.0,GPT4,mimiciii,progress_note,PROMPT2_ICL_entailment
178,48,56,53,3,0.9464285714285714,30,26,4,0.8666666666666667,0.9047931713722916,GPT4,mimiciii,progress_note,PROMPT2_ICL_entailment
179,49,53,46,7,0.8679245283018868,57,48,9,0.8421052631578947,0.8548199767711963,GPT4,mimiciii,progress_note,PROMPT2_ICL_entailment
180,5,56,47,9,0.8392857142857143,80,49,31,0.6125,0.7081795817958181,GPT4,mimiciii,progress_note,PROMPT2_ICL_entailment
181,50,101,87,14,0.8613861386138614,80,68,12,0.85,0.8556551923633208,GPT4,mimiciii,progress_note,PROMPT2_ICL_entailment
182,51,69,55,14,0.7971014492753623,80,36,44,0.45,0.5752469494479954,GPT4,mimiciii,progress_note,PROMPT2_ICL_entailment
183,52,58,49,9,0.8448275862068966,80,59,21,0.7375,0.7875238354671751,GPT4,mimiciii,progress_note,PROMPT2_ICL_entailment
184,53,58,49,9,0.8448275862068966,80,48,32,0.6,0.7016706443914081,GPT4,mimiciii,progress_note,PROMPT2_ICL_entailment
185,54,46,31,15,0.6739130434782609,80,42,38,0.525,0.5902085222121487,GPT4,mimiciii,progress_note,PROMPT2_ICL_entailment
186,55,40,36,4,0.9,80,38,42,0.475,0.6218181818181818,GPT4,mimiciii,progress_note,PROMPT2_ICL_entailment
187,56,15,13,2,0.8666666666666667,40,7,33,0.175,0.2912,GPT4,mimiciii,progress_note,PROMPT2_ICL_entailment
188,57,31,28,3,0.9032258064516128,28,23,5,0.8214285714285714,0.8603874415497662,GPT4,mimiciii,progress_note,PROMPT2_ICL_entailment
189,58,26,15,11,0.5769230769230769,25,16,9,0.64,0.606826801517067,GPT4,mimiciii,progress_note,PROMPT2_ICL_entailment
190,59,27,19,8,0.7037037037037037,25,5,20,0.2,0.3114754098360656,GPT4,mimiciii,progress_note,PROMPT2_ICL_entailment
191,6,59,55,4,0.9322033898305084,80,41,39,0.5125,0.6613873001906437,GPT4,mimiciii,progress_note,PROMPT2_ICL_entailment
192,60,56,42,14,0.75,80,44,36,0.55,0.6346153846153847,GPT4,mimiciii,progress_note,PROMPT2_ICL_entailment
193,61,25,18,7,0.72,37,30,7,0.8108108108108109,0.7627118644067797,GPT4,mimiciii,progress_note,PROMPT2_ICL_entailment
194,62,26,18,8,0.6923076923076923,37,34,3,0.918918918918919,0.7896774193548387,GPT4,mimiciii,progress_note,PROMPT2_ICL_entailment
195,63,53,37,16,0.6981132075471698,80,65,15,0.8125,0.750975800156128,GPT4,mimiciii,progress_note,PROMPT2_ICL_entailment
196,64,1,0,1,0.0,1,0,1,0.0,,GPT4,mimiciii,progress_note,PROMPT2_ICL_entailment
197,65,19,18,1,0.9473684210526316,8,8,0,1.0,0.972972972972973,GPT4,mimiciii,progress_note,PROMPT2_ICL_entailment
198,66,34,30,4,0.8823529411764706,48,35,13,0.7291666666666666,0.7984790874524715,GPT4,mimiciii,progress_note,PROMPT2_ICL_entailment
199,67,75,53,22,0.7066666666666667,80,38,42,0.475,0.5681241184767278,GPT4,mimiciii,progress_note,PROMPT2_ICL_entailment
200,68,73,61,12,0.8356164383561644,80,40,40,0.5,0.6256410256410256,GPT4,mimiciii,progress_note,PROMPT2_ICL_entailment
201,69,61,57,4,0.9344262295081968,80,41,39,0.5125,0.6619459000141622,GPT4,mimiciii,progress_note,PROMPT2_ICL_entailment
202,7,64,56,8,0.875,80,43,37,0.5375,0.6659292035398229,GPT4,mimiciii,progress_note,PROMPT2_ICL_entailment
203,70,63,50,13,0.7936507936507936,80,46,34,0.575,0.666859959408524,GPT4,mimiciii,progress_note,PROMPT2_ICL_entailment
204,71,63,61,2,0.9682539682539684,80,44,36,0.55,0.7015159435441715,GPT4,mimiciii,progress_note,PROMPT2_ICL_entailment
205,72,10,10,0,1.0,15,12,3,0.8,0.888888888888889,GPT4,mimiciii,progress_note,PROMPT2_ICL_entailment
206,73,73,47,26,0.6438356164383562,80,40,40,0.5,0.5628742514970061,GPT4,mimiciii,progress_note,PROMPT2_ICL_entailment
207,74,47,42,5,0.8936170212765957,80,45,35,0.5625,0.6904109589041095,GPT4,mimiciii,progress_note,PROMPT2_ICL_entailment
208,75,47,42,5,0.8936170212765957,40,25,15,0.625,0.7355516637478108,GPT4,mimiciii,progress_note,PROMPT2_ICL_entailment
209,76,44,31,13,0.7045454545454546,58,41,17,0.7068965517241379,0.7057190449750139,GPT4,mimiciii,progress_note,PROMPT2_ICL_entailment
210,77,25,24,1,0.96,27,21,6,0.7777777777777778,0.8593350383631715,GPT4,mimiciii,progress_note,PROMPT2_ICL_entailment
211,78,26,23,3,0.8846153846153846,20,15,5,0.75,0.8117647058823529,GPT4,mimiciii,progress_note,PROMPT2_ICL_entailment
212,79,32,27,5,0.84375,43,26,17,0.6046511627906976,0.7044656297039639,GPT4,mimiciii,progress_note,PROMPT2_ICL_entailment
213,8,59,45,14,0.7627118644067796,78,60,18,0.7692307692307693,0.7659574468085106,GPT4,mimiciii,progress_note,PROMPT2_ICL_entailment
214,80,26,21,5,0.8076923076923077,21,15,6,0.7142857142857143,0.7581227436823106,GPT4,mimiciii,progress_note,PROMPT2_ICL_entailment
215,81,38,26,12,0.6842105263157895,32,24,8,0.75,0.7155963302752295,GPT4,mimiciii,progress_note,PROMPT2_ICL_entailment
216,82,6,6,0,1.0,15,3,12,0.2,0.3333333333333333,GPT4,mimiciii,progress_note,PROMPT2_ICL_entailment
217,83,34,28,6,0.8235294117647058,43,34,9,0.7906976744186046,0.8067796610169492,GPT4,mimiciii,progress_note,PROMPT2_ICL_entailment
218,84,27,25,2,0.925925925925926,35,22,13,0.6285714285714286,0.7488087134104833,GPT4,mimiciii,progress_note,PROMPT2_ICL_entailment
219,85,34,31,3,0.9117647058823528,50,41,9,0.82,0.8634510869565217,GPT4,mimiciii,progress_note,PROMPT2_ICL_entailment
220,86,56,54,2,0.9642857142857144,32,25,7,0.78125,0.8631713554987211,GPT4,mimiciii,progress_note,PROMPT2_ICL_entailment
221,87,8,7,1,0.875,12,12,0,1.0,0.9333333333333332,GPT4,mimiciii,progress_note,PROMPT2_ICL_entailment
222,88,56,47,9,0.8392857142857143,67,49,18,0.7313432835820896,0.781605294417105,GPT4,mimiciii,progress_note,PROMPT2_ICL_entailment
223,89,62,49,13,0.7903225806451613,80,34,46,0.425,0.5527538155275381,GPT4,mimiciii,progress_note,PROMPT2_ICL_entailment
224,9,33,33,0,1.0,42,31,11,0.7380952380952381,0.8493150684931507,GPT4,mimiciii,progress_note,PROMPT2_ICL_entailment
225,90,7,6,1,0.8571428571428571,3,3,0,1.0,0.923076923076923,GPT4,mimiciii,progress_note,PROMPT2_ICL_entailment
226,91,52,47,5,0.903846153846154,79,63,16,0.7974683544303798,0.8473315209615109,GPT4,mimiciii,progress_note,PROMPT2_ICL_entailment
227,92,59,49,10,0.8305084745762712,80,40,40,0.5,0.6242038216560509,GPT4,mimiciii,progress_note,PROMPT2_ICL_entailment
228,93,20,17,3,0.85,27,18,9,0.6666666666666666,0.7472527472527473,GPT4,mimiciii,progress_note,PROMPT2_ICL_entailment
229,94,55,49,6,0.8909090909090909,79,51,28,0.6455696202531646,0.7486518873576992,GPT4,mimiciii,progress_note,PROMPT2_ICL_entailment
230,95,36,28,8,0.7777777777777778,32,21,11,0.65625,0.711864406779661,GPT4,mimiciii,progress_note,PROMPT2_ICL_entailment
231,96,10,10,0,1.0,11,3,8,0.2727272727272727,0.4285714285714285,GPT4,mimiciii,progress_note,PROMPT2_ICL_entailment
232,97,14,14,0,1.0,14,9,5,0.6428571428571429,0.782608695652174,GPT4,mimiciii,progress_note,PROMPT2_ICL_entailment
233,98,22,19,3,0.8636363636363636,24,17,7,0.7083333333333334,0.7783132530120482,GPT4,mimiciii,progress_note,PROMPT2_ICL_entailment
234,99,41,36,5,0.8780487804878049,70,40,30,0.5714285714285714,0.6923076923076923,GPT4,mimiciii,progress_note,PROMPT2_ICL_entailment
0,0,52,41,11,0.7884615384615384,78,64,14,0.8205128205128205,0.8041679436101746,GPT4,mimiciii,progress_note,PROMPT2_entailment
1,1,39,35,4,0.8974358974358975,80,33,47,0.4125,0.5652067531196476,GPT4,mimiciii,progress_note,PROMPT2_entailment
2,10,49,36,13,0.7346938775510204,80,47,33,0.5875,0.6529037237121358,GPT4,mimiciii,progress_note,PROMPT2_entailment
3,100,46,39,7,0.8478260869565217,77,60,17,0.7792207792207793,0.8120770432066633,GPT4,mimiciii,progress_note,PROMPT2_entailment
4,101,27,25,2,0.925925925925926,36,25,11,0.6944444444444444,0.7936507936507936,GPT4,mimiciii,progress_note,PROMPT2_entailment
5,102,35,29,6,0.8285714285714286,42,35,7,0.8333333333333334,0.8309455587392551,GPT4,mimiciii,progress_note,PROMPT2_entailment
6,103,52,33,19,0.6346153846153846,80,27,53,0.3375,0.440652818991098,GPT4,mimiciii,progress_note,PROMPT2_entailment
7,104,25,16,9,0.64,39,26,13,0.6666666666666666,0.6530612244897959,GPT4,mimiciii,progress_note,PROMPT2_entailment
8,105,22,22,0,1.0,17,13,4,0.7647058823529411,0.8666666666666666,GPT4,mimiciii,progress_note,PROMPT2_entailment
9,106,21,16,5,0.7619047619047619,40,25,15,0.625,0.6866952789699571,GPT4,mimiciii,progress_note,PROMPT2_entailment
10,107,23,21,2,0.9130434782608696,31,29,2,0.935483870967742,0.9241274658573596,GPT4,mimiciii,progress_note,PROMPT2_entailment
11,108,39,31,8,0.7948717948717948,68,49,19,0.7205882352941176,0.755909430206519,GPT4,mimiciii,progress_note,PROMPT2_entailment
12,109,59,54,5,0.9152542372881356,80,45,35,0.5625,0.696774193548387,GPT4,mimiciii,progress_note,PROMPT2_entailment
13,11,42,33,9,0.7857142857142857,80,45,35,0.5625,0.6556291390728477,GPT4,mimiciii,progress_note,PROMPT2_entailment
14,110,35,28,7,0.8,80,32,48,0.4,0.5333333333333333,GPT4,mimiciii,progress_note,PROMPT2_entailment
15,111,70,59,11,0.8428571428571429,80,33,47,0.4125,0.5539118065433855,GPT4,mimiciii,progress_note,PROMPT2_entailment
16,112,56,47,9,0.8392857142857143,80,42,38,0.525,0.6459424083769634,GPT4,mimiciii,progress_note,PROMPT2_entailment
17,113,49,34,15,0.6938775510204082,80,53,27,0.6625,0.6778258416400226,GPT4,mimiciii,progress_note,PROMPT2_entailment
18,114,49,40,9,0.8163265306122449,80,29,51,0.3625,0.5020558320709803,GPT4,mimiciii,progress_note,PROMPT2_entailment
19,115,41,32,9,0.7804878048780488,80,37,43,0.4625,0.5808192298258523,GPT4,mimiciii,progress_note,PROMPT2_entailment
20,116,24,21,3,0.875,35,29,6,0.8285714285714286,0.8511530398322852,GPT4,mimiciii,progress_note,PROMPT2_entailment
21,117,17,14,3,0.8235294117647058,20,18,2,0.9,0.8600682593856656,GPT4,mimiciii,progress_note,PROMPT2_entailment
22,118,34,29,5,0.8529411764705882,23,20,3,0.8695652173913043,0.8611729769858946,GPT4,mimiciii,progress_note,PROMPT2_entailment
23,119,14,14,0,1.0,14,10,4,0.7142857142857143,0.8333333333333333,GPT4,mimiciii,progress_note,PROMPT2_entailment
24,12,49,40,9,0.8163265306122449,80,47,33,0.5875,0.6832636743594404,GPT4,mimiciii,progress_note,PROMPT2_entailment
25,120,45,39,6,0.8666666666666667,64,36,28,0.5625,0.6822157434402333,GPT4,mimiciii,progress_note,PROMPT2_entailment
26,121,15,14,1,0.9333333333333332,14,8,6,0.5714285714285714,0.7088607594936709,GPT4,mimiciii,progress_note,PROMPT2_entailment
27,122,43,22,21,0.5116279069767442,47,43,4,0.9148936170212766,0.6562608394033993,GPT4,mimiciii,progress_note,PROMPT2_entailment
28,123,23,20,3,0.8695652173913043,50,31,19,0.62,0.7238762405137187,GPT4,mimiciii,progress_note,PROMPT2_entailment
29,124,32,31,1,0.96875,65,49,16,0.7538461538461538,0.8478928272397432,GPT4,mimiciii,progress_note,PROMPT2_entailment
30,125,28,22,6,0.7857142857142857,50,35,15,0.7,0.7403846153846153,GPT4,mimiciii,progress_note,PROMPT2_entailment
31,126,25,24,1,0.96,27,23,4,0.8518518518518519,0.9026982829108748,GPT4,mimiciii,progress_note,PROMPT2_entailment
32,127,24,22,2,0.9166666666666666,27,24,3,0.8888888888888888,0.9025641025641026,GPT4,mimiciii,progress_note,PROMPT2_entailment
33,128,39,36,3,0.9230769230769232,37,28,9,0.7567567567567568,0.8316831683168316,GPT4,mimiciii,progress_note,PROMPT2_entailment
34,129,45,21,24,0.4666666666666667,66,50,16,0.7575757575757576,0.5775577557755777,GPT4,mimiciii,progress_note,PROMPT2_entailment
35,13,33,24,9,0.7272727272727273,73,38,35,0.5205479452054794,0.6067864271457085,GPT4,mimiciii,progress_note,PROMPT2_entailment
36,130,24,15,9,0.625,44,29,15,0.6590909090909091,0.6415929203539823,GPT4,mimiciii,progress_note,PROMPT2_entailment
37,131,83,71,12,0.8554216867469879,80,40,40,0.5,0.6311111111111111,GPT4,mimiciii,progress_note,PROMPT2_entailment
38,132,51,47,4,0.9215686274509804,80,47,33,0.5875,0.7175572519083969,GPT4,mimiciii,progress_note,PROMPT2_entailment
39,133,41,30,11,0.7317073170731707,80,37,43,0.4625,0.5667602757212152,GPT4,mimiciii,progress_note,PROMPT2_entailment
40,134,11,8,3,0.7272727272727273,18,6,12,0.3333333333333333,0.4571428571428572,GPT4,mimiciii,progress_note,PROMPT2_entailment
41,135,28,21,7,0.75,35,22,13,0.6285714285714286,0.6839378238341969,GPT4,mimiciii,progress_note,PROMPT2_entailment
42,136,29,26,3,0.896551724137931,43,34,9,0.7906976744186046,0.8403041825095056,GPT4,mimiciii,progress_note,PROMPT2_entailment
43,137,18,14,4,0.7777777777777778,26,18,8,0.6923076923076923,0.7325581395348836,GPT4,mimiciii,progress_note,PROMPT2_entailment
44,138,26,25,1,0.9615384615384616,45,26,19,0.5777777777777777,0.7218212104386451,GPT4,mimiciii,progress_note,PROMPT2_entailment
45,139,31,29,2,0.935483870967742,45,38,7,0.8444444444444444,0.8876359242851389,GPT4,mimiciii,progress_note,PROMPT2_entailment
46,14,38,16,22,0.4210526315789473,43,18,25,0.4186046511627907,0.4198250728862974,GPT4,mimiciii,progress_note,PROMPT2_entailment
47,140,21,12,9,0.5714285714285714,25,17,8,0.68,0.6210045662100457,GPT4,mimiciii,progress_note,PROMPT2_entailment
48,141,40,36,4,0.9,45,38,7,0.8444444444444444,0.8713375796178344,GPT4,mimiciii,progress_note,PROMPT2_entailment
49,142,45,41,4,0.9111111111111112,50,32,18,0.64,0.7518624641833811,GPT4,mimiciii,progress_note,PROMPT2_entailment
50,143,8,8,0,1.0,11,6,5,0.5454545454545454,0.7058823529411764,GPT4,mimiciii,progress_note,PROMPT2_entailment
51,144,44,39,5,0.8863636363636364,50,33,17,0.66,0.7566137566137567,GPT4,mimiciii,progress_note,PROMPT2_entailment
52,145,30,16,14,0.5333333333333333,43,25,18,0.5813953488372093,0.5563282336578581,GPT4,mimiciii,progress_note,PROMPT2_entailment
53,146,33,23,10,0.696969696969697,32,23,9,0.71875,0.7076923076923077,GPT4,mimiciii,progress_note,PROMPT2_entailment
54,147,36,33,3,0.9166666666666666,56,39,17,0.6964285714285714,0.7915129151291512,GPT4,mimiciii,progress_note,PROMPT2_entailment
55,148,9,7,2,0.7777777777777778,4,3,1,0.75,0.7636363636363638,GPT4,mimiciii,progress_note,PROMPT2_entailment
56,149,29,25,4,0.8620689655172413,29,25,4,0.8620689655172413,0.8620689655172413,GPT4,mimiciii,progress_note,PROMPT2_entailment
57,15,57,43,14,0.7543859649122807,80,46,34,0.575,0.6525899043220059,GPT4,mimiciii,progress_note,PROMPT2_entailment
58,150,47,39,8,0.8297872340425532,80,48,32,0.6,0.6964285714285714,GPT4,mimiciii,progress_note,PROMPT2_entailment
59,151,30,29,1,0.9666666666666668,80,44,36,0.55,0.7010989010989012,GPT4,mimiciii,progress_note,PROMPT2_entailment
60,152,38,19,19,0.5,45,21,24,0.4666666666666667,0.4827586206896552,GPT4,mimiciii,progress_note,PROMPT2_entailment
61,153,46,44,2,0.9565217391304348,80,39,41,0.4875,0.6458411742566805,GPT4,mimiciii,progress_note,PROMPT2_entailment
62,154,15,14,1,0.9333333333333332,15,15,0,1.0,0.9655172413793104,GPT4,mimiciii,progress_note,PROMPT2_entailment
63,155,21,19,2,0.9047619047619048,32,28,4,0.875,0.8896321070234113,GPT4,mimiciii,progress_note,PROMPT2_entailment
64,156,21,19,2,0.9047619047619048,32,24,8,0.75,0.8201438848920864,GPT4,mimiciii,progress_note,PROMPT2_entailment
65,157,22,21,1,0.9545454545454546,29,19,10,0.6551724137931034,0.7770204479065238,GPT4,mimiciii,progress_note,PROMPT2_entailment
66,158,87,81,6,0.9310344827586208,80,46,34,0.575,0.7109330280480823,GPT4,mimiciii,progress_note,PROMPT2_entailment
67,159,17,15,2,0.8823529411764706,22,13,9,0.5909090909090909,0.7078039927404719,GPT4,mimiciii,progress_note,PROMPT2_entailment
68,16,18,15,3,0.8333333333333334,28,21,7,0.75,0.7894736842105262,GPT4,mimiciii,progress_note,PROMPT2_entailment
69,160,30,25,5,0.8333333333333334,65,55,10,0.8461538461538461,0.8396946564885497,GPT4,mimiciii,progress_note,PROMPT2_entailment
70,161,33,31,2,0.9393939393939394,80,37,43,0.4625,0.6198324777087274,GPT4,mimiciii,progress_note,PROMPT2_entailment
71,162,42,38,4,0.9047619047619048,80,37,43,0.4625,0.6121027427078799,GPT4,mimiciii,progress_note,PROMPT2_entailment
72,163,19,15,4,0.7894736842105263,28,16,12,0.5714285714285714,0.6629834254143646,GPT4,mimiciii,progress_note,PROMPT2_entailment
73,164,25,16,9,0.64,57,36,21,0.631578947368421,0.6357615894039735,GPT4,mimiciii,progress_note,PROMPT2_entailment
74,165,9,9,0,1.0,25,19,6,0.76,0.8636363636363636,GPT4,mimiciii,progress_note,PROMPT2_entailment
75,166,23,15,8,0.6521739130434783,42,29,13,0.6904761904761905,0.6707787201233616,GPT4,mimiciii,progress_note,PROMPT2_entailment
76,167,32,29,3,0.90625,52,32,20,0.6153846153846154,0.7330173775671406,GPT4,mimiciii,progress_note,PROMPT2_entailment
77,168,53,46,7,0.8679245283018868,80,47,33,0.5875,0.7006968076486793,GPT4,mimiciii,progress_note,PROMPT2_entailment
78,169,54,49,5,0.9074074074074074,80,48,32,0.6,0.7223587223587222,GPT4,mimiciii,progress_note,PROMPT2_entailment
79,17,9,8,1,0.8888888888888888,15,12,3,0.8,0.8421052631578948,GPT4,mimiciii,progress_note,PROMPT2_entailment
80,170,60,52,8,0.8666666666666667,80,50,30,0.625,0.7262569832402236,GPT4,mimiciii,progress_note,PROMPT2_entailment
81,171,25,21,4,0.84,80,47,33,0.5875,0.6914185639229422,GPT4,mimiciii,progress_note,PROMPT2_entailment
82,172,49,43,6,0.8775510204081632,80,46,34,0.575,0.694766420793818,GPT4,mimiciii,progress_note,PROMPT2_entailment
83,173,49,41,8,0.8367346938775511,80,52,28,0.65,0.7316403568977351,GPT4,mimiciii,progress_note,PROMPT2_entailment
84,174,47,45,2,0.9574468085106383,80,45,35,0.5625,0.7086614173228346,GPT4,mimiciii,progress_note,PROMPT2_entailment
85,175,64,61,3,0.953125,80,45,35,0.5625,0.7074742268041238,GPT4,mimiciii,progress_note,PROMPT2_entailment
86,176,70,61,9,0.8714285714285714,80,46,34,0.575,0.6928395061728394,GPT4,mimiciii,progress_note,PROMPT2_entailment
87,177,55,49,6,0.8909090909090909,80,59,21,0.7375,0.8069783670621076,GPT4,mimiciii,progress_note,PROMPT2_entailment
88,178,17,16,1,0.9411764705882352,17,14,3,0.8235294117647058,0.8784313725490196,GPT4,mimiciii,progress_note,PROMPT2_entailment
89,179,55,44,11,0.8,80,51,29,0.6375,0.7095652173913044,GPT4,mimiciii,progress_note,PROMPT2_entailment
90,18,20,16,4,0.8,18,16,2,0.8888888888888888,0.8421052631578948,GPT4,mimiciii,progress_note,PROMPT2_entailment
91,180,39,32,7,0.8205128205128205,80,53,27,0.6625,0.7330883942079102,GPT4,mimiciii,progress_note,PROMPT2_entailment
92,181,68,54,14,0.7941176470588235,80,46,34,0.575,0.6670247046186895,GPT4,mimiciii,progress_note,PROMPT2_entailment
93,182,56,47,9,0.8392857142857143,80,54,26,0.675,0.7482311320754718,GPT4,mimiciii,progress_note,PROMPT2_entailment
94,183,74,51,23,0.6891891891891891,80,46,34,0.575,0.6269374665954034,GPT4,mimiciii,progress_note,PROMPT2_entailment
95,184,56,53,3,0.9464285714285714,80,51,29,0.6375,0.7618376550169108,GPT4,mimiciii,progress_note,PROMPT2_entailment
96,185,21,16,5,0.7619047619047619,48,33,15,0.6875,0.7227926078028747,GPT4,mimiciii,progress_note,PROMPT2_entailment
97,186,54,41,13,0.7592592592592593,80,43,37,0.5375,0.6294180649767941,GPT4,mimiciii,progress_note,PROMPT2_entailment
98,187,38,33,5,0.868421052631579,80,34,46,0.425,0.5707019328585962,GPT4,mimiciii,progress_note,PROMPT2_entailment
99,188,48,46,2,0.9583333333333334,80,43,37,0.5375,0.6887186629526463,GPT4,mimiciii,progress_note,PROMPT2_entailment
100,189,41,38,3,0.926829268292683,80,37,43,0.4625,0.6170726355058153,GPT4,mimiciii,progress_note,PROMPT2_entailment
101,19,29,28,1,0.9655172413793104,38,25,13,0.6578947368421053,0.7825600894354389,GPT4,mimiciii,progress_note,PROMPT2_entailment
102,190,29,26,3,0.896551724137931,80,38,42,0.475,0.6209930861093651,GPT4,mimiciii,progress_note,PROMPT2_entailment
103,191,21,19,2,0.9047619047619048,80,26,54,0.325,0.478218780251694,GPT4,mimiciii,progress_note,PROMPT2_entailment
104,192,33,28,5,0.8484848484848485,80,31,49,0.3875,0.5320257431811216,GPT4,mimiciii,progress_note,PROMPT2_entailment
105,193,81,76,5,0.9382716049382716,80,38,42,0.475,0.6307053941908713,GPT4,mimiciii,progress_note,PROMPT2_entailment
106,194,47,38,9,0.8085106382978723,80,42,38,0.525,0.6366174710809732,GPT4,mimiciii,progress_note,PROMPT2_entailment
107,195,28,27,1,0.9642857142857144,44,38,6,0.8636363636363636,0.911190053285968,GPT4,mimiciii,progress_note,PROMPT2_entailment
108,196,29,25,4,0.8620689655172413,42,23,19,0.5476190476190477,0.6697728596389051,GPT4,mimiciii,progress_note,PROMPT2_entailment
109,197,51,49,2,0.9607843137254902,80,63,17,0.7875,0.8655544651619235,GPT4,mimiciii,progress_note,PROMPT2_entailment
110,198,31,27,4,0.8709677419354839,34,30,4,0.8823529411764706,0.8766233766233765,GPT4,mimiciii,progress_note,PROMPT2_entailment
111,199,44,35,9,0.7954545454545454,52,29,23,0.5576923076923077,0.6556847545219638,GPT4,mimiciii,progress_note,PROMPT2_entailment
112,2,41,35,6,0.8536585365853658,80,31,49,0.3875,0.5330385654630312,GPT4,mimiciii,progress_note,PROMPT2_entailment
113,20,21,16,5,0.7619047619047619,33,26,7,0.7878787878787878,0.7746741154562383,GPT4,mimiciii,progress_note,PROMPT2_entailment
114,200,44,29,15,0.6590909090909091,80,31,49,0.3875,0.4880564603691639,GPT4,mimiciii,progress_note,PROMPT2_entailment
115,201,63,60,3,0.9523809523809524,80,38,42,0.475,0.6338615512927439,GPT4,mimiciii,progress_note,PROMPT2_entailment
116,202,49,40,9,0.8163265306122449,80,35,45,0.4375,0.5696846388606307,GPT4,mimiciii,progress_note,PROMPT2_entailment
117,203,67,58,9,0.8656716417910447,80,41,39,0.5125,0.6438337620143494,GPT4,mimiciii,progress_note,PROMPT2_entailment
118,204,75,60,15,0.8,80,43,37,0.5375,0.6429906542056075,GPT4,mimiciii,progress_note,PROMPT2_entailment
119,205,57,52,5,0.912280701754386,80,50,30,0.625,0.7417974322396577,GPT4,mimiciii,progress_note,PROMPT2_entailment
120,206,83,75,8,0.9036144578313252,80,49,31,0.6125,0.730108274560445,GPT4,mimiciii,progress_note,PROMPT2_entailment
121,207,60,55,5,0.9166666666666666,80,52,28,0.65,0.7606382978723404,GPT4,mimiciii,progress_note,PROMPT2_entailment
122,208,36,33,3,0.9166666666666666,80,43,37,0.5375,0.6776504297994269,GPT4,mimiciii,progress_note,PROMPT2_entailment
123,209,54,46,8,0.8518518518518519,80,41,39,0.5125,0.6399728537495758,GPT4,mimiciii,progress_note,PROMPT2_entailment
124,21,24,22,2,0.9166666666666666,80,38,42,0.475,0.625748502994012,GPT4,mimiciii,progress_note,PROMPT2_entailment
125,210,24,21,3,0.875,28,25,3,0.8928571428571429,0.8838383838383839,GPT4,mimiciii,progress_note,PROMPT2_entailment
126,211,38,32,6,0.8421052631578947,54,41,13,0.7592592592592593,0.7985392574558734,GPT4,mimiciii,progress_note,PROMPT2_entailment
127,212,18,18,0,1.0,14,11,3,0.7857142857142857,0.88,GPT4,mimiciii,progress_note,PROMPT2_entailment
128,213,37,33,4,0.8918918918918919,41,24,17,0.5853658536585366,0.7068273092369479,GPT4,mimiciii,progress_note,PROMPT2_entailment
129,214,21,18,3,0.8571428571428571,27,23,4,0.8518518518518519,0.8544891640866873,GPT4,mimiciii,progress_note,PROMPT2_entailment
130,215,44,24,20,0.5454545454545454,66,40,26,0.6060606060606061,0.5741626794258374,GPT4,mimiciii,progress_note,PROMPT2_entailment
131,216,43,29,14,0.6744186046511628,67,41,26,0.6119402985074627,0.6416621694549378,GPT4,mimiciii,progress_note,PROMPT2_entailment
132,217,50,36,14,0.72,73,49,24,0.6712328767123288,0.6947617172115006,GPT4,mimiciii,progress_note,PROMPT2_entailment
133,218,29,25,4,0.8620689655172413,27,23,4,0.8518518518518519,0.856929955290611,GPT4,mimiciii,progress_note,PROMPT2_entailment
134,219,21,19,2,0.9047619047619048,17,13,4,0.7647058823529411,0.8288590604026846,GPT4,mimiciii,progress_note,PROMPT2_entailment
135,22,18,14,4,0.7777777777777778,38,31,7,0.8157894736842105,0.7963302752293578,GPT4,mimiciii,progress_note,PROMPT2_entailment
136,220,44,32,12,0.7272727272727273,34,24,10,0.7058823529411765,0.7164179104477613,GPT4,mimiciii,progress_note,PROMPT2_entailment
137,221,50,46,4,0.92,80,37,43,0.4625,0.6155515370705245,GPT4,mimiciii,progress_note,PROMPT2_entailment
138,222,50,39,11,0.78,80,33,47,0.4125,0.539622641509434,GPT4,mimiciii,progress_note,PROMPT2_entailment
139,223,22,17,5,0.7727272727272727,30,21,9,0.7,0.7345679012345679,GPT4,mimiciii,progress_note,PROMPT2_entailment
140,224,20,17,3,0.85,33,27,6,0.8181818181818182,0.8337874659400545,GPT4,mimiciii,progress_note,PROMPT2_entailment
141,225,21,18,3,0.8571428571428571,37,28,9,0.7567567567567568,0.8038277511961723,GPT4,mimiciii,progress_note,PROMPT2_entailment
142,226,21,19,2,0.9047619047619048,33,22,11,0.6666666666666666,0.7676767676767676,GPT4,mimiciii,progress_note,PROMPT2_entailment
143,227,6,6,0,1.0,15,3,12,0.2,0.3333333333333333,GPT4,mimiciii,progress_note,PROMPT2_entailment
144,228,6,6,0,1.0,15,3,12,0.2,0.3333333333333333,GPT4,mimiciii,progress_note,PROMPT2_entailment
145,229,6,6,0,1.0,15,3,12,0.2,0.3333333333333333,GPT4,mimiciii,progress_note,PROMPT2_entailment
146,23,25,18,7,0.72,37,27,10,0.7297297297297297,0.7248322147651007,GPT4,mimiciii,progress_note,PROMPT2_entailment
147,230,23,17,6,0.7391304347826086,26,16,10,0.6153846153846154,0.671604938271605,GPT4,mimiciii,progress_note,PROMPT2_entailment
148,231,45,42,3,0.9333333333333332,79,48,31,0.6075949367088608,0.7360350492880614,GPT4,mimiciii,progress_note,PROMPT2_entailment
149,232,49,38,11,0.7755102040816326,72,56,16,0.7777777777777778,0.7766423357664234,GPT4,mimiciii,progress_note,PROMPT2_entailment
150,233,50,31,19,0.62,80,57,23,0.7125,0.6630393996247655,GPT4,mimiciii,progress_note,PROMPT2_entailment
151,234,27,23,4,0.8518518518518519,42,30,12,0.7142857142857143,0.7770270270270271,GPT4,mimiciii,progress_note,PROMPT2_entailment
152,24,20,15,5,0.75,22,11,11,0.5,0.6,GPT4,mimiciii,progress_note,PROMPT2_entailment
153,25,18,13,5,0.7222222222222222,22,11,11,0.5,0.5909090909090908,GPT4,mimiciii,progress_note,PROMPT2_entailment
154,26,17,14,3,0.8235294117647058,22,12,10,0.5454545454545454,0.65625,GPT4,mimiciii,progress_note,PROMPT2_entailment
155,27,22,12,10,0.5454545454545454,19,14,5,0.7368421052631579,0.626865671641791,GPT4,mimiciii,progress_note,PROMPT2_entailment
156,28,38,26,12,0.6842105263157895,50,32,18,0.64,0.6613672496025438,GPT4,mimiciii,progress_note,PROMPT2_entailment
157,29,30,29,1,0.9666666666666668,52,32,20,0.6153846153846154,0.7520259319286872,GPT4,mimiciii,progress_note,PROMPT2_entailment
158,3,43,34,9,0.7906976744186046,80,37,43,0.4625,0.5836232892600325,GPT4,mimiciii,progress_note,PROMPT2_entailment
159,30,22,19,3,0.8636363636363636,18,14,4,0.7777777777777778,0.8184615384615385,GPT4,mimiciii,progress_note,PROMPT2_entailment
160,31,20,17,3,0.85,17,13,4,0.7647058823529411,0.8051001821493623,GPT4,mimiciii,progress_note,PROMPT2_entailment
161,32,52,45,7,0.8653846153846154,77,49,28,0.6363636363636364,0.7334109429569268,GPT4,mimiciii,progress_note,PROMPT2_entailment
162,33,55,44,11,0.8,65,46,19,0.7076923076923077,0.7510204081632654,GPT4,mimiciii,progress_note,PROMPT2_entailment
163,34,46,33,13,0.717391304347826,71,45,26,0.6338028169014085,0.673011556764106,GPT4,mimiciii,progress_note,PROMPT2_entailment
164,35,14,11,3,0.7857142857142857,20,7,13,0.35,0.4842767295597484,GPT4,mimiciii,progress_note,PROMPT2_entailment
165,36,22,16,6,0.7272727272727273,40,26,14,0.65,0.6864686468646864,GPT4,mimiciii,progress_note,PROMPT2_entailment
166,37,92,80,12,0.8695652173913043,80,47,33,0.5875,0.7012308839985081,GPT4,mimiciii,progress_note,PROMPT2_entailment
167,38,43,32,11,0.7441860465116279,80,44,36,0.55,0.6325247079964061,GPT4,mimiciii,progress_note,PROMPT2_entailment
168,39,37,37,0,1.0,76,50,26,0.6578947368421053,0.7936507936507937,GPT4,mimiciii,progress_note,PROMPT2_entailment
169,4,48,36,12,0.75,80,36,44,0.45,0.5625000000000001,GPT4,mimiciii,progress_note,PROMPT2_entailment
170,40,38,36,2,0.9473684210526316,76,55,21,0.7236842105263158,0.8205553253211769,GPT4,mimiciii,progress_note,PROMPT2_entailment
171,41,50,37,13,0.74,78,58,20,0.7435897435897436,0.7417905288627722,GPT4,mimiciii,progress_note,PROMPT2_entailment
172,42,61,53,8,0.8688524590163934,78,61,17,0.782051282051282,0.8231699554423934,GPT4,mimiciii,progress_note,PROMPT2_entailment
173,43,48,29,19,0.6041666666666666,79,39,40,0.4936708860759494,0.5433581551765553,GPT4,mimiciii,progress_note,PROMPT2_entailment
174,44,43,38,5,0.8837209302325582,80,37,43,0.4625,0.6072122651695098,GPT4,mimiciii,progress_note,PROMPT2_entailment
175,45,49,42,7,0.8571428571428571,80,62,18,0.775,0.8140043763676149,GPT4,mimiciii,progress_note,PROMPT2_entailment
176,46,28,25,3,0.8928571428571429,36,28,8,0.7777777777777778,0.8313539192399051,GPT4,mimiciii,progress_note,PROMPT2_entailment
177,47,11,11,0,1.0,10,9,1,0.9,0.9473684210526316,GPT4,mimiciii,progress_note,PROMPT2_entailment
178,48,50,44,6,0.88,30,25,5,0.8333333333333334,0.8560311284046693,GPT4,mimiciii,progress_note,PROMPT2_entailment
179,49,57,51,6,0.8947368421052632,57,41,16,0.7192982456140351,0.7974828375286042,GPT4,mimiciii,progress_note,PROMPT2_entailment
180,5,58,53,5,0.913793103448276,80,55,25,0.6875,0.7846567967698521,GPT4,mimiciii,progress_note,PROMPT2_entailment
181,50,60,56,4,0.9333333333333332,80,50,30,0.625,0.7486631016042781,GPT4,mimiciii,progress_note,PROMPT2_entailment
182,51,65,49,16,0.7538461538461538,80,52,28,0.65,0.698082191780822,GPT4,mimiciii,progress_note,PROMPT2_entailment
183,52,46,34,12,0.7391304347826086,80,49,31,0.6125,0.6698833936469643,GPT4,mimiciii,progress_note,PROMPT2_entailment
184,53,42,38,4,0.9047619047619048,80,43,37,0.5375,0.6743706149401568,GPT4,mimiciii,progress_note,PROMPT2_entailment
185,54,39,26,13,0.6666666666666666,80,35,45,0.4375,0.5283018867924528,GPT4,mimiciii,progress_note,PROMPT2_entailment
186,55,50,38,12,0.76,80,46,34,0.575,0.6546816479400749,GPT4,mimiciii,progress_note,PROMPT2_entailment
187,56,12,11,1,0.9166666666666666,40,8,32,0.2,0.3283582089552239,GPT4,mimiciii,progress_note,PROMPT2_entailment
188,57,23,19,4,0.8260869565217391,28,24,4,0.8571428571428571,0.8413284132841329,GPT4,mimiciii,progress_note,PROMPT2_entailment
189,58,21,10,11,0.4761904761904761,25,16,9,0.64,0.546075085324232,GPT4,mimiciii,progress_note,PROMPT2_entailment
190,59,21,12,9,0.5714285714285714,25,17,8,0.68,0.6210045662100457,GPT4,mimiciii,progress_note,PROMPT2_entailment
191,6,45,39,6,0.8666666666666667,80,41,39,0.5125,0.6441087613293052,GPT4,mimiciii,progress_note,PROMPT2_entailment
192,60,55,47,8,0.8545454545454545,80,46,34,0.575,0.6874403815580286,GPT4,mimiciii,progress_note,PROMPT2_entailment
193,61,25,20,5,0.8,37,30,7,0.8108108108108109,0.8053691275167786,GPT4,mimiciii,progress_note,PROMPT2_entailment
194,62,25,22,3,0.88,37,29,8,0.7837837837837838,0.8291098115659519,GPT4,mimiciii,progress_note,PROMPT2_entailment
195,63,46,38,8,0.8260869565217391,80,58,22,0.725,0.7722494744218641,GPT4,mimiciii,progress_note,PROMPT2_entailment
196,64,1,0,1,0.0,1,0,1,0.0,,GPT4,mimiciii,progress_note,PROMPT2_entailment
197,65,16,16,0,1.0,8,8,0,1.0,1.0,GPT4,mimiciii,progress_note,PROMPT2_entailment
198,66,34,30,4,0.8823529411764706,48,36,12,0.75,0.8108108108108107,GPT4,mimiciii,progress_note,PROMPT2_entailment
199,67,24,19,5,0.7916666666666666,80,24,56,0.3,0.4351145038167939,GPT4,mimiciii,progress_note,PROMPT2_entailment
200,68,76,56,20,0.7368421052631579,80,44,36,0.55,0.6298568507157465,GPT4,mimiciii,progress_note,PROMPT2_entailment
201,69,55,48,7,0.8727272727272727,80,50,30,0.625,0.7283763277693475,GPT4,mimiciii,progress_note,PROMPT2_entailment
202,7,65,56,9,0.8615384615384616,80,44,36,0.55,0.6713896457765668,GPT4,mimiciii,progress_note,PROMPT2_entailment
203,70,45,38,7,0.8444444444444444,80,31,49,0.3875,0.531228861330327,GPT4,mimiciii,progress_note,PROMPT2_entailment
204,71,58,57,1,0.9827586206896552,80,34,46,0.425,0.5933864053888549,GPT4,mimiciii,progress_note,PROMPT2_entailment
205,72,10,10,0,1.0,15,11,4,0.7333333333333333,0.846153846153846,GPT4,mimiciii,progress_note,PROMPT2_entailment
206,73,57,45,12,0.7894736842105263,80,34,46,0.425,0.5525460455037919,GPT4,mimiciii,progress_note,PROMPT2_entailment
207,74,69,56,13,0.8115942028985508,80,50,30,0.625,0.7061790668348046,GPT4,mimiciii,progress_note,PROMPT2_entailment
208,75,39,37,2,0.9487179487179488,40,25,15,0.625,0.7535641547861507,GPT4,mimiciii,progress_note,PROMPT2_entailment
209,76,34,22,12,0.6470588235294118,58,42,16,0.7241379310344828,0.6834319526627219,GPT4,mimiciii,progress_note,PROMPT2_entailment
210,77,20,20,0,1.0,27,24,3,0.8888888888888888,0.9411764705882352,GPT4,mimiciii,progress_note,PROMPT2_entailment
211,78,19,17,2,0.8947368421052632,20,13,7,0.65,0.7529812606473595,GPT4,mimiciii,progress_note,PROMPT2_entailment
212,79,28,24,4,0.8571428571428571,43,29,14,0.6744186046511628,0.7548806941431669,GPT4,mimiciii,progress_note,PROMPT2_entailment
213,8,49,39,10,0.7959183673469388,78,58,20,0.7435897435897436,0.7688647178789939,GPT4,mimiciii,progress_note,PROMPT2_entailment
214,80,20,18,2,0.9,21,15,6,0.7142857142857143,0.7964601769911505,GPT4,mimiciii,progress_note,PROMPT2_entailment
215,81,35,26,9,0.7428571428571429,32,29,3,0.90625,0.8164591229020033,GPT4,mimiciii,progress_note,PROMPT2_entailment
216,82,18,16,2,0.8888888888888888,15,15,0,1.0,0.9411764705882352,GPT4,mimiciii,progress_note,PROMPT2_entailment
217,83,24,19,5,0.7916666666666666,43,30,13,0.6976744186046512,0.741704619388419,GPT4,mimiciii,progress_note,PROMPT2_entailment
218,84,20,17,3,0.85,35,23,12,0.6571428571428571,0.7412322274881518,GPT4,mimiciii,progress_note,PROMPT2_entailment
219,85,23,19,4,0.8260869565217391,50,36,14,0.72,0.7694038245219348,GPT4,mimiciii,progress_note,PROMPT2_entailment
220,86,56,53,3,0.9464285714285714,32,26,6,0.8125,0.8743654822335025,GPT4,mimiciii,progress_note,PROMPT2_entailment
221,87,6,4,2,0.6666666666666666,12,3,9,0.25,0.3636363636363636,GPT4,mimiciii,progress_note,PROMPT2_entailment
222,88,40,33,7,0.825,67,46,21,0.6865671641791045,0.7494445815847939,GPT4,mimiciii,progress_note,PROMPT2_entailment
223,89,38,34,4,0.8947368421052632,80,49,31,0.6125,0.7271933653426452,GPT4,mimiciii,progress_note,PROMPT2_entailment
224,9,25,23,2,0.92,42,29,13,0.6904761904761905,0.7888823181549379,GPT4,mimiciii,progress_note,PROMPT2_entailment
225,90,6,6,0,1.0,3,3,0,1.0,1.0,GPT4,mimiciii,progress_note,PROMPT2_entailment
226,91,44,37,7,0.8409090909090909,79,64,15,0.810126582278481,0.8252308764593135,GPT4,mimiciii,progress_note,PROMPT2_entailment
227,92,57,46,11,0.8070175438596491,80,32,48,0.4,0.5348837209302326,GPT4,mimiciii,progress_note,PROMPT2_entailment
228,93,17,14,3,0.8235294117647058,27,18,9,0.6666666666666666,0.7368421052631577,GPT4,mimiciii,progress_note,PROMPT2_entailment
229,94,52,43,9,0.8269230769230769,79,46,33,0.5822784810126582,0.6833650025911211,GPT4,mimiciii,progress_note,PROMPT2_entailment
230,95,26,15,11,0.5769230769230769,32,23,9,0.71875,0.6400742115027829,GPT4,mimiciii,progress_note,PROMPT2_entailment
231,96,6,6,0,1.0,11,3,8,0.2727272727272727,0.4285714285714285,GPT4,mimiciii,progress_note,PROMPT2_entailment
232,97,13,13,0,1.0,14,13,1,0.9285714285714286,0.962962962962963,GPT4,mimiciii,progress_note,PROMPT2_entailment
233,98,20,19,1,0.95,24,23,1,0.9583333333333334,0.9541484716157206,GPT4,mimiciii,progress_note,PROMPT2_entailment
234,99,30,24,6,0.8,70,34,36,0.4857142857142857,0.6044444444444443,GPT4,mimiciii,progress_note,PROMPT2_entailment
0,0,10,10,0,1.0,6,5,1,0.8333333333333334,0.9090909090909092,GPT4,medalign,nursing_note,PROMPT1_entailment
1,1,10,10,0,1.0,1,1,0,1.0,1.0,GPT4,medalign,nursing_note,PROMPT1_entailment
2,10,5,5,0,1.0,5,4,1,0.8,0.888888888888889,GPT4,medalign,nursing_note,PROMPT1_entailment
3,100,9,9,0,1.0,10,8,2,0.8,0.888888888888889,GPT4,medalign,nursing_note,PROMPT1_entailment
4,101,6,6,0,1.0,1,1,0,1.0,1.0,GPT4,medalign,nursing_note,PROMPT1_entailment
5,102,7,7,0,1.0,4,4,0,1.0,1.0,GPT4,medalign,nursing_note,PROMPT1_entailment
6,103,3,3,0,1.0,2,2,0,1.0,1.0,GPT4,medalign,nursing_note,PROMPT1_entailment
7,104,16,15,1,0.9375,15,13,2,0.8666666666666667,0.9006928406466512,GPT4,medalign,nursing_note,PROMPT1_entailment
8,105,3,3,0,1.0,1,1,0,1.0,1.0,GPT4,medalign,nursing_note,PROMPT1_entailment
9,106,3,3,0,1.0,1,1,0,1.0,1.0,GPT4,medalign,nursing_note,PROMPT1_entailment
10,107,7,7,0,1.0,4,3,1,0.75,0.8571428571428571,GPT4,medalign,nursing_note,PROMPT1_entailment
11,108,2,2,0,1.0,2,2,0,1.0,1.0,GPT4,medalign,nursing_note,PROMPT1_entailment
12,109,6,6,0,1.0,5,5,0,1.0,1.0,GPT4,medalign,nursing_note,PROMPT1_entailment
13,11,2,2,0,1.0,1,1,0,1.0,1.0,GPT4,medalign,nursing_note,PROMPT1_entailment
14,110,12,10,2,0.8333333333333334,6,4,2,0.6666666666666666,0.7407407407407408,GPT4,medalign,nursing_note,PROMPT1_entailment
15,111,2,2,0,1.0,1,1,0,1.0,1.0,GPT4,medalign,nursing_note,PROMPT1_entailment
16,112,6,6,0,1.0,2,2,0,1.0,1.0,GPT4,medalign,nursing_note,PROMPT1_entailment
17,113,3,1,2,0.3333333333333333,1,1,0,1.0,0.5,GPT4,medalign,nursing_note,PROMPT1_entailment
18,114,3,3,0,1.0,1,1,0,1.0,1.0,GPT4,medalign,nursing_note,PROMPT1_entailment
19,115,14,13,1,0.9285714285714286,7,5,2,0.7142857142857143,0.8074534161490684,GPT4,medalign,nursing_note,PROMPT1_entailment
20,116,9,9,0,1.0,5,4,1,0.8,0.888888888888889,GPT4,medalign,nursing_note,PROMPT1_entailment
21,117,15,14,1,0.9333333333333332,13,9,4,0.6923076923076923,0.7949526813880127,GPT4,medalign,nursing_note,PROMPT1_entailment
22,118,3,3,0,1.0,2,2,0,1.0,1.0,GPT4,medalign,nursing_note,PROMPT1_entailment
23,119,2,2,0,1.0,2,2,0,1.0,1.0,GPT4,medalign,nursing_note,PROMPT1_entailment
24,12,2,2,0,1.0,1,1,0,1.0,1.0,GPT4,medalign,nursing_note,PROMPT1_entailment
25,120,7,7,0,1.0,7,5,2,0.7142857142857143,0.8333333333333333,GPT4,medalign,nursing_note,PROMPT1_entailment
26,121,3,3,0,1.0,1,1,0,1.0,1.0,GPT4,medalign,nursing_note,PROMPT1_entailment
27,122,2,2,0,1.0,1,1,0,1.0,1.0,GPT4,medalign,nursing_note,PROMPT1_entailment
28,123,4,4,0,1.0,4,4,0,1.0,1.0,GPT4,medalign,nursing_note,PROMPT1_entailment
29,124,14,14,0,1.0,14,11,3,0.7857142857142857,0.88,GPT4,medalign,nursing_note,PROMPT1_entailment
30,125,9,9,0,1.0,9,9,0,1.0,1.0,GPT4,medalign,nursing_note,PROMPT1_entailment
31,126,4,3,1,0.75,2,1,1,0.5,0.6,GPT4,medalign,nursing_note,PROMPT1_entailment
32,127,1,1,0,1.0,1,1,0,1.0,1.0,GPT4,medalign,nursing_note,PROMPT1_entailment
33,128,4,4,0,1.0,2,2,0,1.0,1.0,GPT4,medalign,nursing_note,PROMPT1_entailment
34,129,22,21,1,0.9545454545454546,20,20,0,1.0,0.9767441860465116,GPT4,medalign,nursing_note,PROMPT1_entailment
35,13,6,6,0,1.0,5,5,0,1.0,1.0,GPT4,medalign,nursing_note,PROMPT1_entailment
36,130,5,4,1,0.8,2,2,0,1.0,0.888888888888889,GPT4,medalign,nursing_note,PROMPT1_entailment
37,131,3,3,0,1.0,1,1,0,1.0,1.0,GPT4,medalign,nursing_note,PROMPT1_entailment
38,132,5,5,0,1.0,2,2,0,1.0,1.0,GPT4,medalign,nursing_note,PROMPT1_entailment
39,133,15,12,3,0.8,14,9,5,0.6428571428571429,0.7128712871287128,GPT4,medalign,nursing_note,PROMPT1_entailment
40,134,5,5,0,1.0,3,3,0,1.0,1.0,GPT4,medalign,nursing_note,PROMPT1_entailment
41,135,5,4,1,0.8,2,2,0,1.0,0.888888888888889,GPT4,medalign,nursing_note,PROMPT1_entailment
42,136,24,22,2,0.9166666666666666,51,23,28,0.4509803921568627,0.6045400238948626,GPT4,medalign,nursing_note,PROMPT1_entailment
43,137,7,7,0,1.0,6,6,0,1.0,1.0,GPT4,medalign,nursing_note,PROMPT1_entailment
44,138,2,2,0,1.0,1,1,0,1.0,1.0,GPT4,medalign,nursing_note,PROMPT1_entailment
45,139,5,5,0,1.0,1,1,0,1.0,1.0,GPT4,medalign,nursing_note,PROMPT1_entailment
46,14,2,2,0,1.0,1,1,0,1.0,1.0,GPT4,medalign,nursing_note,PROMPT1_entailment
47,140,4,4,0,1.0,3,3,0,1.0,1.0,GPT4,medalign,nursing_note,PROMPT1_entailment
48,141,3,3,0,1.0,1,1,0,1.0,1.0,GPT4,medalign,nursing_note,PROMPT1_entailment
49,142,2,2,0,1.0,1,1,0,1.0,1.0,GPT4,medalign,nursing_note,PROMPT1_entailment
50,143,2,2,0,1.0,1,1,0,1.0,1.0,GPT4,medalign,nursing_note,PROMPT1_entailment
51,144,4,2,2,0.5,1,1,0,1.0,0.6666666666666666,GPT4,medalign,nursing_note,PROMPT1_entailment
52,145,4,4,0,1.0,4,4,0,1.0,1.0,GPT4,medalign,nursing_note,PROMPT1_entailment
53,146,7,5,2,0.7142857142857143,3,2,1,0.6666666666666666,0.689655172413793,GPT4,medalign,nursing_note,PROMPT1_entailment
54,147,8,8,0,1.0,6,3,3,0.5,0.6666666666666666,GPT4,medalign,nursing_note,PROMPT1_entailment
55,148,10,10,0,1.0,7,7,0,1.0,1.0,GPT4,medalign,nursing_note,PROMPT1_entailment
56,149,3,3,0,1.0,1,0,1,0.0,0.0,GPT4,medalign,nursing_note,PROMPT1_entailment
57,15,2,2,0,1.0,1,0,1,0.0,0.0,GPT4,medalign,nursing_note,PROMPT1_entailment
58,150,4,4,0,1.0,1,1,0,1.0,1.0,GPT4,medalign,nursing_note,PROMPT1_entailment
59,151,12,12,0,1.0,8,8,0,1.0,1.0,GPT4,medalign,nursing_note,PROMPT1_entailment
60,152,5,5,0,1.0,4,4,0,1.0,1.0,GPT4,medalign,nursing_note,PROMPT1_entailment
61,153,14,13,1,0.9285714285714286,14,9,5,0.6428571428571429,0.7597402597402597,GPT4,medalign,nursing_note,PROMPT1_entailment
62,154,2,2,0,1.0,1,1,0,1.0,1.0,GPT4,medalign,nursing_note,PROMPT1_entailment
63,155,15,14,1,0.9333333333333332,14,11,3,0.7857142857142857,0.8531855955678669,GPT4,medalign,nursing_note,PROMPT1_entailment
64,156,10,9,1,0.9,1,1,0,1.0,0.9473684210526316,GPT4,medalign,nursing_note,PROMPT1_entailment
65,157,5,5,0,1.0,3,3,0,1.0,1.0,GPT4,medalign,nursing_note,PROMPT1_entailment
66,158,6,6,0,1.0,1,1,0,1.0,1.0,GPT4,medalign,nursing_note,PROMPT1_entailment
67,159,6,6,0,1.0,3,3,0,1.0,1.0,GPT4,medalign,nursing_note,PROMPT1_entailment
68,16,5,5,0,1.0,3,2,1,0.6666666666666666,0.8,GPT4,medalign,nursing_note,PROMPT1_entailment
69,160,3,3,0,1.0,1,1,0,1.0,1.0,GPT4,medalign,nursing_note,PROMPT1_entailment
70,161,5,4,1,0.8,1,1,0,1.0,0.888888888888889,GPT4,medalign,nursing_note,PROMPT1_entailment
71,162,12,10,2,0.8333333333333334,8,5,3,0.625,0.7142857142857143,GPT4,medalign,nursing_note,PROMPT1_entailment
72,163,4,4,0,1.0,3,2,1,0.6666666666666666,0.8,GPT4,medalign,nursing_note,PROMPT1_entailment
73,164,5,5,0,1.0,2,2,0,1.0,1.0,GPT4,medalign,nursing_note,PROMPT1_entailment
74,165,6,6,0,1.0,4,3,1,0.75,0.8571428571428571,GPT4,medalign,nursing_note,PROMPT1_entailment
75,166,9,8,1,0.8888888888888888,5,5,0,1.0,0.9411764705882352,GPT4,medalign,nursing_note,PROMPT1_entailment
76,167,10,10,0,1.0,2,1,1,0.5,0.6666666666666666,GPT4,medalign,nursing_note,PROMPT1_entailment
77,168,3,3,0,1.0,3,3,0,1.0,1.0,GPT4,medalign,nursing_note,PROMPT1_entailment
78,169,12,11,1,0.9166666666666666,9,8,1,0.8888888888888888,0.9025641025641026,GPT4,medalign,nursing_note,PROMPT1_entailment
79,17,4,3,1,0.75,1,0,1,0.0,0.0,GPT4,medalign,nursing_note,PROMPT1_entailment
80,170,4,4,0,1.0,1,1,0,1.0,1.0,GPT4,medalign,nursing_note,PROMPT1_entailment
81,171,10,9,1,0.9,7,4,3,0.5714285714285714,0.6990291262135921,GPT4,medalign,nursing_note,PROMPT1_entailment
82,172,16,15,1,0.9375,12,8,4,0.6666666666666666,0.7792207792207793,GPT4,medalign,nursing_note,PROMPT1_entailment
83,173,9,9,0,1.0,1,1,0,1.0,1.0,GPT4,medalign,nursing_note,PROMPT1_entailment
84,174,3,3,0,1.0,1,1,0,1.0,1.0,GPT4,medalign,nursing_note,PROMPT1_entailment
85,175,2,2,0,1.0,2,2,0,1.0,1.0,GPT4,medalign,nursing_note,PROMPT1_entailment
86,176,10,7,3,0.7,3,2,1,0.6666666666666666,0.6829268292682926,GPT4,medalign,nursing_note,PROMPT1_entailment
87,177,9,8,1,0.8888888888888888,8,7,1,0.875,0.8818897637795274,GPT4,medalign,nursing_note,PROMPT1_entailment
88,178,10,10,0,1.0,10,10,0,1.0,1.0,GPT4,medalign,nursing_note,PROMPT1_entailment
89,179,8,7,1,0.875,2,2,0,1.0,0.9333333333333332,GPT4,medalign,nursing_note,PROMPT1_entailment
90,18,9,8,1,0.8888888888888888,3,3,0,1.0,0.9411764705882352,GPT4,medalign,nursing_note,PROMPT1_entailment
91,180,8,8,0,1.0,4,3,1,0.75,0.8571428571428571,GPT4,medalign,nursing_note,PROMPT1_entailment
92,181,7,7,0,1.0,7,7,0,1.0,1.0,GPT4,medalign,nursing_note,PROMPT1_entailment
93,182,3,3,0,1.0,2,1,1,0.5,0.6666666666666666,GPT4,medalign,nursing_note,PROMPT1_entailment
94,183,7,7,0,1.0,6,6,0,1.0,1.0,GPT4,medalign,nursing_note,PROMPT1_entailment
95,184,11,9,2,0.8181818181818182,11,10,1,0.9090909090909092,0.861244019138756,GPT4,medalign,nursing_note,PROMPT1_entailment
96,185,4,4,0,1.0,3,3,0,1.0,1.0,GPT4,medalign,nursing_note,PROMPT1_entailment
97,186,4,4,0,1.0,3,3,0,1.0,1.0,GPT4,medalign,nursing_note,PROMPT1_entailment
98,187,2,1,1,0.5,1,1,0,1.0,0.6666666666666666,GPT4,medalign,nursing_note,PROMPT1_entailment
99,188,2,2,0,1.0,3,2,1,0.6666666666666666,0.8,GPT4,medalign,nursing_note,PROMPT1_entailment
100,189,17,16,1,0.9411764705882352,10,9,1,0.9,0.9201277955271564,GPT4,medalign,nursing_note,PROMPT1_entailment
101,19,9,9,0,1.0,7,7,0,1.0,1.0,GPT4,medalign,nursing_note,PROMPT1_entailment
102,190,4,4,0,1.0,2,2,0,1.0,1.0,GPT4,medalign,nursing_note,PROMPT1_entailment
103,191,14,14,0,1.0,5,3,2,0.6,0.7499999999999999,GPT4,medalign,nursing_note,PROMPT1_entailment
104,192,3,3,0,1.0,1,1,0,1.0,1.0,GPT4,medalign,nursing_note,PROMPT1_entailment
105,193,6,6,0,1.0,3,3,0,1.0,1.0,GPT4,medalign,nursing_note,PROMPT1_entailment
106,194,3,3,0,1.0,2,1,1,0.5,0.6666666666666666,GPT4,medalign,nursing_note,PROMPT1_entailment
107,195,11,9,2,0.8181818181818182,10,9,1,0.9,0.8571428571428572,GPT4,medalign,nursing_note,PROMPT1_entailment
108,196,5,5,0,1.0,1,1,0,1.0,1.0,GPT4,medalign,nursing_note,PROMPT1_entailment
109,197,4,4,0,1.0,1,1,0,1.0,1.0,GPT4,medalign,nursing_note,PROMPT1_entailment
110,198,23,22,1,0.9565217391304348,8,8,0,1.0,0.9777777777777776,GPT4,medalign,nursing_note,PROMPT1_entailment
111,199,10,8,2,0.8,7,7,0,1.0,0.888888888888889,GPT4,medalign,nursing_note,PROMPT1_entailment
112,2,14,10,4,0.7142857142857143,5,4,1,0.8,0.7547169811320756,GPT4,medalign,nursing_note,PROMPT1_entailment
113,20,11,7,4,0.6363636363636364,2,2,0,1.0,0.7777777777777778,GPT4,medalign,nursing_note,PROMPT1_entailment
114,200,3,3,0,1.0,3,3,0,1.0,1.0,GPT4,medalign,nursing_note,PROMPT1_entailment
115,201,4,4,0,1.0,1,1,0,1.0,1.0,GPT4,medalign,nursing_note,PROMPT1_entailment
116,202,4,4,0,1.0,1,0,1,0.0,0.0,GPT4,medalign,nursing_note,PROMPT1_entailment
117,203,4,4,0,1.0,1,1,0,1.0,1.0,GPT4,medalign,nursing_note,PROMPT1_entailment
118,204,14,12,2,0.8571428571428571,9,9,0,1.0,0.923076923076923,GPT4,medalign,nursing_note,PROMPT1_entailment
119,205,16,12,4,0.75,8,4,4,0.5,0.6,GPT4,medalign,nursing_note,PROMPT1_entailment
120,206,5,5,0,1.0,4,4,0,1.0,1.0,GPT4,medalign,nursing_note,PROMPT1_entailment
121,207,8,8,0,1.0,6,5,1,0.8333333333333334,0.9090909090909092,GPT4,medalign,nursing_note,PROMPT1_entailment
122,208,13,10,3,0.7692307692307693,10,7,3,0.7,0.7329842931937172,GPT4,medalign,nursing_note,PROMPT1_entailment
123,209,5,5,0,1.0,1,1,0,1.0,1.0,GPT4,medalign,nursing_note,PROMPT1_entailment
124,21,5,5,0,1.0,1,1,0,1.0,1.0,GPT4,medalign,nursing_note,PROMPT1_entailment
125,210,5,4,1,0.8,2,1,1,0.5,0.6153846153846154,GPT4,medalign,nursing_note,PROMPT1_entailment
126,211,3,3,0,1.0,2,2,0,1.0,1.0,GPT4,medalign,nursing_note,PROMPT1_entailment
127,212,6,6,0,1.0,3,3,0,1.0,1.0,GPT4,medalign,nursing_note,PROMPT1_entailment
128,213,10,10,0,1.0,8,8,0,1.0,1.0,GPT4,medalign,nursing_note,PROMPT1_entailment
129,214,2,2,0,1.0,2,2,0,1.0,1.0,GPT4,medalign,nursing_note,PROMPT1_entailment
130,215,2,2,0,1.0,1,1,0,1.0,1.0,GPT4,medalign,nursing_note,PROMPT1_entailment
131,216,5,5,0,1.0,3,3,0,1.0,1.0,GPT4,medalign,nursing_note,PROMPT1_entailment
132,217,13,11,2,0.8461538461538461,11,3,8,0.2727272727272727,0.4125,GPT4,medalign,nursing_note,PROMPT1_entailment
133,218,12,12,0,1.0,3,3,0,1.0,1.0,GPT4,medalign,nursing_note,PROMPT1_entailment
134,219,5,5,0,1.0,2,2,0,1.0,1.0,GPT4,medalign,nursing_note,PROMPT1_entailment
135,22,2,2,0,1.0,1,1,0,1.0,1.0,GPT4,medalign,nursing_note,PROMPT1_entailment
136,220,9,9,0,1.0,7,6,1,0.8571428571428571,0.923076923076923,GPT4,medalign,nursing_note,PROMPT1_entailment
137,221,12,11,1,0.9166666666666666,23,9,14,0.391304347826087,0.5484764542936288,GPT4,medalign,nursing_note,PROMPT1_entailment
138,222,5,5,0,1.0,4,4,0,1.0,1.0,GPT4,medalign,nursing_note,PROMPT1_entailment
139,223,7,7,0,1.0,2,2,0,1.0,1.0,GPT4,medalign,nursing_note,PROMPT1_entailment
140,224,10,9,1,0.9,4,2,2,0.5,0.6428571428571429,GPT4,medalign,nursing_note,PROMPT1_entailment
141,225,4,4,0,1.0,2,2,0,1.0,1.0,GPT4,medalign,nursing_note,PROMPT1_entailment
142,226,12,10,2,0.8333333333333334,5,3,2,0.6,0.6976744186046512,GPT4,medalign,nursing_note,PROMPT1_entailment
143,227,3,2,1,0.6666666666666666,1,1,0,1.0,0.8,GPT4,medalign,nursing_note,PROMPT1_entailment
144,228,16,10,6,0.625,18,15,3,0.8333333333333334,0.7142857142857143,GPT4,medalign,nursing_note,PROMPT1_entailment
145,229,11,10,1,0.9090909090909092,7,7,0,1.0,0.9523809523809524,GPT4,medalign,nursing_note,PROMPT1_entailment
146,23,15,11,4,0.7333333333333333,21,12,9,0.5714285714285714,0.6423357664233577,GPT4,medalign,nursing_note,PROMPT1_entailment
147,230,2,2,0,1.0,1,1,0,1.0,1.0,GPT4,medalign,nursing_note,PROMPT1_entailment
148,231,15,14,1,0.9333333333333332,13,10,3,0.7692307692307693,0.8433734939759036,GPT4,medalign,nursing_note,PROMPT1_entailment
149,232,9,9,0,1.0,6,3,3,0.5,0.6666666666666666,GPT4,medalign,nursing_note,PROMPT1_entailment
150,233,4,3,1,0.75,4,3,1,0.75,0.75,GPT4,medalign,nursing_note,PROMPT1_entailment
151,234,5,5,0,1.0,2,2,0,1.0,1.0,GPT4,medalign,nursing_note,PROMPT1_entailment
152,235,3,3,0,1.0,1,1,0,1.0,1.0,GPT4,medalign,nursing_note,PROMPT1_entailment
153,236,14,14,0,1.0,14,10,4,0.7142857142857143,0.8333333333333333,GPT4,medalign,nursing_note,PROMPT1_entailment
154,237,9,7,2,0.7777777777777778,5,5,0,1.0,0.8750000000000001,GPT4,medalign,nursing_note,PROMPT1_entailment
155,238,9,9,0,1.0,4,4,0,1.0,1.0,GPT4,medalign,nursing_note,PROMPT1_entailment
156,239,8,7,1,0.875,4,4,0,1.0,0.9333333333333332,GPT4,medalign,nursing_note,PROMPT1_entailment
157,24,3,2,1,0.6666666666666666,1,1,0,1.0,0.8,GPT4,medalign,nursing_note,PROMPT1_entailment
158,240,3,3,0,1.0,2,2,0,1.0,1.0,GPT4,medalign,nursing_note,PROMPT1_entailment
159,241,4,4,0,1.0,2,2,0,1.0,1.0,GPT4,medalign,nursing_note,PROMPT1_entailment
160,242,13,11,2,0.8461538461538461,2,1,1,0.5,0.6285714285714286,GPT4,medalign,nursing_note,PROMPT1_entailment
161,243,14,14,0,1.0,10,9,1,0.9,0.9473684210526316,GPT4,medalign,nursing_note,PROMPT1_entailment
162,244,3,3,0,1.0,1,1,0,1.0,1.0,GPT4,medalign,nursing_note,PROMPT1_entailment
163,245,3,3,0,1.0,1,1,0,1.0,1.0,GPT4,medalign,nursing_note,PROMPT1_entailment
164,246,3,3,0,1.0,1,1,0,1.0,1.0,GPT4,medalign,nursing_note,PROMPT1_entailment
165,247,7,7,0,1.0,5,5,0,1.0,1.0,GPT4,medalign,nursing_note,PROMPT1_entailment
166,248,1,1,0,1.0,1,1,0,1.0,1.0,GPT4,medalign,nursing_note,PROMPT1_entailment
167,249,5,5,0,1.0,2,2,0,1.0,1.0,GPT4,medalign,nursing_note,PROMPT1_entailment
168,25,49,43,6,0.8775510204081632,33,21,12,0.6363636363636364,0.7377450980392156,GPT4,medalign,nursing_note,PROMPT1_entailment
169,26,5,5,0,1.0,1,1,0,1.0,1.0,GPT4,medalign,nursing_note,PROMPT1_entailment
170,27,7,6,1,0.8571428571428571,2,2,0,1.0,0.923076923076923,GPT4,medalign,nursing_note,PROMPT1_entailment
171,28,9,8,1,0.8888888888888888,4,4,0,1.0,0.9411764705882352,GPT4,medalign,nursing_note,PROMPT1_entailment
172,29,7,7,0,1.0,3,3,0,1.0,1.0,GPT4,medalign,nursing_note,PROMPT1_entailment
173,3,4,4,0,1.0,2,2,0,1.0,1.0,GPT4,medalign,nursing_note,PROMPT1_entailment
174,30,4,4,0,1.0,1,1,0,1.0,1.0,GPT4,medalign,nursing_note,PROMPT1_entailment
175,31,4,2,2,0.5,1,0,1,0.0,0.0,GPT4,medalign,nursing_note,PROMPT1_entailment
176,32,4,4,0,1.0,2,2,0,1.0,1.0,GPT4,medalign,nursing_note,PROMPT1_entailment
177,33,9,9,0,1.0,5,5,0,1.0,1.0,GPT4,medalign,nursing_note,PROMPT1_entailment
178,34,10,10,0,1.0,4,1,3,0.25,0.4,GPT4,medalign,nursing_note,PROMPT1_entailment
179,35,7,7,0,1.0,4,3,1,0.75,0.8571428571428571,GPT4,medalign,nursing_note,PROMPT1_entailment
180,36,14,10,4,0.7142857142857143,5,3,2,0.6,0.6521739130434783,GPT4,medalign,nursing_note,PROMPT1_entailment
181,37,5,5,0,1.0,3,3,0,1.0,1.0,GPT4,medalign,nursing_note,PROMPT1_entailment
182,38,12,9,3,0.75,5,3,2,0.6,0.6666666666666665,GPT4,medalign,nursing_note,PROMPT1_entailment
183,39,3,3,0,1.0,1,1,0,1.0,1.0,GPT4,medalign,nursing_note,PROMPT1_entailment
184,4,4,3,1,0.75,3,3,0,1.0,0.8571428571428571,GPT4,medalign,nursing_note,PROMPT1_entailment
185,40,10,10,0,1.0,8,8,0,1.0,1.0,GPT4,medalign,nursing_note,PROMPT1_entailment
186,41,2,2,0,1.0,1,1,0,1.0,1.0,GPT4,medalign,nursing_note,PROMPT1_entailment
187,42,9,7,2,0.7777777777777778,8,8,0,1.0,0.8750000000000001,GPT4,medalign,nursing_note,PROMPT1_entailment
188,43,4,3,1,0.75,2,2,0,1.0,0.8571428571428571,GPT4,medalign,nursing_note,PROMPT1_entailment
189,44,4,4,0,1.0,1,1,0,1.0,1.0,GPT4,medalign,nursing_note,PROMPT1_entailment
190,45,1,1,0,1.0,1,1,0,1.0,1.0,GPT4,medalign,nursing_note,PROMPT1_entailment
191,46,6,6,0,1.0,5,5,0,1.0,1.0,GPT4,medalign,nursing_note,PROMPT1_entailment
192,47,20,20,0,1.0,20,20,0,1.0,1.0,GPT4,medalign,nursing_note,PROMPT1_entailment
193,48,4,4,0,1.0,2,2,0,1.0,1.0,GPT4,medalign,nursing_note,PROMPT1_entailment
194,49,7,6,1,0.8571428571428571,2,2,0,1.0,0.923076923076923,GPT4,medalign,nursing_note,PROMPT1_entailment
195,5,16,16,0,1.0,5,5,0,1.0,1.0,GPT4,medalign,nursing_note,PROMPT1_entailment
196,50,4,3,1,0.75,1,1,0,1.0,0.8571428571428571,GPT4,medalign,nursing_note,PROMPT1_entailment
197,51,4,4,0,1.0,2,2,0,1.0,1.0,GPT4,medalign,nursing_note,PROMPT1_entailment
198,52,5,5,0,1.0,4,4,0,1.0,1.0,GPT4,medalign,nursing_note,PROMPT1_entailment
199,53,3,3,0,1.0,1,1,0,1.0,1.0,GPT4,medalign,nursing_note,PROMPT1_entailment
200,54,12,10,2,0.8333333333333334,7,5,2,0.7142857142857143,0.7692307692307692,GPT4,medalign,nursing_note,PROMPT1_entailment
201,55,5,5,0,1.0,2,1,1,0.5,0.6666666666666666,GPT4,medalign,nursing_note,PROMPT1_entailment
202,56,7,7,0,1.0,3,2,1,0.6666666666666666,0.8,GPT4,medalign,nursing_note,PROMPT1_entailment
203,57,10,7,3,0.7,4,3,1,0.75,0.7241379310344827,GPT4,medalign,nursing_note,PROMPT1_entailment
204,58,3,3,0,1.0,1,1,0,1.0,1.0,GPT4,medalign,nursing_note,PROMPT1_entailment
205,59,2,2,0,1.0,1,1,0,1.0,1.0,GPT4,medalign,nursing_note,PROMPT1_entailment
206,6,5,5,0,1.0,3,3,0,1.0,1.0,GPT4,medalign,nursing_note,PROMPT1_entailment
207,60,10,9,1,0.9,9,8,1,0.8888888888888888,0.8944099378881988,GPT4,medalign,nursing_note,PROMPT1_entailment
208,61,3,3,0,1.0,1,1,0,1.0,1.0,GPT4,medalign,nursing_note,PROMPT1_entailment
209,62,12,11,1,0.9166666666666666,5,5,0,1.0,0.9565217391304348,GPT4,medalign,nursing_note,PROMPT1_entailment
210,63,8,7,1,0.875,7,6,1,0.8571428571428571,0.8659793814432989,GPT4,medalign,nursing_note,PROMPT1_entailment
211,64,2,2,0,1.0,1,1,0,1.0,1.0,GPT4,medalign,nursing_note,PROMPT1_entailment
212,65,5,5,0,1.0,2,2,0,1.0,1.0,GPT4,medalign,nursing_note,PROMPT1_entailment
213,66,5,5,0,1.0,4,4,0,1.0,1.0,GPT4,medalign,nursing_note,PROMPT1_entailment
214,67,5,5,0,1.0,4,4,0,1.0,1.0,GPT4,medalign,nursing_note,PROMPT1_entailment
215,68,4,2,2,0.5,1,1,0,1.0,0.6666666666666666,GPT4,medalign,nursing_note,PROMPT1_entailment
216,69,6,6,0,1.0,2,2,0,1.0,1.0,GPT4,medalign,nursing_note,PROMPT1_entailment
217,7,3,3,0,1.0,1,0,1,0.0,0.0,GPT4,medalign,nursing_note,PROMPT1_entailment
218,70,8,8,0,1.0,1,0,1,0.0,0.0,GPT4,medalign,nursing_note,PROMPT1_entailment
219,71,12,10,2,0.8333333333333334,1,1,0,1.0,0.9090909090909092,GPT4,medalign,nursing_note,PROMPT1_entailment
220,72,2,2,0,1.0,1,1,0,1.0,1.0,GPT4,medalign,nursing_note,PROMPT1_entailment
221,73,4,4,0,1.0,2,2,0,1.0,1.0,GPT4,medalign,nursing_note,PROMPT1_entailment
222,74,11,6,5,0.5454545454545454,5,4,1,0.8,0.6486486486486486,GPT4,medalign,nursing_note,PROMPT1_entailment
223,75,3,1,2,0.3333333333333333,1,1,0,1.0,0.5,GPT4,medalign,nursing_note,PROMPT1_entailment
224,76,10,10,0,1.0,5,5,0,1.0,1.0,GPT4,medalign,nursing_note,PROMPT1_entailment
225,77,6,6,0,1.0,3,3,0,1.0,1.0,GPT4,medalign,nursing_note,PROMPT1_entailment
226,78,5,5,0,1.0,3,1,2,0.3333333333333333,0.5,GPT4,medalign,nursing_note,PROMPT1_entailment
227,79,8,7,1,0.875,8,7,1,0.875,0.875,GPT4,medalign,nursing_note,PROMPT1_entailment
228,8,8,8,0,1.0,8,5,3,0.625,0.7692307692307693,GPT4,medalign,nursing_note,PROMPT1_entailment
229,80,11,9,2,0.8181818181818182,10,8,2,0.8,0.8089887640449439,GPT4,medalign,nursing_note,PROMPT1_entailment
230,81,3,1,2,0.3333333333333333,1,1,0,1.0,0.5,GPT4,medalign,nursing_note,PROMPT1_entailment
231,82,3,3,0,1.0,3,3,0,1.0,1.0,GPT4,medalign,nursing_note,PROMPT1_entailment
232,83,6,6,0,1.0,3,2,1,0.6666666666666666,0.8,GPT4,medalign,nursing_note,PROMPT1_entailment
233,84,9,8,1,0.8888888888888888,2,2,0,1.0,0.9411764705882352,GPT4,medalign,nursing_note,PROMPT1_entailment
234,85,12,11,1,0.9166666666666666,8,7,1,0.875,0.8953488372093024,GPT4,medalign,nursing_note,PROMPT1_entailment
235,86,3,3,0,1.0,3,3,0,1.0,1.0,GPT4,medalign,nursing_note,PROMPT1_entailment
236,87,4,4,0,1.0,2,2,0,1.0,1.0,GPT4,medalign,nursing_note,PROMPT1_entailment
237,88,10,9,1,0.9,7,6,1,0.8571428571428571,0.8780487804878048,GPT4,medalign,nursing_note,PROMPT1_entailment
238,89,8,8,0,1.0,6,6,0,1.0,1.0,GPT4,medalign,nursing_note,PROMPT1_entailment
239,9,5,3,2,0.6,2,2,0,1.0,0.7499999999999999,GPT4,medalign,nursing_note,PROMPT1_entailment
240,90,5,5,0,1.0,1,1,0,1.0,1.0,GPT4,medalign,nursing_note,PROMPT1_entailment
241,91,3,3,0,1.0,1,1,0,1.0,1.0,GPT4,medalign,nursing_note,PROMPT1_entailment
242,92,6,6,0,1.0,4,2,2,0.5,0.6666666666666666,GPT4,medalign,nursing_note,PROMPT1_entailment
243,93,4,3,1,0.75,1,1,0,1.0,0.8571428571428571,GPT4,medalign,nursing_note,PROMPT1_entailment
244,94,3,2,1,0.6666666666666666,2,1,1,0.5,0.5714285714285715,GPT4,medalign,nursing_note,PROMPT1_entailment
245,95,2,2,0,1.0,1,1,0,1.0,1.0,GPT4,medalign,nursing_note,PROMPT1_entailment
246,96,3,3,0,1.0,1,1,0,1.0,1.0,GPT4,medalign,nursing_note,PROMPT1_entailment
247,97,6,6,0,1.0,2,2,0,1.0,1.0,GPT4,medalign,nursing_note,PROMPT1_entailment
248,98,9,9,0,1.0,5,5,0,1.0,1.0,GPT4,medalign,nursing_note,PROMPT1_entailment
249,99,14,13,1,0.9285714285714286,7,5,2,0.7142857142857143,0.8074534161490684,GPT4,medalign,nursing_note,PROMPT1_entailment
0,0,12,12,0,1.0,6,5,1,0.8333333333333334,0.9090909090909092,GPT4,medalign,nursing_note,PROMPT1_ICL_entailment
1,1,10,10,0,1.0,1,1,0,1.0,1.0,GPT4,medalign,nursing_note,PROMPT1_ICL_entailment
2,10,9,9,0,1.0,5,4,1,0.8,0.888888888888889,GPT4,medalign,nursing_note,PROMPT1_ICL_entailment
3,100,12,10,2,0.8333333333333334,10,10,0,1.0,0.9090909090909092,GPT4,medalign,nursing_note,PROMPT1_ICL_entailment
4,101,7,7,0,1.0,1,1,0,1.0,1.0,GPT4,medalign,nursing_note,PROMPT1_ICL_entailment
5,102,9,9,0,1.0,4,3,1,0.75,0.8571428571428571,GPT4,medalign,nursing_note,PROMPT1_ICL_entailment
6,103,3,3,0,1.0,2,2,0,1.0,1.0,GPT4,medalign,nursing_note,PROMPT1_ICL_entailment
7,104,19,18,1,0.9473684210526316,15,14,1,0.9333333333333332,0.9402985074626864,GPT4,medalign,nursing_note,PROMPT1_ICL_entailment
8,105,3,3,0,1.0,1,1,0,1.0,1.0,GPT4,medalign,nursing_note,PROMPT1_ICL_entailment
9,106,6,4,2,0.6666666666666666,1,1,0,1.0,0.8,GPT4,medalign,nursing_note,PROMPT1_ICL_entailment
10,107,9,9,0,1.0,4,4,0,1.0,1.0,GPT4,medalign,nursing_note,PROMPT1_ICL_entailment
11,108,2,2,0,1.0,2,2,0,1.0,1.0,GPT4,medalign,nursing_note,PROMPT1_ICL_entailment
12,109,9,9,0,1.0,5,5,0,1.0,1.0,GPT4,medalign,nursing_note,PROMPT1_ICL_entailment
13,11,3,2,1,0.6666666666666666,1,1,0,1.0,0.8,GPT4,medalign,nursing_note,PROMPT1_ICL_entailment
14,110,14,12,2,0.8571428571428571,6,3,3,0.5,0.631578947368421,GPT4,medalign,nursing_note,PROMPT1_ICL_entailment
15,111,2,2,0,1.0,1,1,0,1.0,1.0,GPT4,medalign,nursing_note,PROMPT1_ICL_entailment
16,112,8,8,0,1.0,2,2,0,1.0,1.0,GPT4,medalign,nursing_note,PROMPT1_ICL_entailment
17,113,3,1,2,0.3333333333333333,1,1,0,1.0,0.5,GPT4,medalign,nursing_note,PROMPT1_ICL_entailment
18,114,4,2,2,0.5,1,1,0,1.0,0.6666666666666666,GPT4,medalign,nursing_note,PROMPT1_ICL_entailment
19,115,15,14,1,0.9333333333333332,7,5,2,0.7142857142857143,0.809248554913295,GPT4,medalign,nursing_note,PROMPT1_ICL_entailment
20,116,10,8,2,0.8,5,4,1,0.8,0.8000000000000002,GPT4,medalign,nursing_note,PROMPT1_ICL_entailment
21,117,16,15,1,0.9375,13,9,4,0.6923076923076923,0.7964601769911505,GPT4,medalign,nursing_note,PROMPT1_ICL_entailment
22,118,5,4,1,0.8,2,2,0,1.0,0.888888888888889,GPT4,medalign,nursing_note,PROMPT1_ICL_entailment
23,119,4,4,0,1.0,2,2,0,1.0,1.0,GPT4,medalign,nursing_note,PROMPT1_ICL_entailment
24,12,2,2,0,1.0,1,1,0,1.0,1.0,GPT4,medalign,nursing_note,PROMPT1_ICL_entailment
25,120,11,11,0,1.0,7,6,1,0.8571428571428571,0.923076923076923,GPT4,medalign,nursing_note,PROMPT1_ICL_entailment
26,121,3,3,0,1.0,1,1,0,1.0,1.0,GPT4,medalign,nursing_note,PROMPT1_ICL_entailment
27,122,3,2,1,0.6666666666666666,1,1,0,1.0,0.8,GPT4,medalign,nursing_note,PROMPT1_ICL_entailment
28,123,4,4,0,1.0,4,4,0,1.0,1.0,GPT4,medalign,nursing_note,PROMPT1_ICL_entailment
29,124,21,17,4,0.8095238095238095,14,11,3,0.7857142857142857,0.7974413646055437,GPT4,medalign,nursing_note,PROMPT1_ICL_entailment
30,125,15,15,0,1.0,9,9,0,1.0,1.0,GPT4,medalign,nursing_note,PROMPT1_ICL_entailment
31,126,2,2,0,1.0,2,1,1,0.5,0.6666666666666666,GPT4,medalign,nursing_note,PROMPT1_ICL_entailment
32,127,1,1,0,1.0,1,1,0,1.0,1.0,GPT4,medalign,nursing_note,PROMPT1_ICL_entailment
33,128,3,3,0,1.0,2,1,1,0.5,0.6666666666666666,GPT4,medalign,nursing_note,PROMPT1_ICL_entailment
34,129,27,26,1,0.9629629629629628,20,20,0,1.0,0.981132075471698,GPT4,medalign,nursing_note,PROMPT1_ICL_entailment
35,13,7,7,0,1.0,5,5,0,1.0,1.0,GPT4,medalign,nursing_note,PROMPT1_ICL_entailment
36,130,5,5,0,1.0,2,2,0,1.0,1.0,GPT4,medalign,nursing_note,PROMPT1_ICL_entailment
37,131,4,4,0,1.0,1,1,0,1.0,1.0,GPT4,medalign,nursing_note,PROMPT1_ICL_entailment
38,132,6,6,0,1.0,2,2,0,1.0,1.0,GPT4,medalign,nursing_note,PROMPT1_ICL_entailment
39,133,15,13,2,0.8666666666666667,14,7,7,0.5,0.6341463414634146,GPT4,medalign,nursing_note,PROMPT1_ICL_entailment
40,134,5,5,0,1.0,3,3,0,1.0,1.0,GPT4,medalign,nursing_note,PROMPT1_ICL_entailment
41,135,8,7,1,0.875,2,2,0,1.0,0.9333333333333332,GPT4,medalign,nursing_note,PROMPT1_ICL_entailment
42,136,53,42,11,0.7924528301886793,51,26,25,0.5098039215686274,0.6204545454545455,GPT4,medalign,nursing_note,PROMPT1_ICL_entailment
43,137,15,15,0,1.0,6,6,0,1.0,1.0,GPT4,medalign,nursing_note,PROMPT1_ICL_entailment
44,138,2,1,1,0.5,1,1,0,1.0,0.6666666666666666,GPT4,medalign,nursing_note,PROMPT1_ICL_entailment
45,139,5,5,0,1.0,1,1,0,1.0,1.0,GPT4,medalign,nursing_note,PROMPT1_ICL_entailment
46,14,4,2,2,0.5,1,1,0,1.0,0.6666666666666666,GPT4,medalign,nursing_note,PROMPT1_ICL_entailment
47,140,3,3,0,1.0,3,2,1,0.6666666666666666,0.8,GPT4,medalign,nursing_note,PROMPT1_ICL_entailment
48,141,3,3,0,1.0,1,1,0,1.0,1.0,GPT4,medalign,nursing_note,PROMPT1_ICL_entailment
49,142,3,3,0,1.0,1,1,0,1.0,1.0,GPT4,medalign,nursing_note,PROMPT1_ICL_entailment
50,143,3,2,1,0.6666666666666666,1,1,0,1.0,0.8,GPT4,medalign,nursing_note,PROMPT1_ICL_entailment
51,144,2,2,0,1.0,1,1,0,1.0,1.0,GPT4,medalign,nursing_note,PROMPT1_ICL_entailment
52,145,4,4,0,1.0,4,4,0,1.0,1.0,GPT4,medalign,nursing_note,PROMPT1_ICL_entailment
53,146,20,18,2,0.9,3,2,1,0.6666666666666666,0.7659574468085106,GPT4,medalign,nursing_note,PROMPT1_ICL_entailment
54,147,8,8,0,1.0,6,2,4,0.3333333333333333,0.5,GPT4,medalign,nursing_note,PROMPT1_ICL_entailment
55,148,23,23,0,1.0,7,7,0,1.0,1.0,GPT4,medalign,nursing_note,PROMPT1_ICL_entailment
56,149,9,9,0,1.0,1,1,0,1.0,1.0,GPT4,medalign,nursing_note,PROMPT1_ICL_entailment
57,15,6,5,1,0.8333333333333334,1,0,1,0.0,0.0,GPT4,medalign,nursing_note,PROMPT1_ICL_entailment
58,150,4,4,0,1.0,1,1,0,1.0,1.0,GPT4,medalign,nursing_note,PROMPT1_ICL_entailment
59,151,14,14,0,1.0,8,7,1,0.875,0.9333333333333332,GPT4,medalign,nursing_note,PROMPT1_ICL_entailment
60,152,6,6,0,1.0,4,4,0,1.0,1.0,GPT4,medalign,nursing_note,PROMPT1_ICL_entailment
61,153,15,14,1,0.9333333333333332,14,12,2,0.8571428571428571,0.8936170212765957,GPT4,medalign,nursing_note,PROMPT1_ICL_entailment
62,154,3,3,0,1.0,1,1,0,1.0,1.0,GPT4,medalign,nursing_note,PROMPT1_ICL_entailment
63,155,21,18,3,0.8571428571428571,14,10,4,0.7142857142857143,0.7792207792207793,GPT4,medalign,nursing_note,PROMPT1_ICL_entailment
64,156,11,11,0,1.0,1,1,0,1.0,1.0,GPT4,medalign,nursing_note,PROMPT1_ICL_entailment
65,157,6,4,2,0.6666666666666666,3,3,0,1.0,0.8,GPT4,medalign,nursing_note,PROMPT1_ICL_entailment
66,158,11,10,1,0.9090909090909092,1,0,1,0.0,0.0,GPT4,medalign,nursing_note,PROMPT1_ICL_entailment
67,159,6,6,0,1.0,3,3,0,1.0,1.0,GPT4,medalign,nursing_note,PROMPT1_ICL_entailment
68,16,11,10,1,0.9090909090909092,3,2,1,0.6666666666666666,0.7692307692307692,GPT4,medalign,nursing_note,PROMPT1_ICL_entailment
69,160,3,3,0,1.0,1,1,0,1.0,1.0,GPT4,medalign,nursing_note,PROMPT1_ICL_entailment
70,161,5,5,0,1.0,1,1,0,1.0,1.0,GPT4,medalign,nursing_note,PROMPT1_ICL_entailment
71,162,12,10,2,0.8333333333333334,8,7,1,0.875,0.8536585365853658,GPT4,medalign,nursing_note,PROMPT1_ICL_entailment
72,163,6,6,0,1.0,3,3,0,1.0,1.0,GPT4,medalign,nursing_note,PROMPT1_ICL_entailment
73,164,7,7,0,1.0,2,2,0,1.0,1.0,GPT4,medalign,nursing_note,PROMPT1_ICL_entailment
74,165,9,9,0,1.0,4,4,0,1.0,1.0,GPT4,medalign,nursing_note,PROMPT1_ICL_entailment
75,166,10,9,1,0.9,5,3,2,0.6,0.7200000000000001,GPT4,medalign,nursing_note,PROMPT1_ICL_entailment
76,167,14,13,1,0.9285714285714286,2,1,1,0.5,0.65,GPT4,medalign,nursing_note,PROMPT1_ICL_entailment
77,168,5,5,0,1.0,3,3,0,1.0,1.0,GPT4,medalign,nursing_note,PROMPT1_ICL_entailment
78,169,12,10,2,0.8333333333333334,9,8,1,0.8888888888888888,0.8602150537634408,GPT4,medalign,nursing_note,PROMPT1_ICL_entailment
79,17,7,5,2,0.7142857142857143,1,1,0,1.0,0.8333333333333333,GPT4,medalign,nursing_note,PROMPT1_ICL_entailment
80,170,5,5,0,1.0,1,1,0,1.0,1.0,GPT4,medalign,nursing_note,PROMPT1_ICL_entailment
81,171,11,9,2,0.8181818181818182,7,3,4,0.4285714285714285,0.5625,GPT4,medalign,nursing_note,PROMPT1_ICL_entailment
82,172,15,13,2,0.8666666666666667,12,10,2,0.8333333333333334,0.8496732026143791,GPT4,medalign,nursing_note,PROMPT1_ICL_entailment
83,173,8,8,0,1.0,1,1,0,1.0,1.0,GPT4,medalign,nursing_note,PROMPT1_ICL_entailment
84,174,3,3,0,1.0,1,1,0,1.0,1.0,GPT4,medalign,nursing_note,PROMPT1_ICL_entailment
85,175,3,3,0,1.0,2,2,0,1.0,1.0,GPT4,medalign,nursing_note,PROMPT1_ICL_entailment
86,176,10,7,3,0.7,3,2,1,0.6666666666666666,0.6829268292682926,GPT4,medalign,nursing_note,PROMPT1_ICL_entailment
87,177,12,12,0,1.0,8,7,1,0.875,0.9333333333333332,GPT4,medalign,nursing_note,PROMPT1_ICL_entailment
88,178,12,12,0,1.0,10,10,0,1.0,1.0,GPT4,medalign,nursing_note,PROMPT1_ICL_entailment
89,179,8,8,0,1.0,2,2,0,1.0,1.0,GPT4,medalign,nursing_note,PROMPT1_ICL_entailment
90,18,19,18,1,0.9473684210526316,3,3,0,1.0,0.972972972972973,GPT4,medalign,nursing_note,PROMPT1_ICL_entailment
91,180,11,9,2,0.8181818181818182,4,2,2,0.5,0.6206896551724137,GPT4,medalign,nursing_note,PROMPT1_ICL_entailment
92,181,10,10,0,1.0,7,7,0,1.0,1.0,GPT4,medalign,nursing_note,PROMPT1_ICL_entailment
93,182,3,3,0,1.0,2,2,0,1.0,1.0,GPT4,medalign,nursing_note,PROMPT1_ICL_entailment
94,183,8,6,2,0.75,6,6,0,1.0,0.8571428571428571,GPT4,medalign,nursing_note,PROMPT1_ICL_entailment
95,184,13,10,3,0.7692307692307693,11,10,1,0.9090909090909092,0.8333333333333333,GPT4,medalign,nursing_note,PROMPT1_ICL_entailment
96,185,7,7,0,1.0,3,3,0,1.0,1.0,GPT4,medalign,nursing_note,PROMPT1_ICL_entailment
97,186,6,5,1,0.8333333333333334,3,3,0,1.0,0.9090909090909092,GPT4,medalign,nursing_note,PROMPT1_ICL_entailment
98,187,2,0,2,0.0,1,1,0,1.0,0.0,GPT4,medalign,nursing_note,PROMPT1_ICL_entailment
99,188,3,3,0,1.0,3,3,0,1.0,1.0,GPT4,medalign,nursing_note,PROMPT1_ICL_entailment
100,189,14,13,1,0.9285714285714286,10,7,3,0.7,0.7982456140350878,GPT4,medalign,nursing_note,PROMPT1_ICL_entailment
101,19,15,15,0,1.0,7,7,0,1.0,1.0,GPT4,medalign,nursing_note,PROMPT1_ICL_entailment
102,190,6,6,0,1.0,2,2,0,1.0,1.0,GPT4,medalign,nursing_note,PROMPT1_ICL_entailment
103,191,15,15,0,1.0,5,4,1,0.8,0.888888888888889,GPT4,medalign,nursing_note,PROMPT1_ICL_entailment
104,192,5,5,0,1.0,1,1,0,1.0,1.0,GPT4,medalign,nursing_note,PROMPT1_ICL_entailment
105,193,8,8,0,1.0,3,3,0,1.0,1.0,GPT4,medalign,nursing_note,PROMPT1_ICL_entailment
106,194,2,2,0,1.0,2,0,2,0.0,0.0,GPT4,medalign,nursing_note,PROMPT1_ICL_entailment
107,195,18,17,1,0.9444444444444444,10,7,3,0.7,0.8040540540540541,GPT4,medalign,nursing_note,PROMPT1_ICL_entailment
108,196,6,6,0,1.0,1,1,0,1.0,1.0,GPT4,medalign,nursing_note,PROMPT1_ICL_entailment
109,197,4,4,0,1.0,1,1,0,1.0,1.0,GPT4,medalign,nursing_note,PROMPT1_ICL_entailment
110,198,21,19,2,0.9047619047619048,8,8,0,1.0,0.95,GPT4,medalign,nursing_note,PROMPT1_ICL_entailment
111,199,17,15,2,0.8823529411764706,7,5,2,0.7142857142857143,0.7894736842105262,GPT4,medalign,nursing_note,PROMPT1_ICL_entailment
112,2,18,11,7,0.6111111111111112,5,3,2,0.6,0.6055045871559633,GPT4,medalign,nursing_note,PROMPT1_ICL_entailment
113,20,7,6,1,0.8571428571428571,2,2,0,1.0,0.923076923076923,GPT4,medalign,nursing_note,PROMPT1_ICL_entailment
114,200,5,5,0,1.0,3,3,0,1.0,1.0,GPT4,medalign,nursing_note,PROMPT1_ICL_entailment
115,201,4,4,0,1.0,1,1,0,1.0,1.0,GPT4,medalign,nursing_note,PROMPT1_ICL_entailment
116,202,5,5,0,1.0,1,0,1,0.0,0.0,GPT4,medalign,nursing_note,PROMPT1_ICL_entailment
117,203,4,4,0,1.0,1,1,0,1.0,1.0,GPT4,medalign,nursing_note,PROMPT1_ICL_entailment
118,204,15,15,0,1.0,9,5,4,0.5555555555555556,0.7142857142857143,GPT4,medalign,nursing_note,PROMPT1_ICL_entailment
119,205,23,12,11,0.5217391304347826,8,4,4,0.5,0.5106382978723404,GPT4,medalign,nursing_note,PROMPT1_ICL_entailment
120,206,7,7,0,1.0,4,4,0,1.0,1.0,GPT4,medalign,nursing_note,PROMPT1_ICL_entailment
121,207,13,12,1,0.9230769230769232,6,6,0,1.0,0.96,GPT4,medalign,nursing_note,PROMPT1_ICL_entailment
122,208,12,11,1,0.9166666666666666,10,8,2,0.8,0.854368932038835,GPT4,medalign,nursing_note,PROMPT1_ICL_entailment
123,209,6,6,0,1.0,1,0,1,0.0,0.0,GPT4,medalign,nursing_note,PROMPT1_ICL_entailment
124,21,5,5,0,1.0,1,1,0,1.0,1.0,GPT4,medalign,nursing_note,PROMPT1_ICL_entailment
125,210,4,3,1,0.75,2,1,1,0.5,0.6,GPT4,medalign,nursing_note,PROMPT1_ICL_entailment
126,211,5,5,0,1.0,2,2,0,1.0,1.0,GPT4,medalign,nursing_note,PROMPT1_ICL_entailment
127,212,6,6,0,1.0,3,3,0,1.0,1.0,GPT4,medalign,nursing_note,PROMPT1_ICL_entailment
128,213,15,14,1,0.9333333333333332,8,8,0,1.0,0.9655172413793104,GPT4,medalign,nursing_note,PROMPT1_ICL_entailment
129,214,2,2,0,1.0,2,1,1,0.5,0.6666666666666666,GPT4,medalign,nursing_note,PROMPT1_ICL_entailment
130,215,2,2,0,1.0,1,1,0,1.0,1.0,GPT4,medalign,nursing_note,PROMPT1_ICL_entailment
131,216,5,5,0,1.0,3,3,0,1.0,1.0,GPT4,medalign,nursing_note,PROMPT1_ICL_entailment
132,217,15,14,1,0.9333333333333332,11,9,2,0.8181818181818182,0.8719723183391004,GPT4,medalign,nursing_note,PROMPT1_ICL_entailment
133,218,15,15,0,1.0,3,3,0,1.0,1.0,GPT4,medalign,nursing_note,PROMPT1_ICL_entailment
134,219,9,8,1,0.8888888888888888,2,2,0,1.0,0.9411764705882352,GPT4,medalign,nursing_note,PROMPT1_ICL_entailment
135,22,2,2,0,1.0,1,1,0,1.0,1.0,GPT4,medalign,nursing_note,PROMPT1_ICL_entailment
136,220,9,8,1,0.8888888888888888,7,5,2,0.7142857142857143,0.792079207920792,GPT4,medalign,nursing_note,PROMPT1_ICL_entailment
137,221,28,26,2,0.9285714285714286,23,9,14,0.391304347826087,0.5505882352941177,GPT4,medalign,nursing_note,PROMPT1_ICL_entailment
138,222,6,6,0,1.0,4,4,0,1.0,1.0,GPT4,medalign,nursing_note,PROMPT1_ICL_entailment
139,223,4,4,0,1.0,2,2,0,1.0,1.0,GPT4,medalign,nursing_note,PROMPT1_ICL_entailment
140,224,11,11,0,1.0,4,3,1,0.75,0.8571428571428571,GPT4,medalign,nursing_note,PROMPT1_ICL_entailment
141,225,6,6,0,1.0,2,2,0,1.0,1.0,GPT4,medalign,nursing_note,PROMPT1_ICL_entailment
142,226,16,12,4,0.75,5,3,2,0.6,0.6666666666666665,GPT4,medalign,nursing_note,PROMPT1_ICL_entailment
143,227,3,2,1,0.6666666666666666,1,1,0,1.0,0.8,GPT4,medalign,nursing_note,PROMPT1_ICL_entailment
144,228,32,31,1,0.96875,18,17,1,0.9444444444444444,0.956442831215971,GPT4,medalign,nursing_note,PROMPT1_ICL_entailment
145,229,12,10,2,0.8333333333333334,7,6,1,0.8571428571428571,0.8450704225352113,GPT4,medalign,nursing_note,PROMPT1_ICL_entailment
146,23,20,17,3,0.85,21,10,11,0.4761904761904761,0.6104129263913823,GPT4,medalign,nursing_note,PROMPT1_ICL_entailment
147,230,3,2,1,0.6666666666666666,1,1,0,1.0,0.8,GPT4,medalign,nursing_note,PROMPT1_ICL_entailment
148,231,16,14,2,0.875,13,7,6,0.5384615384615384,0.6666666666666667,GPT4,medalign,nursing_note,PROMPT1_ICL_entailment
149,232,10,10,0,1.0,6,3,3,0.5,0.6666666666666666,GPT4,medalign,nursing_note,PROMPT1_ICL_entailment
150,233,5,3,2,0.6,4,3,1,0.75,0.6666666666666665,GPT4,medalign,nursing_note,PROMPT1_ICL_entailment
151,234,9,9,0,1.0,2,1,1,0.5,0.6666666666666666,GPT4,medalign,nursing_note,PROMPT1_ICL_entailment
152,235,3,3,0,1.0,1,1,0,1.0,1.0,GPT4,medalign,nursing_note,PROMPT1_ICL_entailment
153,236,14,13,1,0.9285714285714286,14,11,3,0.7857142857142857,0.851190476190476,GPT4,medalign,nursing_note,PROMPT1_ICL_entailment
154,237,12,10,2,0.8333333333333334,5,4,1,0.8,0.816326530612245,GPT4,medalign,nursing_note,PROMPT1_ICL_entailment
155,238,13,13,0,1.0,4,4,0,1.0,1.0,GPT4,medalign,nursing_note,PROMPT1_ICL_entailment
156,239,10,10,0,1.0,4,4,0,1.0,1.0,GPT4,medalign,nursing_note,PROMPT1_ICL_entailment
157,24,15,7,8,0.4666666666666667,1,0,1,0.0,0.0,GPT4,medalign,nursing_note,PROMPT1_ICL_entailment
158,240,3,3,0,1.0,2,1,1,0.5,0.6666666666666666,GPT4,medalign,nursing_note,PROMPT1_ICL_entailment
159,241,5,5,0,1.0,2,2,0,1.0,1.0,GPT4,medalign,nursing_note,PROMPT1_ICL_entailment
160,242,20,18,2,0.9,2,1,1,0.5,0.6428571428571429,GPT4,medalign,nursing_note,PROMPT1_ICL_entailment
161,243,23,22,1,0.9565217391304348,10,9,1,0.9,0.9274004683840747,GPT4,medalign,nursing_note,PROMPT1_ICL_entailment
162,244,4,3,1,0.75,1,1,0,1.0,0.8571428571428571,GPT4,medalign,nursing_note,PROMPT1_ICL_entailment
163,245,4,4,0,1.0,1,1,0,1.0,1.0,GPT4,medalign,nursing_note,PROMPT1_ICL_entailment
164,246,3,3,0,1.0,1,1,0,1.0,1.0,GPT4,medalign,nursing_note,PROMPT1_ICL_entailment
165,247,8,8,0,1.0,5,5,0,1.0,1.0,GPT4,medalign,nursing_note,PROMPT1_ICL_entailment
166,248,3,3,0,1.0,1,1,0,1.0,1.0,GPT4,medalign,nursing_note,PROMPT1_ICL_entailment
167,249,9,9,0,1.0,2,2,0,1.0,1.0,GPT4,medalign,nursing_note,PROMPT1_ICL_entailment
168,25,47,45,2,0.9574468085106383,33,18,15,0.5454545454545454,0.6949806949806949,GPT4,medalign,nursing_note,PROMPT1_ICL_entailment
169,26,5,5,0,1.0,1,1,0,1.0,1.0,GPT4,medalign,nursing_note,PROMPT1_ICL_entailment
170,27,14,11,3,0.7857142857142857,2,0,2,0.0,0.0,GPT4,medalign,nursing_note,PROMPT1_ICL_entailment
171,28,12,7,5,0.5833333333333334,4,4,0,1.0,0.7368421052631579,GPT4,medalign,nursing_note,PROMPT1_ICL_entailment
172,29,8,8,0,1.0,3,1,2,0.3333333333333333,0.5,GPT4,medalign,nursing_note,PROMPT1_ICL_entailment
173,3,6,6,0,1.0,2,2,0,1.0,1.0,GPT4,medalign,nursing_note,PROMPT1_ICL_entailment
174,30,5,5,0,1.0,1,1,0,1.0,1.0,GPT4,medalign,nursing_note,PROMPT1_ICL_entailment
175,31,1,1,0,1.0,1,1,0,1.0,1.0,GPT4,medalign,nursing_note,PROMPT1_ICL_entailment
176,32,4,4,0,1.0,2,2,0,1.0,1.0,GPT4,medalign,nursing_note,PROMPT1_ICL_entailment
177,33,11,11,0,1.0,5,5,0,1.0,1.0,GPT4,medalign,nursing_note,PROMPT1_ICL_entailment
178,34,13,11,2,0.8461538461538461,4,1,3,0.25,0.3859649122807017,GPT4,medalign,nursing_note,PROMPT1_ICL_entailment
179,35,10,10,0,1.0,4,3,1,0.75,0.8571428571428571,GPT4,medalign,nursing_note,PROMPT1_ICL_entailment
180,36,16,11,5,0.6875,5,4,1,0.8,0.7394957983193278,GPT4,medalign,nursing_note,PROMPT1_ICL_entailment
181,37,7,7,0,1.0,3,2,1,0.6666666666666666,0.8,GPT4,medalign,nursing_note,PROMPT1_ICL_entailment
182,38,16,11,5,0.6875,5,3,2,0.6,0.6407766990291262,GPT4,medalign,nursing_note,PROMPT1_ICL_entailment
183,39,5,5,0,1.0,1,1,0,1.0,1.0,GPT4,medalign,nursing_note,PROMPT1_ICL_entailment
184,4,6,5,1,0.8333333333333334,3,2,1,0.6666666666666666,0.7407407407407408,GPT4,medalign,nursing_note,PROMPT1_ICL_entailment
185,40,14,13,1,0.9285714285714286,8,5,3,0.625,0.7471264367816093,GPT4,medalign,nursing_note,PROMPT1_ICL_entailment
186,41,3,3,0,1.0,1,1,0,1.0,1.0,GPT4,medalign,nursing_note,PROMPT1_ICL_entailment
187,42,9,8,1,0.8888888888888888,8,7,1,0.875,0.8818897637795274,GPT4,medalign,nursing_note,PROMPT1_ICL_entailment
188,43,5,4,1,0.8,2,2,0,1.0,0.888888888888889,GPT4,medalign,nursing_note,PROMPT1_ICL_entailment
189,44,5,5,0,1.0,1,1,0,1.0,1.0,GPT4,medalign,nursing_note,PROMPT1_ICL_entailment
190,45,1,1,0,1.0,1,1,0,1.0,1.0,GPT4,medalign,nursing_note,PROMPT1_ICL_entailment
191,46,10,10,0,1.0,5,5,0,1.0,1.0,GPT4,medalign,nursing_note,PROMPT1_ICL_entailment
192,47,26,26,0,1.0,20,18,2,0.9,0.9473684210526316,GPT4,medalign,nursing_note,PROMPT1_ICL_entailment
193,48,4,4,0,1.0,2,2,0,1.0,1.0,GPT4,medalign,nursing_note,PROMPT1_ICL_entailment
194,49,8,8,0,1.0,2,2,0,1.0,1.0,GPT4,medalign,nursing_note,PROMPT1_ICL_entailment
195,5,16,16,0,1.0,5,4,1,0.8,0.888888888888889,GPT4,medalign,nursing_note,PROMPT1_ICL_entailment
196,50,3,3,0,1.0,1,1,0,1.0,1.0,GPT4,medalign,nursing_note,PROMPT1_ICL_entailment
197,51,4,4,0,1.0,2,2,0,1.0,1.0,GPT4,medalign,nursing_note,PROMPT1_ICL_entailment
198,52,7,7,0,1.0,4,4,0,1.0,1.0,GPT4,medalign,nursing_note,PROMPT1_ICL_entailment
199,53,4,4,0,1.0,1,1,0,1.0,1.0,GPT4,medalign,nursing_note,PROMPT1_ICL_entailment
200,54,12,10,2,0.8333333333333334,7,6,1,0.8571428571428571,0.8450704225352113,GPT4,medalign,nursing_note,PROMPT1_ICL_entailment
201,55,8,8,0,1.0,2,2,0,1.0,1.0,GPT4,medalign,nursing_note,PROMPT1_ICL_entailment
202,56,11,9,2,0.8181818181818182,3,3,0,1.0,0.9,GPT4,medalign,nursing_note,PROMPT1_ICL_entailment
203,57,16,9,7,0.5625,4,3,1,0.75,0.6428571428571429,GPT4,medalign,nursing_note,PROMPT1_ICL_entailment
204,58,3,3,0,1.0,1,1,0,1.0,1.0,GPT4,medalign,nursing_note,PROMPT1_ICL_entailment
205,59,3,3,0,1.0,1,1,0,1.0,1.0,GPT4,medalign,nursing_note,PROMPT1_ICL_entailment
206,6,3,3,0,1.0,3,3,0,1.0,1.0,GPT4,medalign,nursing_note,PROMPT1_ICL_entailment
207,60,11,10,1,0.9090909090909092,9,7,2,0.7777777777777778,0.8383233532934132,GPT4,medalign,nursing_note,PROMPT1_ICL_entailment
208,61,3,3,0,1.0,1,1,0,1.0,1.0,GPT4,medalign,nursing_note,PROMPT1_ICL_entailment
209,62,13,13,0,1.0,5,4,1,0.8,0.888888888888889,GPT4,medalign,nursing_note,PROMPT1_ICL_entailment
210,63,13,12,1,0.9230769230769232,7,7,0,1.0,0.96,GPT4,medalign,nursing_note,PROMPT1_ICL_entailment
211,64,4,3,1,0.75,1,1,0,1.0,0.8571428571428571,GPT4,medalign,nursing_note,PROMPT1_ICL_entailment
212,65,7,7,0,1.0,2,2,0,1.0,1.0,GPT4,medalign,nursing_note,PROMPT1_ICL_entailment
213,66,6,6,0,1.0,4,4,0,1.0,1.0,GPT4,medalign,nursing_note,PROMPT1_ICL_entailment
214,67,5,4,1,0.8,4,2,2,0.5,0.6153846153846154,GPT4,medalign,nursing_note,PROMPT1_ICL_entailment
215,68,5,5,0,1.0,1,1,0,1.0,1.0,GPT4,medalign,nursing_note,PROMPT1_ICL_entailment
216,69,10,10,0,1.0,2,2,0,1.0,1.0,GPT4,medalign,nursing_note,PROMPT1_ICL_entailment
217,7,6,6,0,1.0,1,1,0,1.0,1.0,GPT4,medalign,nursing_note,PROMPT1_ICL_entailment
218,70,9,9,0,1.0,1,0,1,0.0,0.0,GPT4,medalign,nursing_note,PROMPT1_ICL_entailment
219,71,18,18,0,1.0,1,0,1,0.0,0.0,GPT4,medalign,nursing_note,PROMPT1_ICL_entailment
220,72,3,2,1,0.6666666666666666,1,1,0,1.0,0.8,GPT4,medalign,nursing_note,PROMPT1_ICL_entailment
221,73,4,4,0,1.0,2,2,0,1.0,1.0,GPT4,medalign,nursing_note,PROMPT1_ICL_entailment
222,74,16,9,7,0.5625,5,5,0,1.0,0.72,GPT4,medalign,nursing_note,PROMPT1_ICL_entailment
223,75,1,1,0,1.0,1,1,0,1.0,1.0,GPT4,medalign,nursing_note,PROMPT1_ICL_entailment
224,76,10,10,0,1.0,5,3,2,0.6,0.7499999999999999,GPT4,medalign,nursing_note,PROMPT1_ICL_entailment
225,77,6,6,0,1.0,3,3,0,1.0,1.0,GPT4,medalign,nursing_note,PROMPT1_ICL_entailment
226,78,9,8,1,0.8888888888888888,3,3,0,1.0,0.9411764705882352,GPT4,medalign,nursing_note,PROMPT1_ICL_entailment
227,79,8,6,2,0.75,8,8,0,1.0,0.8571428571428571,GPT4,medalign,nursing_note,PROMPT1_ICL_entailment
228,8,15,13,2,0.8666666666666667,8,6,2,0.75,0.8041237113402062,GPT4,medalign,nursing_note,PROMPT1_ICL_entailment
229,80,13,12,1,0.9230769230769232,10,10,0,1.0,0.96,GPT4,medalign,nursing_note,PROMPT1_ICL_entailment
230,81,3,1,2,0.3333333333333333,1,1,0,1.0,0.5,GPT4,medalign,nursing_note,PROMPT1_ICL_entailment
231,82,4,3,1,0.75,3,3,0,1.0,0.8571428571428571,GPT4,medalign,nursing_note,PROMPT1_ICL_entailment
232,83,9,8,1,0.8888888888888888,3,2,1,0.6666666666666666,0.761904761904762,GPT4,medalign,nursing_note,PROMPT1_ICL_entailment
233,84,9,8,1,0.8888888888888888,2,1,1,0.5,0.64,GPT4,medalign,nursing_note,PROMPT1_ICL_entailment
234,85,17,17,0,1.0,8,7,1,0.875,0.9333333333333332,GPT4,medalign,nursing_note,PROMPT1_ICL_entailment
235,86,3,3,0,1.0,3,3,0,1.0,1.0,GPT4,medalign,nursing_note,PROMPT1_ICL_entailment
236,87,3,3,0,1.0,2,2,0,1.0,1.0,GPT4,medalign,nursing_note,PROMPT1_ICL_entailment
237,88,11,11,0,1.0,7,7,0,1.0,1.0,GPT4,medalign,nursing_note,PROMPT1_ICL_entailment
238,89,8,8,0,1.0,6,6,0,1.0,1.0,GPT4,medalign,nursing_note,PROMPT1_ICL_entailment
239,9,7,6,1,0.8571428571428571,2,2,0,1.0,0.923076923076923,GPT4,medalign,nursing_note,PROMPT1_ICL_entailment
240,90,5,5,0,1.0,1,1,0,1.0,1.0,GPT4,medalign,nursing_note,PROMPT1_ICL_entailment
241,91,4,4,0,1.0,1,1,0,1.0,1.0,GPT4,medalign,nursing_note,PROMPT1_ICL_entailment
242,92,6,6,0,1.0,4,2,2,0.5,0.6666666666666666,GPT4,medalign,nursing_note,PROMPT1_ICL_entailment
243,93,4,4,0,1.0,1,1,0,1.0,1.0,GPT4,medalign,nursing_note,PROMPT1_ICL_entailment
244,94,3,3,0,1.0,2,2,0,1.0,1.0,GPT4,medalign,nursing_note,PROMPT1_ICL_entailment
245,95,3,3,0,1.0,1,1,0,1.0,1.0,GPT4,medalign,nursing_note,PROMPT1_ICL_entailment
246,96,2,2,0,1.0,1,1,0,1.0,1.0,GPT4,medalign,nursing_note,PROMPT1_ICL_entailment
247,97,7,7,0,1.0,2,2,0,1.0,1.0,GPT4,medalign,nursing_note,PROMPT1_ICL_entailment
248,98,13,12,1,0.9230769230769232,5,4,1,0.8,0.8571428571428571,GPT4,medalign,nursing_note,PROMPT1_ICL_entailment
249,99,14,13,1,0.9285714285714286,7,5,2,0.7142857142857143,0.8074534161490684,GPT4,medalign,nursing_note,PROMPT1_ICL_entailment
0,0,12,12,0,1.0,6,5,1,0.8333333333333334,0.9090909090909092,GPT4,medalign,nursing_note,PROMPT2_ICL_entailment
1,1,5,5,0,1.0,1,1,0,1.0,1.0,GPT4,medalign,nursing_note,PROMPT2_ICL_entailment
2,10,9,9,0,1.0,5,4,1,0.8,0.888888888888889,GPT4,medalign,nursing_note,PROMPT2_ICL_entailment
3,100,12,10,2,0.8333333333333334,10,7,3,0.7,0.7608695652173915,GPT4,medalign,nursing_note,PROMPT2_ICL_entailment
4,101,9,9,0,1.0,1,1,0,1.0,1.0,GPT4,medalign,nursing_note,PROMPT2_ICL_entailment
5,102,10,10,0,1.0,4,3,1,0.75,0.8571428571428571,GPT4,medalign,nursing_note,PROMPT2_ICL_entailment
6,103,4,4,0,1.0,2,2,0,1.0,1.0,GPT4,medalign,nursing_note,PROMPT2_ICL_entailment
7,104,19,19,0,1.0,15,11,4,0.7333333333333333,0.846153846153846,GPT4,medalign,nursing_note,PROMPT2_ICL_entailment
8,105,4,3,1,0.75,1,1,0,1.0,0.8571428571428571,GPT4,medalign,nursing_note,PROMPT2_ICL_entailment
9,106,6,4,2,0.6666666666666666,1,1,0,1.0,0.8,GPT4,medalign,nursing_note,PROMPT2_ICL_entailment
10,107,9,9,0,1.0,4,4,0,1.0,1.0,GPT4,medalign,nursing_note,PROMPT2_ICL_entailment
11,108,2,2,0,1.0,2,2,0,1.0,1.0,GPT4,medalign,nursing_note,PROMPT2_ICL_entailment
12,109,12,11,1,0.9166666666666666,5,5,0,1.0,0.9565217391304348,GPT4,medalign,nursing_note,PROMPT2_ICL_entailment
13,11,3,2,1,0.6666666666666666,1,1,0,1.0,0.8,GPT4,medalign,nursing_note,PROMPT2_ICL_entailment
14,110,17,10,7,0.5882352941176471,6,4,2,0.6666666666666666,0.625,GPT4,medalign,nursing_note,PROMPT2_ICL_entailment
15,111,4,2,2,0.5,1,1,0,1.0,0.6666666666666666,GPT4,medalign,nursing_note,PROMPT2_ICL_entailment
16,112,8,7,1,0.875,2,2,0,1.0,0.9333333333333332,GPT4,medalign,nursing_note,PROMPT2_ICL_entailment
17,113,3,1,2,0.3333333333333333,1,1,0,1.0,0.5,GPT4,medalign,nursing_note,PROMPT2_ICL_entailment
18,114,4,3,1,0.75,1,1,0,1.0,0.8571428571428571,GPT4,medalign,nursing_note,PROMPT2_ICL_entailment
19,115,14,14,0,1.0,7,5,2,0.7142857142857143,0.8333333333333333,GPT4,medalign,nursing_note,PROMPT2_ICL_entailment
20,116,9,8,1,0.8888888888888888,5,4,1,0.8,0.8421052631578948,GPT4,medalign,nursing_note,PROMPT2_ICL_entailment
21,117,16,14,2,0.875,13,10,3,0.7692307692307693,0.8187134502923977,GPT4,medalign,nursing_note,PROMPT2_ICL_entailment
22,118,5,4,1,0.8,2,2,0,1.0,0.888888888888889,GPT4,medalign,nursing_note,PROMPT2_ICL_entailment
23,119,4,4,0,1.0,2,2,0,1.0,1.0,GPT4,medalign,nursing_note,PROMPT2_ICL_entailment
24,12,4,4,0,1.0,1,1,0,1.0,1.0,GPT4,medalign,nursing_note,PROMPT2_ICL_entailment
25,120,13,11,2,0.8461538461538461,7,6,1,0.8571428571428571,0.8516129032258064,GPT4,medalign,nursing_note,PROMPT2_ICL_entailment
26,121,4,3,1,0.75,1,1,0,1.0,0.8571428571428571,GPT4,medalign,nursing_note,PROMPT2_ICL_entailment
27,122,4,1,3,0.25,1,1,0,1.0,0.4,GPT4,medalign,nursing_note,PROMPT2_ICL_entailment
28,123,5,4,1,0.8,4,4,0,1.0,0.888888888888889,GPT4,medalign,nursing_note,PROMPT2_ICL_entailment
29,124,27,23,4,0.8518518518518519,14,12,2,0.8571428571428571,0.8544891640866873,GPT4,medalign,nursing_note,PROMPT2_ICL_entailment
30,125,21,21,0,1.0,9,8,1,0.8888888888888888,0.9411764705882352,GPT4,medalign,nursing_note,PROMPT2_ICL_entailment
31,126,3,2,1,0.6666666666666666,2,1,1,0.5,0.5714285714285715,GPT4,medalign,nursing_note,PROMPT2_ICL_entailment
32,127,3,2,1,0.6666666666666666,1,1,0,1.0,0.8,GPT4,medalign,nursing_note,PROMPT2_ICL_entailment
33,128,6,6,0,1.0,2,2,0,1.0,1.0,GPT4,medalign,nursing_note,PROMPT2_ICL_entailment
34,129,31,29,2,0.935483870967742,20,19,1,0.95,0.9426860564585114,GPT4,medalign,nursing_note,PROMPT2_ICL_entailment
35,13,7,7,0,1.0,5,5,0,1.0,1.0,GPT4,medalign,nursing_note,PROMPT2_ICL_entailment
36,130,8,8,0,1.0,2,2,0,1.0,1.0,GPT4,medalign,nursing_note,PROMPT2_ICL_entailment
37,131,4,4,0,1.0,1,1,0,1.0,1.0,GPT4,medalign,nursing_note,PROMPT2_ICL_entailment
38,132,5,4,1,0.8,2,2,0,1.0,0.888888888888889,GPT4,medalign,nursing_note,PROMPT2_ICL_entailment
39,133,17,14,3,0.8235294117647058,14,10,4,0.7142857142857143,0.7650273224043717,GPT4,medalign,nursing_note,PROMPT2_ICL_entailment
40,134,6,6,0,1.0,3,3,0,1.0,1.0,GPT4,medalign,nursing_note,PROMPT2_ICL_entailment
41,135,8,6,2,0.75,2,2,0,1.0,0.8571428571428571,GPT4,medalign,nursing_note,PROMPT2_ICL_entailment
42,136,56,34,22,0.6071428571428571,51,29,22,0.5686274509803921,0.5872543180464562,GPT4,medalign,nursing_note,PROMPT2_ICL_entailment
43,137,16,16,0,1.0,6,6,0,1.0,1.0,GPT4,medalign,nursing_note,PROMPT2_ICL_entailment
44,138,3,2,1,0.6666666666666666,1,1,0,1.0,0.8,GPT4,medalign,nursing_note,PROMPT2_ICL_entailment
45,139,6,4,2,0.6666666666666666,1,1,0,1.0,0.8,GPT4,medalign,nursing_note,PROMPT2_ICL_entailment
46,14,4,1,3,0.25,1,1,0,1.0,0.4,GPT4,medalign,nursing_note,PROMPT2_ICL_entailment
47,140,4,3,1,0.75,3,3,0,1.0,0.8571428571428571,GPT4,medalign,nursing_note,PROMPT2_ICL_entailment
48,141,3,3,0,1.0,1,1,0,1.0,1.0,GPT4,medalign,nursing_note,PROMPT2_ICL_entailment
49,142,4,4,0,1.0,1,1,0,1.0,1.0,GPT4,medalign,nursing_note,PROMPT2_ICL_entailment
50,143,5,3,2,0.6,1,1,0,1.0,0.7499999999999999,GPT4,medalign,nursing_note,PROMPT2_ICL_entailment
51,144,1,0,1,0.0,1,0,1,0.0,,GPT4,medalign,nursing_note,PROMPT2_ICL_entailment
52,145,5,5,0,1.0,4,4,0,1.0,1.0,GPT4,medalign,nursing_note,PROMPT2_ICL_entailment
53,146,22,20,2,0.9090909090909092,3,2,1,0.6666666666666666,0.7692307692307692,GPT4,medalign,nursing_note,PROMPT2_ICL_entailment
54,147,12,12,0,1.0,6,2,4,0.3333333333333333,0.5,GPT4,medalign,nursing_note,PROMPT2_ICL_entailment
55,148,24,24,0,1.0,7,7,0,1.0,1.0,GPT4,medalign,nursing_note,PROMPT2_ICL_entailment
56,149,9,8,1,0.8888888888888888,1,1,0,1.0,0.9411764705882352,GPT4,medalign,nursing_note,PROMPT2_ICL_entailment
57,15,6,5,1,0.8333333333333334,1,0,1,0.0,0.0,GPT4,medalign,nursing_note,PROMPT2_ICL_entailment
58,150,5,4,1,0.8,1,1,0,1.0,0.888888888888889,GPT4,medalign,nursing_note,PROMPT2_ICL_entailment
59,151,17,17,0,1.0,8,7,1,0.875,0.9333333333333332,GPT4,medalign,nursing_note,PROMPT2_ICL_entailment
60,152,7,7,0,1.0,4,4,0,1.0,1.0,GPT4,medalign,nursing_note,PROMPT2_ICL_entailment
61,153,13,13,0,1.0,14,9,5,0.6428571428571429,0.782608695652174,GPT4,medalign,nursing_note,PROMPT2_ICL_entailment
62,154,4,3,1,0.75,1,1,0,1.0,0.8571428571428571,GPT4,medalign,nursing_note,PROMPT2_ICL_entailment
63,155,22,22,0,1.0,14,9,5,0.6428571428571429,0.782608695652174,GPT4,medalign,nursing_note,PROMPT2_ICL_entailment
64,156,11,10,1,0.9090909090909092,1,1,0,1.0,0.9523809523809524,GPT4,medalign,nursing_note,PROMPT2_ICL_entailment
65,157,7,6,1,0.8571428571428571,3,3,0,1.0,0.923076923076923,GPT4,medalign,nursing_note,PROMPT2_ICL_entailment
66,158,12,11,1,0.9166666666666666,1,1,0,1.0,0.9565217391304348,GPT4,medalign,nursing_note,PROMPT2_ICL_entailment
67,159,7,7,0,1.0,3,3,0,1.0,1.0,GPT4,medalign,nursing_note,PROMPT2_ICL_entailment
68,16,12,12,0,1.0,3,2,1,0.6666666666666666,0.8,GPT4,medalign,nursing_note,PROMPT2_ICL_entailment
69,160,4,4,0,1.0,1,1,0,1.0,1.0,GPT4,medalign,nursing_note,PROMPT2_ICL_entailment
70,161,6,6,0,1.0,1,1,0,1.0,1.0,GPT4,medalign,nursing_note,PROMPT2_ICL_entailment
71,162,11,10,1,0.9090909090909092,8,6,2,0.75,0.821917808219178,GPT4,medalign,nursing_note,PROMPT2_ICL_entailment
72,163,6,5,1,0.8333333333333334,3,3,0,1.0,0.9090909090909092,GPT4,medalign,nursing_note,PROMPT2_ICL_entailment
73,164,7,6,1,0.8571428571428571,2,2,0,1.0,0.923076923076923,GPT4,medalign,nursing_note,PROMPT2_ICL_entailment
74,165,19,19,0,1.0,4,4,0,1.0,1.0,GPT4,medalign,nursing_note,PROMPT2_ICL_entailment
75,166,15,14,1,0.9333333333333332,5,4,1,0.8,0.8615384615384616,GPT4,medalign,nursing_note,PROMPT2_ICL_entailment
76,167,14,13,1,0.9285714285714286,2,1,1,0.5,0.65,GPT4,medalign,nursing_note,PROMPT2_ICL_entailment
77,168,6,5,1,0.8333333333333334,3,3,0,1.0,0.9090909090909092,GPT4,medalign,nursing_note,PROMPT2_ICL_entailment
78,169,12,10,2,0.8333333333333334,9,6,3,0.6666666666666666,0.7407407407407408,GPT4,medalign,nursing_note,PROMPT2_ICL_entailment
79,17,4,2,2,0.5,1,0,1,0.0,0.0,GPT4,medalign,nursing_note,PROMPT2_ICL_entailment
80,170,7,6,1,0.8571428571428571,1,1,0,1.0,0.923076923076923,GPT4,medalign,nursing_note,PROMPT2_ICL_entailment
81,171,11,10,1,0.9090909090909092,7,2,5,0.2857142857142857,0.4347826086956521,GPT4,medalign,nursing_note,PROMPT2_ICL_entailment
82,172,14,12,2,0.8571428571428571,12,9,3,0.75,0.7999999999999999,GPT4,medalign,nursing_note,PROMPT2_ICL_entailment
83,173,10,10,0,1.0,1,1,0,1.0,1.0,GPT4,medalign,nursing_note,PROMPT2_ICL_entailment
84,174,3,3,0,1.0,1,1,0,1.0,1.0,GPT4,medalign,nursing_note,PROMPT2_ICL_entailment
85,175,3,2,1,0.6666666666666666,2,2,0,1.0,0.8,GPT4,medalign,nursing_note,PROMPT2_ICL_entailment
86,176,14,6,8,0.4285714285714285,3,2,1,0.6666666666666666,0.5217391304347826,GPT4,medalign,nursing_note,PROMPT2_ICL_entailment
87,177,12,12,0,1.0,8,8,0,1.0,1.0,GPT4,medalign,nursing_note,PROMPT2_ICL_entailment
88,178,10,9,1,0.9,10,9,1,0.9,0.9,GPT4,medalign,nursing_note,PROMPT2_ICL_entailment
89,179,11,10,1,0.9090909090909092,2,2,0,1.0,0.9523809523809524,GPT4,medalign,nursing_note,PROMPT2_ICL_entailment
90,18,19,16,3,0.8421052631578947,3,3,0,1.0,0.9142857142857144,GPT4,medalign,nursing_note,PROMPT2_ICL_entailment
91,180,12,11,1,0.9166666666666666,4,3,1,0.75,0.8250000000000001,GPT4,medalign,nursing_note,PROMPT2_ICL_entailment
92,181,10,10,0,1.0,7,7,0,1.0,1.0,GPT4,medalign,nursing_note,PROMPT2_ICL_entailment
93,182,4,3,1,0.75,2,1,1,0.5,0.6,GPT4,medalign,nursing_note,PROMPT2_ICL_entailment
94,183,10,10,0,1.0,6,6,0,1.0,1.0,GPT4,medalign,nursing_note,PROMPT2_ICL_entailment
95,184,14,13,1,0.9285714285714286,11,11,0,1.0,0.962962962962963,GPT4,medalign,nursing_note,PROMPT2_ICL_entailment
96,185,7,7,0,1.0,3,3,0,1.0,1.0,GPT4,medalign,nursing_note,PROMPT2_ICL_entailment
97,186,7,7,0,1.0,3,3,0,1.0,1.0,GPT4,medalign,nursing_note,PROMPT2_ICL_entailment
98,187,4,1,3,0.25,1,1,0,1.0,0.4,GPT4,medalign,nursing_note,PROMPT2_ICL_entailment
99,188,5,5,0,1.0,3,3,0,1.0,1.0,GPT4,medalign,nursing_note,PROMPT2_ICL_entailment
100,189,14,13,1,0.9285714285714286,10,7,3,0.7,0.7982456140350878,GPT4,medalign,nursing_note,PROMPT2_ICL_entailment
101,19,14,14,0,1.0,7,7,0,1.0,1.0,GPT4,medalign,nursing_note,PROMPT2_ICL_entailment
102,190,5,5,0,1.0,2,2,0,1.0,1.0,GPT4,medalign,nursing_note,PROMPT2_ICL_entailment
103,191,16,16,0,1.0,5,3,2,0.6,0.7499999999999999,GPT4,medalign,nursing_note,PROMPT2_ICL_entailment
104,192,6,6,0,1.0,1,1,0,1.0,1.0,GPT4,medalign,nursing_note,PROMPT2_ICL_entailment
105,193,8,8,0,1.0,3,3,0,1.0,1.0,GPT4,medalign,nursing_note,PROMPT2_ICL_entailment
106,194,4,3,1,0.75,2,2,0,1.0,0.8571428571428571,GPT4,medalign,nursing_note,PROMPT2_ICL_entailment
107,195,11,9,2,0.8181818181818182,10,6,4,0.6,0.6923076923076923,GPT4,medalign,nursing_note,PROMPT2_ICL_entailment
108,196,6,6,0,1.0,1,1,0,1.0,1.0,GPT4,medalign,nursing_note,PROMPT2_ICL_entailment
109,197,6,5,1,0.8333333333333334,1,1,0,1.0,0.9090909090909092,GPT4,medalign,nursing_note,PROMPT2_ICL_entailment
110,198,16,16,0,1.0,8,7,1,0.875,0.9333333333333332,GPT4,medalign,nursing_note,PROMPT2_ICL_entailment
111,199,22,17,5,0.7727272727272727,7,7,0,1.0,0.8717948717948718,GPT4,medalign,nursing_note,PROMPT2_ICL_entailment
112,2,16,7,9,0.4375,5,5,0,1.0,0.6086956521739131,GPT4,medalign,nursing_note,PROMPT2_ICL_entailment
113,20,7,6,1,0.8571428571428571,2,2,0,1.0,0.923076923076923,GPT4,medalign,nursing_note,PROMPT2_ICL_entailment
114,200,7,7,0,1.0,3,3,0,1.0,1.0,GPT4,medalign,nursing_note,PROMPT2_ICL_entailment
115,201,4,4,0,1.0,1,1,0,1.0,1.0,GPT4,medalign,nursing_note,PROMPT2_ICL_entailment
116,202,7,4,3,0.5714285714285714,1,1,0,1.0,0.7272727272727273,GPT4,medalign,nursing_note,PROMPT2_ICL_entailment
117,203,5,4,1,0.8,1,1,0,1.0,0.888888888888889,GPT4,medalign,nursing_note,PROMPT2_ICL_entailment
118,204,20,18,2,0.9,9,5,4,0.5555555555555556,0.6870229007633587,GPT4,medalign,nursing_note,PROMPT2_ICL_entailment
119,205,29,16,13,0.5517241379310345,8,2,6,0.25,0.3440860215053763,GPT4,medalign,nursing_note,PROMPT2_ICL_entailment
120,206,6,6,0,1.0,4,4,0,1.0,1.0,GPT4,medalign,nursing_note,PROMPT2_ICL_entailment
121,207,12,10,2,0.8333333333333334,6,6,0,1.0,0.9090909090909092,GPT4,medalign,nursing_note,PROMPT2_ICL_entailment
122,208,12,12,0,1.0,10,7,3,0.7,0.8235294117647058,GPT4,medalign,nursing_note,PROMPT2_ICL_entailment
123,209,6,6,0,1.0,1,1,0,1.0,1.0,GPT4,medalign,nursing_note,PROMPT2_ICL_entailment
124,21,6,6,0,1.0,1,1,0,1.0,1.0,GPT4,medalign,nursing_note,PROMPT2_ICL_entailment
125,210,4,4,0,1.0,2,1,1,0.5,0.6666666666666666,GPT4,medalign,nursing_note,PROMPT2_ICL_entailment
126,211,5,4,1,0.8,2,2,0,1.0,0.888888888888889,GPT4,medalign,nursing_note,PROMPT2_ICL_entailment
127,212,8,8,0,1.0,3,3,0,1.0,1.0,GPT4,medalign,nursing_note,PROMPT2_ICL_entailment
128,213,16,15,1,0.9375,8,8,0,1.0,0.967741935483871,GPT4,medalign,nursing_note,PROMPT2_ICL_entailment
129,214,4,4,0,1.0,2,2,0,1.0,1.0,GPT4,medalign,nursing_note,PROMPT2_ICL_entailment
130,215,5,4,1,0.8,1,1,0,1.0,0.888888888888889,GPT4,medalign,nursing_note,PROMPT2_ICL_entailment
131,216,6,6,0,1.0,3,3,0,1.0,1.0,GPT4,medalign,nursing_note,PROMPT2_ICL_entailment
132,217,14,13,1,0.9285714285714286,11,6,5,0.5454545454545454,0.6872246696035241,GPT4,medalign,nursing_note,PROMPT2_ICL_entailment
133,218,17,17,0,1.0,3,3,0,1.0,1.0,GPT4,medalign,nursing_note,PROMPT2_ICL_entailment
134,219,11,10,1,0.9090909090909092,2,1,1,0.5,0.6451612903225806,GPT4,medalign,nursing_note,PROMPT2_ICL_entailment
135,22,3,3,0,1.0,1,1,0,1.0,1.0,GPT4,medalign,nursing_note,PROMPT2_ICL_entailment
136,220,11,9,2,0.8181818181818182,7,7,0,1.0,0.9,GPT4,medalign,nursing_note,PROMPT2_ICL_entailment
137,221,32,27,5,0.84375,23,14,9,0.6086956521739131,0.7072029934518241,GPT4,medalign,nursing_note,PROMPT2_ICL_entailment
138,222,7,7,0,1.0,4,4,0,1.0,1.0,GPT4,medalign,nursing_note,PROMPT2_ICL_entailment
139,223,4,4,0,1.0,2,2,0,1.0,1.0,GPT4,medalign,nursing_note,PROMPT2_ICL_entailment
140,224,15,14,1,0.9333333333333332,4,3,1,0.75,0.8316831683168316,GPT4,medalign,nursing_note,PROMPT2_ICL_entailment
141,225,10,10,0,1.0,2,2,0,1.0,1.0,GPT4,medalign,nursing_note,PROMPT2_ICL_entailment
142,226,18,13,5,0.7222222222222222,5,4,1,0.8,0.759124087591241,GPT4,medalign,nursing_note,PROMPT2_ICL_entailment
143,227,4,3,1,0.75,1,1,0,1.0,0.8571428571428571,GPT4,medalign,nursing_note,PROMPT2_ICL_entailment
144,228,34,30,4,0.8823529411764706,18,15,3,0.8333333333333334,0.8571428571428571,GPT4,medalign,nursing_note,PROMPT2_ICL_entailment
145,229,21,20,1,0.9523809523809524,7,5,2,0.7142857142857143,0.8163265306122449,GPT4,medalign,nursing_note,PROMPT2_ICL_entailment
146,23,19,14,5,0.7368421052631579,21,11,10,0.5238095238095238,0.6123260437375745,GPT4,medalign,nursing_note,PROMPT2_ICL_entailment
147,230,3,2,1,0.6666666666666666,1,1,0,1.0,0.8,GPT4,medalign,nursing_note,PROMPT2_ICL_entailment
148,231,15,15,0,1.0,13,9,4,0.6923076923076923,0.8181818181818181,GPT4,medalign,nursing_note,PROMPT2_ICL_entailment
149,232,13,13,0,1.0,6,3,3,0.5,0.6666666666666666,GPT4,medalign,nursing_note,PROMPT2_ICL_entailment
150,233,6,5,1,0.8333333333333334,4,3,1,0.75,0.7894736842105262,GPT4,medalign,nursing_note,PROMPT2_ICL_entailment
151,234,9,9,0,1.0,2,2,0,1.0,1.0,GPT4,medalign,nursing_note,PROMPT2_ICL_entailment
152,235,4,4,0,1.0,1,1,0,1.0,1.0,GPT4,medalign,nursing_note,PROMPT2_ICL_entailment
153,236,14,13,1,0.9285714285714286,14,11,3,0.7857142857142857,0.851190476190476,GPT4,medalign,nursing_note,PROMPT2_ICL_entailment
154,237,16,10,6,0.625,5,4,1,0.8,0.7017543859649122,GPT4,medalign,nursing_note,PROMPT2_ICL_entailment
155,238,12,12,0,1.0,4,4,0,1.0,1.0,GPT4,medalign,nursing_note,PROMPT2_ICL_entailment
156,239,12,12,0,1.0,4,4,0,1.0,1.0,GPT4,medalign,nursing_note,PROMPT2_ICL_entailment
157,24,15,2,13,0.1333333333333333,1,0,1,0.0,0.0,GPT4,medalign,nursing_note,PROMPT2_ICL_entailment
158,240,3,2,1,0.6666666666666666,2,1,1,0.5,0.5714285714285715,GPT4,medalign,nursing_note,PROMPT2_ICL_entailment
159,241,5,4,1,0.8,2,2,0,1.0,0.888888888888889,GPT4,medalign,nursing_note,PROMPT2_ICL_entailment
160,242,13,11,2,0.8461538461538461,2,2,0,1.0,0.9166666666666666,GPT4,medalign,nursing_note,PROMPT2_ICL_entailment
161,243,24,24,0,1.0,10,10,0,1.0,1.0,GPT4,medalign,nursing_note,PROMPT2_ICL_entailment
162,244,4,3,1,0.75,1,1,0,1.0,0.8571428571428571,GPT4,medalign,nursing_note,PROMPT2_ICL_entailment
163,245,5,4,1,0.8,1,1,0,1.0,0.888888888888889,GPT4,medalign,nursing_note,PROMPT2_ICL_entailment
164,246,4,4,0,1.0,1,1,0,1.0,1.0,GPT4,medalign,nursing_note,PROMPT2_ICL_entailment
165,247,10,9,1,0.9,5,5,0,1.0,0.9473684210526316,GPT4,medalign,nursing_note,PROMPT2_ICL_entailment
166,248,6,5,1,0.8333333333333334,1,1,0,1.0,0.9090909090909092,GPT4,medalign,nursing_note,PROMPT2_ICL_entailment
167,249,8,8,0,1.0,2,2,0,1.0,1.0,GPT4,medalign,nursing_note,PROMPT2_ICL_entailment
168,25,58,46,12,0.7931034482758621,33,24,9,0.7272727272727273,0.7587628865979381,GPT4,medalign,nursing_note,PROMPT2_ICL_entailment
169,26,7,6,1,0.8571428571428571,1,1,0,1.0,0.923076923076923,GPT4,medalign,nursing_note,PROMPT2_ICL_entailment
170,27,15,10,5,0.6666666666666666,2,1,1,0.5,0.5714285714285715,GPT4,medalign,nursing_note,PROMPT2_ICL_entailment
171,28,12,7,5,0.5833333333333334,4,3,1,0.75,0.6562499999999999,GPT4,medalign,nursing_note,PROMPT2_ICL_entailment
172,29,10,10,0,1.0,3,3,0,1.0,1.0,GPT4,medalign,nursing_note,PROMPT2_ICL_entailment
173,3,6,6,0,1.0,2,1,1,0.5,0.6666666666666666,GPT4,medalign,nursing_note,PROMPT2_ICL_entailment
174,30,4,4,0,1.0,1,1,0,1.0,1.0,GPT4,medalign,nursing_note,PROMPT2_ICL_entailment
175,31,3,1,2,0.3333333333333333,1,1,0,1.0,0.5,GPT4,medalign,nursing_note,PROMPT2_ICL_entailment
176,32,5,3,2,0.6,2,2,0,1.0,0.7499999999999999,GPT4,medalign,nursing_note,PROMPT2_ICL_entailment
177,33,14,13,1,0.9285714285714286,5,5,0,1.0,0.962962962962963,GPT4,medalign,nursing_note,PROMPT2_ICL_entailment
178,34,13,11,2,0.8461538461538461,4,1,3,0.25,0.3859649122807017,GPT4,medalign,nursing_note,PROMPT2_ICL_entailment
179,35,9,9,0,1.0,4,2,2,0.5,0.6666666666666666,GPT4,medalign,nursing_note,PROMPT2_ICL_entailment
180,36,16,10,6,0.625,5,3,2,0.6,0.6122448979591836,GPT4,medalign,nursing_note,PROMPT2_ICL_entailment
181,37,10,10,0,1.0,3,3,0,1.0,1.0,GPT4,medalign,nursing_note,PROMPT2_ICL_entailment
182,38,16,13,3,0.8125,5,3,2,0.6,0.6902654867256637,GPT4,medalign,nursing_note,PROMPT2_ICL_entailment
183,39,6,6,0,1.0,1,1,0,1.0,1.0,GPT4,medalign,nursing_note,PROMPT2_ICL_entailment
184,4,5,4,1,0.8,3,3,0,1.0,0.888888888888889,GPT4,medalign,nursing_note,PROMPT2_ICL_entailment
185,40,18,13,5,0.7222222222222222,8,3,5,0.375,0.4936708860759493,GPT4,medalign,nursing_note,PROMPT2_ICL_entailment
186,41,3,2,1,0.6666666666666666,1,1,0,1.0,0.8,GPT4,medalign,nursing_note,PROMPT2_ICL_entailment
187,42,16,9,7,0.5625,8,2,6,0.25,0.3461538461538461,GPT4,medalign,nursing_note,PROMPT2_ICL_entailment
188,43,5,4,1,0.8,2,2,0,1.0,0.888888888888889,GPT4,medalign,nursing_note,PROMPT2_ICL_entailment
189,44,6,6,0,1.0,1,1,0,1.0,1.0,GPT4,medalign,nursing_note,PROMPT2_ICL_entailment
190,45,2,1,1,0.5,1,1,0,1.0,0.6666666666666666,GPT4,medalign,nursing_note,PROMPT2_ICL_entailment
191,46,12,12,0,1.0,5,5,0,1.0,1.0,GPT4,medalign,nursing_note,PROMPT2_ICL_entailment
192,47,30,30,0,1.0,20,17,3,0.85,0.9189189189189187,GPT4,medalign,nursing_note,PROMPT2_ICL_entailment
193,48,5,5,0,1.0,2,2,0,1.0,1.0,GPT4,medalign,nursing_note,PROMPT2_ICL_entailment
194,49,8,7,1,0.875,2,2,0,1.0,0.9333333333333332,GPT4,medalign,nursing_note,PROMPT2_ICL_entailment
195,5,14,13,1,0.9285714285714286,5,4,1,0.8,0.859504132231405,GPT4,medalign,nursing_note,PROMPT2_ICL_entailment
196,50,4,2,2,0.5,1,1,0,1.0,0.6666666666666666,GPT4,medalign,nursing_note,PROMPT2_ICL_entailment
197,51,5,5,0,1.0,2,2,0,1.0,1.0,GPT4,medalign,nursing_note,PROMPT2_ICL_entailment
198,52,8,8,0,1.0,4,4,0,1.0,1.0,GPT4,medalign,nursing_note,PROMPT2_ICL_entailment
199,53,4,4,0,1.0,1,1,0,1.0,1.0,GPT4,medalign,nursing_note,PROMPT2_ICL_entailment
200,54,8,6,2,0.75,7,4,3,0.5714285714285714,0.6486486486486486,GPT4,medalign,nursing_note,PROMPT2_ICL_entailment
201,55,7,7,0,1.0,2,2,0,1.0,1.0,GPT4,medalign,nursing_note,PROMPT2_ICL_entailment
202,56,7,7,0,1.0,3,2,1,0.6666666666666666,0.8,GPT4,medalign,nursing_note,PROMPT2_ICL_entailment
203,57,7,5,2,0.7142857142857143,4,2,2,0.5,0.588235294117647,GPT4,medalign,nursing_note,PROMPT2_ICL_entailment
204,58,5,4,1,0.8,1,1,0,1.0,0.888888888888889,GPT4,medalign,nursing_note,PROMPT2_ICL_entailment
205,59,4,3,1,0.75,1,1,0,1.0,0.8571428571428571,GPT4,medalign,nursing_note,PROMPT2_ICL_entailment
206,6,6,6,0,1.0,3,3,0,1.0,1.0,GPT4,medalign,nursing_note,PROMPT2_ICL_entailment
207,60,10,10,0,1.0,9,8,1,0.8888888888888888,0.9411764705882352,GPT4,medalign,nursing_note,PROMPT2_ICL_entailment
208,61,2,2,0,1.0,1,1,0,1.0,1.0,GPT4,medalign,nursing_note,PROMPT2_ICL_entailment
209,62,18,17,1,0.9444444444444444,5,5,0,1.0,0.9714285714285714,GPT4,medalign,nursing_note,PROMPT2_ICL_entailment
210,63,15,12,3,0.8,7,6,1,0.8571428571428571,0.8275862068965518,GPT4,medalign,nursing_note,PROMPT2_ICL_entailment
211,64,1,0,1,0.0,1,0,1,0.0,,GPT4,medalign,nursing_note,PROMPT2_ICL_entailment
212,65,10,8,2,0.8,2,1,1,0.5,0.6153846153846154,GPT4,medalign,nursing_note,PROMPT2_ICL_entailment
213,66,7,7,0,1.0,4,4,0,1.0,1.0,GPT4,medalign,nursing_note,PROMPT2_ICL_entailment
214,67,5,5,0,1.0,4,3,1,0.75,0.8571428571428571,GPT4,medalign,nursing_note,PROMPT2_ICL_entailment
215,68,6,5,1,0.8333333333333334,1,1,0,1.0,0.9090909090909092,GPT4,medalign,nursing_note,PROMPT2_ICL_entailment
216,69,10,10,0,1.0,2,2,0,1.0,1.0,GPT4,medalign,nursing_note,PROMPT2_ICL_entailment
217,7,6,6,0,1.0,1,1,0,1.0,1.0,GPT4,medalign,nursing_note,PROMPT2_ICL_entailment
218,70,11,11,0,1.0,1,1,0,1.0,1.0,GPT4,medalign,nursing_note,PROMPT2_ICL_entailment
219,71,15,13,2,0.8666666666666667,1,1,0,1.0,0.9285714285714286,GPT4,medalign,nursing_note,PROMPT2_ICL_entailment
220,72,3,3,0,1.0,1,1,0,1.0,1.0,GPT4,medalign,nursing_note,PROMPT2_ICL_entailment
221,73,5,5,0,1.0,2,2,0,1.0,1.0,GPT4,medalign,nursing_note,PROMPT2_ICL_entailment
222,74,16,8,8,0.5,5,2,3,0.4,0.4444444444444445,GPT4,medalign,nursing_note,PROMPT2_ICL_entailment
223,75,2,1,1,0.5,1,1,0,1.0,0.6666666666666666,GPT4,medalign,nursing_note,PROMPT2_ICL_entailment
224,76,17,17,0,1.0,5,3,2,0.6,0.7499999999999999,GPT4,medalign,nursing_note,PROMPT2_ICL_entailment
225,77,5,4,1,0.8,3,2,1,0.6666666666666666,0.7272727272727272,GPT4,medalign,nursing_note,PROMPT2_ICL_entailment
226,78,8,6,2,0.75,3,3,0,1.0,0.8571428571428571,GPT4,medalign,nursing_note,PROMPT2_ICL_entailment
227,79,10,8,2,0.8,8,7,1,0.875,0.8358208955223881,GPT4,medalign,nursing_note,PROMPT2_ICL_entailment
228,8,16,14,2,0.875,8,7,1,0.875,0.875,GPT4,medalign,nursing_note,PROMPT2_ICL_entailment
229,80,11,10,1,0.9090909090909092,10,8,2,0.8,0.8510638297872342,GPT4,medalign,nursing_note,PROMPT2_ICL_entailment
230,81,4,3,1,0.75,1,1,0,1.0,0.8571428571428571,GPT4,medalign,nursing_note,PROMPT2_ICL_entailment
231,82,4,3,1,0.75,3,3,0,1.0,0.8571428571428571,GPT4,medalign,nursing_note,PROMPT2_ICL_entailment
232,83,6,6,0,1.0,3,1,2,0.3333333333333333,0.5,GPT4,medalign,nursing_note,PROMPT2_ICL_entailment
233,84,9,8,1,0.8888888888888888,2,1,1,0.5,0.64,GPT4,medalign,nursing_note,PROMPT2_ICL_entailment
234,85,13,12,1,0.9230769230769232,8,7,1,0.875,0.8983957219251337,GPT4,medalign,nursing_note,PROMPT2_ICL_entailment
235,86,4,4,0,1.0,3,3,0,1.0,1.0,GPT4,medalign,nursing_note,PROMPT2_ICL_entailment
236,87,3,3,0,1.0,2,2,0,1.0,1.0,GPT4,medalign,nursing_note,PROMPT2_ICL_entailment
237,88,16,16,0,1.0,7,6,1,0.8571428571428571,0.923076923076923,GPT4,medalign,nursing_note,PROMPT2_ICL_entailment
238,89,8,8,0,1.0,6,6,0,1.0,1.0,GPT4,medalign,nursing_note,PROMPT2_ICL_entailment
239,9,6,6,0,1.0,2,2,0,1.0,1.0,GPT4,medalign,nursing_note,PROMPT2_ICL_entailment
240,90,7,6,1,0.8571428571428571,1,1,0,1.0,0.923076923076923,GPT4,medalign,nursing_note,PROMPT2_ICL_entailment
241,91,5,5,0,1.0,1,1,0,1.0,1.0,GPT4,medalign,nursing_note,PROMPT2_ICL_entailment
242,92,6,6,0,1.0,4,2,2,0.5,0.6666666666666666,GPT4,medalign,nursing_note,PROMPT2_ICL_entailment
243,93,3,3,0,1.0,1,1,0,1.0,1.0,GPT4,medalign,nursing_note,PROMPT2_ICL_entailment
244,94,3,3,0,1.0,2,1,1,0.5,0.6666666666666666,GPT4,medalign,nursing_note,PROMPT2_ICL_entailment
245,95,3,3,0,1.0,1,1,0,1.0,1.0,GPT4,medalign,nursing_note,PROMPT2_ICL_entailment
246,96,3,2,1,0.6666666666666666,1,1,0,1.0,0.8,GPT4,medalign,nursing_note,PROMPT2_ICL_entailment
247,97,7,7,0,1.0,2,2,0,1.0,1.0,GPT4,medalign,nursing_note,PROMPT2_ICL_entailment
248,98,11,11,0,1.0,5,4,1,0.8,0.888888888888889,GPT4,medalign,nursing_note,PROMPT2_ICL_entailment
249,99,12,12,0,1.0,7,5,2,0.7142857142857143,0.8333333333333333,GPT4,medalign,nursing_note,PROMPT2_ICL_entailment
0,0,10,10,0,1.0,6,6,0,1.0,1.0,GPT4,medalign,nursing_note,PROMPT2_entailment
1,1,6,6,0,1.0,1,1,0,1.0,1.0,GPT4,medalign,nursing_note,PROMPT2_entailment
2,10,7,7,0,1.0,5,4,1,0.8,0.888888888888889,GPT4,medalign,nursing_note,PROMPT2_entailment
3,100,11,11,0,1.0,10,9,1,0.9,0.9473684210526316,GPT4,medalign,nursing_note,PROMPT2_entailment
4,101,6,6,0,1.0,1,1,0,1.0,1.0,GPT4,medalign,nursing_note,PROMPT2_entailment
5,102,7,7,0,1.0,4,3,1,0.75,0.8571428571428571,GPT4,medalign,nursing_note,PROMPT2_entailment
6,103,3,3,0,1.0,2,2,0,1.0,1.0,GPT4,medalign,nursing_note,PROMPT2_entailment
7,104,16,14,2,0.875,15,10,5,0.6666666666666666,0.7567567567567567,GPT4,medalign,nursing_note,PROMPT2_entailment
8,105,3,3,0,1.0,1,1,0,1.0,1.0,GPT4,medalign,nursing_note,PROMPT2_entailment
9,106,5,5,0,1.0,1,1,0,1.0,1.0,GPT4,medalign,nursing_note,PROMPT2_entailment
10,107,9,9,0,1.0,4,4,0,1.0,1.0,GPT4,medalign,nursing_note,PROMPT2_entailment
11,108,2,2,0,1.0,2,2,0,1.0,1.0,GPT4,medalign,nursing_note,PROMPT2_entailment
12,109,7,7,0,1.0,5,5,0,1.0,1.0,GPT4,medalign,nursing_note,PROMPT2_entailment
13,11,21,0,21,0.0,1,0,1,0.0,,GPT4,medalign,nursing_note,PROMPT2_entailment
14,110,14,10,4,0.7142857142857143,6,3,3,0.5,0.588235294117647,GPT4,medalign,nursing_note,PROMPT2_entailment
15,111,2,1,1,0.5,1,1,0,1.0,0.6666666666666666,GPT4,medalign,nursing_note,PROMPT2_entailment
16,112,4,4,0,1.0,2,2,0,1.0,1.0,GPT4,medalign,nursing_note,PROMPT2_entailment
17,113,1,0,1,0.0,1,0,1,0.0,,GPT4,medalign,nursing_note,PROMPT2_entailment
18,114,3,2,1,0.6666666666666666,1,1,0,1.0,0.8,GPT4,medalign,nursing_note,PROMPT2_entailment
19,115,13,12,1,0.9230769230769232,7,4,3,0.5714285714285714,0.7058823529411765,GPT4,medalign,nursing_note,PROMPT2_entailment
20,116,9,8,1,0.8888888888888888,5,4,1,0.8,0.8421052631578948,GPT4,medalign,nursing_note,PROMPT2_entailment
21,117,15,14,1,0.9333333333333332,13,9,4,0.6923076923076923,0.7949526813880127,GPT4,medalign,nursing_note,PROMPT2_entailment
22,118,3,3,0,1.0,2,2,0,1.0,1.0,GPT4,medalign,nursing_note,PROMPT2_entailment
23,119,2,0,2,0.0,2,2,0,1.0,0.0,GPT4,medalign,nursing_note,PROMPT2_entailment
24,12,2,2,0,1.0,1,1,0,1.0,1.0,GPT4,medalign,nursing_note,PROMPT2_entailment
25,120,8,8,0,1.0,7,5,2,0.7142857142857143,0.8333333333333333,GPT4,medalign,nursing_note,PROMPT2_entailment
26,121,3,3,0,1.0,1,1,0,1.0,1.0,GPT4,medalign,nursing_note,PROMPT2_entailment
27,122,2,2,0,1.0,1,1,0,1.0,1.0,GPT4,medalign,nursing_note,PROMPT2_entailment
28,123,4,4,0,1.0,4,4,0,1.0,1.0,GPT4,medalign,nursing_note,PROMPT2_entailment
29,124,18,16,2,0.8888888888888888,14,11,3,0.7857142857142857,0.8341232227488152,GPT4,medalign,nursing_note,PROMPT2_entailment
30,125,12,11,1,0.9166666666666666,9,9,0,1.0,0.9565217391304348,GPT4,medalign,nursing_note,PROMPT2_entailment
31,126,3,3,0,1.0,2,2,0,1.0,1.0,GPT4,medalign,nursing_note,PROMPT2_entailment
32,127,1,1,0,1.0,1,1,0,1.0,1.0,GPT4,medalign,nursing_note,PROMPT2_entailment
33,128,4,4,0,1.0,2,2,0,1.0,1.0,GPT4,medalign,nursing_note,PROMPT2_entailment
34,129,32,31,1,0.96875,20,20,0,1.0,0.984126984126984,GPT4,medalign,nursing_note,PROMPT2_entailment
35,13,7,7,0,1.0,5,5,0,1.0,1.0,GPT4,medalign,nursing_note,PROMPT2_entailment
36,130,5,5,0,1.0,2,2,0,1.0,1.0,GPT4,medalign,nursing_note,PROMPT2_entailment
37,131,3,3,0,1.0,1,1,0,1.0,1.0,GPT4,medalign,nursing_note,PROMPT2_entailment
38,132,6,6,0,1.0,2,2,0,1.0,1.0,GPT4,medalign,nursing_note,PROMPT2_entailment
39,133,11,9,2,0.8181818181818182,14,8,6,0.5714285714285714,0.6728971962616823,GPT4,medalign,nursing_note,PROMPT2_entailment
40,134,5,5,0,1.0,3,3,0,1.0,1.0,GPT4,medalign,nursing_note,PROMPT2_entailment
41,135,5,5,0,1.0,2,1,1,0.5,0.6666666666666666,GPT4,medalign,nursing_note,PROMPT2_entailment
42,136,55,25,30,0.4545454545454545,51,25,26,0.4901960784313725,0.4716981132075472,GPT4,medalign,nursing_note,PROMPT2_entailment
43,137,15,15,0,1.0,6,6,0,1.0,1.0,GPT4,medalign,nursing_note,PROMPT2_entailment
44,138,2,1,1,0.5,1,1,0,1.0,0.6666666666666666,GPT4,medalign,nursing_note,PROMPT2_entailment
45,139,3,3,0,1.0,1,1,0,1.0,1.0,GPT4,medalign,nursing_note,PROMPT2_entailment
46,14,18,0,18,0.0,1,0,1,0.0,,GPT4,medalign,nursing_note,PROMPT2_entailment
47,140,4,4,0,1.0,3,3,0,1.0,1.0,GPT4,medalign,nursing_note,PROMPT2_entailment
48,141,3,3,0,1.0,1,1,0,1.0,1.0,GPT4,medalign,nursing_note,PROMPT2_entailment
49,142,3,3,0,1.0,1,1,0,1.0,1.0,GPT4,medalign,nursing_note,PROMPT2_entailment
50,143,21,0,21,0.0,1,1,0,1.0,0.0,GPT4,medalign,nursing_note,PROMPT2_entailment
51,144,2,2,0,1.0,1,1,0,1.0,1.0,GPT4,medalign,nursing_note,PROMPT2_entailment
52,145,4,4,0,1.0,4,3,1,0.75,0.8571428571428571,GPT4,medalign,nursing_note,PROMPT2_entailment
53,146,14,11,3,0.7857142857142857,3,1,2,0.3333333333333333,0.4680851063829786,GPT4,medalign,nursing_note,PROMPT2_entailment
54,147,8,8,0,1.0,6,3,3,0.5,0.6666666666666666,GPT4,medalign,nursing_note,PROMPT2_entailment
55,148,10,10,0,1.0,7,7,0,1.0,1.0,GPT4,medalign,nursing_note,PROMPT2_entailment
56,149,3,3,0,1.0,1,0,1,0.0,0.0,GPT4,medalign,nursing_note,PROMPT2_entailment
57,15,5,5,0,1.0,1,1,0,1.0,1.0,GPT4,medalign,nursing_note,PROMPT2_entailment
58,150,4,4,0,1.0,1,1,0,1.0,1.0,GPT4,medalign,nursing_note,PROMPT2_entailment
59,151,13,13,0,1.0,8,6,2,0.75,0.8571428571428571,GPT4,medalign,nursing_note,PROMPT2_entailment
60,152,5,5,0,1.0,4,4,0,1.0,1.0,GPT4,medalign,nursing_note,PROMPT2_entailment
61,153,12,11,1,0.9166666666666666,14,10,4,0.7142857142857143,0.8029197080291971,GPT4,medalign,nursing_note,PROMPT2_entailment
62,154,3,3,0,1.0,1,1,0,1.0,1.0,GPT4,medalign,nursing_note,PROMPT2_entailment
63,155,19,19,0,1.0,14,9,5,0.6428571428571429,0.782608695652174,GPT4,medalign,nursing_note,PROMPT2_entailment
64,156,10,10,0,1.0,1,0,1,0.0,0.0,GPT4,medalign,nursing_note,PROMPT2_entailment
65,157,4,4,0,1.0,3,2,1,0.6666666666666666,0.8,GPT4,medalign,nursing_note,PROMPT2_entailment
66,158,8,8,0,1.0,1,1,0,1.0,1.0,GPT4,medalign,nursing_note,PROMPT2_entailment
67,159,6,6,0,1.0,3,3,0,1.0,1.0,GPT4,medalign,nursing_note,PROMPT2_entailment
68,16,12,11,1,0.9166666666666666,3,2,1,0.6666666666666666,0.7719298245614035,GPT4,medalign,nursing_note,PROMPT2_entailment
69,160,3,3,0,1.0,1,1,0,1.0,1.0,GPT4,medalign,nursing_note,PROMPT2_entailment
70,161,4,4,0,1.0,1,1,0,1.0,1.0,GPT4,medalign,nursing_note,PROMPT2_entailment
71,162,8,7,1,0.875,8,8,0,1.0,0.9333333333333332,GPT4,medalign,nursing_note,PROMPT2_entailment
72,163,5,4,1,0.8,3,3,0,1.0,0.888888888888889,GPT4,medalign,nursing_note,PROMPT2_entailment
73,164,5,5,0,1.0,2,2,0,1.0,1.0,GPT4,medalign,nursing_note,PROMPT2_entailment
74,165,6,6,0,1.0,4,4,0,1.0,1.0,GPT4,medalign,nursing_note,PROMPT2_entailment
75,166,10,9,1,0.9,5,4,1,0.8,0.8470588235294118,GPT4,medalign,nursing_note,PROMPT2_entailment
76,167,14,13,1,0.9285714285714286,2,1,1,0.5,0.65,GPT4,medalign,nursing_note,PROMPT2_entailment
77,168,5,5,0,1.0,3,3,0,1.0,1.0,GPT4,medalign,nursing_note,PROMPT2_entailment
78,169,12,11,1,0.9166666666666666,9,8,1,0.8888888888888888,0.9025641025641026,GPT4,medalign,nursing_note,PROMPT2_entailment
79,17,2,2,0,1.0,1,0,1,0.0,0.0,GPT4,medalign,nursing_note,PROMPT2_entailment
80,170,3,3,0,1.0,1,1,0,1.0,1.0,GPT4,medalign,nursing_note,PROMPT2_entailment
81,171,11,8,3,0.7272727272727273,7,4,3,0.5714285714285714,0.64,GPT4,medalign,nursing_note,PROMPT2_entailment
82,172,13,12,1,0.9230769230769232,12,7,5,0.5833333333333334,0.7148936170212767,GPT4,medalign,nursing_note,PROMPT2_entailment
83,173,10,10,0,1.0,1,1,0,1.0,1.0,GPT4,medalign,nursing_note,PROMPT2_entailment
84,174,4,4,0,1.0,1,1,0,1.0,1.0,GPT4,medalign,nursing_note,PROMPT2_entailment
85,175,3,3,0,1.0,2,2,0,1.0,1.0,GPT4,medalign,nursing_note,PROMPT2_entailment
86,176,10,7,3,0.7,3,2,1,0.6666666666666666,0.6829268292682926,GPT4,medalign,nursing_note,PROMPT2_entailment
87,177,8,7,1,0.875,8,6,2,0.75,0.8076923076923077,GPT4,medalign,nursing_note,PROMPT2_entailment
88,178,10,10,0,1.0,10,7,3,0.7,0.8235294117647058,GPT4,medalign,nursing_note,PROMPT2_entailment
89,179,7,4,3,0.5714285714285714,2,1,1,0.5,0.5333333333333333,GPT4,medalign,nursing_note,PROMPT2_entailment
90,18,12,11,1,0.9166666666666666,3,3,0,1.0,0.9565217391304348,GPT4,medalign,nursing_note,PROMPT2_entailment
91,180,9,9,0,1.0,4,3,1,0.75,0.8571428571428571,GPT4,medalign,nursing_note,PROMPT2_entailment
92,181,7,7,0,1.0,7,7,0,1.0,1.0,GPT4,medalign,nursing_note,PROMPT2_entailment
93,182,3,3,0,1.0,2,1,1,0.5,0.6666666666666666,GPT4,medalign,nursing_note,PROMPT2_entailment
94,183,8,8,0,1.0,6,6,0,1.0,1.0,GPT4,medalign,nursing_note,PROMPT2_entailment
95,184,12,12,0,1.0,11,11,0,1.0,1.0,GPT4,medalign,nursing_note,PROMPT2_entailment
96,185,5,4,1,0.8,3,3,0,1.0,0.888888888888889,GPT4,medalign,nursing_note,PROMPT2_entailment
97,186,4,4,0,1.0,3,3,0,1.0,1.0,GPT4,medalign,nursing_note,PROMPT2_entailment
98,187,1,1,0,1.0,1,1,0,1.0,1.0,GPT4,medalign,nursing_note,PROMPT2_entailment
99,188,2,2,0,1.0,3,3,0,1.0,1.0,GPT4,medalign,nursing_note,PROMPT2_entailment
100,189,12,12,0,1.0,10,7,3,0.7,0.8235294117647058,GPT4,medalign,nursing_note,PROMPT2_entailment
101,19,14,14,0,1.0,7,5,2,0.7142857142857143,0.8333333333333333,GPT4,medalign,nursing_note,PROMPT2_entailment
102,190,4,4,0,1.0,2,2,0,1.0,1.0,GPT4,medalign,nursing_note,PROMPT2_entailment
103,191,15,15,0,1.0,5,3,2,0.6,0.7499999999999999,GPT4,medalign,nursing_note,PROMPT2_entailment
104,192,3,3,0,1.0,1,1,0,1.0,1.0,GPT4,medalign,nursing_note,PROMPT2_entailment
105,193,6,6,0,1.0,3,3,0,1.0,1.0,GPT4,medalign,nursing_note,PROMPT2_entailment
106,194,3,3,0,1.0,2,1,1,0.5,0.6666666666666666,GPT4,medalign,nursing_note,PROMPT2_entailment
107,195,16,14,2,0.875,10,7,3,0.7,0.7777777777777777,GPT4,medalign,nursing_note,PROMPT2_entailment
108,196,4,4,0,1.0,1,1,0,1.0,1.0,GPT4,medalign,nursing_note,PROMPT2_entailment
109,197,2,2,0,1.0,1,1,0,1.0,1.0,GPT4,medalign,nursing_note,PROMPT2_entailment
110,198,16,16,0,1.0,8,6,2,0.75,0.8571428571428571,GPT4,medalign,nursing_note,PROMPT2_entailment
111,199,16,15,1,0.9375,7,7,0,1.0,0.967741935483871,GPT4,medalign,nursing_note,PROMPT2_entailment
112,2,11,9,2,0.8181818181818182,5,5,0,1.0,0.9,GPT4,medalign,nursing_note,PROMPT2_entailment
113,20,6,4,2,0.6666666666666666,2,2,0,1.0,0.8,GPT4,medalign,nursing_note,PROMPT2_entailment
114,200,3,3,0,1.0,3,3,0,1.0,1.0,GPT4,medalign,nursing_note,PROMPT2_entailment
115,201,3,3,0,1.0,1,1,0,1.0,1.0,GPT4,medalign,nursing_note,PROMPT2_entailment
116,202,2,2,0,1.0,1,0,1,0.0,0.0,GPT4,medalign,nursing_note,PROMPT2_entailment
117,203,4,4,0,1.0,1,1,0,1.0,1.0,GPT4,medalign,nursing_note,PROMPT2_entailment
118,204,16,12,4,0.75,9,6,3,0.6666666666666666,0.7058823529411765,GPT4,medalign,nursing_note,PROMPT2_entailment
119,205,27,15,12,0.5555555555555556,8,3,5,0.375,0.4477611940298507,GPT4,medalign,nursing_note,PROMPT2_entailment
120,206,4,4,0,1.0,4,4,0,1.0,1.0,GPT4,medalign,nursing_note,PROMPT2_entailment
121,207,10,10,0,1.0,6,6,0,1.0,1.0,GPT4,medalign,nursing_note,PROMPT2_entailment
122,208,13,13,0,1.0,10,9,1,0.9,0.9473684210526316,GPT4,medalign,nursing_note,PROMPT2_entailment
123,209,6,6,0,1.0,1,0,1,0.0,0.0,GPT4,medalign,nursing_note,PROMPT2_entailment
124,21,5,5,0,1.0,1,1,0,1.0,1.0,GPT4,medalign,nursing_note,PROMPT2_entailment
125,210,4,4,0,1.0,2,1,1,0.5,0.6666666666666666,GPT4,medalign,nursing_note,PROMPT2_entailment
126,211,4,4,0,1.0,2,2,0,1.0,1.0,GPT4,medalign,nursing_note,PROMPT2_entailment
127,212,7,7,0,1.0,3,3,0,1.0,1.0,GPT4,medalign,nursing_note,PROMPT2_entailment
128,213,14,14,0,1.0,8,7,1,0.875,0.9333333333333332,GPT4,medalign,nursing_note,PROMPT2_entailment
129,214,3,3,0,1.0,2,2,0,1.0,1.0,GPT4,medalign,nursing_note,PROMPT2_entailment
130,215,2,2,0,1.0,1,1,0,1.0,1.0,GPT4,medalign,nursing_note,PROMPT2_entailment
131,216,5,5,0,1.0,3,3,0,1.0,1.0,GPT4,medalign,nursing_note,PROMPT2_entailment
132,217,13,11,2,0.8461538461538461,11,7,4,0.6363636363636364,0.7264150943396226,GPT4,medalign,nursing_note,PROMPT2_entailment
133,218,19,19,0,1.0,3,3,0,1.0,1.0,GPT4,medalign,nursing_note,PROMPT2_entailment
134,219,5,5,0,1.0,2,2,0,1.0,1.0,GPT4,medalign,nursing_note,PROMPT2_entailment
135,22,2,2,0,1.0,1,1,0,1.0,1.0,GPT4,medalign,nursing_note,PROMPT2_entailment
136,220,9,7,2,0.7777777777777778,7,4,3,0.5714285714285714,0.6588235294117646,GPT4,medalign,nursing_note,PROMPT2_entailment
137,221,29,28,1,0.9655172413793104,23,12,11,0.5217391304347826,0.6774193548387096,GPT4,medalign,nursing_note,PROMPT2_entailment
138,222,6,6,0,1.0,4,4,0,1.0,1.0,GPT4,medalign,nursing_note,PROMPT2_entailment
139,223,3,3,0,1.0,2,1,1,0.5,0.6666666666666666,GPT4,medalign,nursing_note,PROMPT2_entailment
140,224,10,10,0,1.0,4,2,2,0.5,0.6666666666666666,GPT4,medalign,nursing_note,PROMPT2_entailment
141,225,5,5,0,1.0,2,2,0,1.0,1.0,GPT4,medalign,nursing_note,PROMPT2_entailment
142,226,14,10,4,0.7142857142857143,5,4,1,0.8,0.7547169811320756,GPT4,medalign,nursing_note,PROMPT2_entailment
143,227,25,0,25,0.0,1,1,0,1.0,0.0,GPT4,medalign,nursing_note,PROMPT2_entailment
144,228,28,24,4,0.8571428571428571,18,16,2,0.8888888888888888,0.8727272727272727,GPT4,medalign,nursing_note,PROMPT2_entailment
145,229,12,12,0,1.0,7,6,1,0.8571428571428571,0.923076923076923,GPT4,medalign,nursing_note,PROMPT2_entailment
146,23,24,23,1,0.9583333333333334,21,10,11,0.4761904761904761,0.636237897648686,GPT4,medalign,nursing_note,PROMPT2_entailment
147,230,2,2,0,1.0,1,1,0,1.0,1.0,GPT4,medalign,nursing_note,PROMPT2_entailment
148,231,13,12,1,0.9230769230769232,13,8,5,0.6153846153846154,0.7384615384615384,GPT4,medalign,nursing_note,PROMPT2_entailment
149,232,9,9,0,1.0,6,2,4,0.3333333333333333,0.5,GPT4,medalign,nursing_note,PROMPT2_entailment
150,233,5,3,2,0.6,4,4,0,1.0,0.7499999999999999,GPT4,medalign,nursing_note,PROMPT2_entailment
151,234,8,8,0,1.0,2,2,0,1.0,1.0,GPT4,medalign,nursing_note,PROMPT2_entailment
152,235,2,2,0,1.0,1,1,0,1.0,1.0,GPT4,medalign,nursing_note,PROMPT2_entailment
153,236,13,12,1,0.9230769230769232,14,10,4,0.7142857142857143,0.8053691275167787,GPT4,medalign,nursing_note,PROMPT2_entailment
154,237,12,10,2,0.8333333333333334,5,5,0,1.0,0.9090909090909092,GPT4,medalign,nursing_note,PROMPT2_entailment
155,238,9,9,0,1.0,4,4,0,1.0,1.0,GPT4,medalign,nursing_note,PROMPT2_entailment
156,239,9,9,0,1.0,4,4,0,1.0,1.0,GPT4,medalign,nursing_note,PROMPT2_entailment
157,24,4,4,0,1.0,1,1,0,1.0,1.0,GPT4,medalign,nursing_note,PROMPT2_entailment
158,240,3,3,0,1.0,2,2,0,1.0,1.0,GPT4,medalign,nursing_note,PROMPT2_entailment
159,241,4,4,0,1.0,2,2,0,1.0,1.0,GPT4,medalign,nursing_note,PROMPT2_entailment
160,242,13,12,1,0.9230769230769232,2,1,1,0.5,0.6486486486486487,GPT4,medalign,nursing_note,PROMPT2_entailment
161,243,21,21,0,1.0,10,9,1,0.9,0.9473684210526316,GPT4,medalign,nursing_note,PROMPT2_entailment
162,244,3,3,0,1.0,1,1,0,1.0,1.0,GPT4,medalign,nursing_note,PROMPT2_entailment
163,245,3,3,0,1.0,1,1,0,1.0,1.0,GPT4,medalign,nursing_note,PROMPT2_entailment
164,246,2,2,0,1.0,1,1,0,1.0,1.0,GPT4,medalign,nursing_note,PROMPT2_entailment
165,247,7,7,0,1.0,5,5,0,1.0,1.0,GPT4,medalign,nursing_note,PROMPT2_entailment
166,248,3,3,0,1.0,1,1,0,1.0,1.0,GPT4,medalign,nursing_note,PROMPT2_entailment
167,249,8,8,0,1.0,2,2,0,1.0,1.0,GPT4,medalign,nursing_note,PROMPT2_entailment
168,25,48,45,3,0.9375,33,17,16,0.5151515151515151,0.664928292046936,GPT4,medalign,nursing_note,PROMPT2_entailment
169,26,5,5,0,1.0,1,1,0,1.0,1.0,GPT4,medalign,nursing_note,PROMPT2_entailment
170,27,15,11,4,0.7333333333333333,2,2,0,1.0,0.846153846153846,GPT4,medalign,nursing_note,PROMPT2_entailment
171,28,9,9,0,1.0,4,3,1,0.75,0.8571428571428571,GPT4,medalign,nursing_note,PROMPT2_entailment
172,29,6,6,0,1.0,3,2,1,0.6666666666666666,0.8,GPT4,medalign,nursing_note,PROMPT2_entailment
173,3,5,4,1,0.8,2,1,1,0.5,0.6153846153846154,GPT4,medalign,nursing_note,PROMPT2_entailment
174,30,4,4,0,1.0,1,1,0,1.0,1.0,GPT4,medalign,nursing_note,PROMPT2_entailment
175,31,1,1,0,1.0,1,1,0,1.0,1.0,GPT4,medalign,nursing_note,PROMPT2_entailment
176,32,4,4,0,1.0,2,2,0,1.0,1.0,GPT4,medalign,nursing_note,PROMPT2_entailment
177,33,9,9,0,1.0,5,4,1,0.8,0.888888888888889,GPT4,medalign,nursing_note,PROMPT2_entailment
178,34,9,9,0,1.0,4,1,3,0.25,0.4,GPT4,medalign,nursing_note,PROMPT2_entailment
179,35,9,9,0,1.0,4,1,3,0.25,0.4,GPT4,medalign,nursing_note,PROMPT2_entailment
180,36,15,10,5,0.6666666666666666,5,4,1,0.8,0.7272727272727272,GPT4,medalign,nursing_note,PROMPT2_entailment
181,37,5,5,0,1.0,3,3,0,1.0,1.0,GPT4,medalign,nursing_note,PROMPT2_entailment
182,38,14,12,2,0.8571428571428571,5,2,3,0.4,0.5454545454545455,GPT4,medalign,nursing_note,PROMPT2_entailment
183,39,3,3,0,1.0,1,1,0,1.0,1.0,GPT4,medalign,nursing_note,PROMPT2_entailment
184,4,4,3,1,0.75,3,3,0,1.0,0.8571428571428571,GPT4,medalign,nursing_note,PROMPT2_entailment
185,40,10,10,0,1.0,8,6,2,0.75,0.8571428571428571,GPT4,medalign,nursing_note,PROMPT2_entailment
186,41,1,1,0,1.0,1,1,0,1.0,1.0,GPT4,medalign,nursing_note,PROMPT2_entailment
187,42,9,8,1,0.8888888888888888,8,5,3,0.625,0.7339449541284404,GPT4,medalign,nursing_note,PROMPT2_entailment
188,43,4,4,0,1.0,2,2,0,1.0,1.0,GPT4,medalign,nursing_note,PROMPT2_entailment
189,44,4,4,0,1.0,1,1,0,1.0,1.0,GPT4,medalign,nursing_note,PROMPT2_entailment
190,45,27,1,26,0.037037037037037,1,0,1,0.0,0.0,GPT4,medalign,nursing_note,PROMPT2_entailment
191,46,7,7,0,1.0,5,5,0,1.0,1.0,GPT4,medalign,nursing_note,PROMPT2_entailment
192,47,23,23,0,1.0,20,17,3,0.85,0.9189189189189187,GPT4,medalign,nursing_note,PROMPT2_entailment
193,48,5,5,0,1.0,2,2,0,1.0,1.0,GPT4,medalign,nursing_note,PROMPT2_entailment
194,49,4,3,1,0.75,2,1,1,0.5,0.6,GPT4,medalign,nursing_note,PROMPT2_entailment
195,5,17,17,0,1.0,5,4,1,0.8,0.888888888888889,GPT4,medalign,nursing_note,PROMPT2_entailment
196,50,3,3,0,1.0,1,1,0,1.0,1.0,GPT4,medalign,nursing_note,PROMPT2_entailment
197,51,3,3,0,1.0,2,2,0,1.0,1.0,GPT4,medalign,nursing_note,PROMPT2_entailment
198,52,5,5,0,1.0,4,4,0,1.0,1.0,GPT4,medalign,nursing_note,PROMPT2_entailment
199,53,2,2,0,1.0,1,1,0,1.0,1.0,GPT4,medalign,nursing_note,PROMPT2_entailment
200,54,11,9,2,0.8181818181818182,7,6,1,0.8571428571428571,0.8372093023255814,GPT4,medalign,nursing_note,PROMPT2_entailment
201,55,6,6,0,1.0,2,2,0,1.0,1.0,GPT4,medalign,nursing_note,PROMPT2_entailment
202,56,7,7,0,1.0,3,2,1,0.6666666666666666,0.8,GPT4,medalign,nursing_note,PROMPT2_entailment
203,57,7,4,3,0.5714285714285714,4,3,1,0.75,0.6486486486486486,GPT4,medalign,nursing_note,PROMPT2_entailment
204,58,3,3,0,1.0,1,1,0,1.0,1.0,GPT4,medalign,nursing_note,PROMPT2_entailment
205,59,3,3,0,1.0,1,1,0,1.0,1.0,GPT4,medalign,nursing_note,PROMPT2_entailment
206,6,2,2,0,1.0,3,3,0,1.0,1.0,GPT4,medalign,nursing_note,PROMPT2_entailment
207,60,10,10,0,1.0,9,7,2,0.7777777777777778,0.8750000000000001,GPT4,medalign,nursing_note,PROMPT2_entailment
208,61,3,3,0,1.0,1,1,0,1.0,1.0,GPT4,medalign,nursing_note,PROMPT2_entailment
209,62,12,12,0,1.0,5,4,1,0.8,0.888888888888889,GPT4,medalign,nursing_note,PROMPT2_entailment
210,63,9,7,2,0.7777777777777778,7,6,1,0.8571428571428571,0.8155339805825242,GPT4,medalign,nursing_note,PROMPT2_entailment
211,64,1,1,0,1.0,1,1,0,1.0,1.0,GPT4,medalign,nursing_note,PROMPT2_entailment
212,65,6,6,0,1.0,2,1,1,0.5,0.6666666666666666,GPT4,medalign,nursing_note,PROMPT2_entailment
213,66,5,5,0,1.0,4,4,0,1.0,1.0,GPT4,medalign,nursing_note,PROMPT2_entailment
214,67,5,5,0,1.0,4,4,0,1.0,1.0,GPT4,medalign,nursing_note,PROMPT2_entailment
215,68,4,2,2,0.5,1,1,0,1.0,0.6666666666666666,GPT4,medalign,nursing_note,PROMPT2_entailment
216,69,5,5,0,1.0,2,2,0,1.0,1.0,GPT4,medalign,nursing_note,PROMPT2_entailment
217,7,3,3,0,1.0,1,0,1,0.0,0.0,GPT4,medalign,nursing_note,PROMPT2_entailment
218,70,6,5,1,0.8333333333333334,1,1,0,1.0,0.9090909090909092,GPT4,medalign,nursing_note,PROMPT2_entailment
219,71,6,5,1,0.8333333333333334,1,1,0,1.0,0.9090909090909092,GPT4,medalign,nursing_note,PROMPT2_entailment
220,72,19,0,19,0.0,1,0,1,0.0,,GPT4,medalign,nursing_note,PROMPT2_entailment
221,73,4,4,0,1.0,2,2,0,1.0,1.0,GPT4,medalign,nursing_note,PROMPT2_entailment
222,74,11,8,3,0.7272727272727273,5,4,1,0.8,0.761904761904762,GPT4,medalign,nursing_note,PROMPT2_entailment
223,75,1,1,0,1.0,1,1,0,1.0,1.0,GPT4,medalign,nursing_note,PROMPT2_entailment
224,76,10,10,0,1.0,5,5,0,1.0,1.0,GPT4,medalign,nursing_note,PROMPT2_entailment
225,77,6,6,0,1.0,3,3,0,1.0,1.0,GPT4,medalign,nursing_note,PROMPT2_entailment
226,78,5,5,0,1.0,3,3,0,1.0,1.0,GPT4,medalign,nursing_note,PROMPT2_entailment
227,79,7,6,1,0.8571428571428571,8,7,1,0.875,0.8659793814432989,GPT4,medalign,nursing_note,PROMPT2_entailment
228,8,10,7,3,0.7,8,6,2,0.75,0.7241379310344827,GPT4,medalign,nursing_note,PROMPT2_entailment
229,80,11,9,2,0.8181818181818182,10,9,1,0.9,0.8571428571428572,GPT4,medalign,nursing_note,PROMPT2_entailment
230,81,25,0,25,0.0,1,1,0,1.0,0.0,GPT4,medalign,nursing_note,PROMPT2_entailment
231,82,3,3,0,1.0,3,3,0,1.0,1.0,GPT4,medalign,nursing_note,PROMPT2_entailment
232,83,6,6,0,1.0,3,2,1,0.6666666666666666,0.8,GPT4,medalign,nursing_note,PROMPT2_entailment
233,84,9,9,0,1.0,2,1,1,0.5,0.6666666666666666,GPT4,medalign,nursing_note,PROMPT2_entailment
234,85,10,9,1,0.9,8,7,1,0.875,0.8873239436619719,GPT4,medalign,nursing_note,PROMPT2_entailment
235,86,3,3,0,1.0,3,3,0,1.0,1.0,GPT4,medalign,nursing_note,PROMPT2_entailment
236,87,3,3,0,1.0,2,2,0,1.0,1.0,GPT4,medalign,nursing_note,PROMPT2_entailment
237,88,13,13,0,1.0,7,6,1,0.8571428571428571,0.923076923076923,GPT4,medalign,nursing_note,PROMPT2_entailment
238,89,12,12,0,1.0,6,6,0,1.0,1.0,GPT4,medalign,nursing_note,PROMPT2_entailment
239,9,4,4,0,1.0,2,2,0,1.0,1.0,GPT4,medalign,nursing_note,PROMPT2_entailment
240,90,5,5,0,1.0,1,1,0,1.0,1.0,GPT4,medalign,nursing_note,PROMPT2_entailment
241,91,2,2,0,1.0,1,0,1,0.0,0.0,GPT4,medalign,nursing_note,PROMPT2_entailment
242,92,6,6,0,1.0,4,2,2,0.5,0.6666666666666666,GPT4,medalign,nursing_note,PROMPT2_entailment
243,93,3,3,0,1.0,1,1,0,1.0,1.0,GPT4,medalign,nursing_note,PROMPT2_entailment
244,94,3,3,0,1.0,2,2,0,1.0,1.0,GPT4,medalign,nursing_note,PROMPT2_entailment
245,95,5,4,1,0.8,1,1,0,1.0,0.888888888888889,GPT4,medalign,nursing_note,PROMPT2_entailment
246,96,1,1,0,1.0,1,1,0,1.0,1.0,GPT4,medalign,nursing_note,PROMPT2_entailment
247,97,6,6,0,1.0,2,2,0,1.0,1.0,GPT4,medalign,nursing_note,PROMPT2_entailment
248,98,9,9,0,1.0,5,4,1,0.8,0.888888888888889,GPT4,medalign,nursing_note,PROMPT2_entailment
249,99,11,10,1,0.9090909090909092,7,5,2,0.7142857142857143,0.8,GPT4,medalign,nursing_note,PROMPT2_entailment
0,0,30,28,2,0.9333333333333332,71,47,24,0.6619718309859155,0.7745732783990582,GPT4,medalign,progress_note,PROMPT1_entailment
1,1,31,28,3,0.9032258064516128,47,23,24,0.4893617021276595,0.6347954657466732,GPT4,medalign,progress_note,PROMPT1_entailment
2,10,33,24,9,0.7272727272727273,48,32,16,0.6666666666666666,0.6956521739130435,GPT4,medalign,progress_note,PROMPT1_entailment
3,100,22,20,2,0.9090909090909092,43,30,13,0.6976744186046512,0.7894736842105263,GPT4,medalign,progress_note,PROMPT1_entailment
4,101,32,30,2,0.9375,73,46,27,0.6301369863013698,0.7536865101037684,GPT4,medalign,progress_note,PROMPT1_entailment
5,102,17,14,3,0.8235294117647058,13,11,2,0.8461538461538461,0.8346883468834688,GPT4,medalign,progress_note,PROMPT1_entailment
6,11,24,23,1,0.9583333333333334,38,30,8,0.7894736842105263,0.8657465495608533,GPT4,medalign,progress_note,PROMPT1_entailment
7,12,36,35,1,0.9722222222222222,46,32,14,0.6956521739130435,0.8110065170166546,GPT4,medalign,progress_note,PROMPT1_entailment
8,13,23,23,0,1.0,68,49,19,0.7205882352941176,0.8376068376068375,GPT4,medalign,progress_note,PROMPT1_entailment
9,14,12,12,0,1.0,13,11,2,0.8461538461538461,0.9166666666666666,GPT4,medalign,progress_note,PROMPT1_entailment
10,15,18,17,1,0.9444444444444444,19,16,3,0.8421052631578947,0.8903436988543372,GPT4,medalign,progress_note,PROMPT1_entailment
11,16,46,42,4,0.9130434782608696,78,49,29,0.6282051282051282,0.7443037974683543,GPT4,medalign,progress_note,PROMPT1_entailment
12,17,34,32,2,0.9411764705882352,33,26,7,0.7878787878787878,0.8577319587628865,GPT4,medalign,progress_note,PROMPT1_entailment
13,18,26,25,1,0.9615384615384616,59,34,25,0.576271186440678,0.7206443408223825,GPT4,medalign,progress_note,PROMPT1_entailment
14,19,39,37,2,0.9487179487179488,57,40,17,0.7017543859649122,0.8067593349686563,GPT4,medalign,progress_note,PROMPT1_entailment
15,2,34,33,1,0.9705882352941176,54,29,25,0.5370370370370371,0.6914739884393064,GPT4,medalign,progress_note,PROMPT1_entailment
16,20,28,26,2,0.9285714285714286,31,30,1,0.967741935483871,0.9477521263669504,GPT4,medalign,progress_note,PROMPT1_entailment
17,21,20,13,7,0.65,31,18,13,0.5806451612903226,0.6133682830930537,GPT4,medalign,progress_note,PROMPT1_entailment
18,22,32,29,3,0.90625,63,37,26,0.5873015873015873,0.712720026569246,GPT4,medalign,progress_note,PROMPT1_entailment
19,23,19,17,2,0.8947368421052632,35,24,11,0.6857142857142857,0.7764034253092293,GPT4,medalign,progress_note,PROMPT1_entailment
20,24,22,22,0,1.0,42,26,16,0.6190476190476191,0.7647058823529412,GPT4,medalign,progress_note,PROMPT1_entailment
21,25,23,23,0,1.0,26,24,2,0.9230769230769232,0.96,GPT4,medalign,progress_note,PROMPT1_entailment
22,26,34,32,2,0.9411764705882352,24,19,5,0.7916666666666666,0.8599717114568598,GPT4,medalign,progress_note,PROMPT1_entailment
23,27,43,40,3,0.9302325581395348,81,48,33,0.5925925925925926,0.7239819004524887,GPT4,medalign,progress_note,PROMPT1_entailment
24,28,21,17,4,0.8095238095238095,38,26,12,0.6842105263157895,0.7416107382550335,GPT4,medalign,progress_note,PROMPT1_entailment
25,29,25,23,2,0.92,99,60,39,0.6060606060606061,0.7307386814932486,GPT4,medalign,progress_note,PROMPT1_entailment
26,3,35,35,0,1.0,56,37,19,0.6607142857142857,0.7956989247311829,GPT4,medalign,progress_note,PROMPT1_entailment
27,30,17,16,1,0.9411764705882352,54,28,26,0.5185185185185185,0.6686567164179105,GPT4,medalign,progress_note,PROMPT1_entailment
28,31,28,20,8,0.7142857142857143,38,31,7,0.8157894736842105,0.7616707616707618,GPT4,medalign,progress_note,PROMPT1_entailment
29,32,29,28,1,0.9655172413793104,45,37,8,0.8222222222222222,0.8881268752678955,GPT4,medalign,progress_note,PROMPT1_entailment
30,33,28,25,3,0.8928571428571429,33,31,2,0.9393939393939394,0.915534554046072,GPT4,medalign,progress_note,PROMPT1_entailment
31,34,22,20,2,0.9090909090909092,30,20,10,0.6666666666666666,0.7692307692307692,GPT4,medalign,progress_note,PROMPT1_entailment
32,35,18,18,0,1.0,57,40,17,0.7017543859649122,0.8247422680412371,GPT4,medalign,progress_note,PROMPT1_entailment
33,36,22,20,2,0.9090909090909092,29,17,12,0.5862068965517241,0.7127882599580712,GPT4,medalign,progress_note,PROMPT1_entailment
34,37,25,16,9,0.64,19,10,9,0.5263157894736842,0.5776173285198556,GPT4,medalign,progress_note,PROMPT1_entailment
35,38,42,39,3,0.9285714285714286,63,48,15,0.7619047619047619,0.8370221327967807,GPT4,medalign,progress_note,PROMPT1_entailment
36,39,38,27,11,0.7105263157894737,43,37,6,0.8604651162790697,0.7783404752629528,GPT4,medalign,progress_note,PROMPT1_entailment
37,4,40,36,4,0.9,65,53,12,0.8153846153846154,0.8556053811659192,GPT4,medalign,progress_note,PROMPT1_entailment
38,40,17,16,1,0.9411764705882352,31,17,14,0.5483870967741935,0.6929936305732484,GPT4,medalign,progress_note,PROMPT1_entailment
39,41,27,27,0,1.0,69,34,35,0.4927536231884058,0.6601941747572816,GPT4,medalign,progress_note,PROMPT1_entailment
40,42,28,25,3,0.8928571428571429,32,26,6,0.8125,0.8507853403141362,GPT4,medalign,progress_note,PROMPT1_entailment
41,43,19,18,1,0.9473684210526316,23,20,3,0.8695652173913043,0.906801007556675,GPT4,medalign,progress_note,PROMPT1_entailment
42,44,26,26,0,1.0,92,67,25,0.7282608695652174,0.8427672955974843,GPT4,medalign,progress_note,PROMPT1_entailment
43,45,16,12,4,0.75,15,14,1,0.9333333333333332,0.8316831683168316,GPT4,medalign,progress_note,PROMPT1_entailment
44,46,20,20,0,1.0,50,27,23,0.54,0.7012987012987013,GPT4,medalign,progress_note,PROMPT1_entailment
45,47,32,28,4,0.875,42,36,6,0.8571428571428571,0.8659793814432989,GPT4,medalign,progress_note,PROMPT1_entailment
46,48,29,26,3,0.896551724137931,56,38,18,0.6785714285714286,0.7724784988272089,GPT4,medalign,progress_note,PROMPT1_entailment
47,49,20,19,1,0.95,58,19,39,0.3275862068965517,0.4871794871794871,GPT4,medalign,progress_note,PROMPT1_entailment
48,5,26,25,1,0.9615384615384616,69,39,30,0.5652173913043478,0.7119386637458927,GPT4,medalign,progress_note,PROMPT1_entailment
49,50,30,28,2,0.9333333333333332,68,46,22,0.6764705882352942,0.7844092570036542,GPT4,medalign,progress_note,PROMPT1_entailment
50,51,16,15,1,0.9375,47,24,23,0.5106382978723404,0.6611570247933884,GPT4,medalign,progress_note,PROMPT1_entailment
51,52,23,21,2,0.9130434782608696,19,16,3,0.8421052631578947,0.8761408083441982,GPT4,medalign,progress_note,PROMPT1_entailment
52,53,22,21,1,0.9545454545454546,54,29,25,0.5370370370370371,0.6873589164785553,GPT4,medalign,progress_note,PROMPT1_entailment
53,54,17,15,2,0.8823529411764706,24,23,1,0.9583333333333334,0.918774966711052,GPT4,medalign,progress_note,PROMPT1_entailment
54,55,20,17,3,0.85,23,22,1,0.9565217391304348,0.9001203369434416,GPT4,medalign,progress_note,PROMPT1_entailment
55,56,25,25,0,1.0,25,23,2,0.92,0.9583333333333334,GPT4,medalign,progress_note,PROMPT1_entailment
56,57,6,6,0,1.0,4,3,1,0.75,0.8571428571428571,GPT4,medalign,progress_note,PROMPT1_entailment
57,58,17,15,2,0.8823529411764706,13,13,0,1.0,0.9375,GPT4,medalign,progress_note,PROMPT1_entailment
58,59,28,23,5,0.8214285714285714,35,25,10,0.7142857142857143,0.7641196013289038,GPT4,medalign,progress_note,PROMPT1_entailment
59,6,28,27,1,0.9642857142857144,59,42,17,0.711864406779661,0.8190682556879739,GPT4,medalign,progress_note,PROMPT1_entailment
60,60,29,28,1,0.9655172413793104,56,36,20,0.6428571428571429,0.7718223583460949,GPT4,medalign,progress_note,PROMPT1_entailment
61,61,16,16,0,1.0,25,24,1,0.96,0.979591836734694,GPT4,medalign,progress_note,PROMPT1_entailment
62,62,24,18,6,0.75,32,26,6,0.8125,0.78,GPT4,medalign,progress_note,PROMPT1_entailment
63,63,17,14,3,0.8235294117647058,10,8,2,0.8,0.8115942028985507,GPT4,medalign,progress_note,PROMPT1_entailment
64,64,25,24,1,0.96,69,37,32,0.5362318840579711,0.6881053855094924,GPT4,medalign,progress_note,PROMPT1_entailment
65,65,31,22,9,0.7096774193548387,104,51,53,0.4903846153846153,0.5799948307056086,GPT4,medalign,progress_note,PROMPT1_entailment
66,66,34,29,5,0.8529411764705882,87,44,43,0.5057471264367817,0.6349838268225928,GPT4,medalign,progress_note,PROMPT1_entailment
67,67,17,15,2,0.8823529411764706,18,14,4,0.7777777777777778,0.8267716535433072,GPT4,medalign,progress_note,PROMPT1_entailment
68,68,16,15,1,0.9375,11,10,1,0.9090909090909092,0.923076923076923,GPT4,medalign,progress_note,PROMPT1_entailment
69,69,29,27,2,0.9310344827586208,68,48,20,0.7058823529411765,0.8029739776951673,GPT4,medalign,progress_note,PROMPT1_entailment
70,7,31,22,9,0.7096774193548387,37,26,11,0.7027027027027027,0.7061728395061728,GPT4,medalign,progress_note,PROMPT1_entailment
71,70,31,30,1,0.967741935483871,69,42,27,0.6086956521739131,0.7473309608540926,GPT4,medalign,progress_note,PROMPT1_entailment
72,71,44,42,2,0.9545454545454546,48,33,15,0.6875,0.7993079584775087,GPT4,medalign,progress_note,PROMPT1_entailment
73,72,34,32,2,0.9411764705882352,69,50,19,0.7246376811594203,0.8188331627430911,GPT4,medalign,progress_note,PROMPT1_entailment
74,73,34,32,2,0.9411764705882352,90,45,45,0.5,0.6530612244897959,GPT4,medalign,progress_note,PROMPT1_entailment
75,74,24,24,0,1.0,22,20,2,0.9090909090909092,0.9523809523809524,GPT4,medalign,progress_note,PROMPT1_entailment
76,75,27,24,3,0.8888888888888888,49,30,19,0.6122448979591837,0.7250755287009063,GPT4,medalign,progress_note,PROMPT1_entailment
77,76,40,35,5,0.875,77,53,24,0.6883116883116883,0.770508826583593,GPT4,medalign,progress_note,PROMPT1_entailment
78,77,38,37,1,0.9736842105263158,38,30,8,0.7894736842105263,0.8719560094265515,GPT4,medalign,progress_note,PROMPT1_entailment
79,78,18,18,0,1.0,54,29,25,0.5370370370370371,0.6987951807228916,GPT4,medalign,progress_note,PROMPT1_entailment
80,79,47,32,15,0.6808510638297872,64,47,17,0.734375,0.7066008926474042,GPT4,medalign,progress_note,PROMPT1_entailment
81,8,21,18,3,0.8571428571428571,31,19,12,0.6129032258064516,0.7147335423197492,GPT4,medalign,progress_note,PROMPT1_entailment
82,80,38,36,2,0.9473684210526316,66,43,23,0.6515151515151515,0.7720698254364089,GPT4,medalign,progress_note,PROMPT1_entailment
83,81,17,13,4,0.7647058823529411,12,10,2,0.8333333333333334,0.7975460122699386,GPT4,medalign,progress_note,PROMPT1_entailment
84,82,10,8,2,0.8,13,12,1,0.9230769230769232,0.8571428571428571,GPT4,medalign,progress_note,PROMPT1_entailment
85,83,10,8,2,0.8,8,6,2,0.75,0.7741935483870969,GPT4,medalign,progress_note,PROMPT1_entailment
86,84,21,16,5,0.7619047619047619,23,18,5,0.782608695652174,0.772117962466488,GPT4,medalign,progress_note,PROMPT1_entailment
87,85,21,20,1,0.9523809523809524,63,26,37,0.4126984126984127,0.5758582502768548,GPT4,medalign,progress_note,PROMPT1_entailment
88,86,31,26,5,0.8387096774193549,75,36,39,0.48,0.6105675146771037,GPT4,medalign,progress_note,PROMPT1_entailment
89,87,28,25,3,0.8928571428571429,87,46,41,0.5287356321839081,0.6641640196361537,GPT4,medalign,progress_note,PROMPT1_entailment
90,88,33,31,2,0.9393939393939394,84,47,37,0.5595238095238095,0.701323706377858,GPT4,medalign,progress_note,PROMPT1_entailment
91,89,25,23,2,0.92,41,32,9,0.7804878048780488,0.8445209409064831,GPT4,medalign,progress_note,PROMPT1_entailment
92,9,33,31,2,0.9393939393939394,68,37,31,0.5441176470588235,0.6890958245719435,GPT4,medalign,progress_note,PROMPT1_entailment
93,90,19,18,1,0.9473684210526316,24,21,3,0.875,0.9097472924187724,GPT4,medalign,progress_note,PROMPT1_entailment
94,91,22,22,0,1.0,45,23,22,0.5111111111111111,0.676470588235294,GPT4,medalign,progress_note,PROMPT1_entailment
95,92,20,19,1,0.95,17,17,0,1.0,0.9743589743589745,GPT4,medalign,progress_note,PROMPT1_entailment
96,93,19,18,1,0.9473684210526316,25,21,4,0.84,0.8904593639575972,GPT4,medalign,progress_note,PROMPT1_entailment
97,94,29,24,5,0.8275862068965517,33,28,5,0.8484848484848485,0.8379052369077307,GPT4,medalign,progress_note,PROMPT1_entailment
98,95,28,27,1,0.9642857142857144,41,32,9,0.7804878048780488,0.8627059410883675,GPT4,medalign,progress_note,PROMPT1_entailment
99,96,40,40,0,1.0,48,30,18,0.625,0.7692307692307693,GPT4,medalign,progress_note,PROMPT1_entailment
100,97,24,21,3,0.875,37,27,10,0.7297297297297297,0.7957894736842105,GPT4,medalign,progress_note,PROMPT1_entailment
101,98,43,28,15,0.6511627906976745,55,42,13,0.7636363636363637,0.7029288702928871,GPT4,medalign,progress_note,PROMPT1_entailment
102,99,24,23,1,0.9583333333333334,73,29,44,0.3972602739726027,0.5616842105263158,GPT4,medalign,progress_note,PROMPT1_entailment
0,0,65,58,7,0.8923076923076924,71,58,13,0.8169014084507042,0.8529411764705882,GPT4,medalign,progress_note,PROMPT1_ICL_entailment
1,1,70,66,4,0.9428571428571428,47,40,7,0.851063829787234,0.8946119959335818,GPT4,medalign,progress_note,PROMPT1_ICL_entailment
2,10,69,61,8,0.8840579710144928,48,38,10,0.7916666666666666,0.8353153153153153,GPT4,medalign,progress_note,PROMPT1_ICL_entailment
3,100,46,43,3,0.9347826086956522,43,35,8,0.813953488372093,0.8701936976004626,GPT4,medalign,progress_note,PROMPT1_ICL_entailment
4,101,56,52,4,0.9285714285714286,73,49,24,0.6712328767123288,0.7792048929663609,GPT4,medalign,progress_note,PROMPT1_ICL_entailment
5,102,18,18,0,1.0,13,10,3,0.7692307692307693,0.8695652173913044,GPT4,medalign,progress_note,PROMPT1_ICL_entailment
6,11,47,47,0,1.0,38,30,8,0.7894736842105263,0.8823529411764706,GPT4,medalign,progress_note,PROMPT1_ICL_entailment
7,12,63,62,1,0.984126984126984,46,31,15,0.6739130434782609,0.7999999999999999,GPT4,medalign,progress_note,PROMPT1_ICL_entailment
8,13,73,65,8,0.8904109589041096,68,49,19,0.7205882352941176,0.7965487057646617,GPT4,medalign,progress_note,PROMPT1_ICL_entailment
9,14,16,15,1,0.9375,13,9,4,0.6923076923076923,0.7964601769911505,GPT4,medalign,progress_note,PROMPT1_ICL_entailment
10,15,18,18,0,1.0,19,11,8,0.5789473684210527,0.7333333333333334,GPT4,medalign,progress_note,PROMPT1_ICL_entailment
11,16,75,70,5,0.9333333333333332,78,54,24,0.6923076923076923,0.7949526813880127,GPT4,medalign,progress_note,PROMPT1_ICL_entailment
12,17,47,42,5,0.8936170212765957,33,28,5,0.8484848484848485,0.8704663212435233,GPT4,medalign,progress_note,PROMPT1_ICL_entailment
13,18,31,31,0,1.0,59,37,22,0.6271186440677966,0.7708333333333333,GPT4,medalign,progress_note,PROMPT1_ICL_entailment
14,19,50,50,0,1.0,57,47,10,0.8245614035087719,0.903846153846154,GPT4,medalign,progress_note,PROMPT1_ICL_entailment
15,2,54,51,3,0.9444444444444444,54,40,14,0.7407407407407407,0.8302808302808302,GPT4,medalign,progress_note,PROMPT1_ICL_entailment
16,20,28,26,2,0.9285714285714286,31,29,2,0.935483870967742,0.9320148331273176,GPT4,medalign,progress_note,PROMPT1_ICL_entailment
17,21,51,45,6,0.8823529411764706,31,20,11,0.6451612903225806,0.7453416149068324,GPT4,medalign,progress_note,PROMPT1_ICL_entailment
18,22,62,58,4,0.935483870967742,63,48,15,0.7619047619047619,0.8398190045248867,GPT4,medalign,progress_note,PROMPT1_ICL_entailment
19,23,40,38,2,0.95,35,29,6,0.8285714285714286,0.8851405622489961,GPT4,medalign,progress_note,PROMPT1_ICL_entailment
20,24,61,58,3,0.9508196721311476,42,34,8,0.8095238095238095,0.8745011086474501,GPT4,medalign,progress_note,PROMPT1_ICL_entailment
21,25,38,37,1,0.9736842105263158,26,23,3,0.8846153846153846,0.9270152505446624,GPT4,medalign,progress_note,PROMPT1_ICL_entailment
22,26,46,43,3,0.9347826086956522,24,21,3,0.875,0.9039039039039038,GPT4,medalign,progress_note,PROMPT1_ICL_entailment
23,27,87,85,2,0.9770114942528736,81,56,25,0.691358024691358,0.8097303733945733,GPT4,medalign,progress_note,PROMPT1_ICL_entailment
24,28,44,43,1,0.9772727272727272,38,30,8,0.7894736842105263,0.8733920108327692,GPT4,medalign,progress_note,PROMPT1_ICL_entailment
25,29,103,95,8,0.9223300970873788,99,52,47,0.5252525252525253,0.6693313461147619,GPT4,medalign,progress_note,PROMPT1_ICL_entailment
26,3,47,45,2,0.9574468085106383,56,38,18,0.6785714285714286,0.7942405945192754,GPT4,medalign,progress_note,PROMPT1_ICL_entailment
27,30,62,55,7,0.8870967741935484,54,42,12,0.7777777777777778,0.8288482238966631,GPT4,medalign,progress_note,PROMPT1_ICL_entailment
28,31,61,41,20,0.6721311475409836,38,34,4,0.8947368421052632,0.7676211453744493,GPT4,medalign,progress_note,PROMPT1_ICL_entailment
29,32,72,70,2,0.9722222222222222,45,39,6,0.8666666666666667,0.916414904330312,GPT4,medalign,progress_note,PROMPT1_ICL_entailment
30,33,36,34,2,0.9444444444444444,33,28,5,0.8484848484848485,0.8938967136150235,GPT4,medalign,progress_note,PROMPT1_ICL_entailment
31,34,39,39,0,1.0,30,23,7,0.7666666666666667,0.8679245283018869,GPT4,medalign,progress_note,PROMPT1_ICL_entailment
32,35,31,30,1,0.967741935483871,57,33,24,0.5789473684210527,0.7244785949506038,GPT4,medalign,progress_note,PROMPT1_ICL_entailment
33,36,28,25,3,0.8928571428571429,29,24,5,0.8275862068965517,0.8589835361488904,GPT4,medalign,progress_note,PROMPT1_ICL_entailment
34,37,27,15,12,0.5555555555555556,19,11,8,0.5789473684210527,0.5670103092783506,GPT4,medalign,progress_note,PROMPT1_ICL_entailment
35,38,81,71,10,0.8765432098765432,63,46,17,0.7301587301587301,0.796682522258812,GPT4,medalign,progress_note,PROMPT1_ICL_entailment
36,39,50,31,19,0.62,43,23,20,0.5348837209302325,0.5743052758759565,GPT4,medalign,progress_note,PROMPT1_ICL_entailment
37,4,85,81,4,0.9529411764705882,65,54,11,0.8307692307692308,0.8876712328767123,GPT4,medalign,progress_note,PROMPT1_ICL_entailment
38,40,35,30,5,0.8571428571428571,31,17,14,0.5483870967741935,0.6688524590163933,GPT4,medalign,progress_note,PROMPT1_ICL_entailment
39,41,60,60,0,1.0,69,52,17,0.7536231884057971,0.859504132231405,GPT4,medalign,progress_note,PROMPT1_ICL_entailment
40,42,44,37,7,0.8409090909090909,32,23,9,0.71875,0.7750455373406193,GPT4,medalign,progress_note,PROMPT1_ICL_entailment
41,43,35,31,4,0.8857142857142857,23,18,5,0.782608695652174,0.830975428145942,GPT4,medalign,progress_note,PROMPT1_ICL_entailment
42,44,70,70,0,1.0,92,67,25,0.7282608695652174,0.8427672955974843,GPT4,medalign,progress_note,PROMPT1_ICL_entailment
43,45,29,23,6,0.7931034482758621,15,12,3,0.8,0.7965367965367965,GPT4,medalign,progress_note,PROMPT1_ICL_entailment
44,46,51,51,0,1.0,50,39,11,0.78,0.8764044943820225,GPT4,medalign,progress_note,PROMPT1_ICL_entailment
45,47,59,51,8,0.864406779661017,42,35,7,0.8333333333333334,0.848585690515807,GPT4,medalign,progress_note,PROMPT1_ICL_entailment
46,48,42,38,4,0.9047619047619048,56,44,12,0.7857142857142857,0.841046277665996,GPT4,medalign,progress_note,PROMPT1_ICL_entailment
47,49,45,44,1,0.9777777777777776,58,36,22,0.6206896551724138,0.7593480345158198,GPT4,medalign,progress_note,PROMPT1_ICL_entailment
48,5,73,68,5,0.9315068493150684,69,42,27,0.6086956521739131,0.7362722351121422,GPT4,medalign,progress_note,PROMPT1_ICL_entailment
49,50,68,66,2,0.9705882352941176,68,62,6,0.9117647058823528,0.9402573529411764,GPT4,medalign,progress_note,PROMPT1_ICL_entailment
50,51,47,45,2,0.9574468085106383,47,38,9,0.8085106382978723,0.8766982824916688,GPT4,medalign,progress_note,PROMPT1_ICL_entailment
51,52,30,27,3,0.9,19,14,5,0.7368421052631579,0.810289389067524,GPT4,medalign,progress_note,PROMPT1_ICL_entailment
52,53,56,55,1,0.9821428571428572,54,41,13,0.7592592592592593,0.8564375237371821,GPT4,medalign,progress_note,PROMPT1_ICL_entailment
53,54,33,21,12,0.6363636363636364,24,16,8,0.6666666666666666,0.6511627906976744,GPT4,medalign,progress_note,PROMPT1_ICL_entailment
54,55,25,20,5,0.8,23,20,3,0.8695652173913043,0.8333333333333333,GPT4,medalign,progress_note,PROMPT1_ICL_entailment
55,56,35,31,4,0.8857142857142857,25,18,7,0.72,0.7943060498220641,GPT4,medalign,progress_note,PROMPT1_ICL_entailment
56,57,9,9,0,1.0,4,4,0,1.0,1.0,GPT4,medalign,progress_note,PROMPT1_ICL_entailment
57,58,17,15,2,0.8823529411764706,13,10,3,0.7692307692307693,0.8219178082191781,GPT4,medalign,progress_note,PROMPT1_ICL_entailment
58,59,45,34,11,0.7555555555555555,35,26,9,0.7428571428571429,0.7491525423728813,GPT4,medalign,progress_note,PROMPT1_ICL_entailment
59,6,81,81,0,1.0,59,46,13,0.7796610169491526,0.8761904761904762,GPT4,medalign,progress_note,PROMPT1_ICL_entailment
60,60,59,55,4,0.9322033898305084,56,41,15,0.7321428571428571,0.8201491180214584,GPT4,medalign,progress_note,PROMPT1_ICL_entailment
61,61,35,31,4,0.8857142857142857,25,23,2,0.92,0.9025316455696204,GPT4,medalign,progress_note,PROMPT1_ICL_entailment
62,62,41,38,3,0.926829268292683,32,19,13,0.59375,0.7238095238095238,GPT4,medalign,progress_note,PROMPT1_ICL_entailment
63,63,26,24,2,0.9230769230769232,10,8,2,0.8,0.8571428571428571,GPT4,medalign,progress_note,PROMPT1_ICL_entailment
64,64,106,92,14,0.8679245283018868,69,53,16,0.7681159420289855,0.8149757646665552,GPT4,medalign,progress_note,PROMPT1_ICL_entailment
65,65,82,64,18,0.7804878048780488,104,45,59,0.4326923076923077,0.5567369031509762,GPT4,medalign,progress_note,PROMPT1_ICL_entailment
66,66,48,46,2,0.9583333333333334,87,57,30,0.6551724137931034,0.7782724844167409,GPT4,medalign,progress_note,PROMPT1_ICL_entailment
67,67,32,29,3,0.90625,18,15,3,0.8333333333333334,0.8682634730538922,GPT4,medalign,progress_note,PROMPT1_ICL_entailment
68,68,18,16,2,0.8888888888888888,11,7,4,0.6363636363636364,0.7417218543046358,GPT4,medalign,progress_note,PROMPT1_ICL_entailment
69,69,53,52,1,0.981132075471698,68,50,18,0.7352941176470589,0.8406078241189783,GPT4,medalign,progress_note,PROMPT1_ICL_entailment
70,7,52,37,15,0.7115384615384616,37,32,5,0.8648648648648649,0.7807451368282229,GPT4,medalign,progress_note,PROMPT1_ICL_entailment
71,70,87,81,6,0.9310344827586208,69,51,18,0.7391304347826086,0.8240574506283662,GPT4,medalign,progress_note,PROMPT1_ICL_entailment
72,71,86,78,8,0.9069767441860463,48,41,7,0.8541666666666666,0.8797799174690508,GPT4,medalign,progress_note,PROMPT1_ICL_entailment
73,72,68,66,2,0.9705882352941176,69,52,17,0.7536231884057971,0.8484548825710755,GPT4,medalign,progress_note,PROMPT1_ICL_entailment
74,73,99,83,16,0.8383838383838383,90,68,22,0.7555555555555555,0.7948176313195325,GPT4,medalign,progress_note,PROMPT1_ICL_entailment
75,74,31,29,2,0.935483870967742,22,22,0,1.0,0.9666666666666666,GPT4,medalign,progress_note,PROMPT1_ICL_entailment
76,75,55,52,3,0.9454545454545454,49,35,14,0.7142857142857143,0.8137715179968701,GPT4,medalign,progress_note,PROMPT1_ICL_entailment
77,76,68,65,3,0.9558823529411764,77,58,19,0.7532467532467533,0.842552240473796,GPT4,medalign,progress_note,PROMPT1_ICL_entailment
78,77,75,71,4,0.9466666666666668,38,35,3,0.9210526315789472,0.933684012774751,GPT4,medalign,progress_note,PROMPT1_ICL_entailment
79,78,60,57,3,0.95,54,38,16,0.7037037037037037,0.8085106382978724,GPT4,medalign,progress_note,PROMPT1_ICL_entailment
80,79,57,46,11,0.8070175438596491,64,36,28,0.5625,0.6629303442754204,GPT4,medalign,progress_note,PROMPT1_ICL_entailment
81,8,49,41,8,0.8367346938775511,31,19,12,0.6129032258064516,0.7075386012715712,GPT4,medalign,progress_note,PROMPT1_ICL_entailment
82,80,56,51,5,0.9107142857142856,66,32,34,0.4848484848484848,0.6328034121752617,GPT4,medalign,progress_note,PROMPT1_ICL_entailment
83,81,16,14,2,0.875,12,7,5,0.5833333333333334,0.7000000000000001,GPT4,medalign,progress_note,PROMPT1_ICL_entailment
84,82,14,14,0,1.0,13,8,5,0.6153846153846154,0.761904761904762,GPT4,medalign,progress_note,PROMPT1_ICL_entailment
85,83,15,14,1,0.9333333333333332,8,7,1,0.875,0.9032258064516128,GPT4,medalign,progress_note,PROMPT1_ICL_entailment
86,84,34,27,7,0.7941176470588235,23,16,7,0.6956521739130435,0.7416309012875537,GPT4,medalign,progress_note,PROMPT1_ICL_entailment
87,85,75,71,4,0.9466666666666668,63,48,15,0.7619047619047619,0.8442958008175399,GPT4,medalign,progress_note,PROMPT1_ICL_entailment
88,86,118,102,16,0.864406779661017,75,59,16,0.7866666666666666,0.8237065425677526,GPT4,medalign,progress_note,PROMPT1_ICL_entailment
89,87,72,67,5,0.9305555555555556,87,66,21,0.7586206896551724,0.8358378225120499,GPT4,medalign,progress_note,PROMPT1_ICL_entailment
90,88,78,65,13,0.8333333333333334,84,62,22,0.7380952380952381,0.7828282828282828,GPT4,medalign,progress_note,PROMPT1_ICL_entailment
91,89,57,53,4,0.9298245614035088,41,29,12,0.7073170731707317,0.803450078410873,GPT4,medalign,progress_note,PROMPT1_ICL_entailment
92,9,99,95,4,0.9595959595959596,68,57,11,0.8382352941176471,0.8948194662480377,GPT4,medalign,progress_note,PROMPT1_ICL_entailment
93,90,22,22,0,1.0,24,16,8,0.6666666666666666,0.8,GPT4,medalign,progress_note,PROMPT1_ICL_entailment
94,91,45,43,2,0.9555555555555556,45,32,13,0.7111111111111111,0.8154074074074074,GPT4,medalign,progress_note,PROMPT1_ICL_entailment
95,92,24,22,2,0.9166666666666666,17,15,2,0.8823529411764706,0.8991825613079019,GPT4,medalign,progress_note,PROMPT1_ICL_entailment
96,93,33,33,0,1.0,25,22,3,0.88,0.9361702127659576,GPT4,medalign,progress_note,PROMPT1_ICL_entailment
97,94,46,35,11,0.7608695652173914,33,26,7,0.7878787878787878,0.7741386643981285,GPT4,medalign,progress_note,PROMPT1_ICL_entailment
98,95,49,44,5,0.8979591836734694,41,34,7,0.8292682926829268,0.8622478386167146,GPT4,medalign,progress_note,PROMPT1_ICL_entailment
99,96,87,83,4,0.9540229885057472,48,43,5,0.8958333333333334,0.9240129449838188,GPT4,medalign,progress_note,PROMPT1_ICL_entailment
100,97,71,67,4,0.943661971830986,37,33,4,0.8918918918918919,0.9170468685192866,GPT4,medalign,progress_note,PROMPT1_ICL_entailment
101,98,64,50,14,0.78125,55,40,15,0.7272727272727273,0.7532956685499059,GPT4,medalign,progress_note,PROMPT1_ICL_entailment
102,99,74,69,5,0.9324324324324323,73,54,19,0.7397260273972602,0.8249750913317835,GPT4,medalign,progress_note,PROMPT1_ICL_entailment
0,0,55,54,1,0.9818181818181818,71,52,19,0.7323943661971831,0.8389602629220196,GPT4,medalign,progress_note,PROMPT2_ICL_entailment
1,1,65,61,4,0.9384615384615383,47,37,10,0.7872340425531915,0.8562215477996964,GPT4,medalign,progress_note,PROMPT2_ICL_entailment
2,10,83,68,15,0.8192771084337349,48,35,13,0.7291666666666666,0.7715999351596694,GPT4,medalign,progress_note,PROMPT2_ICL_entailment
3,100,72,71,1,0.9861111111111112,43,33,10,0.7674418604651163,0.8631423834960399,GPT4,medalign,progress_note,PROMPT2_ICL_entailment
4,101,83,77,6,0.927710843373494,73,55,18,0.7534246575342466,0.8315334773218144,GPT4,medalign,progress_note,PROMPT2_ICL_entailment
5,102,21,18,3,0.8571428571428571,13,11,2,0.8461538461538461,0.8516129032258064,GPT4,medalign,progress_note,PROMPT2_ICL_entailment
6,11,40,40,0,1.0,38,28,10,0.7368421052631579,0.8484848484848484,GPT4,medalign,progress_note,PROMPT2_ICL_entailment
7,12,63,61,2,0.9682539682539684,46,31,15,0.6739130434782609,0.7947047699096449,GPT4,medalign,progress_note,PROMPT2_ICL_entailment
8,13,97,87,10,0.8969072164948454,68,47,21,0.6911764705882353,0.7807159904534606,GPT4,medalign,progress_note,PROMPT2_ICL_entailment
9,14,19,19,0,1.0,13,7,6,0.5384615384615384,0.7000000000000001,GPT4,medalign,progress_note,PROMPT2_ICL_entailment
10,15,23,21,2,0.9130434782608696,19,10,9,0.5263157894736842,0.6677265500794912,GPT4,medalign,progress_note,PROMPT2_ICL_entailment
11,16,61,55,6,0.9016393442622952,78,55,23,0.7051282051282052,0.7913669064748202,GPT4,medalign,progress_note,PROMPT2_ICL_entailment
12,17,53,48,5,0.9056603773584906,33,29,4,0.8787878787878788,0.8920217878884973,GPT4,medalign,progress_note,PROMPT2_ICL_entailment
13,18,46,45,1,0.9782608695652174,59,44,15,0.7457627118644068,0.84633468689891,GPT4,medalign,progress_note,PROMPT2_ICL_entailment
14,19,63,61,2,0.9682539682539684,57,44,13,0.7719298245614035,0.8590174427908466,GPT4,medalign,progress_note,PROMPT2_ICL_entailment
15,2,96,87,9,0.90625,54,38,16,0.7037037037037037,0.792235801581596,GPT4,medalign,progress_note,PROMPT2_ICL_entailment
16,20,31,29,2,0.935483870967742,31,29,2,0.935483870967742,0.935483870967742,GPT4,medalign,progress_note,PROMPT2_ICL_entailment
17,21,53,44,9,0.8301886792452831,31,22,9,0.7096774193548387,0.7652173913043478,GPT4,medalign,progress_note,PROMPT2_ICL_entailment
18,22,52,50,2,0.9615384615384616,63,36,27,0.5714285714285714,0.7168458781362007,GPT4,medalign,progress_note,PROMPT2_ICL_entailment
19,23,48,44,4,0.9166666666666666,35,24,11,0.6857142857142857,0.7845468053491828,GPT4,medalign,progress_note,PROMPT2_ICL_entailment
20,24,75,67,8,0.8933333333333333,42,35,7,0.8333333333333334,0.8622908622908624,GPT4,medalign,progress_note,PROMPT2_ICL_entailment
21,25,39,38,1,0.9743589743589745,26,20,6,0.7692307692307693,0.8597285067873304,GPT4,medalign,progress_note,PROMPT2_ICL_entailment
22,26,46,44,2,0.9565217391304348,24,20,4,0.8333333333333334,0.8906882591093118,GPT4,medalign,progress_note,PROMPT2_ICL_entailment
23,27,125,112,13,0.896,81,51,30,0.6296296296296297,0.7395610798213246,GPT4,medalign,progress_note,PROMPT2_ICL_entailment
24,28,53,50,3,0.9433962264150944,38,25,13,0.6578947368421053,0.7751937984496124,GPT4,medalign,progress_note,PROMPT2_ICL_entailment
25,29,117,105,12,0.8974358974358975,99,44,55,0.4444444444444444,0.5944798301486199,GPT4,medalign,progress_note,PROMPT2_ICL_entailment
26,3,79,76,3,0.9620253164556962,56,47,9,0.8392857142857143,0.8964738361149455,GPT4,medalign,progress_note,PROMPT2_ICL_entailment
27,30,55,54,1,0.9818181818181818,54,31,23,0.5740740740740741,0.7245185024886388,GPT4,medalign,progress_note,PROMPT2_ICL_entailment
28,31,60,45,15,0.75,38,25,13,0.6578947368421053,0.7009345794392524,GPT4,medalign,progress_note,PROMPT2_ICL_entailment
29,32,76,74,2,0.9736842105263158,45,39,6,0.8666666666666667,0.9170638703527167,GPT4,medalign,progress_note,PROMPT2_ICL_entailment
30,33,42,39,3,0.9285714285714286,33,24,9,0.7272727272727273,0.8156862745098039,GPT4,medalign,progress_note,PROMPT2_ICL_entailment
31,34,42,42,0,1.0,30,21,9,0.7,0.8235294117647058,GPT4,medalign,progress_note,PROMPT2_ICL_entailment
32,35,42,41,1,0.9761904761904762,57,39,18,0.6842105263157895,0.8045283018867925,GPT4,medalign,progress_note,PROMPT2_ICL_entailment
33,36,22,21,1,0.9545454545454546,29,21,8,0.7241379310344828,0.823529411764706,GPT4,medalign,progress_note,PROMPT2_ICL_entailment
34,37,41,22,19,0.5365853658536586,19,10,9,0.5263157894736842,0.5314009661835749,GPT4,medalign,progress_note,PROMPT2_ICL_entailment
35,38,86,75,11,0.872093023255814,63,47,16,0.746031746031746,0.8041519333865633,GPT4,medalign,progress_note,PROMPT2_ICL_entailment
36,39,58,38,20,0.6551724137931034,43,30,13,0.6976744186046512,0.6757557794902193,GPT4,medalign,progress_note,PROMPT2_ICL_entailment
37,4,71,67,4,0.943661971830986,65,47,18,0.7230769230769231,0.8187727509100364,GPT4,medalign,progress_note,PROMPT2_ICL_entailment
38,40,40,35,5,0.875,31,16,15,0.5161290322580645,0.6492753623188405,GPT4,medalign,progress_note,PROMPT2_ICL_entailment
39,41,62,60,2,0.967741935483871,69,55,14,0.7971014492753623,0.8741721854304636,GPT4,medalign,progress_note,PROMPT2_ICL_entailment
40,42,47,43,4,0.9148936170212766,32,22,10,0.6875,0.7850622406639004,GPT4,medalign,progress_note,PROMPT2_ICL_entailment
41,43,36,34,2,0.9444444444444444,23,17,6,0.7391304347826086,0.8292682926829269,GPT4,medalign,progress_note,PROMPT2_ICL_entailment
42,44,61,60,1,0.9836065573770492,92,51,41,0.5543478260869565,0.7090719499478624,GPT4,medalign,progress_note,PROMPT2_ICL_entailment
43,45,25,23,2,0.92,15,14,1,0.9333333333333332,0.9266187050359712,GPT4,medalign,progress_note,PROMPT2_ICL_entailment
44,46,63,63,0,1.0,50,39,11,0.78,0.8764044943820225,GPT4,medalign,progress_note,PROMPT2_ICL_entailment
45,47,65,60,5,0.9230769230769232,42,33,9,0.7857142857142857,0.8488745980707394,GPT4,medalign,progress_note,PROMPT2_ICL_entailment
46,48,45,42,3,0.9333333333333332,56,37,19,0.6607142857142857,0.7737117251680359,GPT4,medalign,progress_note,PROMPT2_ICL_entailment
47,49,104,101,3,0.971153846153846,58,46,12,0.7931034482758621,0.8731441458372486,GPT4,medalign,progress_note,PROMPT2_ICL_entailment
48,5,91,84,7,0.9230769230769232,69,49,20,0.7101449275362319,0.8027303754266213,GPT4,medalign,progress_note,PROMPT2_ICL_entailment
49,50,89,86,3,0.9662921348314608,68,55,13,0.8088235294117647,0.8805733966303639,GPT4,medalign,progress_note,PROMPT2_ICL_entailment
50,51,65,63,2,0.9692307692307692,47,38,9,0.8085106382978723,0.8816055974958571,GPT4,medalign,progress_note,PROMPT2_ICL_entailment
51,52,23,22,1,0.9565217391304348,19,10,9,0.5263157894736842,0.6790123456790123,GPT4,medalign,progress_note,PROMPT2_ICL_entailment
52,53,66,65,1,0.9848484848484848,54,39,15,0.7222222222222222,0.8333333333333333,GPT4,medalign,progress_note,PROMPT2_ICL_entailment
53,54,27,18,9,0.6666666666666666,24,13,11,0.5416666666666666,0.5977011494252873,GPT4,medalign,progress_note,PROMPT2_ICL_entailment
54,55,26,23,3,0.8846153846153846,23,18,5,0.782608695652174,0.8304914744232699,GPT4,medalign,progress_note,PROMPT2_ICL_entailment
55,56,28,28,0,1.0,25,16,9,0.64,0.7804878048780487,GPT4,medalign,progress_note,PROMPT2_ICL_entailment
56,57,1,0,1,0.0,4,0,4,0.0,,GPT4,medalign,progress_note,PROMPT2_ICL_entailment
57,58,19,18,1,0.9473684210526316,13,9,4,0.6923076923076923,0.7999999999999999,GPT4,medalign,progress_note,PROMPT2_ICL_entailment
58,59,38,34,4,0.8947368421052632,35,26,9,0.7428571428571429,0.8117539026629935,GPT4,medalign,progress_note,PROMPT2_ICL_entailment
59,6,73,72,1,0.9863013698630136,59,46,13,0.7796610169491526,0.8708914015251117,GPT4,medalign,progress_note,PROMPT2_ICL_entailment
60,60,55,51,4,0.9272727272727272,56,33,23,0.5892857142857143,0.7206165703275529,GPT4,medalign,progress_note,PROMPT2_ICL_entailment
61,61,33,28,5,0.8484848484848485,25,20,5,0.8,0.823529411764706,GPT4,medalign,progress_note,PROMPT2_ICL_entailment
62,62,41,36,5,0.8780487804878049,32,21,11,0.65625,0.7511177347242921,GPT4,medalign,progress_note,PROMPT2_ICL_entailment
63,63,23,21,2,0.9130434782608696,10,7,3,0.7,0.7924528301886793,GPT4,medalign,progress_note,PROMPT2_ICL_entailment
64,64,78,72,6,0.9230769230769232,69,48,21,0.6956521739130435,0.7933884297520661,GPT4,medalign,progress_note,PROMPT2_ICL_entailment
65,65,226,167,59,0.7389380530973452,104,67,37,0.6442307692307693,0.6883420486004307,GPT4,medalign,progress_note,PROMPT2_ICL_entailment
66,66,45,43,2,0.9555555555555556,87,55,32,0.632183908045977,0.760939510939511,GPT4,medalign,progress_note,PROMPT2_ICL_entailment
67,67,26,26,0,1.0,18,14,4,0.7777777777777778,0.8750000000000001,GPT4,medalign,progress_note,PROMPT2_ICL_entailment
68,68,17,15,2,0.8823529411764706,11,7,4,0.6363636363636364,0.73943661971831,GPT4,medalign,progress_note,PROMPT2_ICL_entailment
69,69,83,80,3,0.963855421686747,68,50,18,0.7352941176470589,0.8342022940563087,GPT4,medalign,progress_note,PROMPT2_ICL_entailment
70,7,66,56,10,0.8484848484848485,37,32,5,0.8648648648648649,0.8565965583173996,GPT4,medalign,progress_note,PROMPT2_ICL_entailment
71,70,104,82,22,0.7884615384615384,69,44,25,0.6376811594202898,0.7051006449091264,GPT4,medalign,progress_note,PROMPT2_ICL_entailment
72,71,79,70,9,0.8860759493670886,48,44,4,0.9166666666666666,0.901111761263897,GPT4,medalign,progress_note,PROMPT2_ICL_entailment
73,72,51,51,0,1.0,69,50,19,0.7246376811594203,0.8403361344537814,GPT4,medalign,progress_note,PROMPT2_ICL_entailment
74,73,106,86,20,0.8113207547169812,90,51,39,0.5666666666666667,0.6672752167959836,GPT4,medalign,progress_note,PROMPT2_ICL_entailment
75,74,30,27,3,0.9,22,20,2,0.9090909090909092,0.9045226130653266,GPT4,medalign,progress_note,PROMPT2_ICL_entailment
76,75,63,56,7,0.8888888888888888,49,39,10,0.7959183673469388,0.8398384925975775,GPT4,medalign,progress_note,PROMPT2_ICL_entailment
77,76,88,85,3,0.9659090909090908,77,53,24,0.6883116883116883,0.8038183602462308,GPT4,medalign,progress_note,PROMPT2_ICL_entailment
78,77,81,79,2,0.9753086419753086,38,31,7,0.8157894736842105,0.8884454924723382,GPT4,medalign,progress_note,PROMPT2_ICL_entailment
79,78,68,67,1,0.9852941176470588,54,42,12,0.7777777777777778,0.8693234476367008,GPT4,medalign,progress_note,PROMPT2_ICL_entailment
80,79,94,64,30,0.6808510638297872,64,48,16,0.75,0.7137546468401486,GPT4,medalign,progress_note,PROMPT2_ICL_entailment
81,8,49,46,3,0.9387755102040816,31,18,13,0.5806451612903226,0.7175043327556326,GPT4,medalign,progress_note,PROMPT2_ICL_entailment
82,80,86,79,7,0.9186046511627908,66,36,30,0.5454545454545454,0.6844765342960288,GPT4,medalign,progress_note,PROMPT2_ICL_entailment
83,81,16,13,3,0.8125,12,7,5,0.5833333333333334,0.6791044776119403,GPT4,medalign,progress_note,PROMPT2_ICL_entailment
84,82,16,16,0,1.0,13,7,6,0.5384615384615384,0.7000000000000001,GPT4,medalign,progress_note,PROMPT2_ICL_entailment
85,83,16,16,0,1.0,8,8,0,1.0,1.0,GPT4,medalign,progress_note,PROMPT2_ICL_entailment
86,84,32,27,5,0.84375,23,17,6,0.7391304347826086,0.7879828326180257,GPT4,medalign,progress_note,PROMPT2_ICL_entailment
87,85,61,58,3,0.9508196721311476,63,36,27,0.5714285714285714,0.7138461538461538,GPT4,medalign,progress_note,PROMPT2_ICL_entailment
88,86,113,97,16,0.8584070796460177,75,40,35,0.5333333333333333,0.6579058923272573,GPT4,medalign,progress_note,PROMPT2_ICL_entailment
89,87,90,85,5,0.9444444444444444,87,63,24,0.7241379310344828,0.8197474167623421,GPT4,medalign,progress_note,PROMPT2_ICL_entailment
90,88,86,80,6,0.9302325581395348,84,66,18,0.7857142857142857,0.8518877057115198,GPT4,medalign,progress_note,PROMPT2_ICL_entailment
91,89,46,44,2,0.9565217391304348,41,33,8,0.8048780487804879,0.8741721854304637,GPT4,medalign,progress_note,PROMPT2_ICL_entailment
92,9,102,100,2,0.9803921568627452,68,38,30,0.5588235294117647,0.7118771075309105,GPT4,medalign,progress_note,PROMPT2_ICL_entailment
93,90,26,26,0,1.0,24,16,8,0.6666666666666666,0.8,GPT4,medalign,progress_note,PROMPT2_ICL_entailment
94,91,50,50,0,1.0,45,34,11,0.7555555555555555,0.8607594936708861,GPT4,medalign,progress_note,PROMPT2_ICL_entailment
95,92,19,19,0,1.0,17,13,4,0.7647058823529411,0.8666666666666666,GPT4,medalign,progress_note,PROMPT2_ICL_entailment
96,93,31,28,3,0.9032258064516128,25,19,6,0.76,0.8254460822342902,GPT4,medalign,progress_note,PROMPT2_ICL_entailment
97,94,39,34,5,0.8717948717948718,33,23,10,0.696969696969697,0.7746409113422487,GPT4,medalign,progress_note,PROMPT2_ICL_entailment
98,95,54,50,4,0.925925925925926,41,33,8,0.8048780487804879,0.861169102296451,GPT4,medalign,progress_note,PROMPT2_ICL_entailment
99,96,100,96,4,0.96,48,36,12,0.75,0.8421052631578947,GPT4,medalign,progress_note,PROMPT2_ICL_entailment
100,97,65,59,6,0.9076923076923076,37,30,7,0.8108108108108109,0.8565206871521898,GPT4,medalign,progress_note,PROMPT2_ICL_entailment
101,98,53,36,17,0.6792452830188679,55,45,10,0.8181818181818182,0.7422680412371134,GPT4,medalign,progress_note,PROMPT2_ICL_entailment
102,99,72,63,9,0.875,73,50,23,0.684931506849315,0.7683863885839736,GPT4,medalign,progress_note,PROMPT2_ICL_entailment
0,0,58,51,7,0.8793103448275862,71,45,26,0.6338028169014085,0.7366393837265286,GPT4,medalign,progress_note,PROMPT2_entailment
1,1,55,51,4,0.9272727272727272,47,32,15,0.6808510638297872,0.7851816213615587,GPT4,medalign,progress_note,PROMPT2_entailment
2,10,30,27,3,0.9,48,36,12,0.75,0.8181818181818182,GPT4,medalign,progress_note,PROMPT2_entailment
3,100,27,27,0,1.0,43,27,16,0.627906976744186,0.7714285714285715,GPT4,medalign,progress_note,PROMPT2_entailment
4,101,57,56,1,0.9824561403508772,73,54,19,0.7397260273972602,0.8439854870220486,GPT4,medalign,progress_note,PROMPT2_entailment
5,102,18,17,1,0.9444444444444444,13,10,3,0.7692307692307693,0.8478802992518703,GPT4,medalign,progress_note,PROMPT2_entailment
6,11,29,29,0,1.0,38,25,13,0.6578947368421053,0.7936507936507937,GPT4,medalign,progress_note,PROMPT2_entailment
7,12,52,50,2,0.9615384615384616,46,31,15,0.6739130434782609,0.792433537832311,GPT4,medalign,progress_note,PROMPT2_entailment
8,13,55,50,5,0.9090909090909092,68,51,17,0.75,0.821917808219178,GPT4,medalign,progress_note,PROMPT2_entailment
9,14,15,13,2,0.8666666666666667,13,9,4,0.6923076923076923,0.7697368421052632,GPT4,medalign,progress_note,PROMPT2_entailment
10,15,20,18,2,0.9,19,13,6,0.6842105263157895,0.7774086378737541,GPT4,medalign,progress_note,PROMPT2_entailment
11,16,80,66,14,0.825,78,65,13,0.8333333333333334,0.8291457286432161,GPT4,medalign,progress_note,PROMPT2_entailment
12,17,44,40,4,0.9090909090909092,33,25,8,0.7575757575757576,0.8264462809917356,GPT4,medalign,progress_note,PROMPT2_entailment
13,18,53,50,3,0.9433962264150944,59,48,11,0.8135593220338984,0.8736803785948307,GPT4,medalign,progress_note,PROMPT2_entailment
14,19,48,46,2,0.9583333333333334,57,43,14,0.7543859649122807,0.844216816047802,GPT4,medalign,progress_note,PROMPT2_entailment
15,2,50,42,8,0.84,54,45,9,0.8333333333333334,0.8366533864541832,GPT4,medalign,progress_note,PROMPT2_entailment
16,20,29,27,2,0.9310344827586208,31,27,4,0.8709677419354839,0.9,GPT4,medalign,progress_note,PROMPT2_entailment
17,21,28,22,6,0.7857142857142857,31,23,8,0.7419354838709677,0.7631975867269984,GPT4,medalign,progress_note,PROMPT2_entailment
18,22,38,37,1,0.9736842105263158,63,32,31,0.5079365079365079,0.6676064279672962,GPT4,medalign,progress_note,PROMPT2_entailment
19,23,32,29,3,0.90625,35,20,15,0.5714285714285714,0.7009063444108761,GPT4,medalign,progress_note,PROMPT2_entailment
20,24,30,26,4,0.8666666666666667,42,29,13,0.6904761904761905,0.7686034658511722,GPT4,medalign,progress_note,PROMPT2_entailment
21,25,34,33,1,0.9705882352941176,26,23,3,0.8846153846153846,0.9256097560975608,GPT4,medalign,progress_note,PROMPT2_entailment
22,26,42,39,3,0.9285714285714286,24,21,3,0.875,0.900990099009901,GPT4,medalign,progress_note,PROMPT2_entailment
23,27,37,35,2,0.945945945945946,81,47,34,0.5802469135802469,0.7192829033668562,GPT4,medalign,progress_note,PROMPT2_entailment
24,28,46,39,7,0.8478260869565217,38,24,14,0.631578947368421,0.7238979118329466,GPT4,medalign,progress_note,PROMPT2_entailment
25,29,89,81,8,0.9101123595505618,99,50,49,0.5050505050505051,0.649611035367712,GPT4,medalign,progress_note,PROMPT2_entailment
26,3,35,34,1,0.9714285714285714,56,36,20,0.6428571428571429,0.7737041719342604,GPT4,medalign,progress_note,PROMPT2_entailment
27,30,47,44,3,0.9361702127659576,54,30,24,0.5555555555555556,0.6973058637083994,GPT4,medalign,progress_note,PROMPT2_entailment
28,31,44,38,6,0.8636363636363636,38,30,8,0.7894736842105263,0.824891461649783,GPT4,medalign,progress_note,PROMPT2_entailment
29,32,70,69,1,0.9857142857142858,45,38,7,0.8444444444444444,0.9096270598438856,GPT4,medalign,progress_note,PROMPT2_entailment
30,33,28,28,0,1.0,33,23,10,0.696969696969697,0.8214285714285715,GPT4,medalign,progress_note,PROMPT2_entailment
31,34,32,31,1,0.96875,30,25,5,0.8333333333333334,0.8959537572254336,GPT4,medalign,progress_note,PROMPT2_entailment
32,35,26,26,0,1.0,57,32,25,0.5614035087719298,0.7191011235955056,GPT4,medalign,progress_note,PROMPT2_entailment
33,36,38,36,2,0.9473684210526316,29,19,10,0.6551724137931034,0.7746319365798413,GPT4,medalign,progress_note,PROMPT2_entailment
34,37,29,16,13,0.5517241379310345,19,10,9,0.5263157894736842,0.5387205387205386,GPT4,medalign,progress_note,PROMPT2_entailment
35,38,69,58,11,0.8405797101449275,63,48,15,0.7619047619047619,0.7993109388458225,GPT4,medalign,progress_note,PROMPT2_entailment
36,39,57,42,15,0.7368421052631579,43,30,13,0.6976744186046512,0.7167235494880546,GPT4,medalign,progress_note,PROMPT2_entailment
37,4,57,54,3,0.9473684210526316,65,40,25,0.6153846153846154,0.7461139896373057,GPT4,medalign,progress_note,PROMPT2_entailment
38,40,46,43,3,0.9347826086956522,31,23,8,0.7419354838709677,0.8272689251359264,GPT4,medalign,progress_note,PROMPT2_entailment
39,41,60,57,3,0.95,69,50,19,0.7246376811594203,0.8221549112938122,GPT4,medalign,progress_note,PROMPT2_entailment
40,42,36,32,4,0.8888888888888888,32,26,6,0.8125,0.8489795918367347,GPT4,medalign,progress_note,PROMPT2_entailment
41,43,30,28,2,0.9333333333333332,23,18,5,0.782608695652174,0.8513513513513513,GPT4,medalign,progress_note,PROMPT2_entailment
42,44,72,67,5,0.9305555555555556,92,52,40,0.5652173913043478,0.7032700847799758,GPT4,medalign,progress_note,PROMPT2_entailment
43,45,25,22,3,0.88,15,13,2,0.8666666666666667,0.8732824427480917,GPT4,medalign,progress_note,PROMPT2_entailment
44,46,61,60,1,0.9836065573770492,50,37,13,0.74,0.8445881681567433,GPT4,medalign,progress_note,PROMPT2_entailment
45,47,61,50,11,0.819672131147541,42,30,12,0.7142857142857143,0.7633587786259541,GPT4,medalign,progress_note,PROMPT2_entailment
46,48,40,38,2,0.95,56,35,21,0.625,0.753968253968254,GPT4,medalign,progress_note,PROMPT2_entailment
47,49,80,78,2,0.975,58,31,27,0.5344827586206896,0.6904625928041118,GPT4,medalign,progress_note,PROMPT2_entailment
48,5,77,71,6,0.922077922077922,69,46,23,0.6666666666666666,0.7738419618528609,GPT4,medalign,progress_note,PROMPT2_entailment
49,50,51,51,0,1.0,68,49,19,0.7205882352941176,0.8376068376068375,GPT4,medalign,progress_note,PROMPT2_entailment
50,51,61,59,2,0.9672131147540984,47,36,11,0.7659574468085106,0.8549003823706983,GPT4,medalign,progress_note,PROMPT2_entailment
51,52,20,18,2,0.9,19,14,5,0.7368421052631579,0.810289389067524,GPT4,medalign,progress_note,PROMPT2_entailment
52,53,59,58,1,0.9830508474576272,54,36,18,0.6666666666666666,0.7945205479452054,GPT4,medalign,progress_note,PROMPT2_entailment
53,54,30,29,1,0.9666666666666668,24,16,8,0.6666666666666666,0.7891156462585033,GPT4,medalign,progress_note,PROMPT2_entailment
54,55,26,23,3,0.8846153846153846,23,17,6,0.7391304347826086,0.8053553038105046,GPT4,medalign,progress_note,PROMPT2_entailment
55,56,33,31,2,0.9393939393939394,25,19,6,0.76,0.8402282453637661,GPT4,medalign,progress_note,PROMPT2_entailment
56,57,9,9,0,1.0,4,4,0,1.0,1.0,GPT4,medalign,progress_note,PROMPT2_entailment
57,58,18,16,2,0.8888888888888888,13,11,2,0.8461538461538461,0.8669950738916256,GPT4,medalign,progress_note,PROMPT2_entailment
58,59,29,28,1,0.9655172413793104,35,20,15,0.5714285714285714,0.717948717948718,GPT4,medalign,progress_note,PROMPT2_entailment
59,6,67,67,0,1.0,59,44,15,0.7457627118644068,0.8543689320388349,GPT4,medalign,progress_note,PROMPT2_entailment
60,60,48,45,3,0.9375,56,26,30,0.4642857142857143,0.6210191082802548,GPT4,medalign,progress_note,PROMPT2_entailment
61,61,28,25,3,0.8928571428571429,25,21,4,0.84,0.8656224237427864,GPT4,medalign,progress_note,PROMPT2_entailment
62,62,32,31,1,0.96875,32,16,16,0.5,0.6595744680851063,GPT4,medalign,progress_note,PROMPT2_entailment
63,63,15,13,2,0.8666666666666667,10,8,2,0.8,0.832,GPT4,medalign,progress_note,PROMPT2_entailment
64,64,35,32,3,0.9142857142857144,69,39,30,0.5652173913043478,0.6985726280436608,GPT4,medalign,progress_note,PROMPT2_entailment
65,65,156,115,41,0.7371794871794872,104,56,48,0.5384615384615384,0.6223424816389641,GPT4,medalign,progress_note,PROMPT2_entailment
66,66,66,60,6,0.9090909090909092,87,66,21,0.7586206896551724,0.8270676691729324,GPT4,medalign,progress_note,PROMPT2_entailment
67,67,23,22,1,0.9565217391304348,18,12,6,0.6666666666666666,0.7857142857142856,GPT4,medalign,progress_note,PROMPT2_entailment
68,68,14,14,0,1.0,11,8,3,0.7272727272727273,0.8421052631578948,GPT4,medalign,progress_note,PROMPT2_entailment
69,69,30,30,0,1.0,68,41,27,0.6029411764705882,0.7522935779816513,GPT4,medalign,progress_note,PROMPT2_entailment
70,7,46,34,12,0.7391304347826086,37,31,6,0.8378378378378378,0.7853949329359164,GPT4,medalign,progress_note,PROMPT2_entailment
71,70,58,50,8,0.8620689655172413,69,45,24,0.6521739130434783,0.7425742574257426,GPT4,medalign,progress_note,PROMPT2_entailment
72,71,53,50,3,0.9433962264150944,48,39,9,0.8125,0.873069173942243,GPT4,medalign,progress_note,PROMPT2_entailment
73,72,48,46,2,0.9583333333333334,69,46,23,0.6666666666666666,0.7863247863247863,GPT4,medalign,progress_note,PROMPT2_entailment
74,73,58,41,17,0.7068965517241379,90,58,32,0.6444444444444445,0.6742273887156224,GPT4,medalign,progress_note,PROMPT2_entailment
75,74,25,23,2,0.92,22,21,1,0.9545454545454546,0.9369544131910768,GPT4,medalign,progress_note,PROMPT2_entailment
76,75,33,30,3,0.9090909090909092,49,30,19,0.6122448979591837,0.7317073170731708,GPT4,medalign,progress_note,PROMPT2_entailment
77,76,75,68,7,0.9066666666666666,77,54,23,0.7012987012987013,0.7908679732931293,GPT4,medalign,progress_note,PROMPT2_entailment
78,77,63,59,4,0.9365079365079364,38,32,6,0.8421052631578947,0.886801315171442,GPT4,medalign,progress_note,PROMPT2_entailment
79,78,51,51,0,1.0,54,40,14,0.7407407407407407,0.851063829787234,GPT4,medalign,progress_note,PROMPT2_entailment
80,79,44,41,3,0.9318181818181818,64,41,23,0.640625,0.7592592592592593,GPT4,medalign,progress_note,PROMPT2_entailment
81,8,39,35,4,0.8974358974358975,31,15,16,0.4838709677419355,0.62874251497006,GPT4,medalign,progress_note,PROMPT2_entailment
82,80,49,44,5,0.8979591836734694,66,41,25,0.6212121212121212,0.734378180337879,GPT4,medalign,progress_note,PROMPT2_entailment
83,81,17,14,3,0.8235294117647058,12,9,3,0.75,0.7850467289719627,GPT4,medalign,progress_note,PROMPT2_entailment
84,82,16,16,0,1.0,13,9,4,0.6923076923076923,0.8181818181818181,GPT4,medalign,progress_note,PROMPT2_entailment
85,83,15,14,1,0.9333333333333332,8,6,2,0.75,0.8316831683168316,GPT4,medalign,progress_note,PROMPT2_entailment
86,84,27,19,8,0.7037037037037037,23,17,6,0.7391304347826086,0.7209821428571428,GPT4,medalign,progress_note,PROMPT2_entailment
87,85,40,38,2,0.95,63,34,29,0.5396825396825397,0.6883324453915822,GPT4,medalign,progress_note,PROMPT2_entailment
88,86,87,75,12,0.8620689655172413,75,46,29,0.6133333333333333,0.7167341851043938,GPT4,medalign,progress_note,PROMPT2_entailment
89,87,80,78,2,0.975,87,67,20,0.7701149425287356,0.8605302157088753,GPT4,medalign,progress_note,PROMPT2_entailment
90,88,76,62,14,0.8157894736842105,84,58,26,0.6904761904761905,0.7479201331114809,GPT4,medalign,progress_note,PROMPT2_entailment
91,89,27,24,3,0.8888888888888888,41,26,15,0.6341463414634146,0.7402135231316725,GPT4,medalign,progress_note,PROMPT2_entailment
92,9,43,43,0,1.0,68,34,34,0.5,0.6666666666666666,GPT4,medalign,progress_note,PROMPT2_entailment
93,90,18,18,0,1.0,24,16,8,0.6666666666666666,0.8,GPT4,medalign,progress_note,PROMPT2_entailment
94,91,46,46,0,1.0,45,35,10,0.7777777777777778,0.8750000000000001,GPT4,medalign,progress_note,PROMPT2_entailment
95,92,21,18,3,0.8571428571428571,17,15,2,0.8823529411764706,0.8695652173913043,GPT4,medalign,progress_note,PROMPT2_entailment
96,93,30,30,0,1.0,25,22,3,0.88,0.9361702127659576,GPT4,medalign,progress_note,PROMPT2_entailment
97,94,40,36,4,0.9,33,22,11,0.6666666666666666,0.7659574468085106,GPT4,medalign,progress_note,PROMPT2_entailment
98,95,44,43,1,0.9772727272727272,41,30,11,0.7317073170731707,0.8368472267272138,GPT4,medalign,progress_note,PROMPT2_entailment
99,96,54,52,2,0.9629629629629628,48,39,9,0.8125,0.8813559322033898,GPT4,medalign,progress_note,PROMPT2_entailment
100,97,65,62,3,0.953846153846154,37,30,7,0.8108108108108109,0.8765315739868049,GPT4,medalign,progress_note,PROMPT2_entailment
101,98,49,35,14,0.7142857142857143,55,31,24,0.5636363636363636,0.6300813008130081,GPT4,medalign,progress_note,PROMPT2_entailment
102,99,49,43,6,0.8775510204081632,73,45,28,0.6164383561643836,0.7241766467065868,GPT4,medalign,progress_note,PROMPT2_entailment
0,0,17,16,1,0.9411764705882352,9,9,0,1.0,0.9696969696969696,shc-gpt-4o,coral,pdac,PROMPT1_entailment
1,1,12,12,0,1.0,9,9,0,1.0,1.0,shc-gpt-4o,coral,pdac,PROMPT1_entailment
2,10,22,20,2,0.9090909090909092,11,9,2,0.8181818181818182,0.861244019138756,shc-gpt-4o,coral,pdac,PROMPT1_entailment
3,100,6,6,0,1.0,11,11,0,1.0,1.0,shc-gpt-4o,coral,pdac,PROMPT1_entailment
4,101,22,21,1,0.9545454545454546,11,10,1,0.9090909090909092,0.9312638580931264,shc-gpt-4o,coral,pdac,PROMPT1_entailment
5,102,26,26,0,1.0,27,12,15,0.4444444444444444,0.6153846153846153,shc-gpt-4o,coral,pdac,PROMPT1_entailment
6,103,10,8,2,0.8,15,10,5,0.6666666666666666,0.7272727272727272,shc-gpt-4o,coral,pdac,PROMPT1_entailment
7,104,20,17,3,0.85,12,12,0,1.0,0.9189189189189187,shc-gpt-4o,coral,pdac,PROMPT1_entailment
8,105,23,14,9,0.6086956521739131,33,16,17,0.4848484848484848,0.5397590361445784,shc-gpt-4o,coral,pdac,PROMPT1_entailment
9,106,14,14,0,1.0,10,10,0,1.0,1.0,shc-gpt-4o,coral,pdac,PROMPT1_entailment
10,107,10,10,0,1.0,10,10,0,1.0,1.0,shc-gpt-4o,coral,pdac,PROMPT1_entailment
11,108,18,18,0,1.0,10,10,0,1.0,1.0,shc-gpt-4o,coral,pdac,PROMPT1_entailment
12,109,29,29,0,1.0,34,30,4,0.8823529411764706,0.9375,shc-gpt-4o,coral,pdac,PROMPT1_entailment
13,11,19,18,1,0.9473684210526316,10,7,3,0.7,0.8051118210862619,shc-gpt-4o,coral,pdac,PROMPT1_entailment
14,110,6,6,0,1.0,4,3,1,0.75,0.8571428571428571,shc-gpt-4o,coral,pdac,PROMPT1_entailment
15,111,9,9,0,1.0,3,3,0,1.0,1.0,shc-gpt-4o,coral,pdac,PROMPT1_entailment
16,112,7,6,1,0.8571428571428571,9,7,2,0.7777777777777778,0.8155339805825242,shc-gpt-4o,coral,pdac,PROMPT1_entailment
17,113,14,12,2,0.8571428571428571,6,4,2,0.6666666666666666,0.75,shc-gpt-4o,coral,pdac,PROMPT1_entailment
18,114,13,13,0,1.0,9,8,1,0.8888888888888888,0.9411764705882352,shc-gpt-4o,coral,pdac,PROMPT1_entailment
19,115,9,9,0,1.0,7,6,1,0.8571428571428571,0.923076923076923,shc-gpt-4o,coral,pdac,PROMPT1_entailment
20,116,6,6,0,1.0,2,2,0,1.0,1.0,shc-gpt-4o,coral,pdac,PROMPT1_entailment
21,117,14,12,2,0.8571428571428571,8,8,0,1.0,0.923076923076923,shc-gpt-4o,coral,pdac,PROMPT1_entailment
22,118,17,17,0,1.0,9,9,0,1.0,1.0,shc-gpt-4o,coral,pdac,PROMPT1_entailment
23,119,16,12,4,0.75,12,11,1,0.9166666666666666,0.8250000000000001,shc-gpt-4o,coral,pdac,PROMPT1_entailment
24,12,23,22,1,0.9565217391304348,10,10,0,1.0,0.9777777777777776,shc-gpt-4o,coral,pdac,PROMPT1_entailment
25,120,18,14,4,0.7777777777777778,13,9,4,0.6923076923076923,0.7325581395348836,shc-gpt-4o,coral,pdac,PROMPT1_entailment
26,121,26,26,0,1.0,12,10,2,0.8333333333333334,0.9090909090909092,shc-gpt-4o,coral,pdac,PROMPT1_entailment
27,122,55,30,25,0.5454545454545454,45,29,16,0.6444444444444445,0.5908319185059423,shc-gpt-4o,coral,pdac,PROMPT1_entailment
28,123,14,14,0,1.0,10,7,3,0.7,0.8235294117647058,shc-gpt-4o,coral,pdac,PROMPT1_entailment
29,124,4,4,0,1.0,3,3,0,1.0,1.0,shc-gpt-4o,coral,pdac,PROMPT1_entailment
30,125,15,14,1,0.9333333333333332,8,8,0,1.0,0.9655172413793104,shc-gpt-4o,coral,pdac,PROMPT1_entailment
31,126,15,15,0,1.0,10,9,1,0.9,0.9473684210526316,shc-gpt-4o,coral,pdac,PROMPT1_entailment
32,127,28,19,9,0.6785714285714286,30,28,2,0.9333333333333332,0.7858197932053177,shc-gpt-4o,coral,pdac,PROMPT1_entailment
33,128,46,42,4,0.9130434782608696,35,31,4,0.8857142857142857,0.8991712707182319,shc-gpt-4o,coral,pdac,PROMPT1_entailment
34,129,15,14,1,0.9333333333333332,11,10,1,0.9090909090909092,0.9210526315789476,shc-gpt-4o,coral,pdac,PROMPT1_entailment
35,13,34,33,1,0.9705882352941176,13,11,2,0.8461538461538461,0.9041095890410958,shc-gpt-4o,coral,pdac,PROMPT1_entailment
36,130,19,15,4,0.7894736842105263,12,10,2,0.8333333333333334,0.8108108108108109,shc-gpt-4o,coral,pdac,PROMPT1_entailment
37,131,16,14,2,0.875,12,7,5,0.5833333333333334,0.7000000000000001,shc-gpt-4o,coral,pdac,PROMPT1_entailment
38,132,17,13,4,0.7647058823529411,10,9,1,0.9,0.8268551236749118,shc-gpt-4o,coral,pdac,PROMPT1_entailment
39,133,15,14,1,0.9333333333333332,7,7,0,1.0,0.9655172413793104,shc-gpt-4o,coral,pdac,PROMPT1_entailment
40,134,20,17,3,0.85,15,10,5,0.6666666666666666,0.7472527472527473,shc-gpt-4o,coral,pdac,PROMPT1_entailment
41,135,13,13,0,1.0,9,9,0,1.0,1.0,shc-gpt-4o,coral,pdac,PROMPT1_entailment
42,136,23,21,2,0.9130434782608696,7,5,2,0.7142857142857143,0.8015267175572519,shc-gpt-4o,coral,pdac,PROMPT1_entailment
43,137,15,14,1,0.9333333333333332,10,6,4,0.6,0.7304347826086957,shc-gpt-4o,coral,pdac,PROMPT1_entailment
44,138,39,26,13,0.6666666666666666,25,14,11,0.56,0.6086956521739131,shc-gpt-4o,coral,pdac,PROMPT1_entailment
45,139,43,25,18,0.5813953488372093,62,53,9,0.8548387096774194,0.6920867067119353,shc-gpt-4o,coral,pdac,PROMPT1_entailment
46,14,11,10,1,0.9090909090909092,10,10,0,1.0,0.9523809523809524,shc-gpt-4o,coral,pdac,PROMPT1_entailment
47,140,13,12,1,0.9230769230769232,8,8,0,1.0,0.96,shc-gpt-4o,coral,pdac,PROMPT1_entailment
48,141,17,14,3,0.8235294117647058,11,9,2,0.8181818181818182,0.8208469055374593,shc-gpt-4o,coral,pdac,PROMPT1_entailment
49,142,16,11,5,0.6875,11,10,1,0.9090909090909092,0.7829181494661921,shc-gpt-4o,coral,pdac,PROMPT1_entailment
50,143,13,12,1,0.9230769230769232,9,7,2,0.7777777777777778,0.8442211055276381,shc-gpt-4o,coral,pdac,PROMPT1_entailment
51,144,18,17,1,0.9444444444444444,12,12,0,1.0,0.9714285714285714,shc-gpt-4o,coral,pdac,PROMPT1_entailment
52,145,10,9,1,0.9,10,9,1,0.9,0.9,shc-gpt-4o,coral,pdac,PROMPT1_entailment
53,146,8,8,0,1.0,7,4,3,0.5714285714285714,0.7272727272727273,shc-gpt-4o,coral,pdac,PROMPT1_entailment
54,147,16,13,3,0.8125,12,9,3,0.75,0.78,shc-gpt-4o,coral,pdac,PROMPT1_entailment
55,148,35,29,6,0.8285714285714286,25,17,8,0.68,0.7469696969696971,shc-gpt-4o,coral,pdac,PROMPT1_entailment
56,149,17,16,1,0.9411764705882352,7,6,1,0.8571428571428571,0.897196261682243,shc-gpt-4o,coral,pdac,PROMPT1_entailment
57,15,11,11,0,1.0,10,10,0,1.0,1.0,shc-gpt-4o,coral,pdac,PROMPT1_entailment
58,150,14,14,0,1.0,8,8,0,1.0,1.0,shc-gpt-4o,coral,pdac,PROMPT1_entailment
59,151,17,16,1,0.9411764705882352,10,10,0,1.0,0.9696969696969696,shc-gpt-4o,coral,pdac,PROMPT1_entailment
60,152,17,17,0,1.0,11,7,4,0.6363636363636364,0.7777777777777778,shc-gpt-4o,coral,pdac,PROMPT1_entailment
61,153,44,30,14,0.6818181818181818,30,11,19,0.3666666666666666,0.476878612716763,shc-gpt-4o,coral,pdac,PROMPT1_entailment
62,154,23,21,2,0.9130434782608696,15,13,2,0.8666666666666667,0.8892508143322475,shc-gpt-4o,coral,pdac,PROMPT1_entailment
63,155,4,3,1,0.75,47,31,16,0.6595744680851063,0.7018867924528301,shc-gpt-4o,coral,pdac,PROMPT1_entailment
64,156,13,13,0,1.0,10,8,2,0.8,0.888888888888889,shc-gpt-4o,coral,pdac,PROMPT1_entailment
65,157,20,18,2,0.9,14,11,3,0.7857142857142857,0.8389830508474577,shc-gpt-4o,coral,pdac,PROMPT1_entailment
66,158,13,13,0,1.0,10,9,1,0.9,0.9473684210526316,shc-gpt-4o,coral,pdac,PROMPT1_entailment
67,159,13,10,3,0.7692307692307693,4,3,1,0.75,0.7594936708860761,shc-gpt-4o,coral,pdac,PROMPT1_entailment
68,16,38,34,4,0.8947368421052632,31,26,5,0.8387096774193549,0.8658178256611166,shc-gpt-4o,coral,pdac,PROMPT1_entailment
69,160,16,13,3,0.8125,9,9,0,1.0,0.896551724137931,shc-gpt-4o,coral,pdac,PROMPT1_entailment
70,161,15,15,0,1.0,9,8,1,0.8888888888888888,0.9411764705882352,shc-gpt-4o,coral,pdac,PROMPT1_entailment
71,162,14,14,0,1.0,10,10,0,1.0,1.0,shc-gpt-4o,coral,pdac,PROMPT1_entailment
72,163,12,10,2,0.8333333333333334,13,10,3,0.7692307692307693,0.8,shc-gpt-4o,coral,pdac,PROMPT1_entailment
73,164,53,42,11,0.7924528301886793,36,31,5,0.8611111111111112,0.8253565768621236,shc-gpt-4o,coral,pdac,PROMPT1_entailment
74,165,11,11,0,1.0,10,8,2,0.8,0.888888888888889,shc-gpt-4o,coral,pdac,PROMPT1_entailment
75,166,17,15,2,0.8823529411764706,11,10,1,0.9090909090909092,0.8955223880597014,shc-gpt-4o,coral,pdac,PROMPT1_entailment
76,167,11,9,2,0.8181818181818182,8,7,1,0.875,0.8456375838926175,shc-gpt-4o,coral,pdac,PROMPT1_entailment
77,168,7,6,1,0.8571428571428571,6,6,0,1.0,0.923076923076923,shc-gpt-4o,coral,pdac,PROMPT1_entailment
78,169,10,10,0,1.0,7,7,0,1.0,1.0,shc-gpt-4o,coral,pdac,PROMPT1_entailment
79,17,11,11,0,1.0,5,4,1,0.8,0.888888888888889,shc-gpt-4o,coral,pdac,PROMPT1_entailment
80,170,33,27,6,0.8181818181818182,16,9,7,0.5625,0.6666666666666666,shc-gpt-4o,coral,pdac,PROMPT1_entailment
81,171,17,13,4,0.7647058823529411,13,11,2,0.8461538461538461,0.8033707865168538,shc-gpt-4o,coral,pdac,PROMPT1_entailment
82,172,21,17,4,0.8095238095238095,10,9,1,0.9,0.8523676880222841,shc-gpt-4o,coral,pdac,PROMPT1_entailment
83,173,25,25,0,1.0,22,10,12,0.4545454545454545,0.625,shc-gpt-4o,coral,pdac,PROMPT1_entailment
84,174,7,5,2,0.7142857142857143,11,9,2,0.8181818181818182,0.7627118644067797,shc-gpt-4o,coral,pdac,PROMPT1_entailment
85,175,6,2,4,0.3333333333333333,28,16,12,0.5714285714285714,0.4210526315789474,shc-gpt-4o,coral,pdac,PROMPT1_entailment
86,176,12,12,0,1.0,10,10,0,1.0,1.0,shc-gpt-4o,coral,pdac,PROMPT1_entailment
87,177,12,12,0,1.0,10,9,1,0.9,0.9473684210526316,shc-gpt-4o,coral,pdac,PROMPT1_entailment
88,178,43,25,18,0.5813953488372093,36,9,27,0.25,0.3496503496503496,shc-gpt-4o,coral,pdac,PROMPT1_entailment
89,179,10,10,0,1.0,9,8,1,0.8888888888888888,0.9411764705882352,shc-gpt-4o,coral,pdac,PROMPT1_entailment
90,18,8,7,1,0.875,15,8,7,0.5333333333333333,0.6627218934911243,shc-gpt-4o,coral,pdac,PROMPT1_entailment
91,180,8,8,0,1.0,5,5,0,1.0,1.0,shc-gpt-4o,coral,pdac,PROMPT1_entailment
92,181,20,19,1,0.95,10,10,0,1.0,0.9743589743589745,shc-gpt-4o,coral,pdac,PROMPT1_entailment
93,182,14,13,1,0.9285714285714286,8,8,0,1.0,0.962962962962963,shc-gpt-4o,coral,pdac,PROMPT1_entailment
94,183,15,15,0,1.0,10,8,2,0.8,0.888888888888889,shc-gpt-4o,coral,pdac,PROMPT1_entailment
95,184,9,9,0,1.0,9,4,5,0.4444444444444444,0.6153846153846153,shc-gpt-4o,coral,pdac,PROMPT1_entailment
96,185,25,17,8,0.68,22,17,5,0.7727272727272727,0.7234042553191491,shc-gpt-4o,coral,pdac,PROMPT1_entailment
97,186,13,8,5,0.6153846153846154,32,20,12,0.625,0.6201550387596899,shc-gpt-4o,coral,pdac,PROMPT1_entailment
98,187,65,42,23,0.6461538461538462,34,9,25,0.2647058823529412,0.375558867362146,shc-gpt-4o,coral,pdac,PROMPT1_entailment
99,188,19,18,1,0.9473684210526316,8,7,1,0.875,0.9097472924187724,shc-gpt-4o,coral,pdac,PROMPT1_entailment
100,189,16,15,1,0.9375,5,5,0,1.0,0.967741935483871,shc-gpt-4o,coral,pdac,PROMPT1_entailment
101,19,38,31,7,0.8157894736842105,21,15,6,0.7142857142857143,0.7616707616707618,shc-gpt-4o,coral,pdac,PROMPT1_entailment
102,190,14,12,2,0.8571428571428571,17,11,6,0.6470588235294118,0.7374301675977654,shc-gpt-4o,coral,pdac,PROMPT1_entailment
103,191,4,3,1,0.75,15,14,1,0.9333333333333332,0.8316831683168316,shc-gpt-4o,coral,pdac,PROMPT1_entailment
104,192,11,8,3,0.7272727272727273,12,12,0,1.0,0.8421052631578948,shc-gpt-4o,coral,pdac,PROMPT1_entailment
105,193,10,8,2,0.8,10,9,1,0.9,0.8470588235294118,shc-gpt-4o,coral,pdac,PROMPT1_entailment
106,194,11,10,1,0.9090909090909092,11,11,0,1.0,0.9523809523809524,shc-gpt-4o,coral,pdac,PROMPT1_entailment
107,195,8,6,2,0.75,7,6,1,0.8571428571428571,0.7999999999999999,shc-gpt-4o,coral,pdac,PROMPT1_entailment
108,196,14,13,1,0.9285714285714286,8,8,0,1.0,0.962962962962963,shc-gpt-4o,coral,pdac,PROMPT1_entailment
109,197,21,21,0,1.0,9,5,4,0.5555555555555556,0.7142857142857143,shc-gpt-4o,coral,pdac,PROMPT1_entailment
110,198,18,18,0,1.0,12,10,2,0.8333333333333334,0.9090909090909092,shc-gpt-4o,coral,pdac,PROMPT1_entailment
111,199,22,20,2,0.9090909090909092,9,8,1,0.8888888888888888,0.8988764044943819,shc-gpt-4o,coral,pdac,PROMPT1_entailment
112,2,18,11,7,0.6111111111111112,14,11,3,0.7857142857142857,0.6875000000000001,shc-gpt-4o,coral,pdac,PROMPT1_entailment
113,20,31,23,8,0.7419354838709677,18,9,9,0.5,0.5974025974025974,shc-gpt-4o,coral,pdac,PROMPT1_entailment
114,200,33,31,2,0.9393939393939394,16,14,2,0.875,0.906054279749478,shc-gpt-4o,coral,pdac,PROMPT1_entailment
115,201,11,11,0,1.0,10,10,0,1.0,1.0,shc-gpt-4o,coral,pdac,PROMPT1_entailment
116,202,10,10,0,1.0,10,10,0,1.0,1.0,shc-gpt-4o,coral,pdac,PROMPT1_entailment
117,203,6,4,2,0.6666666666666666,31,20,11,0.6451612903225806,0.6557377049180327,shc-gpt-4o,coral,pdac,PROMPT1_entailment
118,204,15,12,3,0.8,14,12,2,0.8571428571428571,0.8275862068965518,shc-gpt-4o,coral,pdac,PROMPT1_entailment
119,205,17,12,5,0.7058823529411765,7,4,3,0.5714285714285714,0.6315789473684211,shc-gpt-4o,coral,pdac,PROMPT1_entailment
120,206,11,10,1,0.9090909090909092,9,8,1,0.8888888888888888,0.8988764044943819,shc-gpt-4o,coral,pdac,PROMPT1_entailment
121,207,10,9,1,0.9,8,5,3,0.625,0.7377049180327869,shc-gpt-4o,coral,pdac,PROMPT1_entailment
122,208,8,7,1,0.875,8,8,0,1.0,0.9333333333333332,shc-gpt-4o,coral,pdac,PROMPT1_entailment
123,209,24,24,0,1.0,9,8,1,0.8888888888888888,0.9411764705882352,shc-gpt-4o,coral,pdac,PROMPT1_entailment
124,21,10,10,0,1.0,10,10,0,1.0,1.0,shc-gpt-4o,coral,pdac,PROMPT1_entailment
125,210,16,12,4,0.75,9,9,0,1.0,0.8571428571428571,shc-gpt-4o,coral,pdac,PROMPT1_entailment
126,211,16,12,4,0.75,8,8,0,1.0,0.8571428571428571,shc-gpt-4o,coral,pdac,PROMPT1_entailment
127,212,23,22,1,0.9565217391304348,17,15,2,0.8823529411764706,0.917941585535466,shc-gpt-4o,coral,pdac,PROMPT1_entailment
128,213,14,14,0,1.0,11,7,4,0.6363636363636364,0.7777777777777778,shc-gpt-4o,coral,pdac,PROMPT1_entailment
129,214,14,12,2,0.8571428571428571,18,9,9,0.5,0.631578947368421,shc-gpt-4o,coral,pdac,PROMPT1_entailment
130,215,23,12,11,0.5217391304347826,12,8,4,0.6666666666666666,0.5853658536585366,shc-gpt-4o,coral,pdac,PROMPT1_entailment
131,216,47,34,13,0.723404255319149,33,8,25,0.2424242424242424,0.363150867823765,shc-gpt-4o,coral,pdac,PROMPT1_entailment
132,217,31,27,4,0.8709677419354839,19,13,6,0.6842105263157895,0.7663755458515285,shc-gpt-4o,coral,pdac,PROMPT1_entailment
133,218,16,16,0,1.0,11,10,1,0.9090909090909092,0.9523809523809524,shc-gpt-4o,coral,pdac,PROMPT1_entailment
134,219,10,10,0,1.0,8,8,0,1.0,1.0,shc-gpt-4o,coral,pdac,PROMPT1_entailment
135,22,14,9,5,0.6428571428571429,17,15,2,0.8823529411764706,0.7438016528925621,shc-gpt-4o,coral,pdac,PROMPT1_entailment
136,220,15,14,1,0.9333333333333332,11,9,2,0.8181818181818182,0.8719723183391004,shc-gpt-4o,coral,pdac,PROMPT1_entailment
137,221,12,11,1,0.9166666666666666,12,11,1,0.9166666666666666,0.9166666666666666,shc-gpt-4o,coral,pdac,PROMPT1_entailment
138,222,12,10,2,0.8333333333333334,11,10,1,0.9090909090909092,0.8695652173913043,shc-gpt-4o,coral,pdac,PROMPT1_entailment
139,223,47,40,7,0.851063829787234,37,30,7,0.8108108108108109,0.8304498269896194,shc-gpt-4o,coral,pdac,PROMPT1_entailment
140,224,15,6,9,0.4,8,8,0,1.0,0.5714285714285715,shc-gpt-4o,coral,pdac,PROMPT1_entailment
141,225,19,15,4,0.7894736842105263,13,11,2,0.8461538461538461,0.8168316831683169,shc-gpt-4o,coral,pdac,PROMPT1_entailment
142,226,14,13,1,0.9285714285714286,11,9,2,0.8181818181818182,0.8698884758364314,shc-gpt-4o,coral,pdac,PROMPT1_entailment
143,227,13,9,4,0.6923076923076923,10,7,3,0.7,0.6961325966850829,shc-gpt-4o,coral,pdac,PROMPT1_entailment
144,228,15,15,0,1.0,9,9,0,1.0,1.0,shc-gpt-4o,coral,pdac,PROMPT1_entailment
145,229,15,14,1,0.9333333333333332,9,7,2,0.7777777777777778,0.8484848484848485,shc-gpt-4o,coral,pdac,PROMPT1_entailment
146,23,16,16,0,1.0,12,10,2,0.8333333333333334,0.9090909090909092,shc-gpt-4o,coral,pdac,PROMPT1_entailment
147,230,11,10,1,0.9090909090909092,8,8,0,1.0,0.9523809523809524,shc-gpt-4o,coral,pdac,PROMPT1_entailment
148,24,12,12,0,1.0,9,8,1,0.8888888888888888,0.9411764705882352,shc-gpt-4o,coral,pdac,PROMPT1_entailment
149,25,16,14,2,0.875,11,7,4,0.6363636363636364,0.7368421052631579,shc-gpt-4o,coral,pdac,PROMPT1_entailment
150,26,14,14,0,1.0,11,11,0,1.0,1.0,shc-gpt-4o,coral,pdac,PROMPT1_entailment
151,27,12,12,0,1.0,12,9,3,0.75,0.8571428571428571,shc-gpt-4o,coral,pdac,PROMPT1_entailment
152,28,24,24,0,1.0,13,12,1,0.9230769230769232,0.96,shc-gpt-4o,coral,pdac,PROMPT1_entailment
153,29,13,12,1,0.9230769230769232,9,6,3,0.6666666666666666,0.7741935483870968,shc-gpt-4o,coral,pdac,PROMPT1_entailment
154,3,12,11,1,0.9166666666666666,8,6,2,0.75,0.8250000000000001,shc-gpt-4o,coral,pdac,PROMPT1_entailment
155,30,20,18,2,0.9,11,11,0,1.0,0.9473684210526316,shc-gpt-4o,coral,pdac,PROMPT1_entailment
156,31,22,21,1,0.9545454545454546,11,10,1,0.9090909090909092,0.9312638580931264,shc-gpt-4o,coral,pdac,PROMPT1_entailment
157,32,13,12,1,0.9230769230769232,11,8,3,0.7272727272727273,0.8135593220338984,shc-gpt-4o,coral,pdac,PROMPT1_entailment
158,33,26,10,16,0.3846153846153846,24,9,15,0.375,0.379746835443038,shc-gpt-4o,coral,pdac,PROMPT1_entailment
159,34,10,10,0,1.0,10,10,0,1.0,1.0,shc-gpt-4o,coral,pdac,PROMPT1_entailment
160,35,10,10,0,1.0,10,10,0,1.0,1.0,shc-gpt-4o,coral,pdac,PROMPT1_entailment
161,36,12,8,4,0.6666666666666666,44,35,9,0.7954545454545454,0.7253886010362695,shc-gpt-4o,coral,pdac,PROMPT1_entailment
162,37,18,12,6,0.6666666666666666,9,6,3,0.6666666666666666,0.6666666666666666,shc-gpt-4o,coral,pdac,PROMPT1_entailment
163,38,25,22,3,0.88,13,11,2,0.8461538461538461,0.8627450980392156,shc-gpt-4o,coral,pdac,PROMPT1_entailment
164,39,10,10,0,1.0,10,6,4,0.6,0.7499999999999999,shc-gpt-4o,coral,pdac,PROMPT1_entailment
165,4,24,19,5,0.7916666666666666,15,12,3,0.8,0.7958115183246073,shc-gpt-4o,coral,pdac,PROMPT1_entailment
166,40,20,11,9,0.55,10,6,4,0.6,0.5739130434782609,shc-gpt-4o,coral,pdac,PROMPT1_entailment
167,41,12,12,0,1.0,8,7,1,0.875,0.9333333333333332,shc-gpt-4o,coral,pdac,PROMPT1_entailment
168,42,22,20,2,0.9090909090909092,11,9,2,0.8181818181818182,0.861244019138756,shc-gpt-4o,coral,pdac,PROMPT1_entailment
169,43,15,13,2,0.8666666666666667,13,11,2,0.8461538461538461,0.8562874251497006,shc-gpt-4o,coral,pdac,PROMPT1_entailment
170,44,15,15,0,1.0,11,11,0,1.0,1.0,shc-gpt-4o,coral,pdac,PROMPT1_entailment
171,45,20,20,0,1.0,10,8,2,0.8,0.888888888888889,shc-gpt-4o,coral,pdac,PROMPT1_entailment
172,46,17,15,2,0.8823529411764706,11,9,2,0.8181818181818182,0.8490566037735848,shc-gpt-4o,coral,pdac,PROMPT1_entailment
173,47,23,17,6,0.7391304347826086,39,24,15,0.6153846153846154,0.671604938271605,shc-gpt-4o,coral,pdac,PROMPT1_entailment
174,48,12,8,4,0.6666666666666666,10,9,1,0.9,0.7659574468085106,shc-gpt-4o,coral,pdac,PROMPT1_entailment
175,49,14,13,1,0.9285714285714286,10,9,1,0.9,0.9140625,shc-gpt-4o,coral,pdac,PROMPT1_entailment
176,5,13,12,1,0.9230769230769232,10,8,2,0.8,0.8571428571428571,shc-gpt-4o,coral,pdac,PROMPT1_entailment
177,50,11,10,1,0.9090909090909092,10,7,3,0.7,0.7909604519774012,shc-gpt-4o,coral,pdac,PROMPT1_entailment
178,51,18,12,6,0.6666666666666666,12,11,1,0.9166666666666666,0.7719298245614035,shc-gpt-4o,coral,pdac,PROMPT1_entailment
179,52,12,9,3,0.75,10,9,1,0.9,0.8181818181818182,shc-gpt-4o,coral,pdac,PROMPT1_entailment
180,53,12,11,1,0.9166666666666666,8,8,0,1.0,0.9565217391304348,shc-gpt-4o,coral,pdac,PROMPT1_entailment
181,54,3,3,0,1.0,2,2,0,1.0,1.0,shc-gpt-4o,coral,pdac,PROMPT1_entailment
182,55,24,24,0,1.0,10,9,1,0.9,0.9473684210526316,shc-gpt-4o,coral,pdac,PROMPT1_entailment
183,56,19,15,4,0.7894736842105263,8,8,0,1.0,0.8823529411764706,shc-gpt-4o,coral,pdac,PROMPT1_entailment
184,57,42,28,14,0.6666666666666666,13,4,9,0.3076923076923077,0.4210526315789473,shc-gpt-4o,coral,pdac,PROMPT1_entailment
185,58,53,46,7,0.8679245283018868,10,10,0,1.0,0.9292929292929292,shc-gpt-4o,coral,pdac,PROMPT1_entailment
186,59,8,6,2,0.75,21,11,10,0.5238095238095238,0.6168224299065421,shc-gpt-4o,coral,pdac,PROMPT1_entailment
187,6,19,16,3,0.8421052631578947,12,12,0,1.0,0.9142857142857144,shc-gpt-4o,coral,pdac,PROMPT1_entailment
188,60,23,21,2,0.9130434782608696,13,9,4,0.6923076923076923,0.7875,shc-gpt-4o,coral,pdac,PROMPT1_entailment
189,61,11,9,2,0.8181818181818182,7,7,0,1.0,0.9,shc-gpt-4o,coral,pdac,PROMPT1_entailment
190,62,12,10,2,0.8333333333333334,11,7,4,0.6363636363636364,0.7216494845360825,shc-gpt-4o,coral,pdac,PROMPT1_entailment
191,63,12,11,1,0.9166666666666666,10,10,0,1.0,0.9565217391304348,shc-gpt-4o,coral,pdac,PROMPT1_entailment
192,64,13,13,0,1.0,12,9,3,0.75,0.8571428571428571,shc-gpt-4o,coral,pdac,PROMPT1_entailment
193,65,24,21,3,0.875,9,9,0,1.0,0.9333333333333332,shc-gpt-4o,coral,pdac,PROMPT1_entailment
194,66,19,17,2,0.8947368421052632,12,8,4,0.6666666666666666,0.7640449438202247,shc-gpt-4o,coral,pdac,PROMPT1_entailment
195,67,6,6,0,1.0,1,1,0,1.0,1.0,shc-gpt-4o,coral,pdac,PROMPT1_entailment
196,68,16,14,2,0.875,11,10,1,0.9090909090909092,0.8917197452229298,shc-gpt-4o,coral,pdac,PROMPT1_entailment
197,69,16,16,0,1.0,10,9,1,0.9,0.9473684210526316,shc-gpt-4o,coral,pdac,PROMPT1_entailment
198,7,15,15,0,1.0,11,9,2,0.8181818181818182,0.9,shc-gpt-4o,coral,pdac,PROMPT1_entailment
199,70,17,17,0,1.0,15,14,1,0.9333333333333332,0.9655172413793104,shc-gpt-4o,coral,pdac,PROMPT1_entailment
200,71,37,22,15,0.5945945945945946,9,6,3,0.6666666666666666,0.6285714285714286,shc-gpt-4o,coral,pdac,PROMPT1_entailment
201,72,16,14,2,0.875,13,12,1,0.9230769230769232,0.8983957219251337,shc-gpt-4o,coral,pdac,PROMPT1_entailment
202,73,37,5,32,0.1351351351351351,154,70,84,0.4545454545454545,0.2083333333333333,shc-gpt-4o,coral,pdac,PROMPT1_entailment
203,74,15,11,4,0.7333333333333333,8,6,2,0.75,0.7415730337078651,shc-gpt-4o,coral,pdac,PROMPT1_entailment
204,75,14,13,1,0.9285714285714286,7,6,1,0.8571428571428571,0.8914285714285715,shc-gpt-4o,coral,pdac,PROMPT1_entailment
205,76,10,10,0,1.0,7,7,0,1.0,1.0,shc-gpt-4o,coral,pdac,PROMPT1_entailment
206,77,8,6,2,0.75,8,6,2,0.75,0.75,shc-gpt-4o,coral,pdac,PROMPT1_entailment
207,78,7,6,1,0.8571428571428571,8,8,0,1.0,0.923076923076923,shc-gpt-4o,coral,pdac,PROMPT1_entailment
208,79,17,16,1,0.9411764705882352,11,11,0,1.0,0.9696969696969696,shc-gpt-4o,coral,pdac,PROMPT1_entailment
209,8,11,11,0,1.0,2,2,0,1.0,1.0,shc-gpt-4o,coral,pdac,PROMPT1_entailment
210,80,17,15,2,0.8823529411764706,9,9,0,1.0,0.9375,shc-gpt-4o,coral,pdac,PROMPT1_entailment
211,81,11,11,0,1.0,6,4,2,0.6666666666666666,0.8,shc-gpt-4o,coral,pdac,PROMPT1_entailment
212,82,24,23,1,0.9583333333333334,4,2,2,0.5,0.6571428571428571,shc-gpt-4o,coral,pdac,PROMPT1_entailment
213,83,28,24,4,0.8571428571428571,11,9,2,0.8181818181818182,0.8372093023255814,shc-gpt-4o,coral,pdac,PROMPT1_entailment
214,84,19,8,11,0.4210526315789473,11,9,2,0.8181818181818182,0.555984555984556,shc-gpt-4o,coral,pdac,PROMPT1_entailment
215,85,41,29,12,0.7073170731707317,35,23,12,0.6571428571428571,0.6813074565883555,shc-gpt-4o,coral,pdac,PROMPT1_entailment
216,86,5,3,2,0.6,10,9,1,0.9,0.7200000000000001,shc-gpt-4o,coral,pdac,PROMPT1_entailment
217,87,17,14,3,0.8235294117647058,7,5,2,0.7142857142857143,0.7650273224043717,shc-gpt-4o,coral,pdac,PROMPT1_entailment
218,88,12,8,4,0.6666666666666666,8,7,1,0.875,0.7567567567567567,shc-gpt-4o,coral,pdac,PROMPT1_entailment
219,89,16,11,5,0.6875,10,9,1,0.9,0.7795275590551182,shc-gpt-4o,coral,pdac,PROMPT1_entailment
220,9,8,7,1,0.875,12,11,1,0.9166666666666666,0.8953488372093024,shc-gpt-4o,coral,pdac,PROMPT1_entailment
221,90,16,11,5,0.6875,9,5,4,0.5555555555555556,0.6145251396648045,shc-gpt-4o,coral,pdac,PROMPT1_entailment
222,91,12,12,0,1.0,10,8,2,0.8,0.888888888888889,shc-gpt-4o,coral,pdac,PROMPT1_entailment
223,92,18,16,2,0.8888888888888888,10,8,2,0.8,0.8421052631578948,shc-gpt-4o,coral,pdac,PROMPT1_entailment
224,93,13,13,0,1.0,9,8,1,0.8888888888888888,0.9411764705882352,shc-gpt-4o,coral,pdac,PROMPT1_entailment
225,94,10,8,2,0.8,7,5,2,0.7142857142857143,0.7547169811320756,shc-gpt-4o,coral,pdac,PROMPT1_entailment
226,95,12,8,4,0.6666666666666666,8,6,2,0.75,0.7058823529411765,shc-gpt-4o,coral,pdac,PROMPT1_entailment
227,96,8,8,0,1.0,4,4,0,1.0,1.0,shc-gpt-4o,coral,pdac,PROMPT1_entailment
228,97,12,10,2,0.8333333333333334,8,5,3,0.625,0.7142857142857143,shc-gpt-4o,coral,pdac,PROMPT1_entailment
229,98,18,17,1,0.9444444444444444,9,9,0,1.0,0.9714285714285714,shc-gpt-4o,coral,pdac,PROMPT1_entailment
230,99,14,12,2,0.8571428571428571,9,8,1,0.8888888888888888,0.8727272727272727,shc-gpt-4o,coral,pdac,PROMPT1_entailment
0,0,20,17,3,0.85,9,9,0,1.0,0.9189189189189187,shc-gpt-4o,coral,pdac,PROMPT1_ICL_entailment
1,1,18,18,0,1.0,9,7,2,0.7777777777777778,0.8750000000000001,shc-gpt-4o,coral,pdac,PROMPT1_ICL_entailment
2,10,26,23,3,0.8846153846153846,11,11,0,1.0,0.9387755102040816,shc-gpt-4o,coral,pdac,PROMPT1_ICL_entailment
3,100,21,15,6,0.7142857142857143,11,9,2,0.8181818181818182,0.7627118644067797,shc-gpt-4o,coral,pdac,PROMPT1_ICL_entailment
4,101,23,21,2,0.9130434782608696,11,10,1,0.9090909090909092,0.9110629067245118,shc-gpt-4o,coral,pdac,PROMPT1_ICL_entailment
5,102,40,37,3,0.925,27,16,11,0.5925925925925926,0.7223917022574741,shc-gpt-4o,coral,pdac,PROMPT1_ICL_entailment
6,103,35,27,8,0.7714285714285715,15,7,8,0.4666666666666667,0.5815384615384616,shc-gpt-4o,coral,pdac,PROMPT1_ICL_entailment
7,104,22,20,2,0.9090909090909092,12,11,1,0.9166666666666666,0.9128630705394192,shc-gpt-4o,coral,pdac,PROMPT1_ICL_entailment
8,105,65,38,27,0.5846153846153846,33,18,15,0.5454545454545454,0.5643564356435643,shc-gpt-4o,coral,pdac,PROMPT1_ICL_entailment
9,106,15,15,0,1.0,10,10,0,1.0,1.0,shc-gpt-4o,coral,pdac,PROMPT1_ICL_entailment
10,107,11,11,0,1.0,10,10,0,1.0,1.0,shc-gpt-4o,coral,pdac,PROMPT1_ICL_entailment
11,108,18,18,0,1.0,10,10,0,1.0,1.0,shc-gpt-4o,coral,pdac,PROMPT1_ICL_entailment
12,109,64,57,7,0.890625,34,29,5,0.8529411764705882,0.8713758566157089,shc-gpt-4o,coral,pdac,PROMPT1_ICL_entailment
13,11,20,16,4,0.8,10,9,1,0.9,0.8470588235294118,shc-gpt-4o,coral,pdac,PROMPT1_ICL_entailment
14,110,18,17,1,0.9444444444444444,4,4,0,1.0,0.9714285714285714,shc-gpt-4o,coral,pdac,PROMPT1_ICL_entailment
15,111,16,14,2,0.875,3,3,0,1.0,0.9333333333333332,shc-gpt-4o,coral,pdac,PROMPT1_ICL_entailment
16,112,14,14,0,1.0,9,9,0,1.0,1.0,shc-gpt-4o,coral,pdac,PROMPT1_ICL_entailment
17,113,17,15,2,0.8823529411764706,6,5,1,0.8333333333333334,0.8571428571428571,shc-gpt-4o,coral,pdac,PROMPT1_ICL_entailment
18,114,18,17,1,0.9444444444444444,9,9,0,1.0,0.9714285714285714,shc-gpt-4o,coral,pdac,PROMPT1_ICL_entailment
19,115,18,18,0,1.0,7,7,0,1.0,1.0,shc-gpt-4o,coral,pdac,PROMPT1_ICL_entailment
20,116,7,7,0,1.0,2,2,0,1.0,1.0,shc-gpt-4o,coral,pdac,PROMPT1_ICL_entailment
21,117,26,26,0,1.0,8,8,0,1.0,1.0,shc-gpt-4o,coral,pdac,PROMPT1_ICL_entailment
22,118,24,24,0,1.0,9,9,0,1.0,1.0,shc-gpt-4o,coral,pdac,PROMPT1_ICL_entailment
23,119,19,17,2,0.8947368421052632,12,11,1,0.9166666666666666,0.9055690072639224,shc-gpt-4o,coral,pdac,PROMPT1_ICL_entailment
24,12,26,26,0,1.0,10,10,0,1.0,1.0,shc-gpt-4o,coral,pdac,PROMPT1_ICL_entailment
25,120,31,28,3,0.9032258064516128,13,11,2,0.8461538461538461,0.873758865248227,shc-gpt-4o,coral,pdac,PROMPT1_ICL_entailment
26,121,26,22,4,0.8461538461538461,12,9,3,0.75,0.7951807228915662,shc-gpt-4o,coral,pdac,PROMPT1_ICL_entailment
27,122,101,78,23,0.7722772277227723,45,41,4,0.9111111111111112,0.8359691543589073,shc-gpt-4o,coral,pdac,PROMPT1_ICL_entailment
28,123,20,17,3,0.85,10,10,0,1.0,0.9189189189189187,shc-gpt-4o,coral,pdac,PROMPT1_ICL_entailment
29,124,7,7,0,1.0,3,3,0,1.0,1.0,shc-gpt-4o,coral,pdac,PROMPT1_ICL_entailment
30,125,20,20,0,1.0,8,8,0,1.0,1.0,shc-gpt-4o,coral,pdac,PROMPT1_ICL_entailment
31,126,22,22,0,1.0,10,10,0,1.0,1.0,shc-gpt-4o,coral,pdac,PROMPT1_ICL_entailment
32,127,48,39,9,0.8125,30,28,2,0.9333333333333332,0.8687350835322195,shc-gpt-4o,coral,pdac,PROMPT1_ICL_entailment
33,128,72,64,8,0.8888888888888888,35,23,12,0.6571428571428571,0.75564681724846,shc-gpt-4o,coral,pdac,PROMPT1_ICL_entailment
34,129,16,12,4,0.75,11,10,1,0.9090909090909092,0.821917808219178,shc-gpt-4o,coral,pdac,PROMPT1_ICL_entailment
35,13,35,34,1,0.9714285714285714,13,11,2,0.8461538461538461,0.9044740024183796,shc-gpt-4o,coral,pdac,PROMPT1_ICL_entailment
36,130,24,22,2,0.9166666666666666,12,10,2,0.8333333333333334,0.8730158730158729,shc-gpt-4o,coral,pdac,PROMPT1_ICL_entailment
37,131,38,36,2,0.9473684210526316,12,7,5,0.5833333333333334,0.7220630372492838,shc-gpt-4o,coral,pdac,PROMPT1_ICL_entailment
38,132,18,17,1,0.9444444444444444,10,8,2,0.8,0.8662420382165604,shc-gpt-4o,coral,pdac,PROMPT1_ICL_entailment
39,133,24,24,0,1.0,7,7,0,1.0,1.0,shc-gpt-4o,coral,pdac,PROMPT1_ICL_entailment
40,134,36,34,2,0.9444444444444444,15,11,4,0.7333333333333333,0.82560706401766,shc-gpt-4o,coral,pdac,PROMPT1_ICL_entailment
41,135,24,22,2,0.9166666666666666,9,9,0,1.0,0.9565217391304348,shc-gpt-4o,coral,pdac,PROMPT1_ICL_entailment
42,136,34,29,5,0.8529411764705882,7,4,3,0.5714285714285714,0.6843657817109144,shc-gpt-4o,coral,pdac,PROMPT1_ICL_entailment
43,137,15,13,2,0.8666666666666667,10,5,5,0.5,0.6341463414634146,shc-gpt-4o,coral,pdac,PROMPT1_ICL_entailment
44,138,41,37,4,0.902439024390244,25,19,6,0.76,0.8251173708920188,shc-gpt-4o,coral,pdac,PROMPT1_ICL_entailment
45,139,134,107,27,0.7985074626865671,62,27,35,0.4354838709677419,0.5635973468591494,shc-gpt-4o,coral,pdac,PROMPT1_ICL_entailment
46,14,14,13,1,0.9285714285714286,10,10,0,1.0,0.962962962962963,shc-gpt-4o,coral,pdac,PROMPT1_ICL_entailment
47,140,17,16,1,0.9411764705882352,8,8,0,1.0,0.9696969696969696,shc-gpt-4o,coral,pdac,PROMPT1_ICL_entailment
48,141,23,23,0,1.0,11,9,2,0.8181818181818182,0.9,shc-gpt-4o,coral,pdac,PROMPT1_ICL_entailment
49,142,27,21,6,0.7777777777777778,11,9,2,0.8181818181818182,0.7974683544303799,shc-gpt-4o,coral,pdac,PROMPT1_ICL_entailment
50,143,18,15,3,0.8333333333333334,9,9,0,1.0,0.9090909090909092,shc-gpt-4o,coral,pdac,PROMPT1_ICL_entailment
51,144,31,24,7,0.7741935483870968,12,12,0,1.0,0.8727272727272727,shc-gpt-4o,coral,pdac,PROMPT1_ICL_entailment
52,145,19,19,0,1.0,10,10,0,1.0,1.0,shc-gpt-4o,coral,pdac,PROMPT1_ICL_entailment
53,146,17,10,7,0.5882352941176471,7,6,1,0.8571428571428571,0.6976744186046512,shc-gpt-4o,coral,pdac,PROMPT1_ICL_entailment
54,147,23,20,3,0.8695652173913043,12,12,0,1.0,0.9302325581395348,shc-gpt-4o,coral,pdac,PROMPT1_ICL_entailment
55,148,58,54,4,0.9310344827586208,25,18,7,0.72,0.8120300751879699,shc-gpt-4o,coral,pdac,PROMPT1_ICL_entailment
56,149,22,21,1,0.9545454545454546,7,6,1,0.8571428571428571,0.9032258064516128,shc-gpt-4o,coral,pdac,PROMPT1_ICL_entailment
57,15,12,11,1,0.9166666666666666,10,10,0,1.0,0.9565217391304348,shc-gpt-4o,coral,pdac,PROMPT1_ICL_entailment
58,150,18,16,2,0.8888888888888888,8,8,0,1.0,0.9411764705882352,shc-gpt-4o,coral,pdac,PROMPT1_ICL_entailment
59,151,22,22,0,1.0,10,9,1,0.9,0.9473684210526316,shc-gpt-4o,coral,pdac,PROMPT1_ICL_entailment
60,152,21,20,1,0.9523809523809524,11,10,1,0.9090909090909092,0.9302325581395348,shc-gpt-4o,coral,pdac,PROMPT1_ICL_entailment
61,153,79,51,28,0.6455696202531646,30,22,8,0.7333333333333333,0.6866585067319462,shc-gpt-4o,coral,pdac,PROMPT1_ICL_entailment
62,154,32,26,6,0.8125,15,13,2,0.8666666666666667,0.8387096774193549,shc-gpt-4o,coral,pdac,PROMPT1_ICL_entailment
63,155,93,87,6,0.935483870967742,47,37,10,0.7872340425531915,0.8549800796812749,shc-gpt-4o,coral,pdac,PROMPT1_ICL_entailment
64,156,18,16,2,0.8888888888888888,10,7,3,0.7,0.7832167832167831,shc-gpt-4o,coral,pdac,PROMPT1_ICL_entailment
65,157,32,26,6,0.8125,14,11,3,0.7857142857142857,0.7988826815642458,shc-gpt-4o,coral,pdac,PROMPT1_ICL_entailment
66,158,21,19,2,0.9047619047619048,10,8,2,0.8,0.8491620111731844,shc-gpt-4o,coral,pdac,PROMPT1_ICL_entailment
67,159,21,19,2,0.9047619047619048,4,3,1,0.75,0.8201438848920864,shc-gpt-4o,coral,pdac,PROMPT1_ICL_entailment
68,16,42,41,1,0.9761904761904762,31,25,6,0.8064516129032258,0.8832399827660491,shc-gpt-4o,coral,pdac,PROMPT1_ICL_entailment
69,160,20,19,1,0.95,9,9,0,1.0,0.9743589743589745,shc-gpt-4o,coral,pdac,PROMPT1_ICL_entailment
70,161,23,22,1,0.9565217391304348,9,8,1,0.8888888888888888,0.9214659685863874,shc-gpt-4o,coral,pdac,PROMPT1_ICL_entailment
71,162,18,18,0,1.0,10,10,0,1.0,1.0,shc-gpt-4o,coral,pdac,PROMPT1_ICL_entailment
72,163,25,20,5,0.8,13,9,4,0.6923076923076923,0.7422680412371134,shc-gpt-4o,coral,pdac,PROMPT1_ICL_entailment
73,164,55,49,6,0.8909090909090909,36,29,7,0.8055555555555556,0.8460851443882108,shc-gpt-4o,coral,pdac,PROMPT1_ICL_entailment
74,165,28,25,3,0.8928571428571429,10,3,7,0.3,0.4491017964071856,shc-gpt-4o,coral,pdac,PROMPT1_ICL_entailment
75,166,24,20,4,0.8333333333333334,11,11,0,1.0,0.9090909090909092,shc-gpt-4o,coral,pdac,PROMPT1_ICL_entailment
76,167,17,15,2,0.8823529411764706,8,5,3,0.625,0.7317073170731708,shc-gpt-4o,coral,pdac,PROMPT1_ICL_entailment
77,168,15,13,2,0.8666666666666667,6,5,1,0.8333333333333334,0.8496732026143791,shc-gpt-4o,coral,pdac,PROMPT1_ICL_entailment
78,169,16,15,1,0.9375,7,7,0,1.0,0.967741935483871,shc-gpt-4o,coral,pdac,PROMPT1_ICL_entailment
79,17,18,18,0,1.0,5,5,0,1.0,1.0,shc-gpt-4o,coral,pdac,PROMPT1_ICL_entailment
80,170,51,40,11,0.7843137254901961,16,15,1,0.9375,0.8540925266903915,shc-gpt-4o,coral,pdac,PROMPT1_ICL_entailment
81,171,30,23,7,0.7666666666666667,13,13,0,1.0,0.8679245283018869,shc-gpt-4o,coral,pdac,PROMPT1_ICL_entailment
82,172,22,17,5,0.7727272727272727,10,9,1,0.9,0.8315217391304347,shc-gpt-4o,coral,pdac,PROMPT1_ICL_entailment
83,173,35,29,6,0.8285714285714286,22,12,10,0.5454545454545454,0.6578449905482041,shc-gpt-4o,coral,pdac,PROMPT1_ICL_entailment
84,174,21,16,5,0.7619047619047619,11,8,3,0.7272727272727273,0.7441860465116279,shc-gpt-4o,coral,pdac,PROMPT1_ICL_entailment
85,175,63,28,35,0.4444444444444444,28,15,13,0.5357142857142857,0.48582995951417,shc-gpt-4o,coral,pdac,PROMPT1_ICL_entailment
86,176,15,14,1,0.9333333333333332,10,10,0,1.0,0.9655172413793104,shc-gpt-4o,coral,pdac,PROMPT1_ICL_entailment
87,177,16,16,0,1.0,10,10,0,1.0,1.0,shc-gpt-4o,coral,pdac,PROMPT1_ICL_entailment
88,178,40,26,14,0.65,36,15,21,0.4166666666666667,0.5078125000000001,shc-gpt-4o,coral,pdac,PROMPT1_ICL_entailment
89,179,13,10,3,0.7692307692307693,9,8,1,0.8888888888888888,0.8247422680412372,shc-gpt-4o,coral,pdac,PROMPT1_ICL_entailment
90,18,35,35,0,1.0,15,14,1,0.9333333333333332,0.9655172413793104,shc-gpt-4o,coral,pdac,PROMPT1_ICL_entailment
91,180,13,9,4,0.6923076923076923,5,4,1,0.8,0.7422680412371134,shc-gpt-4o,coral,pdac,PROMPT1_ICL_entailment
92,181,23,23,0,1.0,10,10,0,1.0,1.0,shc-gpt-4o,coral,pdac,PROMPT1_ICL_entailment
93,182,18,17,1,0.9444444444444444,8,5,3,0.625,0.752212389380531,shc-gpt-4o,coral,pdac,PROMPT1_ICL_entailment
94,183,19,19,0,1.0,10,7,3,0.7,0.8235294117647058,shc-gpt-4o,coral,pdac,PROMPT1_ICL_entailment
95,184,24,12,12,0.5,9,9,0,1.0,0.6666666666666666,shc-gpt-4o,coral,pdac,PROMPT1_ICL_entailment
96,185,34,30,4,0.8823529411764706,22,12,10,0.5454545454545454,0.6741573033707865,shc-gpt-4o,coral,pdac,PROMPT1_ICL_entailment
97,186,69,49,20,0.7101449275362319,32,20,12,0.625,0.6648575305291723,shc-gpt-4o,coral,pdac,PROMPT1_ICL_entailment
98,187,67,49,18,0.7313432835820896,34,24,10,0.7058823529411765,0.7183872938301772,shc-gpt-4o,coral,pdac,PROMPT1_ICL_entailment
99,188,22,20,2,0.9090909090909092,8,7,1,0.875,0.8917197452229298,shc-gpt-4o,coral,pdac,PROMPT1_ICL_entailment
100,189,21,18,3,0.8571428571428571,5,5,0,1.0,0.923076923076923,shc-gpt-4o,coral,pdac,PROMPT1_ICL_entailment
101,19,52,45,7,0.8653846153846154,21,15,6,0.7142857142857143,0.7826086956521738,shc-gpt-4o,coral,pdac,PROMPT1_ICL_entailment
102,190,60,51,9,0.85,17,12,5,0.7058823529411765,0.771266540642722,shc-gpt-4o,coral,pdac,PROMPT1_ICL_entailment
103,191,55,48,7,0.8727272727272727,15,11,4,0.7333333333333333,0.7969811320754716,shc-gpt-4o,coral,pdac,PROMPT1_ICL_entailment
104,192,42,35,7,0.8333333333333334,12,8,4,0.6666666666666666,0.7407407407407408,shc-gpt-4o,coral,pdac,PROMPT1_ICL_entailment
105,193,17,16,1,0.9411764705882352,10,8,2,0.8,0.8648648648648648,shc-gpt-4o,coral,pdac,PROMPT1_ICL_entailment
106,194,15,14,1,0.9333333333333332,11,10,1,0.9090909090909092,0.9210526315789476,shc-gpt-4o,coral,pdac,PROMPT1_ICL_entailment
107,195,16,13,3,0.8125,7,6,1,0.8571428571428571,0.8342245989304812,shc-gpt-4o,coral,pdac,PROMPT1_ICL_entailment
108,196,19,17,2,0.8947368421052632,8,6,2,0.75,0.816,shc-gpt-4o,coral,pdac,PROMPT1_ICL_entailment
109,197,21,21,0,1.0,9,8,1,0.8888888888888888,0.9411764705882352,shc-gpt-4o,coral,pdac,PROMPT1_ICL_entailment
110,198,22,21,1,0.9545454545454546,12,11,1,0.9166666666666666,0.9352226720647774,shc-gpt-4o,coral,pdac,PROMPT1_ICL_entailment
111,199,32,32,0,1.0,9,9,0,1.0,1.0,shc-gpt-4o,coral,pdac,PROMPT1_ICL_entailment
112,2,27,23,4,0.8518518518518519,14,13,1,0.9285714285714286,0.8885586924219911,shc-gpt-4o,coral,pdac,PROMPT1_ICL_entailment
113,20,35,22,13,0.6285714285714286,18,14,4,0.7777777777777778,0.6952595936794582,shc-gpt-4o,coral,pdac,PROMPT1_ICL_entailment
114,200,40,34,6,0.85,16,15,1,0.9375,0.8916083916083916,shc-gpt-4o,coral,pdac,PROMPT1_ICL_entailment
115,201,12,12,0,1.0,10,10,0,1.0,1.0,shc-gpt-4o,coral,pdac,PROMPT1_ICL_entailment
116,202,16,16,0,1.0,10,10,0,1.0,1.0,shc-gpt-4o,coral,pdac,PROMPT1_ICL_entailment
117,203,41,33,8,0.8048780487804879,31,25,6,0.8064516129032258,0.8056640625,shc-gpt-4o,coral,pdac,PROMPT1_ICL_entailment
118,204,31,24,7,0.7741935483870968,14,8,6,0.5714285714285714,0.6575342465753424,shc-gpt-4o,coral,pdac,PROMPT1_ICL_entailment
119,205,23,17,6,0.7391304347826086,7,6,1,0.8571428571428571,0.7937743190661479,shc-gpt-4o,coral,pdac,PROMPT1_ICL_entailment
120,206,18,16,2,0.8888888888888888,9,8,1,0.8888888888888888,0.8888888888888888,shc-gpt-4o,coral,pdac,PROMPT1_ICL_entailment
121,207,19,17,2,0.8947368421052632,8,6,2,0.75,0.816,shc-gpt-4o,coral,pdac,PROMPT1_ICL_entailment
122,208,12,12,0,1.0,8,8,0,1.0,1.0,shc-gpt-4o,coral,pdac,PROMPT1_ICL_entailment
123,209,37,36,1,0.972972972972973,9,8,1,0.8888888888888888,0.9290322580645162,shc-gpt-4o,coral,pdac,PROMPT1_ICL_entailment
124,21,11,11,0,1.0,10,10,0,1.0,1.0,shc-gpt-4o,coral,pdac,PROMPT1_ICL_entailment
125,210,20,19,1,0.95,9,9,0,1.0,0.9743589743589745,shc-gpt-4o,coral,pdac,PROMPT1_ICL_entailment
126,211,24,21,3,0.875,8,8,0,1.0,0.9333333333333332,shc-gpt-4o,coral,pdac,PROMPT1_ICL_entailment
127,212,27,25,2,0.925925925925926,17,14,3,0.8235294117647058,0.87173100871731,shc-gpt-4o,coral,pdac,PROMPT1_ICL_entailment
128,213,22,20,2,0.9090909090909092,11,11,0,1.0,0.9523809523809524,shc-gpt-4o,coral,pdac,PROMPT1_ICL_entailment
129,214,29,27,2,0.9310344827586208,18,10,8,0.5555555555555556,0.6958762886597938,shc-gpt-4o,coral,pdac,PROMPT1_ICL_entailment
130,215,40,17,23,0.425,12,8,4,0.6666666666666666,0.5190839694656489,shc-gpt-4o,coral,pdac,PROMPT1_ICL_entailment
131,216,42,34,8,0.8095238095238095,33,28,5,0.8484848484848485,0.8285465622280244,shc-gpt-4o,coral,pdac,PROMPT1_ICL_entailment
132,217,33,32,1,0.9696969696969696,19,15,4,0.7894736842105263,0.8703535811423391,shc-gpt-4o,coral,pdac,PROMPT1_ICL_entailment
133,218,36,36,0,1.0,11,11,0,1.0,1.0,shc-gpt-4o,coral,pdac,PROMPT1_ICL_entailment
134,219,16,16,0,1.0,8,8,0,1.0,1.0,shc-gpt-4o,coral,pdac,PROMPT1_ICL_entailment
135,22,35,26,9,0.7428571428571429,17,14,3,0.8235294117647058,0.7811158798283262,shc-gpt-4o,coral,pdac,PROMPT1_ICL_entailment
136,220,29,24,5,0.8275862068965517,11,10,1,0.9090909090909092,0.8664259927797834,shc-gpt-4o,coral,pdac,PROMPT1_ICL_entailment
137,221,21,18,3,0.8571428571428571,12,11,1,0.9166666666666666,0.8859060402684563,shc-gpt-4o,coral,pdac,PROMPT1_ICL_entailment
138,222,48,35,13,0.7291666666666666,11,10,1,0.9090909090909092,0.8092485549132948,shc-gpt-4o,coral,pdac,PROMPT1_ICL_entailment
139,223,79,66,13,0.8354430379746836,37,30,7,0.8108108108108109,0.8229426433915211,shc-gpt-4o,coral,pdac,PROMPT1_ICL_entailment
140,224,28,20,8,0.7142857142857143,8,8,0,1.0,0.8333333333333333,shc-gpt-4o,coral,pdac,PROMPT1_ICL_entailment
141,225,24,22,2,0.9166666666666666,13,12,1,0.9230769230769232,0.9198606271777002,shc-gpt-4o,coral,pdac,PROMPT1_ICL_entailment
142,226,21,20,1,0.9523809523809524,11,8,3,0.7272727272727273,0.8247422680412371,shc-gpt-4o,coral,pdac,PROMPT1_ICL_entailment
143,227,23,15,8,0.6521739130434783,10,8,2,0.8,0.718562874251497,shc-gpt-4o,coral,pdac,PROMPT1_ICL_entailment
144,228,23,23,0,1.0,9,9,0,1.0,1.0,shc-gpt-4o,coral,pdac,PROMPT1_ICL_entailment
145,229,20,16,4,0.8,9,9,0,1.0,0.888888888888889,shc-gpt-4o,coral,pdac,PROMPT1_ICL_entailment
146,23,25,22,3,0.88,12,10,2,0.8333333333333334,0.8560311284046693,shc-gpt-4o,coral,pdac,PROMPT1_ICL_entailment
147,230,25,23,2,0.92,8,8,0,1.0,0.9583333333333334,shc-gpt-4o,coral,pdac,PROMPT1_ICL_entailment
148,24,18,17,1,0.9444444444444444,9,7,2,0.7777777777777778,0.8530465949820788,shc-gpt-4o,coral,pdac,PROMPT1_ICL_entailment
149,25,23,21,2,0.9130434782608696,11,9,2,0.8181818181818182,0.863013698630137,shc-gpt-4o,coral,pdac,PROMPT1_ICL_entailment
150,26,16,16,0,1.0,11,11,0,1.0,1.0,shc-gpt-4o,coral,pdac,PROMPT1_ICL_entailment
151,27,31,27,4,0.8709677419354839,12,10,2,0.8333333333333334,0.8517350157728707,shc-gpt-4o,coral,pdac,PROMPT1_ICL_entailment
152,28,42,40,2,0.9523809523809524,13,11,2,0.8461538461538461,0.8961303462321792,shc-gpt-4o,coral,pdac,PROMPT1_ICL_entailment
153,29,51,41,10,0.803921568627451,9,5,4,0.5555555555555556,0.6570512820512822,shc-gpt-4o,coral,pdac,PROMPT1_ICL_entailment
154,3,19,17,2,0.8947368421052632,8,8,0,1.0,0.9444444444444444,shc-gpt-4o,coral,pdac,PROMPT1_ICL_entailment
155,30,46,42,4,0.9130434782608696,11,9,2,0.8181818181818182,0.863013698630137,shc-gpt-4o,coral,pdac,PROMPT1_ICL_entailment
156,31,36,28,8,0.7777777777777778,11,11,0,1.0,0.8750000000000001,shc-gpt-4o,coral,pdac,PROMPT1_ICL_entailment
157,32,47,38,9,0.8085106382978723,11,10,1,0.9090909090909092,0.8558558558558559,shc-gpt-4o,coral,pdac,PROMPT1_ICL_entailment
158,33,89,39,50,0.4382022471910112,24,18,6,0.75,0.5531914893617021,shc-gpt-4o,coral,pdac,PROMPT1_ICL_entailment
159,34,11,10,1,0.9090909090909092,10,10,0,1.0,0.9523809523809524,shc-gpt-4o,coral,pdac,PROMPT1_ICL_entailment
160,35,17,16,1,0.9411764705882352,10,10,0,1.0,0.9696969696969696,shc-gpt-4o,coral,pdac,PROMPT1_ICL_entailment
161,36,46,42,4,0.9130434782608696,44,35,9,0.7954545454545454,0.8502024291497975,shc-gpt-4o,coral,pdac,PROMPT1_ICL_entailment
162,37,29,28,1,0.9655172413793104,9,8,1,0.8888888888888888,0.9256198347107438,shc-gpt-4o,coral,pdac,PROMPT1_ICL_entailment
163,38,32,30,2,0.9375,13,10,3,0.7692307692307693,0.8450704225352113,shc-gpt-4o,coral,pdac,PROMPT1_ICL_entailment
164,39,27,27,0,1.0,10,9,1,0.9,0.9473684210526316,shc-gpt-4o,coral,pdac,PROMPT1_ICL_entailment
165,4,29,26,3,0.896551724137931,15,12,3,0.8,0.8455284552845529,shc-gpt-4o,coral,pdac,PROMPT1_ICL_entailment
166,40,21,15,6,0.7142857142857143,10,6,4,0.6,0.6521739130434783,shc-gpt-4o,coral,pdac,PROMPT1_ICL_entailment
167,41,25,25,0,1.0,8,7,1,0.875,0.9333333333333332,shc-gpt-4o,coral,pdac,PROMPT1_ICL_entailment
168,42,34,31,3,0.9117647058823528,11,10,1,0.9090909090909092,0.9104258443465492,shc-gpt-4o,coral,pdac,PROMPT1_ICL_entailment
169,43,38,34,4,0.8947368421052632,13,10,3,0.7692307692307693,0.8272506082725061,shc-gpt-4o,coral,pdac,PROMPT1_ICL_entailment
170,44,20,15,5,0.75,11,11,0,1.0,0.8571428571428571,shc-gpt-4o,coral,pdac,PROMPT1_ICL_entailment
171,45,23,22,1,0.9565217391304348,10,8,2,0.8,0.8712871287128713,shc-gpt-4o,coral,pdac,PROMPT1_ICL_entailment
172,46,26,21,5,0.8076923076923077,11,9,2,0.8181818181818182,0.8129032258064518,shc-gpt-4o,coral,pdac,PROMPT1_ICL_entailment
173,47,50,46,4,0.92,39,33,6,0.8461538461538461,0.8815331010452963,shc-gpt-4o,coral,pdac,PROMPT1_ICL_entailment
174,48,17,13,4,0.7647058823529411,10,8,2,0.8,0.7819548872180452,shc-gpt-4o,coral,pdac,PROMPT1_ICL_entailment
175,49,17,16,1,0.9411764705882352,10,7,3,0.7,0.8028673835125448,shc-gpt-4o,coral,pdac,PROMPT1_ICL_entailment
176,5,20,18,2,0.9,10,9,1,0.9,0.9,shc-gpt-4o,coral,pdac,PROMPT1_ICL_entailment
177,50,14,12,2,0.8571428571428571,10,9,1,0.9,0.8780487804878048,shc-gpt-4o,coral,pdac,PROMPT1_ICL_entailment
178,51,16,11,5,0.6875,12,10,2,0.8333333333333334,0.7534246575342466,shc-gpt-4o,coral,pdac,PROMPT1_ICL_entailment
179,52,22,17,5,0.7727272727272727,10,9,1,0.9,0.8315217391304347,shc-gpt-4o,coral,pdac,PROMPT1_ICL_entailment
180,53,16,14,2,0.875,8,8,0,1.0,0.9333333333333332,shc-gpt-4o,coral,pdac,PROMPT1_ICL_entailment
181,54,5,4,1,0.8,2,2,0,1.0,0.888888888888889,shc-gpt-4o,coral,pdac,PROMPT1_ICL_entailment
182,55,34,34,0,1.0,10,8,2,0.8,0.888888888888889,shc-gpt-4o,coral,pdac,PROMPT1_ICL_entailment
183,56,28,25,3,0.8928571428571429,8,7,1,0.875,0.8838383838383839,shc-gpt-4o,coral,pdac,PROMPT1_ICL_entailment
184,57,53,32,21,0.6037735849056604,13,10,3,0.7692307692307693,0.6765327695560254,shc-gpt-4o,coral,pdac,PROMPT1_ICL_entailment
185,58,44,40,4,0.9090909090909092,10,10,0,1.0,0.9523809523809524,shc-gpt-4o,coral,pdac,PROMPT1_ICL_entailment
186,59,37,26,11,0.7027027027027027,21,16,5,0.7619047619047619,0.7311072056239016,shc-gpt-4o,coral,pdac,PROMPT1_ICL_entailment
187,6,25,20,5,0.8,12,11,1,0.9166666666666666,0.854368932038835,shc-gpt-4o,coral,pdac,PROMPT1_ICL_entailment
188,60,46,40,6,0.8695652173913043,13,9,4,0.6923076923076923,0.7708779443254816,shc-gpt-4o,coral,pdac,PROMPT1_ICL_entailment
189,61,14,14,0,1.0,7,7,0,1.0,1.0,shc-gpt-4o,coral,pdac,PROMPT1_ICL_entailment
190,62,22,16,6,0.7272727272727273,11,8,3,0.7272727272727273,0.7272727272727273,shc-gpt-4o,coral,pdac,PROMPT1_ICL_entailment
191,63,13,13,0,1.0,10,10,0,1.0,1.0,shc-gpt-4o,coral,pdac,PROMPT1_ICL_entailment
192,64,22,20,2,0.9090909090909092,12,12,0,1.0,0.9523809523809524,shc-gpt-4o,coral,pdac,PROMPT1_ICL_entailment
193,65,34,31,3,0.9117647058823528,9,7,2,0.7777777777777778,0.8394584139264991,shc-gpt-4o,coral,pdac,PROMPT1_ICL_entailment
194,66,27,25,2,0.925925925925926,12,11,1,0.9166666666666666,0.9212730318257956,shc-gpt-4o,coral,pdac,PROMPT1_ICL_entailment
195,67,8,8,0,1.0,1,1,0,1.0,1.0,shc-gpt-4o,coral,pdac,PROMPT1_ICL_entailment
196,68,29,28,1,0.9655172413793104,11,10,1,0.9090909090909092,0.9364548494983278,shc-gpt-4o,coral,pdac,PROMPT1_ICL_entailment
197,69,27,25,2,0.925925925925926,10,10,0,1.0,0.9615384615384616,shc-gpt-4o,coral,pdac,PROMPT1_ICL_entailment
198,7,20,18,2,0.9,11,11,0,1.0,0.9473684210526316,shc-gpt-4o,coral,pdac,PROMPT1_ICL_entailment
199,70,25,24,1,0.96,15,15,0,1.0,0.979591836734694,shc-gpt-4o,coral,pdac,PROMPT1_ICL_entailment
200,71,45,36,9,0.8,9,8,1,0.8888888888888888,0.8421052631578948,shc-gpt-4o,coral,pdac,PROMPT1_ICL_entailment
201,72,51,46,5,0.9019607843137256,13,11,2,0.8461538461538461,0.8731665228645383,shc-gpt-4o,coral,pdac,PROMPT1_ICL_entailment
202,73,160,20,140,0.125,154,96,58,0.6233766233766234,0.2082429501084598,shc-gpt-4o,coral,pdac,PROMPT1_ICL_entailment
203,74,27,20,7,0.7407407407407407,8,8,0,1.0,0.851063829787234,shc-gpt-4o,coral,pdac,PROMPT1_ICL_entailment
204,75,24,22,2,0.9166666666666666,7,6,1,0.8571428571428571,0.8859060402684563,shc-gpt-4o,coral,pdac,PROMPT1_ICL_entailment
205,76,13,12,1,0.9230769230769232,7,7,0,1.0,0.96,shc-gpt-4o,coral,pdac,PROMPT1_ICL_entailment
206,77,22,17,5,0.7727272727272727,8,8,0,1.0,0.8717948717948718,shc-gpt-4o,coral,pdac,PROMPT1_ICL_entailment
207,78,22,17,5,0.7727272727272727,8,7,1,0.875,0.8206896551724138,shc-gpt-4o,coral,pdac,PROMPT1_ICL_entailment
208,79,26,24,2,0.9230769230769232,11,11,0,1.0,0.96,shc-gpt-4o,coral,pdac,PROMPT1_ICL_entailment
209,8,13,13,0,1.0,2,2,0,1.0,1.0,shc-gpt-4o,coral,pdac,PROMPT1_ICL_entailment
210,80,32,28,4,0.875,9,7,2,0.7777777777777778,0.823529411764706,shc-gpt-4o,coral,pdac,PROMPT1_ICL_entailment
211,81,20,18,2,0.9,6,5,1,0.8333333333333334,0.8653846153846153,shc-gpt-4o,coral,pdac,PROMPT1_ICL_entailment
212,82,36,36,0,1.0,4,3,1,0.75,0.8571428571428571,shc-gpt-4o,coral,pdac,PROMPT1_ICL_entailment
213,83,33,29,4,0.8787878787878788,11,8,3,0.7272727272727273,0.7958833619210979,shc-gpt-4o,coral,pdac,PROMPT1_ICL_entailment
214,84,32,21,11,0.65625,11,9,2,0.8181818181818182,0.7283236994219653,shc-gpt-4o,coral,pdac,PROMPT1_ICL_entailment
215,85,44,36,8,0.8181818181818182,35,23,12,0.6571428571428571,0.7288732394366197,shc-gpt-4o,coral,pdac,PROMPT1_ICL_entailment
216,86,19,16,3,0.8421052631578947,10,8,2,0.8,0.8205128205128205,shc-gpt-4o,coral,pdac,PROMPT1_ICL_entailment
217,87,33,28,5,0.8484848484848485,7,6,1,0.8571428571428571,0.8527918781725888,shc-gpt-4o,coral,pdac,PROMPT1_ICL_entailment
218,88,22,20,2,0.9090909090909092,8,3,5,0.375,0.5309734513274336,shc-gpt-4o,coral,pdac,PROMPT1_ICL_entailment
219,89,25,18,7,0.72,10,9,1,0.9,0.7999999999999999,shc-gpt-4o,coral,pdac,PROMPT1_ICL_entailment
220,9,18,17,1,0.9444444444444444,12,10,2,0.8333333333333334,0.8854166666666667,shc-gpt-4o,coral,pdac,PROMPT1_ICL_entailment
221,90,23,18,5,0.782608695652174,9,7,2,0.7777777777777778,0.7801857585139319,shc-gpt-4o,coral,pdac,PROMPT1_ICL_entailment
222,91,17,16,1,0.9411764705882352,10,10,0,1.0,0.9696969696969696,shc-gpt-4o,coral,pdac,PROMPT1_ICL_entailment
223,92,26,23,3,0.8846153846153846,10,9,1,0.9,0.8922413793103449,shc-gpt-4o,coral,pdac,PROMPT1_ICL_entailment
224,93,15,13,2,0.8666666666666667,9,7,2,0.7777777777777778,0.81981981981982,shc-gpt-4o,coral,pdac,PROMPT1_ICL_entailment
225,94,21,15,6,0.7142857142857143,7,7,0,1.0,0.8333333333333333,shc-gpt-4o,coral,pdac,PROMPT1_ICL_entailment
226,95,30,27,3,0.9,8,8,0,1.0,0.9473684210526316,shc-gpt-4o,coral,pdac,PROMPT1_ICL_entailment
227,96,13,13,0,1.0,4,4,0,1.0,1.0,shc-gpt-4o,coral,pdac,PROMPT1_ICL_entailment
228,97,20,17,3,0.85,8,8,0,1.0,0.9189189189189187,shc-gpt-4o,coral,pdac,PROMPT1_ICL_entailment
229,98,32,29,3,0.90625,9,9,0,1.0,0.9508196721311476,shc-gpt-4o,coral,pdac,PROMPT1_ICL_entailment
230,99,25,24,1,0.96,9,9,0,1.0,0.979591836734694,shc-gpt-4o,coral,pdac,PROMPT1_ICL_entailment
0,0,22,20,2,0.9090909090909092,9,9,0,1.0,0.9523809523809524,shc-gpt-4o,coral,pdac,PROMPT2_ICL_entailment
1,1,25,21,4,0.84,9,9,0,1.0,0.9130434782608696,shc-gpt-4o,coral,pdac,PROMPT2_ICL_entailment
2,10,27,24,3,0.8888888888888888,11,9,2,0.8181818181818182,0.8520710059171598,shc-gpt-4o,coral,pdac,PROMPT2_ICL_entailment
3,100,20,19,1,0.95,11,10,1,0.9090909090909092,0.9290953545232272,shc-gpt-4o,coral,pdac,PROMPT2_ICL_entailment
4,101,23,16,7,0.6956521739130435,11,10,1,0.9090909090909092,0.7881773399014779,shc-gpt-4o,coral,pdac,PROMPT2_ICL_entailment
5,102,49,45,4,0.9183673469387756,27,16,11,0.5925925925925926,0.720360180090045,shc-gpt-4o,coral,pdac,PROMPT2_ICL_entailment
6,103,48,39,9,0.8125,15,7,8,0.4666666666666667,0.5928338762214983,shc-gpt-4o,coral,pdac,PROMPT2_ICL_entailment
7,104,21,19,2,0.9047619047619048,12,11,1,0.9166666666666666,0.9106753812636164,shc-gpt-4o,coral,pdac,PROMPT2_ICL_entailment
8,105,62,33,29,0.532258064516129,33,13,20,0.3939393939393939,0.4527704485488126,shc-gpt-4o,coral,pdac,PROMPT2_ICL_entailment
9,106,14,14,0,1.0,10,9,1,0.9,0.9473684210526316,shc-gpt-4o,coral,pdac,PROMPT2_ICL_entailment
10,107,10,10,0,1.0,10,10,0,1.0,1.0,shc-gpt-4o,coral,pdac,PROMPT2_ICL_entailment
11,108,17,17,0,1.0,10,10,0,1.0,1.0,shc-gpt-4o,coral,pdac,PROMPT2_ICL_entailment
12,109,27,24,3,0.8888888888888888,34,29,5,0.8529411764705882,0.8705440900562851,shc-gpt-4o,coral,pdac,PROMPT2_ICL_entailment
13,11,21,21,0,1.0,10,7,3,0.7,0.8235294117647058,shc-gpt-4o,coral,pdac,PROMPT2_ICL_entailment
14,110,17,16,1,0.9411764705882352,4,4,0,1.0,0.9696969696969696,shc-gpt-4o,coral,pdac,PROMPT2_ICL_entailment
15,111,16,15,1,0.9375,3,3,0,1.0,0.967741935483871,shc-gpt-4o,coral,pdac,PROMPT2_ICL_entailment
16,112,22,20,2,0.9090909090909092,9,9,0,1.0,0.9523809523809524,shc-gpt-4o,coral,pdac,PROMPT2_ICL_entailment
17,113,22,21,1,0.9545454545454546,6,6,0,1.0,0.9767441860465116,shc-gpt-4o,coral,pdac,PROMPT2_ICL_entailment
18,114,19,19,0,1.0,9,9,0,1.0,1.0,shc-gpt-4o,coral,pdac,PROMPT2_ICL_entailment
19,115,16,15,1,0.9375,7,7,0,1.0,0.967741935483871,shc-gpt-4o,coral,pdac,PROMPT2_ICL_entailment
20,116,7,7,0,1.0,2,2,0,1.0,1.0,shc-gpt-4o,coral,pdac,PROMPT2_ICL_entailment
21,117,32,32,0,1.0,8,8,0,1.0,1.0,shc-gpt-4o,coral,pdac,PROMPT2_ICL_entailment
22,118,27,27,0,1.0,9,9,0,1.0,1.0,shc-gpt-4o,coral,pdac,PROMPT2_ICL_entailment
23,119,21,18,3,0.8571428571428571,12,11,1,0.9166666666666666,0.8859060402684563,shc-gpt-4o,coral,pdac,PROMPT2_ICL_entailment
24,12,24,24,0,1.0,10,10,0,1.0,1.0,shc-gpt-4o,coral,pdac,PROMPT2_ICL_entailment
25,120,33,31,2,0.9393939393939394,13,5,8,0.3846153846153846,0.545774647887324,shc-gpt-4o,coral,pdac,PROMPT2_ICL_entailment
26,121,32,26,6,0.8125,12,10,2,0.8333333333333334,0.8227848101265822,shc-gpt-4o,coral,pdac,PROMPT2_ICL_entailment
27,122,116,94,22,0.8103448275862069,45,38,7,0.8444444444444444,0.8270432970595044,shc-gpt-4o,coral,pdac,PROMPT2_ICL_entailment
28,123,28,25,3,0.8928571428571429,10,7,3,0.7,0.7847533632286995,shc-gpt-4o,coral,pdac,PROMPT2_ICL_entailment
29,124,6,6,0,1.0,3,3,0,1.0,1.0,shc-gpt-4o,coral,pdac,PROMPT2_ICL_entailment
30,125,27,26,1,0.9629629629629628,8,8,0,1.0,0.981132075471698,shc-gpt-4o,coral,pdac,PROMPT2_ICL_entailment
31,126,20,19,1,0.95,10,9,1,0.9,0.9243243243243242,shc-gpt-4o,coral,pdac,PROMPT2_ICL_entailment
32,127,53,48,5,0.9056603773584906,30,23,7,0.7666666666666667,0.8303873636705529,shc-gpt-4o,coral,pdac,PROMPT2_ICL_entailment
33,128,75,64,11,0.8533333333333334,35,29,6,0.8285714285714286,0.8407701019252549,shc-gpt-4o,coral,pdac,PROMPT2_ICL_entailment
34,129,17,15,2,0.8823529411764706,11,10,1,0.9090909090909092,0.8955223880597014,shc-gpt-4o,coral,pdac,PROMPT2_ICL_entailment
35,13,39,35,4,0.8974358974358975,13,12,1,0.9230769230769232,0.9100758396533044,shc-gpt-4o,coral,pdac,PROMPT2_ICL_entailment
36,130,23,22,1,0.9565217391304348,12,8,4,0.6666666666666666,0.7857142857142856,shc-gpt-4o,coral,pdac,PROMPT2_ICL_entailment
37,131,29,26,3,0.896551724137931,12,8,4,0.6666666666666666,0.7647058823529411,shc-gpt-4o,coral,pdac,PROMPT2_ICL_entailment
38,132,17,13,4,0.7647058823529411,10,8,2,0.8,0.7819548872180452,shc-gpt-4o,coral,pdac,PROMPT2_ICL_entailment
39,133,26,25,1,0.9615384615384616,7,6,1,0.8571428571428571,0.9063444108761328,shc-gpt-4o,coral,pdac,PROMPT2_ICL_entailment
40,134,31,30,1,0.967741935483871,15,8,7,0.5333333333333333,0.6876790830945559,shc-gpt-4o,coral,pdac,PROMPT2_ICL_entailment
41,135,24,23,1,0.9583333333333334,9,9,0,1.0,0.9787234042553192,shc-gpt-4o,coral,pdac,PROMPT2_ICL_entailment
42,136,33,27,6,0.8181818181818182,7,4,3,0.5714285714285714,0.6728971962616823,shc-gpt-4o,coral,pdac,PROMPT2_ICL_entailment
43,137,24,22,2,0.9166666666666666,10,5,5,0.5,0.6470588235294118,shc-gpt-4o,coral,pdac,PROMPT2_ICL_entailment
44,138,52,38,14,0.7307692307692307,25,18,7,0.72,0.7253446447507953,shc-gpt-4o,coral,pdac,PROMPT2_ICL_entailment
45,139,119,75,44,0.6302521008403361,62,35,27,0.5645161290322581,0.5955757231990926,shc-gpt-4o,coral,pdac,PROMPT2_ICL_entailment
46,14,14,13,1,0.9285714285714286,10,10,0,1.0,0.962962962962963,shc-gpt-4o,coral,pdac,PROMPT2_ICL_entailment
47,140,26,23,3,0.8846153846153846,8,8,0,1.0,0.9387755102040816,shc-gpt-4o,coral,pdac,PROMPT2_ICL_entailment
48,141,27,26,1,0.9629629629629628,11,7,4,0.6363636363636364,0.7663157894736842,shc-gpt-4o,coral,pdac,PROMPT2_ICL_entailment
49,142,28,20,8,0.7142857142857143,11,8,3,0.7272727272727273,0.7207207207207208,shc-gpt-4o,coral,pdac,PROMPT2_ICL_entailment
50,143,17,16,1,0.9411764705882352,9,8,1,0.8888888888888888,0.9142857142857144,shc-gpt-4o,coral,pdac,PROMPT2_ICL_entailment
51,144,33,26,7,0.7878787878787878,12,11,1,0.9166666666666666,0.8474074074074074,shc-gpt-4o,coral,pdac,PROMPT2_ICL_entailment
52,145,20,20,0,1.0,10,10,0,1.0,1.0,shc-gpt-4o,coral,pdac,PROMPT2_ICL_entailment
53,146,28,22,6,0.7857142857142857,7,6,1,0.8571428571428571,0.8198757763975155,shc-gpt-4o,coral,pdac,PROMPT2_ICL_entailment
54,147,24,20,4,0.8333333333333334,12,10,2,0.8333333333333334,0.8333333333333334,shc-gpt-4o,coral,pdac,PROMPT2_ICL_entailment
55,148,56,50,6,0.8928571428571429,25,19,6,0.76,0.8210890233362143,shc-gpt-4o,coral,pdac,PROMPT2_ICL_entailment
56,149,22,19,3,0.8636363636363636,7,6,1,0.8571428571428571,0.860377358490566,shc-gpt-4o,coral,pdac,PROMPT2_ICL_entailment
57,15,11,11,0,1.0,10,10,0,1.0,1.0,shc-gpt-4o,coral,pdac,PROMPT2_ICL_entailment
58,150,20,19,1,0.95,8,7,1,0.875,0.910958904109589,shc-gpt-4o,coral,pdac,PROMPT2_ICL_entailment
59,151,22,22,0,1.0,10,8,2,0.8,0.888888888888889,shc-gpt-4o,coral,pdac,PROMPT2_ICL_entailment
60,152,22,21,1,0.9545454545454546,11,10,1,0.9090909090909092,0.9312638580931264,shc-gpt-4o,coral,pdac,PROMPT2_ICL_entailment
61,153,100,50,50,0.5,30,22,8,0.7333333333333333,0.5945945945945945,shc-gpt-4o,coral,pdac,PROMPT2_ICL_entailment
62,154,37,33,4,0.8918918918918919,15,12,3,0.8,0.8434504792332269,shc-gpt-4o,coral,pdac,PROMPT2_ICL_entailment
63,155,104,94,10,0.903846153846154,47,36,11,0.7659574468085106,0.8292085273217348,shc-gpt-4o,coral,pdac,PROMPT2_ICL_entailment
64,156,22,20,2,0.9090909090909092,10,9,1,0.9,0.9045226130653266,shc-gpt-4o,coral,pdac,PROMPT2_ICL_entailment
65,157,31,27,4,0.8709677419354839,14,10,4,0.7142857142857143,0.7848837209302325,shc-gpt-4o,coral,pdac,PROMPT2_ICL_entailment
66,158,20,16,4,0.8,10,7,3,0.7,0.7466666666666666,shc-gpt-4o,coral,pdac,PROMPT2_ICL_entailment
67,159,21,19,2,0.9047619047619048,4,4,0,1.0,0.95,shc-gpt-4o,coral,pdac,PROMPT2_ICL_entailment
68,16,41,37,4,0.902439024390244,31,23,8,0.7419354838709677,0.8143540669856458,shc-gpt-4o,coral,pdac,PROMPT2_ICL_entailment
69,160,25,22,3,0.88,9,9,0,1.0,0.9361702127659576,shc-gpt-4o,coral,pdac,PROMPT2_ICL_entailment
70,161,26,25,1,0.9615384615384616,9,8,1,0.8888888888888888,0.9237875288683602,shc-gpt-4o,coral,pdac,PROMPT2_ICL_entailment
71,162,20,19,1,0.95,10,10,0,1.0,0.9743589743589745,shc-gpt-4o,coral,pdac,PROMPT2_ICL_entailment
72,163,26,19,7,0.7307692307692307,13,11,2,0.8461538461538461,0.7842401500938085,shc-gpt-4o,coral,pdac,PROMPT2_ICL_entailment
73,164,94,82,12,0.8723404255319149,36,32,4,0.8888888888888888,0.8805369127516779,shc-gpt-4o,coral,pdac,PROMPT2_ICL_entailment
74,165,27,22,5,0.8148148148148148,10,8,2,0.8,0.8073394495412846,shc-gpt-4o,coral,pdac,PROMPT2_ICL_entailment
75,166,28,26,2,0.9285714285714286,11,9,2,0.8181818181818182,0.8698884758364314,shc-gpt-4o,coral,pdac,PROMPT2_ICL_entailment
76,167,30,27,3,0.9,8,7,1,0.875,0.8873239436619719,shc-gpt-4o,coral,pdac,PROMPT2_ICL_entailment
77,168,19,17,2,0.8947368421052632,6,6,0,1.0,0.9444444444444444,shc-gpt-4o,coral,pdac,PROMPT2_ICL_entailment
78,169,14,14,0,1.0,7,7,0,1.0,1.0,shc-gpt-4o,coral,pdac,PROMPT2_ICL_entailment
79,17,17,17,0,1.0,5,5,0,1.0,1.0,shc-gpt-4o,coral,pdac,PROMPT2_ICL_entailment
80,170,51,40,11,0.7843137254901961,16,13,3,0.8125,0.7981580966999232,shc-gpt-4o,coral,pdac,PROMPT2_ICL_entailment
81,171,34,24,10,0.7058823529411765,13,11,2,0.8461538461538461,0.7696793002915452,shc-gpt-4o,coral,pdac,PROMPT2_ICL_entailment
82,172,21,19,2,0.9047619047619048,10,10,0,1.0,0.95,shc-gpt-4o,coral,pdac,PROMPT2_ICL_entailment
83,173,37,33,4,0.8918918918918919,22,16,6,0.7272727272727273,0.8012139605462822,shc-gpt-4o,coral,pdac,PROMPT2_ICL_entailment
84,174,34,32,2,0.9411764705882352,11,7,4,0.6363636363636364,0.759322033898305,shc-gpt-4o,coral,pdac,PROMPT2_ICL_entailment
85,175,70,26,44,0.3714285714285714,28,16,12,0.5714285714285714,0.4502164502164502,shc-gpt-4o,coral,pdac,PROMPT2_ICL_entailment
86,176,15,14,1,0.9333333333333332,10,10,0,1.0,0.9655172413793104,shc-gpt-4o,coral,pdac,PROMPT2_ICL_entailment
87,177,15,15,0,1.0,10,10,0,1.0,1.0,shc-gpt-4o,coral,pdac,PROMPT2_ICL_entailment
88,178,63,43,20,0.6825396825396826,36,29,7,0.8055555555555556,0.7389629629629629,shc-gpt-4o,coral,pdac,PROMPT2_ICL_entailment
89,179,16,16,0,1.0,9,8,1,0.8888888888888888,0.9411764705882352,shc-gpt-4o,coral,pdac,PROMPT2_ICL_entailment
90,18,43,40,3,0.9302325581395348,15,13,2,0.8666666666666667,0.8973252804141502,shc-gpt-4o,coral,pdac,PROMPT2_ICL_entailment
91,180,17,15,2,0.8823529411764706,5,5,0,1.0,0.9375,shc-gpt-4o,coral,pdac,PROMPT2_ICL_entailment
92,181,26,25,1,0.9615384615384616,10,10,0,1.0,0.9803921568627452,shc-gpt-4o,coral,pdac,PROMPT2_ICL_entailment
93,182,22,19,3,0.8636363636363636,8,8,0,1.0,0.9268292682926828,shc-gpt-4o,coral,pdac,PROMPT2_ICL_entailment
94,183,17,16,1,0.9411764705882352,10,6,4,0.6,0.7328244274809161,shc-gpt-4o,coral,pdac,PROMPT2_ICL_entailment
95,184,17,9,8,0.5294117647058824,9,7,2,0.7777777777777778,0.63,shc-gpt-4o,coral,pdac,PROMPT2_ICL_entailment
96,185,49,40,9,0.8163265306122449,22,15,7,0.6818181818181818,0.7430340557275542,shc-gpt-4o,coral,pdac,PROMPT2_ICL_entailment
97,186,64,41,23,0.640625,32,17,15,0.53125,0.5808333333333333,shc-gpt-4o,coral,pdac,PROMPT2_ICL_entailment
98,187,69,56,13,0.8115942028985508,34,29,5,0.8529411764705882,0.8317541613316262,shc-gpt-4o,coral,pdac,PROMPT2_ICL_entailment
99,188,31,29,2,0.935483870967742,8,8,0,1.0,0.9666666666666666,shc-gpt-4o,coral,pdac,PROMPT2_ICL_entailment
100,189,29,26,3,0.896551724137931,5,5,0,1.0,0.9454545454545454,shc-gpt-4o,coral,pdac,PROMPT2_ICL_entailment
101,19,64,49,15,0.765625,21,15,6,0.7142857142857143,0.7390648567119155,shc-gpt-4o,coral,pdac,PROMPT2_ICL_entailment
102,190,65,58,7,0.8923076923076924,17,10,7,0.5882352941176471,0.7090464547677262,shc-gpt-4o,coral,pdac,PROMPT2_ICL_entailment
103,191,54,45,9,0.8333333333333334,15,14,1,0.9333333333333332,0.8805031446540881,shc-gpt-4o,coral,pdac,PROMPT2_ICL_entailment
104,192,45,37,8,0.8222222222222222,12,8,4,0.6666666666666666,0.7363184079601989,shc-gpt-4o,coral,pdac,PROMPT2_ICL_entailment
105,193,20,19,1,0.95,10,8,2,0.8,0.8685714285714285,shc-gpt-4o,coral,pdac,PROMPT2_ICL_entailment
106,194,24,19,5,0.7916666666666666,11,11,0,1.0,0.8837209302325582,shc-gpt-4o,coral,pdac,PROMPT2_ICL_entailment
107,195,20,18,2,0.9,7,6,1,0.8571428571428571,0.8780487804878048,shc-gpt-4o,coral,pdac,PROMPT2_ICL_entailment
108,196,25,19,6,0.76,8,8,0,1.0,0.8636363636363636,shc-gpt-4o,coral,pdac,PROMPT2_ICL_entailment
109,197,50,43,7,0.86,9,9,0,1.0,0.924731182795699,shc-gpt-4o,coral,pdac,PROMPT2_ICL_entailment
110,198,30,27,3,0.9,12,11,1,0.9166666666666666,0.908256880733945,shc-gpt-4o,coral,pdac,PROMPT2_ICL_entailment
111,199,34,33,1,0.9705882352941176,9,9,0,1.0,0.9850746268656716,shc-gpt-4o,coral,pdac,PROMPT2_ICL_entailment
112,2,47,34,13,0.723404255319149,14,12,2,0.8571428571428571,0.7846153846153846,shc-gpt-4o,coral,pdac,PROMPT2_ICL_entailment
113,20,31,23,8,0.7419354838709677,18,14,4,0.7777777777777778,0.7594339622641508,shc-gpt-4o,coral,pdac,PROMPT2_ICL_entailment
114,200,43,39,4,0.9069767441860463,16,15,1,0.9375,0.9219858156028368,shc-gpt-4o,coral,pdac,PROMPT2_ICL_entailment
115,201,11,11,0,1.0,10,10,0,1.0,1.0,shc-gpt-4o,coral,pdac,PROMPT2_ICL_entailment
116,202,15,15,0,1.0,10,10,0,1.0,1.0,shc-gpt-4o,coral,pdac,PROMPT2_ICL_entailment
117,203,76,67,9,0.881578947368421,31,16,15,0.5161290322580645,0.6510780443364713,shc-gpt-4o,coral,pdac,PROMPT2_ICL_entailment
118,204,42,36,6,0.8571428571428571,14,10,4,0.7142857142857143,0.7792207792207793,shc-gpt-4o,coral,pdac,PROMPT2_ICL_entailment
119,205,24,22,2,0.9166666666666666,7,5,2,0.7142857142857143,0.8029197080291971,shc-gpt-4o,coral,pdac,PROMPT2_ICL_entailment
120,206,20,17,3,0.85,9,9,0,1.0,0.9189189189189187,shc-gpt-4o,coral,pdac,PROMPT2_ICL_entailment
121,207,26,19,7,0.7307692307692307,8,8,0,1.0,0.8444444444444443,shc-gpt-4o,coral,pdac,PROMPT2_ICL_entailment
122,208,21,18,3,0.8571428571428571,8,7,1,0.875,0.8659793814432989,shc-gpt-4o,coral,pdac,PROMPT2_ICL_entailment
123,209,39,38,1,0.9743589743589745,9,6,3,0.6666666666666666,0.7916666666666666,shc-gpt-4o,coral,pdac,PROMPT2_ICL_entailment
124,21,10,10,0,1.0,10,10,0,1.0,1.0,shc-gpt-4o,coral,pdac,PROMPT2_ICL_entailment
125,210,30,26,4,0.8666666666666667,9,9,0,1.0,0.9285714285714286,shc-gpt-4o,coral,pdac,PROMPT2_ICL_entailment
126,211,29,27,2,0.9310344827586208,8,7,1,0.875,0.9021479713603818,shc-gpt-4o,coral,pdac,PROMPT2_ICL_entailment
127,212,33,32,1,0.9696969696969696,17,14,3,0.8235294117647058,0.8906560636182903,shc-gpt-4o,coral,pdac,PROMPT2_ICL_entailment
128,213,23,23,0,1.0,11,10,1,0.9090909090909092,0.9523809523809524,shc-gpt-4o,coral,pdac,PROMPT2_ICL_entailment
129,214,44,37,7,0.8409090909090909,18,9,9,0.5,0.6271186440677967,shc-gpt-4o,coral,pdac,PROMPT2_ICL_entailment
130,215,45,24,21,0.5333333333333333,12,10,2,0.8333333333333334,0.6504065040650406,shc-gpt-4o,coral,pdac,PROMPT2_ICL_entailment
131,216,43,36,7,0.8372093023255814,33,27,6,0.8181818181818182,0.8275862068965518,shc-gpt-4o,coral,pdac,PROMPT2_ICL_entailment
132,217,51,48,3,0.9411764705882352,19,14,5,0.7368421052631579,0.8265682656826568,shc-gpt-4o,coral,pdac,PROMPT2_ICL_entailment
133,218,35,35,0,1.0,11,6,5,0.5454545454545454,0.7058823529411764,shc-gpt-4o,coral,pdac,PROMPT2_ICL_entailment
134,219,20,17,3,0.85,8,5,3,0.625,0.7203389830508474,shc-gpt-4o,coral,pdac,PROMPT2_ICL_entailment
135,22,36,23,13,0.6388888888888888,17,16,1,0.9411764705882352,0.7611168562564633,shc-gpt-4o,coral,pdac,PROMPT2_ICL_entailment
136,220,34,28,6,0.8235294117647058,11,10,1,0.9090909090909092,0.8641975308641976,shc-gpt-4o,coral,pdac,PROMPT2_ICL_entailment
137,221,21,20,1,0.9523809523809524,12,11,1,0.9166666666666666,0.9341825902335456,shc-gpt-4o,coral,pdac,PROMPT2_ICL_entailment
138,222,44,27,17,0.6136363636363636,11,9,2,0.8181818181818182,0.7012987012987013,shc-gpt-4o,coral,pdac,PROMPT2_ICL_entailment
139,223,113,100,13,0.8849557522123894,37,35,2,0.945945945945946,0.914435009797518,shc-gpt-4o,coral,pdac,PROMPT2_ICL_entailment
140,224,28,18,10,0.6428571428571429,8,8,0,1.0,0.782608695652174,shc-gpt-4o,coral,pdac,PROMPT2_ICL_entailment
141,225,20,20,0,1.0,13,8,5,0.6153846153846154,0.761904761904762,shc-gpt-4o,coral,pdac,PROMPT2_ICL_entailment
142,226,23,22,1,0.9565217391304348,11,9,2,0.8181818181818182,0.8819599109131404,shc-gpt-4o,coral,pdac,PROMPT2_ICL_entailment
143,227,24,21,3,0.875,10,9,1,0.9,0.8873239436619719,shc-gpt-4o,coral,pdac,PROMPT2_ICL_entailment
144,228,23,23,0,1.0,9,9,0,1.0,1.0,shc-gpt-4o,coral,pdac,PROMPT2_ICL_entailment
145,229,25,20,5,0.8,9,8,1,0.8888888888888888,0.8421052631578948,shc-gpt-4o,coral,pdac,PROMPT2_ICL_entailment
146,23,27,26,1,0.9629629629629628,12,9,3,0.75,0.8432432432432433,shc-gpt-4o,coral,pdac,PROMPT2_ICL_entailment
147,230,25,22,3,0.88,8,8,0,1.0,0.9361702127659576,shc-gpt-4o,coral,pdac,PROMPT2_ICL_entailment
148,24,21,20,1,0.9523809523809524,9,7,2,0.7777777777777778,0.856269113149847,shc-gpt-4o,coral,pdac,PROMPT2_ICL_entailment
149,25,33,25,8,0.7575757575757576,11,9,2,0.8181818181818182,0.7867132867132868,shc-gpt-4o,coral,pdac,PROMPT2_ICL_entailment
150,26,17,17,0,1.0,11,11,0,1.0,1.0,shc-gpt-4o,coral,pdac,PROMPT2_ICL_entailment
151,27,26,23,3,0.8846153846153846,12,11,1,0.9166666666666666,0.900355871886121,shc-gpt-4o,coral,pdac,PROMPT2_ICL_entailment
152,28,49,45,4,0.9183673469387756,13,9,4,0.6923076923076923,0.7894736842105262,shc-gpt-4o,coral,pdac,PROMPT2_ICL_entailment
153,29,45,38,7,0.8444444444444444,9,6,3,0.6666666666666666,0.7450980392156862,shc-gpt-4o,coral,pdac,PROMPT2_ICL_entailment
154,3,25,22,3,0.88,8,8,0,1.0,0.9361702127659576,shc-gpt-4o,coral,pdac,PROMPT2_ICL_entailment
155,30,39,34,5,0.8717948717948718,11,9,2,0.8181818181818182,0.8441379310344828,shc-gpt-4o,coral,pdac,PROMPT2_ICL_entailment
156,31,37,31,6,0.8378378378378378,11,11,0,1.0,0.911764705882353,shc-gpt-4o,coral,pdac,PROMPT2_ICL_entailment
157,32,46,38,8,0.8260869565217391,11,9,2,0.8181818181818182,0.8221153846153847,shc-gpt-4o,coral,pdac,PROMPT2_ICL_entailment
158,33,69,25,44,0.3623188405797101,24,15,9,0.625,0.4587155963302752,shc-gpt-4o,coral,pdac,PROMPT2_ICL_entailment
159,34,10,10,0,1.0,10,10,0,1.0,1.0,shc-gpt-4o,coral,pdac,PROMPT2_ICL_entailment
160,35,16,16,0,1.0,10,10,0,1.0,1.0,shc-gpt-4o,coral,pdac,PROMPT2_ICL_entailment
161,36,57,53,4,0.9298245614035088,44,35,9,0.7954545454545454,0.8574069794314767,shc-gpt-4o,coral,pdac,PROMPT2_ICL_entailment
162,37,31,26,5,0.8387096774193549,9,8,1,0.8888888888888888,0.8630705394190872,shc-gpt-4o,coral,pdac,PROMPT2_ICL_entailment
163,38,27,25,2,0.925925925925926,13,10,3,0.7692307692307693,0.8403361344537816,shc-gpt-4o,coral,pdac,PROMPT2_ICL_entailment
164,39,22,20,2,0.9090909090909092,10,9,1,0.9,0.9045226130653266,shc-gpt-4o,coral,pdac,PROMPT2_ICL_entailment
165,4,36,32,4,0.8888888888888888,15,11,4,0.7333333333333333,0.8036529680365296,shc-gpt-4o,coral,pdac,PROMPT2_ICL_entailment
166,40,18,12,6,0.6666666666666666,10,7,3,0.7,0.6829268292682926,shc-gpt-4o,coral,pdac,PROMPT2_ICL_entailment
167,41,26,26,0,1.0,8,8,0,1.0,1.0,shc-gpt-4o,coral,pdac,PROMPT2_ICL_entailment
168,42,41,38,3,0.926829268292683,11,10,1,0.9090909090909092,0.9178743961352656,shc-gpt-4o,coral,pdac,PROMPT2_ICL_entailment
169,43,42,41,1,0.9761904761904762,13,6,7,0.4615384615384615,0.6267515923566879,shc-gpt-4o,coral,pdac,PROMPT2_ICL_entailment
170,44,19,18,1,0.9473684210526316,11,11,0,1.0,0.972972972972973,shc-gpt-4o,coral,pdac,PROMPT2_ICL_entailment
171,45,24,22,2,0.9166666666666666,10,9,1,0.9,0.908256880733945,shc-gpt-4o,coral,pdac,PROMPT2_ICL_entailment
172,46,31,27,4,0.8709677419354839,11,9,2,0.8181818181818182,0.84375,shc-gpt-4o,coral,pdac,PROMPT2_ICL_entailment
173,47,62,57,5,0.9193548387096774,39,33,6,0.8461538461538461,0.8812368236120871,shc-gpt-4o,coral,pdac,PROMPT2_ICL_entailment
174,48,18,10,8,0.5555555555555556,10,8,2,0.8,0.6557377049180328,shc-gpt-4o,coral,pdac,PROMPT2_ICL_entailment
175,49,21,19,2,0.9047619047619048,10,8,2,0.8,0.8491620111731844,shc-gpt-4o,coral,pdac,PROMPT2_ICL_entailment
176,5,20,19,1,0.95,10,8,2,0.8,0.8685714285714285,shc-gpt-4o,coral,pdac,PROMPT2_ICL_entailment
177,50,24,24,0,1.0,10,6,4,0.6,0.7499999999999999,shc-gpt-4o,coral,pdac,PROMPT2_ICL_entailment
178,51,22,17,5,0.7727272727272727,12,10,2,0.8333333333333334,0.8018867924528302,shc-gpt-4o,coral,pdac,PROMPT2_ICL_entailment
179,52,30,27,3,0.9,10,9,1,0.9,0.9,shc-gpt-4o,coral,pdac,PROMPT2_ICL_entailment
180,53,16,14,2,0.875,8,6,2,0.75,0.8076923076923077,shc-gpt-4o,coral,pdac,PROMPT2_ICL_entailment
181,54,5,5,0,1.0,2,2,0,1.0,1.0,shc-gpt-4o,coral,pdac,PROMPT2_ICL_entailment
182,55,35,34,1,0.9714285714285714,10,8,2,0.8,0.8774193548387097,shc-gpt-4o,coral,pdac,PROMPT2_ICL_entailment
183,56,34,31,3,0.9117647058823528,8,6,2,0.75,0.8230088495575222,shc-gpt-4o,coral,pdac,PROMPT2_ICL_entailment
184,57,52,32,20,0.6153846153846154,13,6,7,0.4615384615384615,0.5274725274725274,shc-gpt-4o,coral,pdac,PROMPT2_ICL_entailment
185,58,49,43,6,0.8775510204081632,10,9,1,0.9,0.8886337543053962,shc-gpt-4o,coral,pdac,PROMPT2_ICL_entailment
186,59,49,40,9,0.8163265306122449,21,19,2,0.9047619047619048,0.8582721626199888,shc-gpt-4o,coral,pdac,PROMPT2_ICL_entailment
187,6,26,23,3,0.8846153846153846,12,11,1,0.9166666666666666,0.900355871886121,shc-gpt-4o,coral,pdac,PROMPT2_ICL_entailment
188,60,51,49,2,0.9607843137254902,13,8,5,0.6153846153846154,0.7502392344497607,shc-gpt-4o,coral,pdac,PROMPT2_ICL_entailment
189,61,21,19,2,0.9047619047619048,7,6,1,0.8571428571428571,0.8803088803088803,shc-gpt-4o,coral,pdac,PROMPT2_ICL_entailment
190,62,23,16,7,0.6956521739130435,11,6,5,0.5454545454545454,0.6114649681528662,shc-gpt-4o,coral,pdac,PROMPT2_ICL_entailment
191,63,14,14,0,1.0,10,10,0,1.0,1.0,shc-gpt-4o,coral,pdac,PROMPT2_ICL_entailment
192,64,21,18,3,0.8571428571428571,12,11,1,0.9166666666666666,0.8859060402684563,shc-gpt-4o,coral,pdac,PROMPT2_ICL_entailment
193,65,38,34,4,0.8947368421052632,9,8,1,0.8888888888888888,0.8918032786885245,shc-gpt-4o,coral,pdac,PROMPT2_ICL_entailment
194,66,27,25,2,0.925925925925926,12,8,4,0.6666666666666666,0.7751937984496123,shc-gpt-4o,coral,pdac,PROMPT2_ICL_entailment
195,67,7,7,0,1.0,1,1,0,1.0,1.0,shc-gpt-4o,coral,pdac,PROMPT2_ICL_entailment
196,68,30,29,1,0.9666666666666668,11,11,0,1.0,0.983050847457627,shc-gpt-4o,coral,pdac,PROMPT2_ICL_entailment
197,69,27,27,0,1.0,10,10,0,1.0,1.0,shc-gpt-4o,coral,pdac,PROMPT2_ICL_entailment
198,7,21,20,1,0.9523809523809524,11,9,2,0.8181818181818182,0.880195599022005,shc-gpt-4o,coral,pdac,PROMPT2_ICL_entailment
199,70,36,34,2,0.9444444444444444,15,14,1,0.9333333333333332,0.9388560157790926,shc-gpt-4o,coral,pdac,PROMPT2_ICL_entailment
200,71,44,28,16,0.6363636363636364,9,7,2,0.7777777777777778,0.7000000000000001,shc-gpt-4o,coral,pdac,PROMPT2_ICL_entailment
201,72,43,32,11,0.7441860465116279,13,12,1,0.9230769230769232,0.8240343347639485,shc-gpt-4o,coral,pdac,PROMPT2_ICL_entailment
202,73,99,26,73,0.2626262626262626,154,83,71,0.538961038961039,0.3531625889861713,shc-gpt-4o,coral,pdac,PROMPT2_ICL_entailment
203,74,34,22,12,0.6470588235294118,8,8,0,1.0,0.7857142857142858,shc-gpt-4o,coral,pdac,PROMPT2_ICL_entailment
204,75,30,27,3,0.9,7,5,2,0.7142857142857143,0.7964601769911505,shc-gpt-4o,coral,pdac,PROMPT2_ICL_entailment
205,76,29,24,5,0.8275862068965517,7,6,1,0.8571428571428571,0.8421052631578947,shc-gpt-4o,coral,pdac,PROMPT2_ICL_entailment
206,77,30,26,4,0.8666666666666667,8,8,0,1.0,0.9285714285714286,shc-gpt-4o,coral,pdac,PROMPT2_ICL_entailment
207,78,21,17,4,0.8095238095238095,8,7,1,0.875,0.8409893992932863,shc-gpt-4o,coral,pdac,PROMPT2_ICL_entailment
208,79,27,26,1,0.9629629629629628,11,11,0,1.0,0.981132075471698,shc-gpt-4o,coral,pdac,PROMPT2_ICL_entailment
209,8,14,14,0,1.0,2,2,0,1.0,1.0,shc-gpt-4o,coral,pdac,PROMPT2_ICL_entailment
210,80,34,30,4,0.8823529411764706,9,5,4,0.5555555555555556,0.6818181818181819,shc-gpt-4o,coral,pdac,PROMPT2_ICL_entailment
211,81,21,21,0,1.0,6,5,1,0.8333333333333334,0.9090909090909092,shc-gpt-4o,coral,pdac,PROMPT2_ICL_entailment
212,82,36,34,2,0.9444444444444444,4,3,1,0.75,0.8360655737704917,shc-gpt-4o,coral,pdac,PROMPT2_ICL_entailment
213,83,41,37,4,0.902439024390244,11,9,2,0.8181818181818182,0.8582474226804124,shc-gpt-4o,coral,pdac,PROMPT2_ICL_entailment
214,84,29,21,8,0.7241379310344828,11,8,3,0.7272727272727273,0.7257019438444924,shc-gpt-4o,coral,pdac,PROMPT2_ICL_entailment
215,85,64,47,17,0.734375,35,25,10,0.7142857142857143,0.724191063174114,shc-gpt-4o,coral,pdac,PROMPT2_ICL_entailment
216,86,20,19,1,0.95,10,9,1,0.9,0.9243243243243242,shc-gpt-4o,coral,pdac,PROMPT2_ICL_entailment
217,87,35,30,5,0.8571428571428571,7,4,3,0.5714285714285714,0.6857142857142857,shc-gpt-4o,coral,pdac,PROMPT2_ICL_entailment
218,88,29,29,0,1.0,8,7,1,0.875,0.9333333333333332,shc-gpt-4o,coral,pdac,PROMPT2_ICL_entailment
219,89,27,16,11,0.5925925925925926,10,8,2,0.8,0.6808510638297872,shc-gpt-4o,coral,pdac,PROMPT2_ICL_entailment
220,9,25,21,4,0.84,12,10,2,0.8333333333333334,0.8366533864541832,shc-gpt-4o,coral,pdac,PROMPT2_ICL_entailment
221,90,31,27,4,0.8709677419354839,9,8,1,0.8888888888888888,0.879837067209776,shc-gpt-4o,coral,pdac,PROMPT2_ICL_entailment
222,91,20,20,0,1.0,10,9,1,0.9,0.9473684210526316,shc-gpt-4o,coral,pdac,PROMPT2_ICL_entailment
223,92,30,26,4,0.8666666666666667,10,10,0,1.0,0.9285714285714286,shc-gpt-4o,coral,pdac,PROMPT2_ICL_entailment
224,93,24,23,1,0.9583333333333334,9,7,2,0.7777777777777778,0.8586666666666668,shc-gpt-4o,coral,pdac,PROMPT2_ICL_entailment
225,94,25,18,7,0.72,7,7,0,1.0,0.8372093023255813,shc-gpt-4o,coral,pdac,PROMPT2_ICL_entailment
226,95,29,26,3,0.896551724137931,8,7,1,0.875,0.8856447688564477,shc-gpt-4o,coral,pdac,PROMPT2_ICL_entailment
227,96,16,15,1,0.9375,4,4,0,1.0,0.967741935483871,shc-gpt-4o,coral,pdac,PROMPT2_ICL_entailment
228,97,21,18,3,0.8571428571428571,8,8,0,1.0,0.923076923076923,shc-gpt-4o,coral,pdac,PROMPT2_ICL_entailment
229,98,27,25,2,0.925925925925926,9,7,2,0.7777777777777778,0.8454106280193238,shc-gpt-4o,coral,pdac,PROMPT2_ICL_entailment
230,99,27,26,1,0.9629629629629628,9,8,1,0.8888888888888888,0.9244444444444444,shc-gpt-4o,coral,pdac,PROMPT2_ICL_entailment
0,0,17,16,1,0.9411764705882352,9,9,0,1.0,0.9696969696969696,shc-gpt-4o,coral,pdac,PROMPT2_entailment
1,1,18,18,0,1.0,9,7,2,0.7777777777777778,0.8750000000000001,shc-gpt-4o,coral,pdac,PROMPT2_entailment
2,10,28,26,2,0.9285714285714286,11,6,5,0.5454545454545454,0.6872246696035241,shc-gpt-4o,coral,pdac,PROMPT2_entailment
3,100,17,14,3,0.8235294117647058,11,9,2,0.8181818181818182,0.8208469055374593,shc-gpt-4o,coral,pdac,PROMPT2_entailment
4,101,21,21,0,1.0,11,10,1,0.9090909090909092,0.9523809523809524,shc-gpt-4o,coral,pdac,PROMPT2_entailment
5,102,27,26,1,0.9629629629629628,27,18,9,0.6666666666666666,0.7878787878787878,shc-gpt-4o,coral,pdac,PROMPT2_entailment
6,103,19,15,4,0.7894736842105263,15,11,4,0.7333333333333333,0.76036866359447,shc-gpt-4o,coral,pdac,PROMPT2_entailment
7,104,21,18,3,0.8571428571428571,12,9,3,0.75,0.7999999999999999,shc-gpt-4o,coral,pdac,PROMPT2_entailment
8,105,54,27,27,0.5,33,15,18,0.4545454545454545,0.4761904761904761,shc-gpt-4o,coral,pdac,PROMPT2_entailment
9,106,14,14,0,1.0,10,10,0,1.0,1.0,shc-gpt-4o,coral,pdac,PROMPT2_entailment
10,107,10,10,0,1.0,10,10,0,1.0,1.0,shc-gpt-4o,coral,pdac,PROMPT2_entailment
11,108,17,17,0,1.0,10,10,0,1.0,1.0,shc-gpt-4o,coral,pdac,PROMPT2_entailment
12,109,27,27,0,1.0,34,27,7,0.7941176470588235,0.8852459016393442,shc-gpt-4o,coral,pdac,PROMPT2_entailment
13,11,19,16,3,0.8421052631578947,10,9,1,0.9,0.8700906344410877,shc-gpt-4o,coral,pdac,PROMPT2_entailment
14,110,9,9,0,1.0,4,4,0,1.0,1.0,shc-gpt-4o,coral,pdac,PROMPT2_entailment
15,111,11,9,2,0.8181818181818182,3,3,0,1.0,0.9,shc-gpt-4o,coral,pdac,PROMPT2_entailment
16,112,12,11,1,0.9166666666666666,9,7,2,0.7777777777777778,0.8415300546448087,shc-gpt-4o,coral,pdac,PROMPT2_entailment
17,113,14,12,2,0.8571428571428571,6,6,0,1.0,0.923076923076923,shc-gpt-4o,coral,pdac,PROMPT2_entailment
18,114,14,14,0,1.0,9,9,0,1.0,1.0,shc-gpt-4o,coral,pdac,PROMPT2_entailment
19,115,12,12,0,1.0,7,6,1,0.8571428571428571,0.923076923076923,shc-gpt-4o,coral,pdac,PROMPT2_entailment
20,116,6,5,1,0.8333333333333334,2,2,0,1.0,0.9090909090909092,shc-gpt-4o,coral,pdac,PROMPT2_entailment
21,117,19,18,1,0.9473684210526316,8,7,1,0.875,0.9097472924187724,shc-gpt-4o,coral,pdac,PROMPT2_entailment
22,118,25,24,1,0.96,9,9,0,1.0,0.979591836734694,shc-gpt-4o,coral,pdac,PROMPT2_entailment
23,119,18,14,4,0.7777777777777778,12,10,2,0.8333333333333334,0.8045977011494253,shc-gpt-4o,coral,pdac,PROMPT2_entailment
24,12,23,22,1,0.9565217391304348,10,9,1,0.9,0.9274004683840747,shc-gpt-4o,coral,pdac,PROMPT2_entailment
25,120,19,14,5,0.7368421052631579,13,7,6,0.5384615384615384,0.6222222222222222,shc-gpt-4o,coral,pdac,PROMPT2_entailment
26,121,25,21,4,0.84,12,9,3,0.75,0.7924528301886793,shc-gpt-4o,coral,pdac,PROMPT2_entailment
27,122,58,49,9,0.8448275862068966,45,32,13,0.7111111111111111,0.7722235902487072,shc-gpt-4o,coral,pdac,PROMPT2_entailment
28,123,17,16,1,0.9411764705882352,10,8,2,0.8,0.8648648648648648,shc-gpt-4o,coral,pdac,PROMPT2_entailment
29,124,4,4,0,1.0,3,3,0,1.0,1.0,shc-gpt-4o,coral,pdac,PROMPT2_entailment
30,125,19,19,0,1.0,8,8,0,1.0,1.0,shc-gpt-4o,coral,pdac,PROMPT2_entailment
31,126,19,19,0,1.0,10,8,2,0.8,0.888888888888889,shc-gpt-4o,coral,pdac,PROMPT2_entailment
32,127,44,32,12,0.7272727272727273,30,29,1,0.9666666666666668,0.8300536672629696,shc-gpt-4o,coral,pdac,PROMPT2_entailment
33,128,46,37,9,0.8043478260869565,35,27,8,0.7714285714285715,0.787544343713047,shc-gpt-4o,coral,pdac,PROMPT2_entailment
34,129,15,14,1,0.9333333333333332,11,7,4,0.6363636363636364,0.7567567567567568,shc-gpt-4o,coral,pdac,PROMPT2_entailment
35,13,25,24,1,0.96,13,11,2,0.8461538461538461,0.8994889267461669,shc-gpt-4o,coral,pdac,PROMPT2_entailment
36,130,18,16,2,0.8888888888888888,12,7,5,0.5833333333333334,0.7044025157232704,shc-gpt-4o,coral,pdac,PROMPT2_entailment
37,131,31,30,1,0.967741935483871,12,9,3,0.75,0.8450704225352113,shc-gpt-4o,coral,pdac,PROMPT2_entailment
38,132,13,12,1,0.9230769230769232,10,8,2,0.8,0.8571428571428571,shc-gpt-4o,coral,pdac,PROMPT2_entailment
39,133,26,25,1,0.9615384615384616,7,7,0,1.0,0.9803921568627452,shc-gpt-4o,coral,pdac,PROMPT2_entailment
40,134,27,25,2,0.925925925925926,15,8,7,0.5333333333333333,0.676818950930626,shc-gpt-4o,coral,pdac,PROMPT2_entailment
41,135,24,24,0,1.0,9,8,1,0.8888888888888888,0.9411764705882352,shc-gpt-4o,coral,pdac,PROMPT2_entailment
42,136,32,28,4,0.875,7,3,4,0.4285714285714285,0.5753424657534246,shc-gpt-4o,coral,pdac,PROMPT2_entailment
43,137,15,12,3,0.8,10,6,4,0.6,0.6857142857142857,shc-gpt-4o,coral,pdac,PROMPT2_entailment
44,138,35,25,10,0.7142857142857143,25,16,9,0.64,0.6751054852320676,shc-gpt-4o,coral,pdac,PROMPT2_entailment
45,139,78,51,27,0.6538461538461539,62,43,19,0.6935483870967742,0.6731123388581952,shc-gpt-4o,coral,pdac,PROMPT2_entailment
46,14,13,13,0,1.0,10,10,0,1.0,1.0,shc-gpt-4o,coral,pdac,PROMPT2_entailment
47,140,15,14,1,0.9333333333333332,8,7,1,0.875,0.9032258064516128,shc-gpt-4o,coral,pdac,PROMPT2_entailment
48,141,19,18,1,0.9473684210526316,11,5,6,0.4545454545454545,0.6143344709897611,shc-gpt-4o,coral,pdac,PROMPT2_entailment
49,142,20,17,3,0.85,11,9,2,0.8181818181818182,0.8337874659400545,shc-gpt-4o,coral,pdac,PROMPT2_entailment
50,143,16,13,3,0.8125,9,9,0,1.0,0.896551724137931,shc-gpt-4o,coral,pdac,PROMPT2_entailment
51,144,27,21,6,0.7777777777777778,12,11,1,0.9166666666666666,0.8415300546448087,shc-gpt-4o,coral,pdac,PROMPT2_entailment
52,145,16,16,0,1.0,10,8,2,0.8,0.888888888888889,shc-gpt-4o,coral,pdac,PROMPT2_entailment
53,146,15,11,4,0.7333333333333333,7,7,0,1.0,0.846153846153846,shc-gpt-4o,coral,pdac,PROMPT2_entailment
54,147,14,12,2,0.8571428571428571,12,8,4,0.6666666666666666,0.75,shc-gpt-4o,coral,pdac,PROMPT2_entailment
55,148,63,55,8,0.873015873015873,25,17,8,0.68,0.7645134914145543,shc-gpt-4o,coral,pdac,PROMPT2_entailment
56,149,18,16,2,0.8888888888888888,7,6,1,0.8571428571428571,0.8727272727272727,shc-gpt-4o,coral,pdac,PROMPT2_entailment
57,15,11,11,0,1.0,10,10,0,1.0,1.0,shc-gpt-4o,coral,pdac,PROMPT2_entailment
58,150,17,15,2,0.8823529411764706,8,7,1,0.875,0.8786610878661087,shc-gpt-4o,coral,pdac,PROMPT2_entailment
59,151,22,21,1,0.9545454545454546,10,9,1,0.9,0.9264705882352942,shc-gpt-4o,coral,pdac,PROMPT2_entailment
60,152,20,20,0,1.0,11,10,1,0.9090909090909092,0.9523809523809524,shc-gpt-4o,coral,pdac,PROMPT2_entailment
61,153,44,42,2,0.9545454545454546,30,13,17,0.4333333333333333,0.5960698689956332,shc-gpt-4o,coral,pdac,PROMPT2_entailment
62,154,22,21,1,0.9545454545454546,15,14,1,0.9333333333333332,0.9438202247191012,shc-gpt-4o,coral,pdac,PROMPT2_entailment
63,155,47,44,3,0.9361702127659576,47,33,14,0.7021276595744681,0.8024316109422492,shc-gpt-4o,coral,pdac,PROMPT2_entailment
64,156,17,17,0,1.0,10,8,2,0.8,0.888888888888889,shc-gpt-4o,coral,pdac,PROMPT2_entailment
65,157,22,20,2,0.9090909090909092,14,8,6,0.5714285714285714,0.7017543859649122,shc-gpt-4o,coral,pdac,PROMPT2_entailment
66,158,13,13,0,1.0,10,6,4,0.6,0.7499999999999999,shc-gpt-4o,coral,pdac,PROMPT2_entailment
67,159,15,14,1,0.9333333333333332,4,3,1,0.75,0.8316831683168316,shc-gpt-4o,coral,pdac,PROMPT2_entailment
68,16,42,35,7,0.8333333333333334,31,20,11,0.6451612903225806,0.7272727272727272,shc-gpt-4o,coral,pdac,PROMPT2_entailment
69,160,20,19,1,0.95,9,8,1,0.8888888888888888,0.918429003021148,shc-gpt-4o,coral,pdac,PROMPT2_entailment
70,161,14,14,0,1.0,9,8,1,0.8888888888888888,0.9411764705882352,shc-gpt-4o,coral,pdac,PROMPT2_entailment
71,162,16,16,0,1.0,10,10,0,1.0,1.0,shc-gpt-4o,coral,pdac,PROMPT2_entailment
72,163,24,22,2,0.9166666666666666,13,12,1,0.9230769230769232,0.9198606271777002,shc-gpt-4o,coral,pdac,PROMPT2_entailment
73,164,47,37,10,0.7872340425531915,36,28,8,0.7777777777777778,0.782477341389728,shc-gpt-4o,coral,pdac,PROMPT2_entailment
74,165,21,17,4,0.8095238095238095,10,4,6,0.4,0.5354330708661417,shc-gpt-4o,coral,pdac,PROMPT2_entailment
75,166,15,14,1,0.9333333333333332,11,8,3,0.7272727272727273,0.8175182481751825,shc-gpt-4o,coral,pdac,PROMPT2_entailment
76,167,12,10,2,0.8333333333333334,8,6,2,0.75,0.7894736842105262,shc-gpt-4o,coral,pdac,PROMPT2_entailment
77,168,12,11,1,0.9166666666666666,6,6,0,1.0,0.9565217391304348,shc-gpt-4o,coral,pdac,PROMPT2_entailment
78,169,12,12,0,1.0,7,7,0,1.0,1.0,shc-gpt-4o,coral,pdac,PROMPT2_entailment
79,17,15,15,0,1.0,5,5,0,1.0,1.0,shc-gpt-4o,coral,pdac,PROMPT2_entailment
80,170,43,30,13,0.6976744186046512,16,15,1,0.9375,0.8000000000000002,shc-gpt-4o,coral,pdac,PROMPT2_entailment
81,171,24,16,8,0.6666666666666666,13,10,3,0.7692307692307693,0.7142857142857142,shc-gpt-4o,coral,pdac,PROMPT2_entailment
82,172,23,18,5,0.782608695652174,10,10,0,1.0,0.878048780487805,shc-gpt-4o,coral,pdac,PROMPT2_entailment
83,173,25,22,3,0.88,22,15,7,0.6818181818181818,0.7683352735739232,shc-gpt-4o,coral,pdac,PROMPT2_entailment
84,174,19,16,3,0.8421052631578947,11,9,2,0.8181818181818182,0.829971181556196,shc-gpt-4o,coral,pdac,PROMPT2_entailment
85,175,56,8,48,0.1428571428571428,28,10,18,0.3571428571428571,0.2040816326530612,shc-gpt-4o,coral,pdac,PROMPT2_entailment
86,176,14,14,0,1.0,10,10,0,1.0,1.0,shc-gpt-4o,coral,pdac,PROMPT2_entailment
87,177,15,15,0,1.0,10,10,0,1.0,1.0,shc-gpt-4o,coral,pdac,PROMPT2_entailment
88,178,36,23,13,0.6388888888888888,36,20,16,0.5555555555555556,0.5943152454780362,shc-gpt-4o,coral,pdac,PROMPT2_entailment
89,179,12,11,1,0.9166666666666666,9,8,1,0.8888888888888888,0.9025641025641026,shc-gpt-4o,coral,pdac,PROMPT2_entailment
90,18,34,33,1,0.9705882352941176,15,13,2,0.8666666666666667,0.9156883671291356,shc-gpt-4o,coral,pdac,PROMPT2_entailment
91,180,15,15,0,1.0,5,5,0,1.0,1.0,shc-gpt-4o,coral,pdac,PROMPT2_entailment
92,181,21,19,2,0.9047619047619048,10,8,2,0.8,0.8491620111731844,shc-gpt-4o,coral,pdac,PROMPT2_entailment
93,182,18,18,0,1.0,8,6,2,0.75,0.8571428571428571,shc-gpt-4o,coral,pdac,PROMPT2_entailment
94,183,19,14,5,0.7368421052631579,10,9,1,0.9,0.810289389067524,shc-gpt-4o,coral,pdac,PROMPT2_entailment
95,184,19,10,9,0.5263157894736842,9,7,2,0.7777777777777778,0.6278026905829596,shc-gpt-4o,coral,pdac,PROMPT2_entailment
96,185,29,27,2,0.9310344827586208,22,16,6,0.7272727272727273,0.8166351606805292,shc-gpt-4o,coral,pdac,PROMPT2_entailment
97,186,59,40,19,0.6779661016949152,32,14,18,0.4375,0.5318138651471984,shc-gpt-4o,coral,pdac,PROMPT2_entailment
98,187,67,47,20,0.7014925373134329,34,19,15,0.5588235294117647,0.6220828979449669,shc-gpt-4o,coral,pdac,PROMPT2_entailment
99,188,24,22,2,0.9166666666666666,8,7,1,0.875,0.8953488372093024,shc-gpt-4o,coral,pdac,PROMPT2_entailment
100,189,21,18,3,0.8571428571428571,5,5,0,1.0,0.923076923076923,shc-gpt-4o,coral,pdac,PROMPT2_entailment
101,19,37,32,5,0.8648648648648649,21,12,9,0.5714285714285714,0.6881720430107527,shc-gpt-4o,coral,pdac,PROMPT2_entailment
102,190,53,47,6,0.8867924528301887,17,10,7,0.5882352941176471,0.7072987208427388,shc-gpt-4o,coral,pdac,PROMPT2_entailment
103,191,54,43,11,0.7962962962962963,15,12,3,0.8,0.7981438515081207,shc-gpt-4o,coral,pdac,PROMPT2_entailment
104,192,37,32,5,0.8648648648648649,12,8,4,0.6666666666666666,0.7529411764705882,shc-gpt-4o,coral,pdac,PROMPT2_entailment
105,193,17,16,1,0.9411764705882352,10,7,3,0.7,0.8028673835125448,shc-gpt-4o,coral,pdac,PROMPT2_entailment
106,194,15,12,3,0.8,11,9,2,0.8181818181818182,0.8089887640449439,shc-gpt-4o,coral,pdac,PROMPT2_entailment
107,195,16,14,2,0.875,7,4,3,0.5714285714285714,0.691358024691358,shc-gpt-4o,coral,pdac,PROMPT2_entailment
108,196,18,18,0,1.0,8,8,0,1.0,1.0,shc-gpt-4o,coral,pdac,PROMPT2_entailment
109,197,43,37,6,0.8604651162790697,9,6,3,0.6666666666666666,0.7512690355329947,shc-gpt-4o,coral,pdac,PROMPT2_entailment
110,198,15,15,0,1.0,12,8,4,0.6666666666666666,0.8,shc-gpt-4o,coral,pdac,PROMPT2_entailment
111,199,30,29,1,0.9666666666666668,9,9,0,1.0,0.983050847457627,shc-gpt-4o,coral,pdac,PROMPT2_entailment
112,2,35,28,7,0.8,14,10,4,0.7142857142857143,0.7547169811320756,shc-gpt-4o,coral,pdac,PROMPT2_entailment
113,20,28,20,8,0.7142857142857143,18,13,5,0.7222222222222222,0.7182320441988951,shc-gpt-4o,coral,pdac,PROMPT2_entailment
114,200,38,34,4,0.8947368421052632,16,15,1,0.9375,0.9156193895870736,shc-gpt-4o,coral,pdac,PROMPT2_entailment
115,201,11,11,0,1.0,10,10,0,1.0,1.0,shc-gpt-4o,coral,pdac,PROMPT2_entailment
116,202,17,17,0,1.0,10,10,0,1.0,1.0,shc-gpt-4o,coral,pdac,PROMPT2_entailment
117,203,34,30,4,0.8823529411764706,31,21,10,0.6774193548387096,0.7664233576642336,shc-gpt-4o,coral,pdac,PROMPT2_entailment
118,204,24,17,7,0.7083333333333334,14,11,3,0.7857142857142857,0.7450199203187251,shc-gpt-4o,coral,pdac,PROMPT2_entailment
119,205,23,17,6,0.7391304347826086,7,6,1,0.8571428571428571,0.7937743190661479,shc-gpt-4o,coral,pdac,PROMPT2_entailment
120,206,14,13,1,0.9285714285714286,9,6,3,0.6666666666666666,0.7761194029850746,shc-gpt-4o,coral,pdac,PROMPT2_entailment
121,207,18,15,3,0.8333333333333334,8,6,2,0.75,0.7894736842105262,shc-gpt-4o,coral,pdac,PROMPT2_entailment
122,208,9,9,0,1.0,8,8,0,1.0,1.0,shc-gpt-4o,coral,pdac,PROMPT2_entailment
123,209,27,27,0,1.0,9,7,2,0.7777777777777778,0.8750000000000001,shc-gpt-4o,coral,pdac,PROMPT2_entailment
124,21,10,10,0,1.0,10,10,0,1.0,1.0,shc-gpt-4o,coral,pdac,PROMPT2_entailment
125,210,19,18,1,0.9473684210526316,9,8,1,0.8888888888888888,0.9171974522292994,shc-gpt-4o,coral,pdac,PROMPT2_entailment
126,211,20,19,1,0.95,8,6,2,0.75,0.838235294117647,shc-gpt-4o,coral,pdac,PROMPT2_entailment
127,212,27,25,2,0.925925925925926,17,10,7,0.5882352941176471,0.7194244604316546,shc-gpt-4o,coral,pdac,PROMPT2_entailment
128,213,20,20,0,1.0,11,8,3,0.7272727272727273,0.8421052631578948,shc-gpt-4o,coral,pdac,PROMPT2_entailment
129,214,14,11,3,0.7857142857142857,18,12,6,0.6666666666666666,0.721311475409836,shc-gpt-4o,coral,pdac,PROMPT2_entailment
130,215,27,13,14,0.4814814814814814,12,7,5,0.5833333333333334,0.527536231884058,shc-gpt-4o,coral,pdac,PROMPT2_entailment
131,216,41,32,9,0.7804878048780488,33,24,9,0.7272727272727273,0.7529411764705882,shc-gpt-4o,coral,pdac,PROMPT2_entailment
132,217,37,35,2,0.945945945945946,19,14,5,0.7368421052631579,0.8284023668639052,shc-gpt-4o,coral,pdac,PROMPT2_entailment
133,218,28,28,0,1.0,11,8,3,0.7272727272727273,0.8421052631578948,shc-gpt-4o,coral,pdac,PROMPT2_entailment
134,219,14,12,2,0.8571428571428571,8,5,3,0.625,0.7228915662650602,shc-gpt-4o,coral,pdac,PROMPT2_entailment
135,22,30,21,9,0.7,17,14,3,0.8235294117647058,0.7567567567567567,shc-gpt-4o,coral,pdac,PROMPT2_entailment
136,220,27,21,6,0.7777777777777778,11,10,1,0.9090909090909092,0.8383233532934132,shc-gpt-4o,coral,pdac,PROMPT2_entailment
137,221,17,13,4,0.7647058823529411,12,10,2,0.8333333333333334,0.7975460122699386,shc-gpt-4o,coral,pdac,PROMPT2_entailment
138,222,15,12,3,0.8,11,8,3,0.7272727272727273,0.761904761904762,shc-gpt-4o,coral,pdac,PROMPT2_entailment
139,223,78,65,13,0.8333333333333334,37,31,6,0.8378378378378378,0.8355795148247978,shc-gpt-4o,coral,pdac,PROMPT2_entailment
140,224,26,17,9,0.6538461538461539,8,8,0,1.0,0.7906976744186047,shc-gpt-4o,coral,pdac,PROMPT2_entailment
141,225,18,15,3,0.8333333333333334,13,8,5,0.6153846153846154,0.7079646017699115,shc-gpt-4o,coral,pdac,PROMPT2_entailment
142,226,17,16,1,0.9411764705882352,11,7,4,0.6363636363636364,0.759322033898305,shc-gpt-4o,coral,pdac,PROMPT2_entailment
143,227,16,12,4,0.75,10,8,2,0.8,0.7741935483870969,shc-gpt-4o,coral,pdac,PROMPT2_entailment
144,228,18,18,0,1.0,9,9,0,1.0,1.0,shc-gpt-4o,coral,pdac,PROMPT2_entailment
145,229,17,15,2,0.8823529411764706,9,8,1,0.8888888888888888,0.8856088560885608,shc-gpt-4o,coral,pdac,PROMPT2_entailment
146,23,19,19,0,1.0,12,9,3,0.75,0.8571428571428571,shc-gpt-4o,coral,pdac,PROMPT2_entailment
147,230,18,17,1,0.9444444444444444,8,8,0,1.0,0.9714285714285714,shc-gpt-4o,coral,pdac,PROMPT2_entailment
148,24,14,14,0,1.0,9,7,2,0.7777777777777778,0.8750000000000001,shc-gpt-4o,coral,pdac,PROMPT2_entailment
149,25,17,15,2,0.8823529411764706,11,8,3,0.7272727272727273,0.7973421926910299,shc-gpt-4o,coral,pdac,PROMPT2_entailment
150,26,14,13,1,0.9285714285714286,11,11,0,1.0,0.962962962962963,shc-gpt-4o,coral,pdac,PROMPT2_entailment
151,27,19,18,1,0.9473684210526316,12,10,2,0.8333333333333334,0.8866995073891626,shc-gpt-4o,coral,pdac,PROMPT2_entailment
152,28,38,36,2,0.9473684210526316,13,7,6,0.5384615384615384,0.6866485013623977,shc-gpt-4o,coral,pdac,PROMPT2_entailment
153,29,42,36,6,0.8571428571428571,9,7,2,0.7777777777777778,0.8155339805825242,shc-gpt-4o,coral,pdac,PROMPT2_entailment
154,3,17,16,1,0.9411764705882352,8,7,1,0.875,0.9068825910931174,shc-gpt-4o,coral,pdac,PROMPT2_entailment
155,30,34,26,8,0.7647058823529411,11,7,4,0.6363636363636364,0.6946564885496184,shc-gpt-4o,coral,pdac,PROMPT2_entailment
156,31,35,28,7,0.8,11,11,0,1.0,0.888888888888889,shc-gpt-4o,coral,pdac,PROMPT2_entailment
157,32,37,24,13,0.6486486486486487,11,8,3,0.7272727272727273,0.6857142857142857,shc-gpt-4o,coral,pdac,PROMPT2_entailment
158,33,65,17,48,0.2615384615384615,24,21,3,0.875,0.4027072758037225,shc-gpt-4o,coral,pdac,PROMPT2_entailment
159,34,10,9,1,0.9,10,10,0,1.0,0.9473684210526316,shc-gpt-4o,coral,pdac,PROMPT2_entailment
160,35,16,16,0,1.0,10,10,0,1.0,1.0,shc-gpt-4o,coral,pdac,PROMPT2_entailment
161,36,37,36,1,0.972972972972973,44,35,9,0.7954545454545454,0.8753039249739493,shc-gpt-4o,coral,pdac,PROMPT2_entailment
162,37,28,24,4,0.8571428571428571,9,8,1,0.8888888888888888,0.8727272727272727,shc-gpt-4o,coral,pdac,PROMPT2_entailment
163,38,28,25,3,0.8928571428571429,13,10,3,0.7692307692307693,0.8264462809917357,shc-gpt-4o,coral,pdac,PROMPT2_entailment
164,39,18,17,1,0.9444444444444444,10,8,2,0.8,0.8662420382165604,shc-gpt-4o,coral,pdac,PROMPT2_entailment
165,4,27,24,3,0.8888888888888888,15,9,6,0.6,0.7164179104477612,shc-gpt-4o,coral,pdac,PROMPT2_entailment
166,40,12,9,3,0.75,10,8,2,0.8,0.7741935483870969,shc-gpt-4o,coral,pdac,PROMPT2_entailment
167,41,24,22,2,0.9166666666666666,8,7,1,0.875,0.8953488372093024,shc-gpt-4o,coral,pdac,PROMPT2_entailment
168,42,32,30,2,0.9375,11,9,2,0.8181818181818182,0.8737864077669902,shc-gpt-4o,coral,pdac,PROMPT2_entailment
169,43,36,33,3,0.9166666666666666,13,8,5,0.6153846153846154,0.7364016736401674,shc-gpt-4o,coral,pdac,PROMPT2_entailment
170,44,17,16,1,0.9411764705882352,11,10,1,0.9090909090909092,0.92485549132948,shc-gpt-4o,coral,pdac,PROMPT2_entailment
171,45,22,22,0,1.0,10,9,1,0.9,0.9473684210526316,shc-gpt-4o,coral,pdac,PROMPT2_entailment
172,46,25,22,3,0.88,11,9,2,0.8181818181818182,0.84796573875803,shc-gpt-4o,coral,pdac,PROMPT2_entailment
173,47,42,36,6,0.8571428571428571,39,23,16,0.5897435897435898,0.6987341772151898,shc-gpt-4o,coral,pdac,PROMPT2_entailment
174,48,10,4,6,0.4,10,8,2,0.8,0.5333333333333333,shc-gpt-4o,coral,pdac,PROMPT2_entailment
175,49,16,16,0,1.0,10,6,4,0.6,0.7499999999999999,shc-gpt-4o,coral,pdac,PROMPT2_entailment
176,5,15,13,2,0.8666666666666667,10,6,4,0.6,0.7090909090909091,shc-gpt-4o,coral,pdac,PROMPT2_entailment
177,50,13,10,3,0.7692307692307693,10,6,4,0.6,0.6741573033707865,shc-gpt-4o,coral,pdac,PROMPT2_entailment
178,51,19,16,3,0.8421052631578947,12,10,2,0.8333333333333334,0.8376963350785339,shc-gpt-4o,coral,pdac,PROMPT2_entailment
179,52,16,13,3,0.8125,10,9,1,0.9,0.854014598540146,shc-gpt-4o,coral,pdac,PROMPT2_entailment
180,53,13,13,0,1.0,8,5,3,0.625,0.7692307692307693,shc-gpt-4o,coral,pdac,PROMPT2_entailment
181,54,5,5,0,1.0,2,2,0,1.0,1.0,shc-gpt-4o,coral,pdac,PROMPT2_entailment
182,55,25,23,2,0.92,10,8,2,0.8,0.8558139534883721,shc-gpt-4o,coral,pdac,PROMPT2_entailment
183,56,21,17,4,0.8095238095238095,8,7,1,0.875,0.8409893992932863,shc-gpt-4o,coral,pdac,PROMPT2_entailment
184,57,40,27,13,0.675,13,5,8,0.3846153846153846,0.4900181488203267,shc-gpt-4o,coral,pdac,PROMPT2_entailment
185,58,48,45,3,0.9375,10,10,0,1.0,0.967741935483871,shc-gpt-4o,coral,pdac,PROMPT2_entailment
186,59,44,35,9,0.7954545454545454,21,17,4,0.8095238095238095,0.8024275118004046,shc-gpt-4o,coral,pdac,PROMPT2_entailment
187,6,20,17,3,0.85,12,10,2,0.8333333333333334,0.8415841584158417,shc-gpt-4o,coral,pdac,PROMPT2_entailment
188,60,40,38,2,0.95,13,7,6,0.5384615384615384,0.6873385012919896,shc-gpt-4o,coral,pdac,PROMPT2_entailment
189,61,13,12,1,0.9230769230769232,7,7,0,1.0,0.96,shc-gpt-4o,coral,pdac,PROMPT2_entailment
190,62,22,15,7,0.6818181818181818,11,7,4,0.6363636363636364,0.658307210031348,shc-gpt-4o,coral,pdac,PROMPT2_entailment
191,63,12,12,0,1.0,10,10,0,1.0,1.0,shc-gpt-4o,coral,pdac,PROMPT2_entailment
192,64,17,16,1,0.9411764705882352,12,11,1,0.9166666666666666,0.9287598944591028,shc-gpt-4o,coral,pdac,PROMPT2_entailment
193,65,30,26,4,0.8666666666666667,9,9,0,1.0,0.9285714285714286,shc-gpt-4o,coral,pdac,PROMPT2_entailment
194,66,25,24,1,0.96,12,9,3,0.75,0.8421052631578947,shc-gpt-4o,coral,pdac,PROMPT2_entailment
195,67,7,7,0,1.0,1,1,0,1.0,1.0,shc-gpt-4o,coral,pdac,PROMPT2_entailment
196,68,19,16,3,0.8421052631578947,11,9,2,0.8181818181818182,0.829971181556196,shc-gpt-4o,coral,pdac,PROMPT2_entailment
197,69,24,22,2,0.9166666666666666,10,10,0,1.0,0.9565217391304348,shc-gpt-4o,coral,pdac,PROMPT2_entailment
198,7,15,15,0,1.0,11,9,2,0.8181818181818182,0.9,shc-gpt-4o,coral,pdac,PROMPT2_entailment
199,70,26,25,1,0.9615384615384616,15,12,3,0.8,0.8733624454148472,shc-gpt-4o,coral,pdac,PROMPT2_entailment
200,71,43,36,7,0.8372093023255814,9,8,1,0.8888888888888888,0.8622754491017963,shc-gpt-4o,coral,pdac,PROMPT2_entailment
201,72,47,34,13,0.723404255319149,13,12,1,0.9230769230769232,0.8111332007952287,shc-gpt-4o,coral,pdac,PROMPT2_entailment
202,73,172,25,147,0.1453488372093023,154,23,131,0.1493506493506493,0.1473225723802203,shc-gpt-4o,coral,pdac,PROMPT2_entailment
203,74,24,15,9,0.625,8,5,3,0.625,0.625,shc-gpt-4o,coral,pdac,PROMPT2_entailment
204,75,20,18,2,0.9,7,7,0,1.0,0.9473684210526316,shc-gpt-4o,coral,pdac,PROMPT2_entailment
205,76,13,13,0,1.0,7,7,0,1.0,1.0,shc-gpt-4o,coral,pdac,PROMPT2_entailment
206,77,22,17,5,0.7727272727272727,8,8,0,1.0,0.8717948717948718,shc-gpt-4o,coral,pdac,PROMPT2_entailment
207,78,14,12,2,0.8571428571428571,8,5,3,0.625,0.7228915662650602,shc-gpt-4o,coral,pdac,PROMPT2_entailment
208,79,22,21,1,0.9545454545454546,11,11,0,1.0,0.9767441860465116,shc-gpt-4o,coral,pdac,PROMPT2_entailment
209,8,13,13,0,1.0,2,2,0,1.0,1.0,shc-gpt-4o,coral,pdac,PROMPT2_entailment
210,80,30,24,6,0.8,9,6,3,0.6666666666666666,0.7272727272727272,shc-gpt-4o,coral,pdac,PROMPT2_entailment
211,81,18,17,1,0.9444444444444444,6,5,1,0.8333333333333334,0.8854166666666667,shc-gpt-4o,coral,pdac,PROMPT2_entailment
212,82,30,29,1,0.9666666666666668,4,3,1,0.75,0.8446601941747572,shc-gpt-4o,coral,pdac,PROMPT2_entailment
213,83,33,28,5,0.8484848484848485,11,6,5,0.5454545454545454,0.6640316205533596,shc-gpt-4o,coral,pdac,PROMPT2_entailment
214,84,23,17,6,0.7391304347826086,11,8,3,0.7272727272727273,0.7331536388140162,shc-gpt-4o,coral,pdac,PROMPT2_entailment
215,85,39,31,8,0.7948717948717948,35,19,16,0.5428571428571428,0.6451259583789705,shc-gpt-4o,coral,pdac,PROMPT2_entailment
216,86,17,15,2,0.8823529411764706,10,8,2,0.8,0.8391608391608392,shc-gpt-4o,coral,pdac,PROMPT2_entailment
217,87,22,18,4,0.8181818181818182,7,7,0,1.0,0.9,shc-gpt-4o,coral,pdac,PROMPT2_entailment
218,88,15,12,3,0.8,8,4,4,0.5,0.6153846153846154,shc-gpt-4o,coral,pdac,PROMPT2_entailment
219,89,21,18,3,0.8571428571428571,10,7,3,0.7,0.7706422018348624,shc-gpt-4o,coral,pdac,PROMPT2_entailment
220,9,17,17,0,1.0,12,10,2,0.8333333333333334,0.9090909090909092,shc-gpt-4o,coral,pdac,PROMPT2_entailment
221,90,20,15,5,0.75,9,9,0,1.0,0.8571428571428571,shc-gpt-4o,coral,pdac,PROMPT2_entailment
222,91,15,14,1,0.9333333333333332,10,9,1,0.9,0.9163636363636364,shc-gpt-4o,coral,pdac,PROMPT2_entailment
223,92,26,22,4,0.8461538461538461,10,9,1,0.9,0.8722466960352422,shc-gpt-4o,coral,pdac,PROMPT2_entailment
224,93,17,17,0,1.0,9,4,5,0.4444444444444444,0.6153846153846153,shc-gpt-4o,coral,pdac,PROMPT2_entailment
225,94,19,13,6,0.6842105263157895,7,5,2,0.7142857142857143,0.6989247311827957,shc-gpt-4o,coral,pdac,PROMPT2_entailment
226,95,18,14,4,0.7777777777777778,8,7,1,0.875,0.823529411764706,shc-gpt-4o,coral,pdac,PROMPT2_entailment
227,96,10,10,0,1.0,4,4,0,1.0,1.0,shc-gpt-4o,coral,pdac,PROMPT2_entailment
228,97,20,17,3,0.85,8,8,0,1.0,0.9189189189189187,shc-gpt-4o,coral,pdac,PROMPT2_entailment
229,98,27,26,1,0.9629629629629628,9,8,1,0.8888888888888888,0.9244444444444444,shc-gpt-4o,coral,pdac,PROMPT2_entailment
230,99,22,20,2,0.9090909090909092,9,8,1,0.8888888888888888,0.8988764044943819,shc-gpt-4o,coral,pdac,PROMPT2_entailment
0,0,15,15,0,1.0,10,10,0,1.0,1.0,shc-gpt-4o,coral,breastca,PROMPT1_entailment
1,1,15,13,2,0.8666666666666667,12,8,4,0.6666666666666666,0.7536231884057971,shc-gpt-4o,coral,breastca,PROMPT1_entailment
2,10,16,16,0,1.0,10,9,1,0.9,0.9473684210526316,shc-gpt-4o,coral,breastca,PROMPT1_entailment
3,100,14,12,2,0.8571428571428571,26,13,13,0.5,0.631578947368421,shc-gpt-4o,coral,breastca,PROMPT1_entailment
4,101,36,32,4,0.8888888888888888,18,14,4,0.7777777777777778,0.8296296296296296,shc-gpt-4o,coral,breastca,PROMPT1_entailment
5,102,7,7,0,1.0,7,6,1,0.8571428571428571,0.923076923076923,shc-gpt-4o,coral,breastca,PROMPT1_entailment
6,103,25,25,0,1.0,10,8,2,0.8,0.888888888888889,shc-gpt-4o,coral,breastca,PROMPT1_entailment
7,104,31,28,3,0.9032258064516128,26,19,7,0.7307692307692307,0.8078967350037964,shc-gpt-4o,coral,breastca,PROMPT1_entailment
8,105,18,18,0,1.0,15,14,1,0.9333333333333332,0.9655172413793104,shc-gpt-4o,coral,breastca,PROMPT1_entailment
9,106,14,14,0,1.0,9,7,2,0.7777777777777778,0.8750000000000001,shc-gpt-4o,coral,breastca,PROMPT1_entailment
10,107,14,13,1,0.9285714285714286,9,7,2,0.7777777777777778,0.8465116279069766,shc-gpt-4o,coral,breastca,PROMPT1_entailment
11,108,12,12,0,1.0,11,10,1,0.9090909090909092,0.9523809523809524,shc-gpt-4o,coral,breastca,PROMPT1_entailment
12,109,12,12,0,1.0,11,9,2,0.8181818181818182,0.9,shc-gpt-4o,coral,breastca,PROMPT1_entailment
13,11,10,10,0,1.0,3,3,0,1.0,1.0,shc-gpt-4o,coral,breastca,PROMPT1_entailment
14,110,14,14,0,1.0,11,9,2,0.8181818181818182,0.9,shc-gpt-4o,coral,breastca,PROMPT1_entailment
15,111,16,15,1,0.9375,10,7,3,0.7,0.8015267175572519,shc-gpt-4o,coral,breastca,PROMPT1_entailment
16,112,16,16,0,1.0,10,8,2,0.8,0.888888888888889,shc-gpt-4o,coral,breastca,PROMPT1_entailment
17,113,52,39,13,0.75,49,32,17,0.6530612244897959,0.6981818181818182,shc-gpt-4o,coral,breastca,PROMPT1_entailment
18,114,47,31,16,0.6595744680851063,21,7,14,0.3333333333333333,0.4428571428571429,shc-gpt-4o,coral,breastca,PROMPT1_entailment
19,115,21,19,2,0.9047619047619048,9,9,0,1.0,0.95,shc-gpt-4o,coral,breastca,PROMPT1_entailment
20,116,19,18,1,0.9473684210526316,14,12,2,0.8571428571428571,0.9,shc-gpt-4o,coral,breastca,PROMPT1_entailment
21,117,7,7,0,1.0,2,2,0,1.0,1.0,shc-gpt-4o,coral,breastca,PROMPT1_entailment
22,118,22,16,6,0.7272727272727273,19,10,9,0.5263157894736842,0.6106870229007633,shc-gpt-4o,coral,breastca,PROMPT1_entailment
23,119,13,13,0,1.0,10,10,0,1.0,1.0,shc-gpt-4o,coral,breastca,PROMPT1_entailment
24,12,13,13,0,1.0,10,9,1,0.9,0.9473684210526316,shc-gpt-4o,coral,breastca,PROMPT1_entailment
25,120,21,21,0,1.0,9,9,0,1.0,1.0,shc-gpt-4o,coral,breastca,PROMPT1_entailment
26,121,21,19,2,0.9047619047619048,10,10,0,1.0,0.95,shc-gpt-4o,coral,breastca,PROMPT1_entailment
27,122,19,19,0,1.0,9,8,1,0.8888888888888888,0.9411764705882352,shc-gpt-4o,coral,breastca,PROMPT1_entailment
28,123,14,14,0,1.0,8,8,0,1.0,1.0,shc-gpt-4o,coral,breastca,PROMPT1_entailment
29,124,14,14,0,1.0,10,10,0,1.0,1.0,shc-gpt-4o,coral,breastca,PROMPT1_entailment
30,125,21,21,0,1.0,11,8,3,0.7272727272727273,0.8421052631578948,shc-gpt-4o,coral,breastca,PROMPT1_entailment
31,126,11,11,0,1.0,10,10,0,1.0,1.0,shc-gpt-4o,coral,breastca,PROMPT1_entailment
32,127,17,17,0,1.0,10,8,2,0.8,0.888888888888889,shc-gpt-4o,coral,breastca,PROMPT1_entailment
33,128,21,21,0,1.0,11,10,1,0.9090909090909092,0.9523809523809524,shc-gpt-4o,coral,breastca,PROMPT1_entailment
34,129,19,18,1,0.9473684210526316,11,8,3,0.7272727272727273,0.8228571428571427,shc-gpt-4o,coral,breastca,PROMPT1_entailment
35,13,18,17,1,0.9444444444444444,10,8,2,0.8,0.8662420382165604,shc-gpt-4o,coral,breastca,PROMPT1_entailment
36,130,14,13,1,0.9285714285714286,7,6,1,0.8571428571428571,0.8914285714285715,shc-gpt-4o,coral,breastca,PROMPT1_entailment
37,131,30,29,1,0.9666666666666668,10,10,0,1.0,0.983050847457627,shc-gpt-4o,coral,breastca,PROMPT1_entailment
38,132,13,13,0,1.0,8,8,0,1.0,1.0,shc-gpt-4o,coral,breastca,PROMPT1_entailment
39,133,35,27,8,0.7714285714285715,29,9,20,0.3103448275862069,0.4426229508196721,shc-gpt-4o,coral,breastca,PROMPT1_entailment
40,134,15,12,3,0.8,11,8,3,0.7272727272727273,0.761904761904762,shc-gpt-4o,coral,breastca,PROMPT1_entailment
41,135,19,17,2,0.8947368421052632,16,9,7,0.5625,0.6907449209932279,shc-gpt-4o,coral,breastca,PROMPT1_entailment
42,136,20,18,2,0.9,10,9,1,0.9,0.9,shc-gpt-4o,coral,breastca,PROMPT1_entailment
43,137,14,13,1,0.9285714285714286,10,10,0,1.0,0.962962962962963,shc-gpt-4o,coral,breastca,PROMPT1_entailment
44,138,13,13,0,1.0,10,10,0,1.0,1.0,shc-gpt-4o,coral,breastca,PROMPT1_entailment
45,139,20,20,0,1.0,11,7,4,0.6363636363636364,0.7777777777777778,shc-gpt-4o,coral,breastca,PROMPT1_entailment
46,14,13,10,3,0.7692307692307693,59,32,27,0.5423728813559322,0.6361829025844931,shc-gpt-4o,coral,breastca,PROMPT1_entailment
47,140,12,12,0,1.0,9,8,1,0.8888888888888888,0.9411764705882352,shc-gpt-4o,coral,breastca,PROMPT1_entailment
48,141,4,4,0,1.0,11,10,1,0.9090909090909092,0.9523809523809524,shc-gpt-4o,coral,breastca,PROMPT1_entailment
49,142,6,6,0,1.0,10,10,0,1.0,1.0,shc-gpt-4o,coral,breastca,PROMPT1_entailment
50,143,10,10,0,1.0,10,7,3,0.7,0.8235294117647058,shc-gpt-4o,coral,breastca,PROMPT1_entailment
51,144,8,8,0,1.0,5,4,1,0.8,0.888888888888889,shc-gpt-4o,coral,breastca,PROMPT1_entailment
52,145,12,12,0,1.0,5,4,1,0.8,0.888888888888889,shc-gpt-4o,coral,breastca,PROMPT1_entailment
53,146,13,12,1,0.9230769230769232,9,7,2,0.7777777777777778,0.8442211055276381,shc-gpt-4o,coral,breastca,PROMPT1_entailment
54,147,9,8,1,0.8888888888888888,5,4,1,0.8,0.8421052631578948,shc-gpt-4o,coral,breastca,PROMPT1_entailment
55,148,26,24,2,0.9230769230769232,4,2,2,0.5,0.6486486486486487,shc-gpt-4o,coral,breastca,PROMPT1_entailment
56,149,10,10,0,1.0,1,1,0,1.0,1.0,shc-gpt-4o,coral,breastca,PROMPT1_entailment
57,15,7,7,0,1.0,16,9,7,0.5625,0.72,shc-gpt-4o,coral,breastca,PROMPT1_entailment
58,150,8,6,2,0.75,2,2,0,1.0,0.8571428571428571,shc-gpt-4o,coral,breastca,PROMPT1_entailment
59,151,12,12,0,1.0,9,8,1,0.8888888888888888,0.9411764705882352,shc-gpt-4o,coral,breastca,PROMPT1_entailment
60,152,12,12,0,1.0,16,10,6,0.625,0.7692307692307693,shc-gpt-4o,coral,breastca,PROMPT1_entailment
61,153,10,10,0,1.0,1,1,0,1.0,1.0,shc-gpt-4o,coral,breastca,PROMPT1_entailment
62,154,16,15,1,0.9375,10,7,3,0.7,0.8015267175572519,shc-gpt-4o,coral,breastca,PROMPT1_entailment
63,155,28,27,1,0.9642857142857144,9,9,0,1.0,0.9818181818181818,shc-gpt-4o,coral,breastca,PROMPT1_entailment
64,156,20,19,1,0.95,8,8,0,1.0,0.9743589743589745,shc-gpt-4o,coral,breastca,PROMPT1_entailment
65,157,14,14,0,1.0,9,9,0,1.0,1.0,shc-gpt-4o,coral,breastca,PROMPT1_entailment
66,158,30,23,7,0.7666666666666667,16,16,0,1.0,0.8679245283018869,shc-gpt-4o,coral,breastca,PROMPT1_entailment
67,159,7,6,1,0.8571428571428571,29,16,13,0.5517241379310345,0.6713286713286714,shc-gpt-4o,coral,breastca,PROMPT1_entailment
68,16,20,20,0,1.0,10,8,2,0.8,0.888888888888889,shc-gpt-4o,coral,breastca,PROMPT1_entailment
69,160,11,8,3,0.7272727272727273,18,13,5,0.7222222222222222,0.7247386759581883,shc-gpt-4o,coral,breastca,PROMPT1_entailment
70,161,25,21,4,0.84,11,11,0,1.0,0.9130434782608696,shc-gpt-4o,coral,breastca,PROMPT1_entailment
71,162,15,15,0,1.0,16,14,2,0.875,0.9333333333333332,shc-gpt-4o,coral,breastca,PROMPT1_entailment
72,163,12,12,0,1.0,11,10,1,0.9090909090909092,0.9523809523809524,shc-gpt-4o,coral,breastca,PROMPT1_entailment
73,164,17,16,1,0.9411764705882352,8,6,2,0.75,0.8347826086956521,shc-gpt-4o,coral,breastca,PROMPT1_entailment
74,165,25,23,2,0.92,12,8,4,0.6666666666666666,0.7731092436974789,shc-gpt-4o,coral,breastca,PROMPT1_entailment
75,166,13,12,1,0.9230769230769232,10,4,6,0.4,0.5581395348837209,shc-gpt-4o,coral,breastca,PROMPT1_entailment
76,167,12,10,2,0.8333333333333334,7,6,1,0.8571428571428571,0.8450704225352113,shc-gpt-4o,coral,breastca,PROMPT1_entailment
77,168,10,8,2,0.8,7,5,2,0.7142857142857143,0.7547169811320756,shc-gpt-4o,coral,breastca,PROMPT1_entailment
78,169,16,14,2,0.875,11,9,2,0.8181818181818182,0.8456375838926175,shc-gpt-4o,coral,breastca,PROMPT1_entailment
79,17,7,7,0,1.0,3,3,0,1.0,1.0,shc-gpt-4o,coral,breastca,PROMPT1_entailment
80,170,14,14,0,1.0,10,10,0,1.0,1.0,shc-gpt-4o,coral,breastca,PROMPT1_entailment
81,171,23,22,1,0.9565217391304348,9,9,0,1.0,0.9777777777777776,shc-gpt-4o,coral,breastca,PROMPT1_entailment
82,172,23,19,4,0.8260869565217391,32,19,13,0.59375,0.6909090909090908,shc-gpt-4o,coral,breastca,PROMPT1_entailment
83,173,12,12,0,1.0,11,9,2,0.8181818181818182,0.9,shc-gpt-4o,coral,breastca,PROMPT1_entailment
84,174,10,10,0,1.0,7,6,1,0.8571428571428571,0.923076923076923,shc-gpt-4o,coral,breastca,PROMPT1_entailment
85,175,9,8,1,0.8888888888888888,10,9,1,0.9,0.8944099378881988,shc-gpt-4o,coral,breastca,PROMPT1_entailment
86,176,15,15,0,1.0,10,10,0,1.0,1.0,shc-gpt-4o,coral,breastca,PROMPT1_entailment
87,177,15,15,0,1.0,9,7,2,0.7777777777777778,0.8750000000000001,shc-gpt-4o,coral,breastca,PROMPT1_entailment
88,178,20,20,0,1.0,10,9,1,0.9,0.9473684210526316,shc-gpt-4o,coral,breastca,PROMPT1_entailment
89,179,10,10,0,1.0,9,7,2,0.7777777777777778,0.8750000000000001,shc-gpt-4o,coral,breastca,PROMPT1_entailment
90,18,15,15,0,1.0,8,8,0,1.0,1.0,shc-gpt-4o,coral,breastca,PROMPT1_entailment
91,180,16,15,1,0.9375,10,9,1,0.9,0.9183673469387756,shc-gpt-4o,coral,breastca,PROMPT1_entailment
92,181,13,13,0,1.0,9,7,2,0.7777777777777778,0.8750000000000001,shc-gpt-4o,coral,breastca,PROMPT1_entailment
93,182,14,14,0,1.0,9,9,0,1.0,1.0,shc-gpt-4o,coral,breastca,PROMPT1_entailment
94,183,12,12,0,1.0,10,8,2,0.8,0.888888888888889,shc-gpt-4o,coral,breastca,PROMPT1_entailment
95,184,19,18,1,0.9473684210526316,9,8,1,0.8888888888888888,0.9171974522292994,shc-gpt-4o,coral,breastca,PROMPT1_entailment
96,185,5,5,0,1.0,10,9,1,0.9,0.9473684210526316,shc-gpt-4o,coral,breastca,PROMPT1_entailment
97,186,10,10,0,1.0,5,5,0,1.0,1.0,shc-gpt-4o,coral,breastca,PROMPT1_entailment
98,187,11,9,2,0.8181818181818182,26,19,7,0.7307692307692307,0.7720090293453725,shc-gpt-4o,coral,breastca,PROMPT1_entailment
99,188,13,12,1,0.9230769230769232,9,9,0,1.0,0.96,shc-gpt-4o,coral,breastca,PROMPT1_entailment
100,189,16,16,0,1.0,9,8,1,0.8888888888888888,0.9411764705882352,shc-gpt-4o,coral,breastca,PROMPT1_entailment
101,19,12,12,0,1.0,8,7,1,0.875,0.9333333333333332,shc-gpt-4o,coral,breastca,PROMPT1_entailment
102,190,53,16,37,0.3018867924528302,34,11,23,0.3235294117647059,0.3123336291038154,shc-gpt-4o,coral,breastca,PROMPT1_entailment
103,191,25,21,4,0.84,14,11,3,0.7857142857142857,0.8119507908611598,shc-gpt-4o,coral,breastca,PROMPT1_entailment
104,192,14,14,0,1.0,12,9,3,0.75,0.8571428571428571,shc-gpt-4o,coral,breastca,PROMPT1_entailment
105,193,15,15,0,1.0,2,1,1,0.5,0.6666666666666666,shc-gpt-4o,coral,breastca,PROMPT1_entailment
106,194,29,28,1,0.9655172413793104,15,12,3,0.8,0.8750000000000001,shc-gpt-4o,coral,breastca,PROMPT1_entailment
107,195,10,10,0,1.0,13,11,2,0.8461538461538461,0.9166666666666666,shc-gpt-4o,coral,breastca,PROMPT1_entailment
108,196,38,30,8,0.7894736842105263,30,22,8,0.7333333333333333,0.76036866359447,shc-gpt-4o,coral,breastca,PROMPT1_entailment
109,197,27,27,0,1.0,14,11,3,0.7857142857142857,0.88,shc-gpt-4o,coral,breastca,PROMPT1_entailment
110,198,21,20,1,0.9523809523809524,11,10,1,0.9090909090909092,0.9302325581395348,shc-gpt-4o,coral,breastca,PROMPT1_entailment
111,199,5,5,0,1.0,2,2,0,1.0,1.0,shc-gpt-4o,coral,breastca,PROMPT1_entailment
112,2,22,16,6,0.7272727272727273,10,9,1,0.9,0.8044692737430167,shc-gpt-4o,coral,breastca,PROMPT1_entailment
113,20,14,13,1,0.9285714285714286,17,8,9,0.4705882352941176,0.6246246246246246,shc-gpt-4o,coral,breastca,PROMPT1_entailment
114,200,13,11,2,0.8461538461538461,15,12,3,0.8,0.8224299065420562,shc-gpt-4o,coral,breastca,PROMPT1_entailment
115,201,28,20,8,0.7142857142857143,26,17,9,0.6538461538461539,0.6827309236947792,shc-gpt-4o,coral,breastca,PROMPT1_entailment
116,202,33,27,6,0.8181818181818182,17,17,0,1.0,0.9,shc-gpt-4o,coral,breastca,PROMPT1_entailment
117,203,23,17,6,0.7391304347826086,27,16,11,0.5925925925925926,0.6577992744860943,shc-gpt-4o,coral,breastca,PROMPT1_entailment
118,204,13,13,0,1.0,11,9,2,0.8181818181818182,0.9,shc-gpt-4o,coral,breastca,PROMPT1_entailment
119,205,11,11,0,1.0,11,11,0,1.0,1.0,shc-gpt-4o,coral,breastca,PROMPT1_entailment
120,206,9,9,0,1.0,4,4,0,1.0,1.0,shc-gpt-4o,coral,breastca,PROMPT1_entailment
121,207,19,19,0,1.0,12,10,2,0.8333333333333334,0.9090909090909092,shc-gpt-4o,coral,breastca,PROMPT1_entailment
122,208,13,13,0,1.0,9,9,0,1.0,1.0,shc-gpt-4o,coral,breastca,PROMPT1_entailment
123,209,4,4,0,1.0,11,5,6,0.4545454545454545,0.625,shc-gpt-4o,coral,breastca,PROMPT1_entailment
124,21,13,11,2,0.8461538461538461,27,17,10,0.6296296296296297,0.7220077220077219,shc-gpt-4o,coral,breastca,PROMPT1_entailment
125,210,26,22,4,0.8461538461538461,13,10,3,0.7692307692307693,0.8058608058608059,shc-gpt-4o,coral,breastca,PROMPT1_entailment
126,211,13,10,3,0.7692307692307693,11,6,5,0.5454545454545454,0.6382978723404256,shc-gpt-4o,coral,breastca,PROMPT1_entailment
127,212,12,12,0,1.0,9,8,1,0.8888888888888888,0.9411764705882352,shc-gpt-4o,coral,breastca,PROMPT1_entailment
128,213,10,9,1,0.9,11,10,1,0.9090909090909092,0.9045226130653266,shc-gpt-4o,coral,breastca,PROMPT1_entailment
129,214,9,5,4,0.5555555555555556,28,15,13,0.5357142857142857,0.5454545454545454,shc-gpt-4o,coral,breastca,PROMPT1_entailment
130,215,7,6,1,0.8571428571428571,37,22,15,0.5945945945945946,0.7021276595744681,shc-gpt-4o,coral,breastca,PROMPT1_entailment
131,216,31,29,2,0.935483870967742,15,13,2,0.8666666666666667,0.8997613365155132,shc-gpt-4o,coral,breastca,PROMPT1_entailment
132,22,15,11,4,0.7333333333333333,7,3,4,0.4285714285714285,0.540983606557377,shc-gpt-4o,coral,breastca,PROMPT1_entailment
133,23,16,16,0,1.0,9,6,3,0.6666666666666666,0.8,shc-gpt-4o,coral,breastca,PROMPT1_entailment
134,24,12,11,1,0.9166666666666666,10,8,2,0.8,0.854368932038835,shc-gpt-4o,coral,breastca,PROMPT1_entailment
135,25,15,15,0,1.0,8,8,0,1.0,1.0,shc-gpt-4o,coral,breastca,PROMPT1_entailment
136,26,19,19,0,1.0,11,10,1,0.9090909090909092,0.9523809523809524,shc-gpt-4o,coral,breastca,PROMPT1_entailment
137,27,24,24,0,1.0,12,10,2,0.8333333333333334,0.9090909090909092,shc-gpt-4o,coral,breastca,PROMPT1_entailment
138,28,18,18,0,1.0,18,15,3,0.8333333333333334,0.9090909090909092,shc-gpt-4o,coral,breastca,PROMPT1_entailment
139,29,9,8,1,0.8888888888888888,9,5,4,0.5555555555555556,0.6837606837606838,shc-gpt-4o,coral,breastca,PROMPT1_entailment
140,3,14,9,5,0.6428571428571429,11,9,2,0.8181818181818182,0.7200000000000001,shc-gpt-4o,coral,breastca,PROMPT1_entailment
141,30,22,15,7,0.6818181818181818,18,8,10,0.4444444444444444,0.538116591928251,shc-gpt-4o,coral,breastca,PROMPT1_entailment
142,31,15,14,1,0.9333333333333332,13,9,4,0.6923076923076923,0.7949526813880127,shc-gpt-4o,coral,breastca,PROMPT1_entailment
143,32,11,11,0,1.0,9,7,2,0.7777777777777778,0.8750000000000001,shc-gpt-4o,coral,breastca,PROMPT1_entailment
144,33,12,12,0,1.0,8,6,2,0.75,0.8571428571428571,shc-gpt-4o,coral,breastca,PROMPT1_entailment
145,34,8,8,0,1.0,10,8,2,0.8,0.888888888888889,shc-gpt-4o,coral,breastca,PROMPT1_entailment
146,35,21,21,0,1.0,12,11,1,0.9166666666666666,0.9565217391304348,shc-gpt-4o,coral,breastca,PROMPT1_entailment
147,36,16,16,0,1.0,11,10,1,0.9090909090909092,0.9523809523809524,shc-gpt-4o,coral,breastca,PROMPT1_entailment
148,37,16,16,0,1.0,11,9,2,0.8181818181818182,0.9,shc-gpt-4o,coral,breastca,PROMPT1_entailment
149,38,24,24,0,1.0,11,9,2,0.8181818181818182,0.9,shc-gpt-4o,coral,breastca,PROMPT1_entailment
150,39,14,14,0,1.0,11,9,2,0.8181818181818182,0.9,shc-gpt-4o,coral,breastca,PROMPT1_entailment
151,4,66,32,34,0.4848484848484848,59,25,34,0.423728813559322,0.4522328999434709,shc-gpt-4o,coral,breastca,PROMPT1_entailment
152,40,15,15,0,1.0,9,9,0,1.0,1.0,shc-gpt-4o,coral,breastca,PROMPT1_entailment
153,41,30,27,3,0.9,14,11,3,0.7857142857142857,0.8389830508474577,shc-gpt-4o,coral,breastca,PROMPT1_entailment
154,42,21,19,2,0.9047619047619048,9,8,1,0.8888888888888888,0.8967551622418879,shc-gpt-4o,coral,breastca,PROMPT1_entailment
155,43,15,15,0,1.0,9,7,2,0.7777777777777778,0.8750000000000001,shc-gpt-4o,coral,breastca,PROMPT1_entailment
156,44,14,14,0,1.0,9,9,0,1.0,1.0,shc-gpt-4o,coral,breastca,PROMPT1_entailment
157,45,5,5,0,1.0,2,2,0,1.0,1.0,shc-gpt-4o,coral,breastca,PROMPT1_entailment
158,46,20,20,0,1.0,5,5,0,1.0,1.0,shc-gpt-4o,coral,breastca,PROMPT1_entailment
159,47,14,13,1,0.9285714285714286,2,2,0,1.0,0.962962962962963,shc-gpt-4o,coral,breastca,PROMPT1_entailment
160,48,9,9,0,1.0,5,4,1,0.8,0.888888888888889,shc-gpt-4o,coral,breastca,PROMPT1_entailment
161,49,18,17,1,0.9444444444444444,16,10,6,0.625,0.752212389380531,shc-gpt-4o,coral,breastca,PROMPT1_entailment
162,5,40,33,7,0.825,12,9,3,0.75,0.7857142857142856,shc-gpt-4o,coral,breastca,PROMPT1_entailment
163,50,29,17,12,0.5862068965517241,16,10,6,0.625,0.6049822064056939,shc-gpt-4o,coral,breastca,PROMPT1_entailment
164,51,39,37,2,0.9487179487179488,11,8,3,0.7272727272727273,0.82336578581363,shc-gpt-4o,coral,breastca,PROMPT1_entailment
165,52,19,19,0,1.0,10,10,0,1.0,1.0,shc-gpt-4o,coral,breastca,PROMPT1_entailment
166,53,18,16,2,0.8888888888888888,10,10,0,1.0,0.9411764705882352,shc-gpt-4o,coral,breastca,PROMPT1_entailment
167,54,19,19,0,1.0,9,9,0,1.0,1.0,shc-gpt-4o,coral,breastca,PROMPT1_entailment
168,55,2,2,0,1.0,1,1,0,1.0,1.0,shc-gpt-4o,coral,breastca,PROMPT1_entailment
169,56,10,10,0,1.0,18,10,8,0.5555555555555556,0.7142857142857143,shc-gpt-4o,coral,breastca,PROMPT1_entailment
170,57,24,22,2,0.9166666666666666,10,9,1,0.9,0.908256880733945,shc-gpt-4o,coral,breastca,PROMPT1_entailment
171,58,20,20,0,1.0,10,10,0,1.0,1.0,shc-gpt-4o,coral,breastca,PROMPT1_entailment
172,59,19,18,1,0.9473684210526316,9,7,2,0.7777777777777778,0.8542372881355932,shc-gpt-4o,coral,breastca,PROMPT1_entailment
173,6,11,11,0,1.0,8,6,2,0.75,0.8571428571428571,shc-gpt-4o,coral,breastca,PROMPT1_entailment
174,60,17,17,0,1.0,10,10,0,1.0,1.0,shc-gpt-4o,coral,breastca,PROMPT1_entailment
175,61,17,17,0,1.0,11,10,1,0.9090909090909092,0.9523809523809524,shc-gpt-4o,coral,breastca,PROMPT1_entailment
176,62,19,19,0,1.0,10,8,2,0.8,0.888888888888889,shc-gpt-4o,coral,breastca,PROMPT1_entailment
177,63,14,14,0,1.0,11,9,2,0.8181818181818182,0.9,shc-gpt-4o,coral,breastca,PROMPT1_entailment
178,64,11,10,1,0.9090909090909092,17,10,7,0.5882352941176471,0.7142857142857143,shc-gpt-4o,coral,breastca,PROMPT1_entailment
179,65,19,18,1,0.9473684210526316,6,6,0,1.0,0.972972972972973,shc-gpt-4o,coral,breastca,PROMPT1_entailment
180,66,17,16,1,0.9411764705882352,10,10,0,1.0,0.9696969696969696,shc-gpt-4o,coral,breastca,PROMPT1_entailment
181,67,46,21,25,0.4565217391304347,49,16,33,0.3265306122448979,0.3807365439093484,shc-gpt-4o,coral,breastca,PROMPT1_entailment
182,68,14,14,0,1.0,8,7,1,0.875,0.9333333333333332,shc-gpt-4o,coral,breastca,PROMPT1_entailment
183,69,19,15,4,0.7894736842105263,12,2,10,0.1666666666666666,0.2752293577981651,shc-gpt-4o,coral,breastca,PROMPT1_entailment
184,7,12,12,0,1.0,11,10,1,0.9090909090909092,0.9523809523809524,shc-gpt-4o,coral,breastca,PROMPT1_entailment
185,70,91,53,38,0.5824175824175825,51,19,32,0.3725490196078431,0.4544223826714801,shc-gpt-4o,coral,breastca,PROMPT1_entailment
186,71,8,8,0,1.0,5,5,0,1.0,1.0,shc-gpt-4o,coral,breastca,PROMPT1_entailment
187,72,11,11,0,1.0,3,2,1,0.6666666666666666,0.8,shc-gpt-4o,coral,breastca,PROMPT1_entailment
188,73,10,10,0,1.0,1,1,0,1.0,1.0,shc-gpt-4o,coral,breastca,PROMPT1_entailment
189,74,10,9,1,0.9,2,1,1,0.5,0.6428571428571429,shc-gpt-4o,coral,breastca,PROMPT1_entailment
190,75,9,9,0,1.0,6,6,0,1.0,1.0,shc-gpt-4o,coral,breastca,PROMPT1_entailment
191,76,13,12,1,0.9230769230769232,7,7,0,1.0,0.96,shc-gpt-4o,coral,breastca,PROMPT1_entailment
192,77,22,22,0,1.0,15,13,2,0.8666666666666667,0.9285714285714286,shc-gpt-4o,coral,breastca,PROMPT1_entailment
193,78,16,15,1,0.9375,8,8,0,1.0,0.967741935483871,shc-gpt-4o,coral,breastca,PROMPT1_entailment
194,79,11,11,0,1.0,8,8,0,1.0,1.0,shc-gpt-4o,coral,breastca,PROMPT1_entailment
195,8,9,8,1,0.8888888888888888,9,7,2,0.7777777777777778,0.8296296296296296,shc-gpt-4o,coral,breastca,PROMPT1_entailment
196,80,35,34,1,0.9714285714285714,24,14,10,0.5833333333333334,0.7289433384379785,shc-gpt-4o,coral,breastca,PROMPT1_entailment
197,81,8,8,0,1.0,11,10,1,0.9090909090909092,0.9523809523809524,shc-gpt-4o,coral,breastca,PROMPT1_entailment
198,82,13,12,1,0.9230769230769232,6,5,1,0.8333333333333334,0.8759124087591241,shc-gpt-4o,coral,breastca,PROMPT1_entailment
199,83,15,15,0,1.0,6,6,0,1.0,1.0,shc-gpt-4o,coral,breastca,PROMPT1_entailment
200,84,23,20,3,0.8695652173913043,11,10,1,0.9090909090909092,0.888888888888889,shc-gpt-4o,coral,breastca,PROMPT1_entailment
201,85,12,12,0,1.0,7,7,0,1.0,1.0,shc-gpt-4o,coral,breastca,PROMPT1_entailment
202,86,19,14,5,0.7368421052631579,16,14,2,0.875,0.7999999999999999,shc-gpt-4o,coral,breastca,PROMPT1_entailment
203,87,12,12,0,1.0,8,7,1,0.875,0.9333333333333332,shc-gpt-4o,coral,breastca,PROMPT1_entailment
204,88,7,7,0,1.0,8,7,1,0.875,0.9333333333333332,shc-gpt-4o,coral,breastca,PROMPT1_entailment
205,89,4,4,0,1.0,11,8,3,0.7272727272727273,0.8421052631578948,shc-gpt-4o,coral,breastca,PROMPT1_entailment
206,9,12,11,1,0.9166666666666666,6,6,0,1.0,0.9565217391304348,shc-gpt-4o,coral,breastca,PROMPT1_entailment
207,90,9,7,2,0.7777777777777778,17,11,6,0.6470588235294118,0.7064220183486238,shc-gpt-4o,coral,breastca,PROMPT1_entailment
208,91,15,13,2,0.8666666666666667,7,6,1,0.8571428571428571,0.861878453038674,shc-gpt-4o,coral,breastca,PROMPT1_entailment
209,92,10,10,0,1.0,2,2,0,1.0,1.0,shc-gpt-4o,coral,breastca,PROMPT1_entailment
210,93,21,19,2,0.9047619047619048,13,11,2,0.8461538461538461,0.8744769874476986,shc-gpt-4o,coral,breastca,PROMPT1_entailment
211,94,34,20,14,0.5882352941176471,25,17,8,0.68,0.6307977736549165,shc-gpt-4o,coral,breastca,PROMPT1_entailment
212,95,9,9,0,1.0,13,10,3,0.7692307692307693,0.8695652173913044,shc-gpt-4o,coral,breastca,PROMPT1_entailment
213,96,17,15,2,0.8823529411764706,10,8,2,0.8,0.8391608391608392,shc-gpt-4o,coral,breastca,PROMPT1_entailment
214,97,15,15,0,1.0,11,8,3,0.7272727272727273,0.8421052631578948,shc-gpt-4o,coral,breastca,PROMPT1_entailment
215,98,6,6,0,1.0,2,2,0,1.0,1.0,shc-gpt-4o,coral,breastca,PROMPT1_entailment
216,99,16,15,1,0.9375,15,13,2,0.8666666666666667,0.9006928406466512,shc-gpt-4o,coral,breastca,PROMPT1_entailment
0,0,30,30,0,1.0,10,10,0,1.0,1.0,shc-gpt-4o,coral,breastca,PROMPT1_ICL_entailment
1,1,57,46,11,0.8070175438596491,12,11,1,0.9166666666666666,0.8583545377438507,shc-gpt-4o,coral,breastca,PROMPT1_ICL_entailment
2,10,21,19,2,0.9047619047619048,10,9,1,0.9,0.9023746701846964,shc-gpt-4o,coral,breastca,PROMPT1_ICL_entailment
3,100,43,35,8,0.813953488372093,26,14,12,0.5384615384615384,0.6481481481481481,shc-gpt-4o,coral,breastca,PROMPT1_ICL_entailment
4,101,65,64,1,0.9846153846153848,18,15,3,0.8333333333333334,0.9026798307475318,shc-gpt-4o,coral,breastca,PROMPT1_ICL_entailment
5,102,15,15,0,1.0,7,6,1,0.8571428571428571,0.923076923076923,shc-gpt-4o,coral,breastca,PROMPT1_ICL_entailment
6,103,53,51,2,0.9622641509433962,10,10,0,1.0,0.9807692307692308,shc-gpt-4o,coral,breastca,PROMPT1_ICL_entailment
7,104,72,58,14,0.8055555555555556,26,20,6,0.7692307692307693,0.7869742198100407,shc-gpt-4o,coral,breastca,PROMPT1_ICL_entailment
8,105,26,25,1,0.9615384615384616,15,14,1,0.9333333333333332,0.9472259810554804,shc-gpt-4o,coral,breastca,PROMPT1_ICL_entailment
9,106,26,25,1,0.9615384615384616,9,9,0,1.0,0.9803921568627452,shc-gpt-4o,coral,breastca,PROMPT1_ICL_entailment
10,107,21,17,4,0.8095238095238095,9,7,2,0.7777777777777778,0.7933333333333333,shc-gpt-4o,coral,breastca,PROMPT1_ICL_entailment
11,108,20,20,0,1.0,11,10,1,0.9090909090909092,0.9523809523809524,shc-gpt-4o,coral,breastca,PROMPT1_ICL_entailment
12,109,21,20,1,0.9523809523809524,11,11,0,1.0,0.975609756097561,shc-gpt-4o,coral,breastca,PROMPT1_ICL_entailment
13,11,18,13,5,0.7222222222222222,3,3,0,1.0,0.8387096774193548,shc-gpt-4o,coral,breastca,PROMPT1_ICL_entailment
14,110,15,14,1,0.9333333333333332,11,10,1,0.9090909090909092,0.9210526315789476,shc-gpt-4o,coral,breastca,PROMPT1_ICL_entailment
15,111,22,18,4,0.8181818181818182,10,8,2,0.8,0.8089887640449439,shc-gpt-4o,coral,breastca,PROMPT1_ICL_entailment
16,112,22,21,1,0.9545454545454546,10,9,1,0.9,0.9264705882352942,shc-gpt-4o,coral,breastca,PROMPT1_ICL_entailment
17,113,91,61,30,0.6703296703296703,49,30,19,0.6122448979591837,0.6399720230809581,shc-gpt-4o,coral,breastca,PROMPT1_ICL_entailment
18,114,52,43,9,0.8269230769230769,21,14,7,0.6666666666666666,0.7381974248927038,shc-gpt-4o,coral,breastca,PROMPT1_ICL_entailment
19,115,22,20,2,0.9090909090909092,9,7,2,0.7777777777777778,0.8383233532934132,shc-gpt-4o,coral,breastca,PROMPT1_ICL_entailment
20,116,36,32,4,0.8888888888888888,14,9,5,0.6428571428571429,0.7461139896373057,shc-gpt-4o,coral,breastca,PROMPT1_ICL_entailment
21,117,10,9,1,0.9,2,2,0,1.0,0.9473684210526316,shc-gpt-4o,coral,breastca,PROMPT1_ICL_entailment
22,118,15,15,0,1.0,19,13,6,0.6842105263157895,0.8125000000000001,shc-gpt-4o,coral,breastca,PROMPT1_ICL_entailment
23,119,20,18,2,0.9,10,9,1,0.9,0.9,shc-gpt-4o,coral,breastca,PROMPT1_ICL_entailment
24,12,27,26,1,0.9629629629629628,10,10,0,1.0,0.981132075471698,shc-gpt-4o,coral,breastca,PROMPT1_ICL_entailment
25,120,27,25,2,0.925925925925926,9,9,0,1.0,0.9615384615384616,shc-gpt-4o,coral,breastca,PROMPT1_ICL_entailment
26,121,32,29,3,0.90625,10,10,0,1.0,0.9508196721311476,shc-gpt-4o,coral,breastca,PROMPT1_ICL_entailment
27,122,26,23,3,0.8846153846153846,9,9,0,1.0,0.9387755102040816,shc-gpt-4o,coral,breastca,PROMPT1_ICL_entailment
28,123,24,24,0,1.0,8,8,0,1.0,1.0,shc-gpt-4o,coral,breastca,PROMPT1_ICL_entailment
29,124,21,20,1,0.9523809523809524,10,8,2,0.8,0.8695652173913043,shc-gpt-4o,coral,breastca,PROMPT1_ICL_entailment
30,125,26,25,1,0.9615384615384616,11,10,1,0.9090909090909092,0.9345794392523366,shc-gpt-4o,coral,breastca,PROMPT1_ICL_entailment
31,126,16,15,1,0.9375,10,10,0,1.0,0.967741935483871,shc-gpt-4o,coral,breastca,PROMPT1_ICL_entailment
32,127,25,23,2,0.92,10,10,0,1.0,0.9583333333333334,shc-gpt-4o,coral,breastca,PROMPT1_ICL_entailment
33,128,32,30,2,0.9375,11,8,3,0.7272727272727273,0.8191126279863482,shc-gpt-4o,coral,breastca,PROMPT1_ICL_entailment
34,129,28,24,4,0.8571428571428571,11,7,4,0.6363636363636364,0.7304347826086957,shc-gpt-4o,coral,breastca,PROMPT1_ICL_entailment
35,13,21,17,4,0.8095238095238095,10,9,1,0.9,0.8523676880222841,shc-gpt-4o,coral,breastca,PROMPT1_ICL_entailment
36,130,13,12,1,0.9230769230769232,7,6,1,0.8571428571428571,0.888888888888889,shc-gpt-4o,coral,breastca,PROMPT1_ICL_entailment
37,131,53,49,4,0.9245283018867924,10,10,0,1.0,0.9607843137254902,shc-gpt-4o,coral,breastca,PROMPT1_ICL_entailment
38,132,20,18,2,0.9,8,8,0,1.0,0.9473684210526316,shc-gpt-4o,coral,breastca,PROMPT1_ICL_entailment
39,133,43,39,4,0.9069767441860463,29,15,14,0.5172413793103449,0.6587837837837838,shc-gpt-4o,coral,breastca,PROMPT1_ICL_entailment
40,134,31,16,15,0.5161290322580645,11,8,3,0.7272727272727273,0.6037735849056604,shc-gpt-4o,coral,breastca,PROMPT1_ICL_entailment
41,135,27,21,6,0.7777777777777778,16,12,4,0.75,0.7636363636363638,shc-gpt-4o,coral,breastca,PROMPT1_ICL_entailment
42,136,25,21,4,0.84,10,7,3,0.7,0.7636363636363636,shc-gpt-4o,coral,breastca,PROMPT1_ICL_entailment
43,137,16,16,0,1.0,10,10,0,1.0,1.0,shc-gpt-4o,coral,breastca,PROMPT1_ICL_entailment
44,138,13,12,1,0.9230769230769232,10,10,0,1.0,0.96,shc-gpt-4o,coral,breastca,PROMPT1_ICL_entailment
45,139,21,20,1,0.9523809523809524,11,10,1,0.9090909090909092,0.9302325581395348,shc-gpt-4o,coral,breastca,PROMPT1_ICL_entailment
46,14,68,60,8,0.8823529411764706,59,25,34,0.423728813559322,0.5725190839694657,shc-gpt-4o,coral,breastca,PROMPT1_ICL_entailment
47,140,32,31,1,0.96875,9,9,0,1.0,0.984126984126984,shc-gpt-4o,coral,breastca,PROMPT1_ICL_entailment
48,141,38,37,1,0.9736842105263158,11,10,1,0.9090909090909092,0.940279542566709,shc-gpt-4o,coral,breastca,PROMPT1_ICL_entailment
49,142,18,17,1,0.9444444444444444,10,10,0,1.0,0.9714285714285714,shc-gpt-4o,coral,breastca,PROMPT1_ICL_entailment
50,143,16,13,3,0.8125,10,10,0,1.0,0.896551724137931,shc-gpt-4o,coral,breastca,PROMPT1_ICL_entailment
51,144,22,21,1,0.9545454545454546,5,4,1,0.8,0.8704663212435233,shc-gpt-4o,coral,breastca,PROMPT1_ICL_entailment
52,145,16,15,1,0.9375,5,4,1,0.8,0.8633093525179856,shc-gpt-4o,coral,breastca,PROMPT1_ICL_entailment
53,146,19,18,1,0.9473684210526316,9,8,1,0.8888888888888888,0.9171974522292994,shc-gpt-4o,coral,breastca,PROMPT1_ICL_entailment
54,147,30,29,1,0.9666666666666668,5,4,1,0.8,0.8754716981132077,shc-gpt-4o,coral,breastca,PROMPT1_ICL_entailment
55,148,27,21,6,0.7777777777777778,4,0,4,0.0,0.0,shc-gpt-4o,coral,breastca,PROMPT1_ICL_entailment
56,149,14,14,0,1.0,1,1,0,1.0,1.0,shc-gpt-4o,coral,breastca,PROMPT1_ICL_entailment
57,15,82,48,34,0.5853658536585366,16,8,8,0.5,0.5393258426966292,shc-gpt-4o,coral,breastca,PROMPT1_ICL_entailment
58,150,21,19,2,0.9047619047619048,2,2,0,1.0,0.95,shc-gpt-4o,coral,breastca,PROMPT1_ICL_entailment
59,151,16,16,0,1.0,9,9,0,1.0,1.0,shc-gpt-4o,coral,breastca,PROMPT1_ICL_entailment
60,152,25,23,2,0.92,16,15,1,0.9375,0.9286675639300136,shc-gpt-4o,coral,breastca,PROMPT1_ICL_entailment
61,153,13,12,1,0.9230769230769232,1,1,0,1.0,0.96,shc-gpt-4o,coral,breastca,PROMPT1_ICL_entailment
62,154,17,16,1,0.9411764705882352,10,9,1,0.9,0.9201277955271564,shc-gpt-4o,coral,breastca,PROMPT1_ICL_entailment
63,155,29,27,2,0.9310344827586208,9,8,1,0.8888888888888888,0.9094736842105264,shc-gpt-4o,coral,breastca,PROMPT1_ICL_entailment
64,156,28,26,2,0.9285714285714286,8,8,0,1.0,0.962962962962963,shc-gpt-4o,coral,breastca,PROMPT1_ICL_entailment
65,157,23,23,0,1.0,9,9,0,1.0,1.0,shc-gpt-4o,coral,breastca,PROMPT1_ICL_entailment
66,158,64,47,17,0.734375,16,16,0,1.0,0.8468468468468469,shc-gpt-4o,coral,breastca,PROMPT1_ICL_entailment
67,159,43,32,11,0.7441860465116279,29,15,14,0.5172413793103449,0.610298792116974,shc-gpt-4o,coral,breastca,PROMPT1_ICL_entailment
68,16,28,26,2,0.9285714285714286,10,10,0,1.0,0.962962962962963,shc-gpt-4o,coral,breastca,PROMPT1_ICL_entailment
69,160,109,81,28,0.7431192660550459,18,13,5,0.7222222222222222,0.7325217391304348,shc-gpt-4o,coral,breastca,PROMPT1_ICL_entailment
70,161,39,38,1,0.9743589743589745,11,10,1,0.9090909090909092,0.9405940594059408,shc-gpt-4o,coral,breastca,PROMPT1_ICL_entailment
71,162,28,19,9,0.6785714285714286,16,15,1,0.9375,0.787292817679558,shc-gpt-4o,coral,breastca,PROMPT1_ICL_entailment
72,163,19,18,1,0.9473684210526316,11,10,1,0.9090909090909092,0.9278350515463918,shc-gpt-4o,coral,breastca,PROMPT1_ICL_entailment
73,164,28,24,4,0.8571428571428571,8,6,2,0.75,0.7999999999999999,shc-gpt-4o,coral,breastca,PROMPT1_ICL_entailment
74,165,25,23,2,0.92,12,9,3,0.75,0.8263473053892216,shc-gpt-4o,coral,breastca,PROMPT1_ICL_entailment
75,166,26,26,0,1.0,10,5,5,0.5,0.6666666666666666,shc-gpt-4o,coral,breastca,PROMPT1_ICL_entailment
76,167,23,20,3,0.8695652173913043,7,7,0,1.0,0.9302325581395348,shc-gpt-4o,coral,breastca,PROMPT1_ICL_entailment
77,168,15,11,4,0.7333333333333333,7,4,3,0.5714285714285714,0.6423357664233577,shc-gpt-4o,coral,breastca,PROMPT1_ICL_entailment
78,169,21,16,5,0.7619047619047619,11,10,1,0.9090909090909092,0.8290155440414507,shc-gpt-4o,coral,breastca,PROMPT1_ICL_entailment
79,17,7,6,1,0.8571428571428571,3,3,0,1.0,0.923076923076923,shc-gpt-4o,coral,breastca,PROMPT1_ICL_entailment
80,170,26,25,1,0.9615384615384616,10,9,1,0.9,0.9297520661157024,shc-gpt-4o,coral,breastca,PROMPT1_ICL_entailment
81,171,39,38,1,0.9743589743589745,9,7,2,0.7777777777777778,0.8650406504065041,shc-gpt-4o,coral,breastca,PROMPT1_ICL_entailment
82,172,58,54,4,0.9310344827586208,32,22,10,0.6875,0.7909454061251665,shc-gpt-4o,coral,breastca,PROMPT1_ICL_entailment
83,173,22,20,2,0.9090909090909092,11,9,2,0.8181818181818182,0.861244019138756,shc-gpt-4o,coral,breastca,PROMPT1_ICL_entailment
84,174,18,14,4,0.7777777777777778,7,5,2,0.7142857142857143,0.7446808510638298,shc-gpt-4o,coral,breastca,PROMPT1_ICL_entailment
85,175,19,11,8,0.5789473684210527,10,10,0,1.0,0.7333333333333334,shc-gpt-4o,coral,breastca,PROMPT1_ICL_entailment
86,176,21,21,0,1.0,10,10,0,1.0,1.0,shc-gpt-4o,coral,breastca,PROMPT1_ICL_entailment
87,177,21,21,0,1.0,9,9,0,1.0,1.0,shc-gpt-4o,coral,breastca,PROMPT1_ICL_entailment
88,178,33,28,5,0.8484848484848485,10,9,1,0.9,0.8734835355285963,shc-gpt-4o,coral,breastca,PROMPT1_ICL_entailment
89,179,26,26,0,1.0,9,9,0,1.0,1.0,shc-gpt-4o,coral,breastca,PROMPT1_ICL_entailment
90,18,26,24,2,0.9230769230769232,8,8,0,1.0,0.96,shc-gpt-4o,coral,breastca,PROMPT1_ICL_entailment
91,180,26,24,2,0.9230769230769232,10,9,1,0.9,0.9113924050632912,shc-gpt-4o,coral,breastca,PROMPT1_ICL_entailment
92,181,19,15,4,0.7894736842105263,9,9,0,1.0,0.8823529411764706,shc-gpt-4o,coral,breastca,PROMPT1_ICL_entailment
93,182,25,23,2,0.92,9,9,0,1.0,0.9583333333333334,shc-gpt-4o,coral,breastca,PROMPT1_ICL_entailment
94,183,17,17,0,1.0,10,8,2,0.8,0.888888888888889,shc-gpt-4o,coral,breastca,PROMPT1_ICL_entailment
95,184,30,27,3,0.9,9,9,0,1.0,0.9473684210526316,shc-gpt-4o,coral,breastca,PROMPT1_ICL_entailment
96,185,32,32,0,1.0,10,10,0,1.0,1.0,shc-gpt-4o,coral,breastca,PROMPT1_ICL_entailment
97,186,13,13,0,1.0,5,5,0,1.0,1.0,shc-gpt-4o,coral,breastca,PROMPT1_ICL_entailment
98,187,70,60,10,0.8571428571428571,26,22,4,0.8461538461538461,0.8516129032258064,shc-gpt-4o,coral,breastca,PROMPT1_ICL_entailment
99,188,21,21,0,1.0,9,8,1,0.8888888888888888,0.9411764705882352,shc-gpt-4o,coral,breastca,PROMPT1_ICL_entailment
100,189,19,18,1,0.9473684210526316,9,9,0,1.0,0.972972972972973,shc-gpt-4o,coral,breastca,PROMPT1_ICL_entailment
101,19,17,15,2,0.8823529411764706,8,8,0,1.0,0.9375,shc-gpt-4o,coral,breastca,PROMPT1_ICL_entailment
102,190,55,17,38,0.3090909090909091,34,10,24,0.2941176470588235,0.301418439716312,shc-gpt-4o,coral,breastca,PROMPT1_ICL_entailment
103,191,67,47,20,0.7014925373134329,14,10,4,0.7142857142857143,0.7078313253012049,shc-gpt-4o,coral,breastca,PROMPT1_ICL_entailment
104,192,25,23,2,0.92,12,12,0,1.0,0.9583333333333334,shc-gpt-4o,coral,breastca,PROMPT1_ICL_entailment
105,193,18,13,5,0.7222222222222222,2,2,0,1.0,0.8387096774193548,shc-gpt-4o,coral,breastca,PROMPT1_ICL_entailment
106,194,37,36,1,0.972972972972973,15,13,2,0.8666666666666667,0.9167482859941234,shc-gpt-4o,coral,breastca,PROMPT1_ICL_entailment
107,195,25,24,1,0.96,13,12,1,0.9230769230769232,0.9411764705882352,shc-gpt-4o,coral,breastca,PROMPT1_ICL_entailment
108,196,52,49,3,0.9423076923076924,30,21,9,0.7,0.8032786885245902,shc-gpt-4o,coral,breastca,PROMPT1_ICL_entailment
109,197,84,72,12,0.8571428571428571,14,11,3,0.7857142857142857,0.8198757763975155,shc-gpt-4o,coral,breastca,PROMPT1_ICL_entailment
110,198,29,27,2,0.9310344827586208,11,10,1,0.9090909090909092,0.919931856899489,shc-gpt-4o,coral,breastca,PROMPT1_ICL_entailment
111,199,6,5,1,0.8333333333333334,2,2,0,1.0,0.9090909090909092,shc-gpt-4o,coral,breastca,PROMPT1_ICL_entailment
112,2,34,30,4,0.8823529411764706,10,8,2,0.8,0.8391608391608392,shc-gpt-4o,coral,breastca,PROMPT1_ICL_entailment
113,20,34,26,8,0.7647058823529411,17,10,7,0.5882352941176471,0.6649616368286445,shc-gpt-4o,coral,breastca,PROMPT1_ICL_entailment
114,200,84,84,0,1.0,15,11,4,0.7333333333333333,0.846153846153846,shc-gpt-4o,coral,breastca,PROMPT1_ICL_entailment
115,201,38,21,17,0.5526315789473685,26,15,11,0.5769230769230769,0.5645161290322581,shc-gpt-4o,coral,breastca,PROMPT1_ICL_entailment
116,202,26,23,3,0.8846153846153846,17,14,3,0.8235294117647058,0.8529801324503311,shc-gpt-4o,coral,breastca,PROMPT1_ICL_entailment
117,203,73,53,20,0.726027397260274,27,20,7,0.7407407407407407,0.7333102732618471,shc-gpt-4o,coral,breastca,PROMPT1_ICL_entailment
118,204,23,19,4,0.8260869565217391,11,11,0,1.0,0.9047619047619048,shc-gpt-4o,coral,breastca,PROMPT1_ICL_entailment
119,205,23,22,1,0.9565217391304348,11,11,0,1.0,0.9777777777777776,shc-gpt-4o,coral,breastca,PROMPT1_ICL_entailment
120,206,23,23,0,1.0,4,4,0,1.0,1.0,shc-gpt-4o,coral,breastca,PROMPT1_ICL_entailment
121,207,26,22,4,0.8461538461538461,12,10,2,0.8333333333333334,0.8396946564885497,shc-gpt-4o,coral,breastca,PROMPT1_ICL_entailment
122,208,21,20,1,0.9523809523809524,9,9,0,1.0,0.975609756097561,shc-gpt-4o,coral,breastca,PROMPT1_ICL_entailment
123,209,49,48,1,0.979591836734694,11,10,1,0.9090909090909092,0.9430255402750491,shc-gpt-4o,coral,breastca,PROMPT1_ICL_entailment
124,21,100,59,41,0.59,27,19,8,0.7037037037037037,0.6418551388491268,shc-gpt-4o,coral,breastca,PROMPT1_ICL_entailment
125,210,58,50,8,0.8620689655172413,13,9,4,0.6923076923076923,0.7679180887372012,shc-gpt-4o,coral,breastca,PROMPT1_ICL_entailment
126,211,47,41,6,0.8723404255319149,11,11,0,1.0,0.931818181818182,shc-gpt-4o,coral,breastca,PROMPT1_ICL_entailment
127,212,24,21,3,0.875,9,7,2,0.7777777777777778,0.823529411764706,shc-gpt-4o,coral,breastca,PROMPT1_ICL_entailment
128,213,43,37,6,0.8604651162790697,11,8,3,0.7272727272727273,0.7882822902796272,shc-gpt-4o,coral,breastca,PROMPT1_ICL_entailment
129,214,39,20,19,0.5128205128205128,28,14,14,0.5,0.5063291139240506,shc-gpt-4o,coral,breastca,PROMPT1_ICL_entailment
130,215,94,67,27,0.7127659574468085,37,23,14,0.6216216216216216,0.6640810170221935,shc-gpt-4o,coral,breastca,PROMPT1_ICL_entailment
131,216,47,42,5,0.8936170212765957,15,12,3,0.8,0.8442211055276382,shc-gpt-4o,coral,breastca,PROMPT1_ICL_entailment
132,22,20,14,6,0.7,7,4,3,0.5714285714285714,0.6292134831460674,shc-gpt-4o,coral,breastca,PROMPT1_ICL_entailment
133,23,18,18,0,1.0,9,7,2,0.7777777777777778,0.8750000000000001,shc-gpt-4o,coral,breastca,PROMPT1_ICL_entailment
134,24,24,20,4,0.8333333333333334,10,9,1,0.9,0.8653846153846153,shc-gpt-4o,coral,breastca,PROMPT1_ICL_entailment
135,25,28,28,0,1.0,8,7,1,0.875,0.9333333333333332,shc-gpt-4o,coral,breastca,PROMPT1_ICL_entailment
136,26,21,19,2,0.9047619047619048,11,11,0,1.0,0.95,shc-gpt-4o,coral,breastca,PROMPT1_ICL_entailment
137,27,29,27,2,0.9310344827586208,12,11,1,0.9166666666666666,0.9237947122861586,shc-gpt-4o,coral,breastca,PROMPT1_ICL_entailment
138,28,35,30,5,0.8571428571428571,18,13,5,0.7222222222222222,0.7839195979899497,shc-gpt-4o,coral,breastca,PROMPT1_ICL_entailment
139,29,36,29,7,0.8055555555555556,9,3,6,0.3333333333333333,0.4715447154471544,shc-gpt-4o,coral,breastca,PROMPT1_ICL_entailment
140,3,49,40,9,0.8163265306122449,11,8,3,0.7272727272727273,0.7692307692307693,shc-gpt-4o,coral,breastca,PROMPT1_ICL_entailment
141,30,90,62,28,0.6888888888888889,18,15,3,0.8333333333333334,0.7542579075425792,shc-gpt-4o,coral,breastca,PROMPT1_ICL_entailment
142,31,22,14,8,0.6363636363636364,13,11,2,0.8461538461538461,0.7264150943396226,shc-gpt-4o,coral,breastca,PROMPT1_ICL_entailment
143,32,18,15,3,0.8333333333333334,9,8,1,0.8888888888888888,0.8602150537634408,shc-gpt-4o,coral,breastca,PROMPT1_ICL_entailment
144,33,27,24,3,0.8888888888888888,8,7,1,0.875,0.8818897637795274,shc-gpt-4o,coral,breastca,PROMPT1_ICL_entailment
145,34,13,12,1,0.9230769230769232,10,7,3,0.7,0.7962085308056872,shc-gpt-4o,coral,breastca,PROMPT1_ICL_entailment
146,35,23,21,2,0.9130434782608696,12,10,2,0.8333333333333334,0.871369294605809,shc-gpt-4o,coral,breastca,PROMPT1_ICL_entailment
147,36,23,22,1,0.9565217391304348,11,11,0,1.0,0.9777777777777776,shc-gpt-4o,coral,breastca,PROMPT1_ICL_entailment
148,37,20,18,2,0.9,11,8,3,0.7272727272727273,0.8044692737430167,shc-gpt-4o,coral,breastca,PROMPT1_ICL_entailment
149,38,30,29,1,0.9666666666666668,11,10,1,0.9090909090909092,0.9369951534733442,shc-gpt-4o,coral,breastca,PROMPT1_ICL_entailment
150,39,24,23,1,0.9583333333333334,11,11,0,1.0,0.9787234042553192,shc-gpt-4o,coral,breastca,PROMPT1_ICL_entailment
151,4,83,42,41,0.5060240963855421,59,20,39,0.3389830508474576,0.4059932334461092,shc-gpt-4o,coral,breastca,PROMPT1_ICL_entailment
152,40,23,21,2,0.9130434782608696,9,9,0,1.0,0.9545454545454544,shc-gpt-4o,coral,breastca,PROMPT1_ICL_entailment
153,41,39,37,2,0.9487179487179488,14,12,2,0.8571428571428571,0.9006085192697768,shc-gpt-4o,coral,breastca,PROMPT1_ICL_entailment
154,42,28,21,7,0.75,9,5,4,0.5555555555555556,0.6382978723404256,shc-gpt-4o,coral,breastca,PROMPT1_ICL_entailment
155,43,20,17,3,0.85,9,9,0,1.0,0.9189189189189187,shc-gpt-4o,coral,breastca,PROMPT1_ICL_entailment
156,44,20,16,4,0.8,9,9,0,1.0,0.888888888888889,shc-gpt-4o,coral,breastca,PROMPT1_ICL_entailment
157,45,10,9,1,0.9,2,2,0,1.0,0.9473684210526316,shc-gpt-4o,coral,breastca,PROMPT1_ICL_entailment
158,46,19,19,0,1.0,5,5,0,1.0,1.0,shc-gpt-4o,coral,breastca,PROMPT1_ICL_entailment
159,47,17,16,1,0.9411764705882352,2,2,0,1.0,0.9696969696969696,shc-gpt-4o,coral,breastca,PROMPT1_ICL_entailment
160,48,20,20,0,1.0,5,4,1,0.8,0.888888888888889,shc-gpt-4o,coral,breastca,PROMPT1_ICL_entailment
161,49,15,9,6,0.6,16,13,3,0.8125,0.6902654867256637,shc-gpt-4o,coral,breastca,PROMPT1_ICL_entailment
162,5,52,45,7,0.8653846153846154,12,8,4,0.6666666666666666,0.7531380753138075,shc-gpt-4o,coral,breastca,PROMPT1_ICL_entailment
163,50,47,33,14,0.7021276595744681,16,8,8,0.5,0.584070796460177,shc-gpt-4o,coral,breastca,PROMPT1_ICL_entailment
164,51,41,33,8,0.8048780487804879,11,9,2,0.8181818181818182,0.8114754098360656,shc-gpt-4o,coral,breastca,PROMPT1_ICL_entailment
165,52,25,24,1,0.96,10,10,0,1.0,0.979591836734694,shc-gpt-4o,coral,breastca,PROMPT1_ICL_entailment
166,53,25,23,2,0.92,10,10,0,1.0,0.9583333333333334,shc-gpt-4o,coral,breastca,PROMPT1_ICL_entailment
167,54,35,33,2,0.9428571428571428,9,8,1,0.8888888888888888,0.9150779896013864,shc-gpt-4o,coral,breastca,PROMPT1_ICL_entailment
168,55,4,4,0,1.0,1,1,0,1.0,1.0,shc-gpt-4o,coral,breastca,PROMPT1_ICL_entailment
169,56,16,14,2,0.875,18,7,11,0.3888888888888889,0.5384615384615385,shc-gpt-4o,coral,breastca,PROMPT1_ICL_entailment
170,57,39,37,2,0.9487179487179488,10,9,1,0.9,0.9237170596393895,shc-gpt-4o,coral,breastca,PROMPT1_ICL_entailment
171,58,30,30,0,1.0,10,9,1,0.9,0.9473684210526316,shc-gpt-4o,coral,breastca,PROMPT1_ICL_entailment
172,59,19,18,1,0.9473684210526316,9,7,2,0.7777777777777778,0.8542372881355932,shc-gpt-4o,coral,breastca,PROMPT1_ICL_entailment
173,6,22,18,4,0.8181818181818182,8,8,0,1.0,0.9,shc-gpt-4o,coral,breastca,PROMPT1_ICL_entailment
174,60,20,18,2,0.9,10,10,0,1.0,0.9473684210526316,shc-gpt-4o,coral,breastca,PROMPT1_ICL_entailment
175,61,21,21,0,1.0,11,11,0,1.0,1.0,shc-gpt-4o,coral,breastca,PROMPT1_ICL_entailment
176,62,20,19,1,0.95,10,9,1,0.9,0.9243243243243242,shc-gpt-4o,coral,breastca,PROMPT1_ICL_entailment
177,63,20,19,1,0.95,11,8,3,0.7272727272727273,0.8238482384823849,shc-gpt-4o,coral,breastca,PROMPT1_ICL_entailment
178,64,14,11,3,0.7857142857142857,17,8,9,0.4705882352941176,0.588628762541806,shc-gpt-4o,coral,breastca,PROMPT1_ICL_entailment
179,65,38,34,4,0.8947368421052632,6,6,0,1.0,0.9444444444444444,shc-gpt-4o,coral,breastca,PROMPT1_ICL_entailment
180,66,30,29,1,0.9666666666666668,10,10,0,1.0,0.983050847457627,shc-gpt-4o,coral,breastca,PROMPT1_ICL_entailment
181,67,67,32,35,0.4776119402985074,49,22,27,0.4489795918367347,0.462853385930309,shc-gpt-4o,coral,breastca,PROMPT1_ICL_entailment
182,68,21,18,3,0.8571428571428571,8,8,0,1.0,0.923076923076923,shc-gpt-4o,coral,breastca,PROMPT1_ICL_entailment
183,69,57,27,30,0.4736842105263157,12,7,5,0.5833333333333334,0.5228215767634855,shc-gpt-4o,coral,breastca,PROMPT1_ICL_entailment
184,7,25,23,2,0.92,11,11,0,1.0,0.9583333333333334,shc-gpt-4o,coral,breastca,PROMPT1_ICL_entailment
185,70,167,137,30,0.8203592814371258,51,36,15,0.7058823529411765,0.7588276021232403,shc-gpt-4o,coral,breastca,PROMPT1_ICL_entailment
186,71,20,18,2,0.9,5,4,1,0.8,0.8470588235294118,shc-gpt-4o,coral,breastca,PROMPT1_ICL_entailment
187,72,14,13,1,0.9285714285714286,3,3,0,1.0,0.962962962962963,shc-gpt-4o,coral,breastca,PROMPT1_ICL_entailment
188,73,16,16,0,1.0,1,1,0,1.0,1.0,shc-gpt-4o,coral,breastca,PROMPT1_ICL_entailment
189,74,19,17,2,0.8947368421052632,2,2,0,1.0,0.9444444444444444,shc-gpt-4o,coral,breastca,PROMPT1_ICL_entailment
190,75,26,24,2,0.9230769230769232,6,6,0,1.0,0.96,shc-gpt-4o,coral,breastca,PROMPT1_ICL_entailment
191,76,19,18,1,0.9473684210526316,7,7,0,1.0,0.972972972972973,shc-gpt-4o,coral,breastca,PROMPT1_ICL_entailment
192,77,21,18,3,0.8571428571428571,15,14,1,0.9333333333333332,0.8936170212765957,shc-gpt-4o,coral,breastca,PROMPT1_ICL_entailment
193,78,21,19,2,0.9047619047619048,8,8,0,1.0,0.95,shc-gpt-4o,coral,breastca,PROMPT1_ICL_entailment
194,79,20,15,5,0.75,8,8,0,1.0,0.8571428571428571,shc-gpt-4o,coral,breastca,PROMPT1_ICL_entailment
195,8,13,12,1,0.9230769230769232,9,7,2,0.7777777777777778,0.8442211055276381,shc-gpt-4o,coral,breastca,PROMPT1_ICL_entailment
196,80,51,47,4,0.9215686274509804,24,17,7,0.7083333333333334,0.8010025062656642,shc-gpt-4o,coral,breastca,PROMPT1_ICL_entailment
197,81,33,31,2,0.9393939393939394,11,8,3,0.7272727272727273,0.8198347107438017,shc-gpt-4o,coral,breastca,PROMPT1_ICL_entailment
198,82,15,14,1,0.9333333333333332,6,6,0,1.0,0.9655172413793104,shc-gpt-4o,coral,breastca,PROMPT1_ICL_entailment
199,83,16,15,1,0.9375,6,6,0,1.0,0.967741935483871,shc-gpt-4o,coral,breastca,PROMPT1_ICL_entailment
200,84,36,32,4,0.8888888888888888,11,9,2,0.8181818181818182,0.8520710059171598,shc-gpt-4o,coral,breastca,PROMPT1_ICL_entailment
201,85,16,15,1,0.9375,7,7,0,1.0,0.967741935483871,shc-gpt-4o,coral,breastca,PROMPT1_ICL_entailment
202,86,35,26,9,0.7428571428571429,16,12,4,0.75,0.7464114832535885,shc-gpt-4o,coral,breastca,PROMPT1_ICL_entailment
203,87,18,17,1,0.9444444444444444,8,8,0,1.0,0.9714285714285714,shc-gpt-4o,coral,breastca,PROMPT1_ICL_entailment
204,88,12,12,0,1.0,8,8,0,1.0,1.0,shc-gpt-4o,coral,breastca,PROMPT1_ICL_entailment
205,89,18,17,1,0.9444444444444444,11,11,0,1.0,0.9714285714285714,shc-gpt-4o,coral,breastca,PROMPT1_ICL_entailment
206,9,23,21,2,0.9130434782608696,6,5,1,0.8333333333333334,0.871369294605809,shc-gpt-4o,coral,breastca,PROMPT1_ICL_entailment
207,90,82,51,31,0.6219512195121951,17,11,6,0.6470588235294118,0.634256642170718,shc-gpt-4o,coral,breastca,PROMPT1_ICL_entailment
208,91,26,21,5,0.8076923076923077,7,6,1,0.8571428571428571,0.8316831683168318,shc-gpt-4o,coral,breastca,PROMPT1_ICL_entailment
209,92,8,7,1,0.875,2,2,0,1.0,0.9333333333333332,shc-gpt-4o,coral,breastca,PROMPT1_ICL_entailment
210,93,60,55,5,0.9166666666666666,13,13,0,1.0,0.9565217391304348,shc-gpt-4o,coral,breastca,PROMPT1_ICL_entailment
211,94,36,25,11,0.6944444444444444,25,20,5,0.8,0.7434944237918216,shc-gpt-4o,coral,breastca,PROMPT1_ICL_entailment
212,95,65,50,15,0.7692307692307693,13,9,4,0.6923076923076923,0.728744939271255,shc-gpt-4o,coral,breastca,PROMPT1_ICL_entailment
213,96,21,18,3,0.8571428571428571,10,9,1,0.9,0.8780487804878048,shc-gpt-4o,coral,breastca,PROMPT1_ICL_entailment
214,97,35,35,0,1.0,11,9,2,0.8181818181818182,0.9,shc-gpt-4o,coral,breastca,PROMPT1_ICL_entailment
215,98,14,13,1,0.9285714285714286,2,2,0,1.0,0.962962962962963,shc-gpt-4o,coral,breastca,PROMPT1_ICL_entailment
216,99,38,35,3,0.9210526315789472,15,12,3,0.8,0.8562691131498472,shc-gpt-4o,coral,breastca,PROMPT1_ICL_entailment
0,0,37,36,1,0.972972972972973,10,10,0,1.0,0.9863013698630138,shc-gpt-4o,coral,breastca,PROMPT2_ICL_entailment
1,1,58,55,3,0.9482758620689656,12,10,2,0.8333333333333334,0.8870967741935484,shc-gpt-4o,coral,breastca,PROMPT2_ICL_entailment
2,10,30,30,0,1.0,10,9,1,0.9,0.9473684210526316,shc-gpt-4o,coral,breastca,PROMPT2_ICL_entailment
3,100,38,30,8,0.7894736842105263,26,8,18,0.3076923076923077,0.4428044280442804,shc-gpt-4o,coral,breastca,PROMPT2_ICL_entailment
4,101,67,62,5,0.9253731343283582,18,16,2,0.8888888888888888,0.906764168190128,shc-gpt-4o,coral,breastca,PROMPT2_ICL_entailment
5,102,14,13,1,0.9285714285714286,7,5,2,0.7142857142857143,0.8074534161490684,shc-gpt-4o,coral,breastca,PROMPT2_ICL_entailment
6,103,57,56,1,0.9824561403508772,10,10,0,1.0,0.991150442477876,shc-gpt-4o,coral,breastca,PROMPT2_ICL_entailment
7,104,119,116,3,0.9747899159663864,26,21,5,0.8076923076923077,0.8834088848594742,shc-gpt-4o,coral,breastca,PROMPT2_ICL_entailment
8,105,28,28,0,1.0,15,15,0,1.0,1.0,shc-gpt-4o,coral,breastca,PROMPT2_ICL_entailment
9,106,24,24,0,1.0,9,9,0,1.0,1.0,shc-gpt-4o,coral,breastca,PROMPT2_ICL_entailment
10,107,25,22,3,0.88,9,9,0,1.0,0.9361702127659576,shc-gpt-4o,coral,breastca,PROMPT2_ICL_entailment
11,108,27,27,0,1.0,11,11,0,1.0,1.0,shc-gpt-4o,coral,breastca,PROMPT2_ICL_entailment
12,109,26,26,0,1.0,11,10,1,0.9090909090909092,0.9523809523809524,shc-gpt-4o,coral,breastca,PROMPT2_ICL_entailment
13,11,17,11,6,0.6470588235294118,3,3,0,1.0,0.7857142857142858,shc-gpt-4o,coral,breastca,PROMPT2_ICL_entailment
14,110,19,18,1,0.9473684210526316,11,8,3,0.7272727272727273,0.8228571428571427,shc-gpt-4o,coral,breastca,PROMPT2_ICL_entailment
15,111,20,15,5,0.75,10,9,1,0.9,0.8181818181818182,shc-gpt-4o,coral,breastca,PROMPT2_ICL_entailment
16,112,27,27,0,1.0,10,10,0,1.0,1.0,shc-gpt-4o,coral,breastca,PROMPT2_ICL_entailment
17,113,78,56,22,0.717948717948718,49,25,24,0.5102040816326531,0.5965061780997017,shc-gpt-4o,coral,breastca,PROMPT2_ICL_entailment
18,114,59,48,11,0.8135593220338984,21,13,8,0.6190476190476191,0.7030985915492958,shc-gpt-4o,coral,breastca,PROMPT2_ICL_entailment
19,115,24,24,0,1.0,9,8,1,0.8888888888888888,0.9411764705882352,shc-gpt-4o,coral,breastca,PROMPT2_ICL_entailment
20,116,41,36,5,0.8780487804878049,14,9,5,0.6428571428571429,0.7422680412371134,shc-gpt-4o,coral,breastca,PROMPT2_ICL_entailment
21,117,6,6,0,1.0,2,1,1,0.5,0.6666666666666666,shc-gpt-4o,coral,breastca,PROMPT2_ICL_entailment
22,118,16,16,0,1.0,19,5,14,0.2631578947368421,0.4166666666666667,shc-gpt-4o,coral,breastca,PROMPT2_ICL_entailment
23,119,23,20,3,0.8695652173913043,10,9,1,0.9,0.8845208845208845,shc-gpt-4o,coral,breastca,PROMPT2_ICL_entailment
24,12,39,39,0,1.0,10,9,1,0.9,0.9473684210526316,shc-gpt-4o,coral,breastca,PROMPT2_ICL_entailment
25,120,37,37,0,1.0,9,9,0,1.0,1.0,shc-gpt-4o,coral,breastca,PROMPT2_ICL_entailment
26,121,36,34,2,0.9444444444444444,10,7,3,0.7,0.8040540540540541,shc-gpt-4o,coral,breastca,PROMPT2_ICL_entailment
27,122,27,25,2,0.925925925925926,9,9,0,1.0,0.9615384615384616,shc-gpt-4o,coral,breastca,PROMPT2_ICL_entailment
28,123,30,30,0,1.0,8,8,0,1.0,1.0,shc-gpt-4o,coral,breastca,PROMPT2_ICL_entailment
29,124,26,26,0,1.0,10,10,0,1.0,1.0,shc-gpt-4o,coral,breastca,PROMPT2_ICL_entailment
30,125,30,30,0,1.0,11,9,2,0.8181818181818182,0.9,shc-gpt-4o,coral,breastca,PROMPT2_ICL_entailment
31,126,21,21,0,1.0,10,10,0,1.0,1.0,shc-gpt-4o,coral,breastca,PROMPT2_ICL_entailment
32,127,35,33,2,0.9428571428571428,10,8,2,0.8,0.8655737704918033,shc-gpt-4o,coral,breastca,PROMPT2_ICL_entailment
33,128,32,31,1,0.96875,11,8,3,0.7272727272727273,0.8308207705192631,shc-gpt-4o,coral,breastca,PROMPT2_ICL_entailment
34,129,34,31,3,0.9117647058823528,11,8,3,0.7272727272727273,0.8091353996737356,shc-gpt-4o,coral,breastca,PROMPT2_ICL_entailment
35,13,31,29,2,0.935483870967742,10,8,2,0.8,0.8624535315985131,shc-gpt-4o,coral,breastca,PROMPT2_ICL_entailment
36,130,16,16,0,1.0,7,7,0,1.0,1.0,shc-gpt-4o,coral,breastca,PROMPT2_ICL_entailment
37,131,54,52,2,0.9629629629629628,10,10,0,1.0,0.981132075471698,shc-gpt-4o,coral,breastca,PROMPT2_ICL_entailment
38,132,21,21,0,1.0,8,8,0,1.0,1.0,shc-gpt-4o,coral,breastca,PROMPT2_ICL_entailment
39,133,56,48,8,0.8571428571428571,29,14,15,0.4827586206896552,0.6176470588235294,shc-gpt-4o,coral,breastca,PROMPT2_ICL_entailment
40,134,25,15,10,0.6,11,9,2,0.8181818181818182,0.6923076923076923,shc-gpt-4o,coral,breastca,PROMPT2_ICL_entailment
41,135,29,26,3,0.896551724137931,16,13,3,0.8125,0.8524590163934426,shc-gpt-4o,coral,breastca,PROMPT2_ICL_entailment
42,136,25,24,1,0.96,10,9,1,0.9,0.9290322580645162,shc-gpt-4o,coral,breastca,PROMPT2_ICL_entailment
43,137,15,15,0,1.0,10,10,0,1.0,1.0,shc-gpt-4o,coral,breastca,PROMPT2_ICL_entailment
44,138,12,12,0,1.0,10,10,0,1.0,1.0,shc-gpt-4o,coral,breastca,PROMPT2_ICL_entailment
45,139,22,22,0,1.0,11,8,3,0.7272727272727273,0.8421052631578948,shc-gpt-4o,coral,breastca,PROMPT2_ICL_entailment
46,14,66,48,18,0.7272727272727273,59,20,39,0.3389830508474576,0.4624277456647399,shc-gpt-4o,coral,breastca,PROMPT2_ICL_entailment
47,140,33,31,2,0.9393939393939394,9,9,0,1.0,0.96875,shc-gpt-4o,coral,breastca,PROMPT2_ICL_entailment
48,141,36,36,0,1.0,11,11,0,1.0,1.0,shc-gpt-4o,coral,breastca,PROMPT2_ICL_entailment
49,142,20,20,0,1.0,10,10,0,1.0,1.0,shc-gpt-4o,coral,breastca,PROMPT2_ICL_entailment
50,143,20,20,0,1.0,10,9,1,0.9,0.9473684210526316,shc-gpt-4o,coral,breastca,PROMPT2_ICL_entailment
51,144,23,23,0,1.0,5,4,1,0.8,0.888888888888889,shc-gpt-4o,coral,breastca,PROMPT2_ICL_entailment
52,145,16,15,1,0.9375,5,4,1,0.8,0.8633093525179856,shc-gpt-4o,coral,breastca,PROMPT2_ICL_entailment
53,146,26,26,0,1.0,9,8,1,0.8888888888888888,0.9411764705882352,shc-gpt-4o,coral,breastca,PROMPT2_ICL_entailment
54,147,30,29,1,0.9666666666666668,5,5,0,1.0,0.983050847457627,shc-gpt-4o,coral,breastca,PROMPT2_ICL_entailment
55,148,27,23,4,0.8518518518518519,4,1,3,0.25,0.3865546218487395,shc-gpt-4o,coral,breastca,PROMPT2_ICL_entailment
56,149,22,22,0,1.0,1,1,0,1.0,1.0,shc-gpt-4o,coral,breastca,PROMPT2_ICL_entailment
57,15,116,61,55,0.5258620689655172,16,7,9,0.4375,0.4776286353467561,shc-gpt-4o,coral,breastca,PROMPT2_ICL_entailment
58,150,21,21,0,1.0,2,2,0,1.0,1.0,shc-gpt-4o,coral,breastca,PROMPT2_ICL_entailment
59,151,23,23,0,1.0,9,6,3,0.6666666666666666,0.8,shc-gpt-4o,coral,breastca,PROMPT2_ICL_entailment
60,152,22,21,1,0.9545454545454546,16,13,3,0.8125,0.8778135048231511,shc-gpt-4o,coral,breastca,PROMPT2_ICL_entailment
61,153,16,16,0,1.0,1,1,0,1.0,1.0,shc-gpt-4o,coral,breastca,PROMPT2_ICL_entailment
62,154,20,19,1,0.95,10,9,1,0.9,0.9243243243243242,shc-gpt-4o,coral,breastca,PROMPT2_ICL_entailment
63,155,33,32,1,0.9696969696969696,9,9,0,1.0,0.9846153846153848,shc-gpt-4o,coral,breastca,PROMPT2_ICL_entailment
64,156,30,30,0,1.0,8,8,0,1.0,1.0,shc-gpt-4o,coral,breastca,PROMPT2_ICL_entailment
65,157,29,29,0,1.0,9,9,0,1.0,1.0,shc-gpt-4o,coral,breastca,PROMPT2_ICL_entailment
66,158,66,55,11,0.8333333333333334,16,16,0,1.0,0.9090909090909092,shc-gpt-4o,coral,breastca,PROMPT2_ICL_entailment
67,159,41,36,5,0.8780487804878049,29,16,13,0.5517241379310345,0.6776470588235294,shc-gpt-4o,coral,breastca,PROMPT2_ICL_entailment
68,16,28,26,2,0.9285714285714286,10,8,2,0.8,0.859504132231405,shc-gpt-4o,coral,breastca,PROMPT2_ICL_entailment
69,160,123,97,26,0.7886178861788617,18,14,4,0.7777777777777778,0.7831603229527104,shc-gpt-4o,coral,breastca,PROMPT2_ICL_entailment
70,161,43,43,0,1.0,11,8,3,0.7272727272727273,0.8421052631578948,shc-gpt-4o,coral,breastca,PROMPT2_ICL_entailment
71,162,31,30,1,0.967741935483871,16,15,1,0.9375,0.9523809523809524,shc-gpt-4o,coral,breastca,PROMPT2_ICL_entailment
72,163,19,19,0,1.0,11,11,0,1.0,1.0,shc-gpt-4o,coral,breastca,PROMPT2_ICL_entailment
73,164,26,24,2,0.9230769230769232,8,8,0,1.0,0.96,shc-gpt-4o,coral,breastca,PROMPT2_ICL_entailment
74,165,31,31,0,1.0,12,8,4,0.6666666666666666,0.8,shc-gpt-4o,coral,breastca,PROMPT2_ICL_entailment
75,166,24,24,0,1.0,10,7,3,0.7,0.8235294117647058,shc-gpt-4o,coral,breastca,PROMPT2_ICL_entailment
76,167,26,22,4,0.8461538461538461,7,7,0,1.0,0.9166666666666666,shc-gpt-4o,coral,breastca,PROMPT2_ICL_entailment
77,168,18,16,2,0.8888888888888888,7,6,1,0.8571428571428571,0.8727272727272727,shc-gpt-4o,coral,breastca,PROMPT2_ICL_entailment
78,169,21,17,4,0.8095238095238095,11,10,1,0.9090909090909092,0.8564231738035265,shc-gpt-4o,coral,breastca,PROMPT2_ICL_entailment
79,17,6,6,0,1.0,3,3,0,1.0,1.0,shc-gpt-4o,coral,breastca,PROMPT2_ICL_entailment
80,170,31,31,0,1.0,10,10,0,1.0,1.0,shc-gpt-4o,coral,breastca,PROMPT2_ICL_entailment
81,171,55,54,1,0.9818181818181818,9,8,1,0.8888888888888888,0.9330453563714902,shc-gpt-4o,coral,breastca,PROMPT2_ICL_entailment
82,172,119,110,9,0.9243697478991596,32,22,10,0.6875,0.7885304659498209,shc-gpt-4o,coral,breastca,PROMPT2_ICL_entailment
83,173,21,21,0,1.0,11,10,1,0.9090909090909092,0.9523809523809524,shc-gpt-4o,coral,breastca,PROMPT2_ICL_entailment
84,174,25,23,2,0.92,7,6,1,0.8571428571428571,0.887459807073955,shc-gpt-4o,coral,breastca,PROMPT2_ICL_entailment
85,175,16,15,1,0.9375,10,10,0,1.0,0.967741935483871,shc-gpt-4o,coral,breastca,PROMPT2_ICL_entailment
86,176,24,24,0,1.0,10,10,0,1.0,1.0,shc-gpt-4o,coral,breastca,PROMPT2_ICL_entailment
87,177,24,24,0,1.0,9,9,0,1.0,1.0,shc-gpt-4o,coral,breastca,PROMPT2_ICL_entailment
88,178,30,27,3,0.9,10,9,1,0.9,0.9,shc-gpt-4o,coral,breastca,PROMPT2_ICL_entailment
89,179,27,26,1,0.9629629629629628,9,9,0,1.0,0.981132075471698,shc-gpt-4o,coral,breastca,PROMPT2_ICL_entailment
90,18,37,37,0,1.0,8,8,0,1.0,1.0,shc-gpt-4o,coral,breastca,PROMPT2_ICL_entailment
91,180,28,26,2,0.9285714285714286,10,8,2,0.8,0.859504132231405,shc-gpt-4o,coral,breastca,PROMPT2_ICL_entailment
92,181,20,19,1,0.95,9,8,1,0.8888888888888888,0.918429003021148,shc-gpt-4o,coral,breastca,PROMPT2_ICL_entailment
93,182,24,24,0,1.0,9,9,0,1.0,1.0,shc-gpt-4o,coral,breastca,PROMPT2_ICL_entailment
94,183,18,18,0,1.0,10,7,3,0.7,0.8235294117647058,shc-gpt-4o,coral,breastca,PROMPT2_ICL_entailment
95,184,41,37,4,0.902439024390244,9,9,0,1.0,0.9487179487179488,shc-gpt-4o,coral,breastca,PROMPT2_ICL_entailment
96,185,32,31,1,0.96875,10,10,0,1.0,0.984126984126984,shc-gpt-4o,coral,breastca,PROMPT2_ICL_entailment
97,186,15,14,1,0.9333333333333332,5,5,0,1.0,0.9655172413793104,shc-gpt-4o,coral,breastca,PROMPT2_ICL_entailment
98,187,93,79,14,0.8494623655913979,26,25,1,0.9615384615384616,0.9020324274948618,shc-gpt-4o,coral,breastca,PROMPT2_ICL_entailment
99,188,24,24,0,1.0,9,8,1,0.8888888888888888,0.9411764705882352,shc-gpt-4o,coral,breastca,PROMPT2_ICL_entailment
100,189,23,22,1,0.9565217391304348,9,8,1,0.8888888888888888,0.9214659685863874,shc-gpt-4o,coral,breastca,PROMPT2_ICL_entailment
101,19,22,22,0,1.0,8,7,1,0.875,0.9333333333333332,shc-gpt-4o,coral,breastca,PROMPT2_ICL_entailment
102,190,59,23,36,0.3898305084745763,34,16,18,0.4705882352941176,0.4264194669756663,shc-gpt-4o,coral,breastca,PROMPT2_ICL_entailment
103,191,70,48,22,0.6857142857142857,14,10,4,0.7142857142857143,0.6997084548104957,shc-gpt-4o,coral,breastca,PROMPT2_ICL_entailment
104,192,28,28,0,1.0,12,11,1,0.9166666666666666,0.9565217391304348,shc-gpt-4o,coral,breastca,PROMPT2_ICL_entailment
105,193,17,13,4,0.7647058823529411,2,2,0,1.0,0.8666666666666666,shc-gpt-4o,coral,breastca,PROMPT2_ICL_entailment
106,194,33,32,1,0.9696969696969696,15,12,3,0.8,0.8767123287671234,shc-gpt-4o,coral,breastca,PROMPT2_ICL_entailment
107,195,29,24,5,0.8275862068965517,13,12,1,0.9230769230769232,0.8727272727272727,shc-gpt-4o,coral,breastca,PROMPT2_ICL_entailment
108,196,51,46,5,0.9019607843137256,30,20,10,0.6666666666666666,0.7666666666666666,shc-gpt-4o,coral,breastca,PROMPT2_ICL_entailment
109,197,86,78,8,0.9069767441860463,14,12,2,0.8571428571428571,0.8813559322033897,shc-gpt-4o,coral,breastca,PROMPT2_ICL_entailment
110,198,34,32,2,0.9411764705882352,11,9,2,0.8181818181818182,0.8753799392097266,shc-gpt-4o,coral,breastca,PROMPT2_ICL_entailment
111,199,7,6,1,0.8571428571428571,2,2,0,1.0,0.923076923076923,shc-gpt-4o,coral,breastca,PROMPT2_ICL_entailment
112,2,38,31,7,0.8157894736842105,10,8,2,0.8,0.8078175895765473,shc-gpt-4o,coral,breastca,PROMPT2_ICL_entailment
113,20,36,26,10,0.7222222222222222,17,12,5,0.7058823529411765,0.71395881006865,shc-gpt-4o,coral,breastca,PROMPT2_ICL_entailment
114,200,93,84,9,0.9032258064516128,15,14,1,0.9333333333333332,0.918032786885246,shc-gpt-4o,coral,breastca,PROMPT2_ICL_entailment
115,201,41,34,7,0.8292682926829268,26,20,6,0.7692307692307693,0.7981220657276995,shc-gpt-4o,coral,breastca,PROMPT2_ICL_entailment
116,202,25,22,3,0.88,17,15,2,0.8823529411764706,0.8811748998664888,shc-gpt-4o,coral,breastca,PROMPT2_ICL_entailment
117,203,100,85,15,0.85,27,23,4,0.8518518518518519,0.850924918389554,shc-gpt-4o,coral,breastca,PROMPT2_ICL_entailment
118,204,36,36,0,1.0,11,10,1,0.9090909090909092,0.9523809523809524,shc-gpt-4o,coral,breastca,PROMPT2_ICL_entailment
119,205,38,38,0,1.0,11,10,1,0.9090909090909092,0.9523809523809524,shc-gpt-4o,coral,breastca,PROMPT2_ICL_entailment
120,206,22,22,0,1.0,4,4,0,1.0,1.0,shc-gpt-4o,coral,breastca,PROMPT2_ICL_entailment
121,207,30,25,5,0.8333333333333334,12,9,3,0.75,0.7894736842105262,shc-gpt-4o,coral,breastca,PROMPT2_ICL_entailment
122,208,24,24,0,1.0,9,9,0,1.0,1.0,shc-gpt-4o,coral,breastca,PROMPT2_ICL_entailment
123,209,52,51,1,0.9807692307692308,11,10,1,0.9090909090909092,0.9435707678075856,shc-gpt-4o,coral,breastca,PROMPT2_ICL_entailment
124,21,110,61,49,0.5545454545454546,27,17,10,0.6296296296296297,0.5897071367642878,shc-gpt-4o,coral,breastca,PROMPT2_ICL_entailment
125,210,58,53,5,0.913793103448276,13,9,4,0.6923076923076923,0.7877786952931461,shc-gpt-4o,coral,breastca,PROMPT2_ICL_entailment
126,211,66,60,6,0.9090909090909092,11,10,1,0.9090909090909092,0.9090909090909092,shc-gpt-4o,coral,breastca,PROMPT2_ICL_entailment
127,212,30,29,1,0.9666666666666668,9,7,2,0.7777777777777778,0.861995753715499,shc-gpt-4o,coral,breastca,PROMPT2_ICL_entailment
128,213,39,31,8,0.7948717948717948,11,9,2,0.8181818181818182,0.8063583815028901,shc-gpt-4o,coral,breastca,PROMPT2_ICL_entailment
129,214,62,38,24,0.6129032258064516,28,13,15,0.4642857142857143,0.5283422459893048,shc-gpt-4o,coral,breastca,PROMPT2_ICL_entailment
130,215,99,60,39,0.6060606060606061,37,23,14,0.6216216216216216,0.6137424949966644,shc-gpt-4o,coral,breastca,PROMPT2_ICL_entailment
131,216,51,45,6,0.8823529411764706,15,12,3,0.8,0.8391608391608392,shc-gpt-4o,coral,breastca,PROMPT2_ICL_entailment
132,22,27,24,3,0.8888888888888888,7,4,3,0.5714285714285714,0.6956521739130435,shc-gpt-4o,coral,breastca,PROMPT2_ICL_entailment
133,23,23,23,0,1.0,9,9,0,1.0,1.0,shc-gpt-4o,coral,breastca,PROMPT2_ICL_entailment
134,24,20,19,1,0.95,10,9,1,0.9,0.9243243243243242,shc-gpt-4o,coral,breastca,PROMPT2_ICL_entailment
135,25,35,35,0,1.0,8,8,0,1.0,1.0,shc-gpt-4o,coral,breastca,PROMPT2_ICL_entailment
136,26,23,22,1,0.9565217391304348,11,10,1,0.9090909090909092,0.9322033898305084,shc-gpt-4o,coral,breastca,PROMPT2_ICL_entailment
137,27,31,31,0,1.0,12,9,3,0.75,0.8571428571428571,shc-gpt-4o,coral,breastca,PROMPT2_ICL_entailment
138,28,39,32,7,0.8205128205128205,18,12,6,0.6666666666666666,0.7356321839080459,shc-gpt-4o,coral,breastca,PROMPT2_ICL_entailment
139,29,41,33,8,0.8048780487804879,9,5,4,0.5555555555555556,0.6573705179282869,shc-gpt-4o,coral,breastca,PROMPT2_ICL_entailment
140,3,42,30,12,0.7142857142857143,11,7,4,0.6363636363636364,0.673076923076923,shc-gpt-4o,coral,breastca,PROMPT2_ICL_entailment
141,30,93,79,14,0.8494623655913979,18,15,3,0.8333333333333334,0.8413205537806178,shc-gpt-4o,coral,breastca,PROMPT2_ICL_entailment
142,31,27,23,4,0.8518518518518519,13,10,3,0.7692307692307693,0.8084358523725834,shc-gpt-4o,coral,breastca,PROMPT2_ICL_entailment
143,32,19,18,1,0.9473684210526316,9,9,0,1.0,0.972972972972973,shc-gpt-4o,coral,breastca,PROMPT2_ICL_entailment
144,33,45,43,2,0.9555555555555556,8,8,0,1.0,0.9772727272727272,shc-gpt-4o,coral,breastca,PROMPT2_ICL_entailment
145,34,14,13,1,0.9285714285714286,10,5,5,0.5,0.65,shc-gpt-4o,coral,breastca,PROMPT2_ICL_entailment
146,35,30,28,2,0.9333333333333332,12,11,1,0.9166666666666666,0.9249249249249248,shc-gpt-4o,coral,breastca,PROMPT2_ICL_entailment
147,36,30,30,0,1.0,11,11,0,1.0,1.0,shc-gpt-4o,coral,breastca,PROMPT2_ICL_entailment
148,37,27,27,0,1.0,11,11,0,1.0,1.0,shc-gpt-4o,coral,breastca,PROMPT2_ICL_entailment
149,38,28,28,0,1.0,11,10,1,0.9090909090909092,0.9523809523809524,shc-gpt-4o,coral,breastca,PROMPT2_ICL_entailment
150,39,23,23,0,1.0,11,9,2,0.8181818181818182,0.9,shc-gpt-4o,coral,breastca,PROMPT2_ICL_entailment
151,4,88,40,48,0.4545454545454545,59,32,27,0.5423728813559322,0.4945904173106646,shc-gpt-4o,coral,breastca,PROMPT2_ICL_entailment
152,40,26,25,1,0.9615384615384616,9,8,1,0.8888888888888888,0.9237875288683602,shc-gpt-4o,coral,breastca,PROMPT2_ICL_entailment
153,41,22,21,1,0.9545454545454546,14,9,5,0.6428571428571429,0.7682926829268294,shc-gpt-4o,coral,breastca,PROMPT2_ICL_entailment
154,42,31,26,5,0.8387096774193549,9,5,4,0.5555555555555556,0.6683804627249358,shc-gpt-4o,coral,breastca,PROMPT2_ICL_entailment
155,43,22,21,1,0.9545454545454546,9,7,2,0.7777777777777778,0.8571428571428572,shc-gpt-4o,coral,breastca,PROMPT2_ICL_entailment
156,44,23,19,4,0.8260869565217391,9,9,0,1.0,0.9047619047619048,shc-gpt-4o,coral,breastca,PROMPT2_ICL_entailment
157,45,19,0,19,0.0,2,1,1,0.5,0.0,shc-gpt-4o,coral,breastca,PROMPT2_ICL_entailment
158,46,24,24,0,1.0,5,5,0,1.0,1.0,shc-gpt-4o,coral,breastca,PROMPT2_ICL_entailment
159,47,17,16,1,0.9411764705882352,2,2,0,1.0,0.9696969696969696,shc-gpt-4o,coral,breastca,PROMPT2_ICL_entailment
160,48,24,21,3,0.875,5,5,0,1.0,0.9333333333333332,shc-gpt-4o,coral,breastca,PROMPT2_ICL_entailment
161,49,43,34,9,0.7906976744186046,16,9,7,0.5625,0.6573576799140708,shc-gpt-4o,coral,breastca,PROMPT2_ICL_entailment
162,5,49,44,5,0.8979591836734694,12,8,4,0.6666666666666666,0.7652173913043478,shc-gpt-4o,coral,breastca,PROMPT2_ICL_entailment
163,50,53,35,18,0.660377358490566,16,10,6,0.625,0.6422018348623852,shc-gpt-4o,coral,breastca,PROMPT2_ICL_entailment
164,51,41,39,2,0.951219512195122,11,10,1,0.9090909090909092,0.9296781883194276,shc-gpt-4o,coral,breastca,PROMPT2_ICL_entailment
165,52,25,25,0,1.0,10,9,1,0.9,0.9473684210526316,shc-gpt-4o,coral,breastca,PROMPT2_ICL_entailment
166,53,24,24,0,1.0,10,9,1,0.9,0.9473684210526316,shc-gpt-4o,coral,breastca,PROMPT2_ICL_entailment
167,54,36,35,1,0.9722222222222222,9,9,0,1.0,0.9859154929577464,shc-gpt-4o,coral,breastca,PROMPT2_ICL_entailment
168,55,4,4,0,1.0,1,1,0,1.0,1.0,shc-gpt-4o,coral,breastca,PROMPT2_ICL_entailment
169,56,18,16,2,0.8888888888888888,18,7,11,0.3888888888888889,0.5410628019323671,shc-gpt-4o,coral,breastca,PROMPT2_ICL_entailment
170,57,38,38,0,1.0,10,9,1,0.9,0.9473684210526316,shc-gpt-4o,coral,breastca,PROMPT2_ICL_entailment
171,58,30,30,0,1.0,10,9,1,0.9,0.9473684210526316,shc-gpt-4o,coral,breastca,PROMPT2_ICL_entailment
172,59,26,25,1,0.9615384615384616,9,8,1,0.8888888888888888,0.9237875288683602,shc-gpt-4o,coral,breastca,PROMPT2_ICL_entailment
173,6,23,22,1,0.9565217391304348,8,8,0,1.0,0.9777777777777776,shc-gpt-4o,coral,breastca,PROMPT2_ICL_entailment
174,60,20,20,0,1.0,10,8,2,0.8,0.888888888888889,shc-gpt-4o,coral,breastca,PROMPT2_ICL_entailment
175,61,23,23,0,1.0,11,9,2,0.8181818181818182,0.9,shc-gpt-4o,coral,breastca,PROMPT2_ICL_entailment
176,62,30,28,2,0.9333333333333332,10,10,0,1.0,0.9655172413793104,shc-gpt-4o,coral,breastca,PROMPT2_ICL_entailment
177,63,25,25,0,1.0,11,11,0,1.0,1.0,shc-gpt-4o,coral,breastca,PROMPT2_ICL_entailment
178,64,7,7,0,1.0,17,8,9,0.4705882352941176,0.6399999999999999,shc-gpt-4o,coral,breastca,PROMPT2_ICL_entailment
179,65,38,38,0,1.0,6,6,0,1.0,1.0,shc-gpt-4o,coral,breastca,PROMPT2_ICL_entailment
180,66,33,31,2,0.9393939393939394,10,10,0,1.0,0.96875,shc-gpt-4o,coral,breastca,PROMPT2_ICL_entailment
181,67,61,35,26,0.5737704918032787,49,21,28,0.4285714285714285,0.4906542056074766,shc-gpt-4o,coral,breastca,PROMPT2_ICL_entailment
182,68,24,20,4,0.8333333333333334,8,7,1,0.875,0.8536585365853658,shc-gpt-4o,coral,breastca,PROMPT2_ICL_entailment
183,69,60,35,25,0.5833333333333334,12,8,4,0.6666666666666666,0.6222222222222222,shc-gpt-4o,coral,breastca,PROMPT2_ICL_entailment
184,7,28,28,0,1.0,11,11,0,1.0,1.0,shc-gpt-4o,coral,breastca,PROMPT2_ICL_entailment
185,70,213,162,51,0.7605633802816901,51,33,18,0.6470588235294118,0.6992348440258976,shc-gpt-4o,coral,breastca,PROMPT2_ICL_entailment
186,71,15,15,0,1.0,5,5,0,1.0,1.0,shc-gpt-4o,coral,breastca,PROMPT2_ICL_entailment
187,72,15,14,1,0.9333333333333332,3,3,0,1.0,0.9655172413793104,shc-gpt-4o,coral,breastca,PROMPT2_ICL_entailment
188,73,18,18,0,1.0,1,1,0,1.0,1.0,shc-gpt-4o,coral,breastca,PROMPT2_ICL_entailment
189,74,20,19,1,0.95,2,1,1,0.5,0.6551724137931034,shc-gpt-4o,coral,breastca,PROMPT2_ICL_entailment
190,75,28,28,0,1.0,6,6,0,1.0,1.0,shc-gpt-4o,coral,breastca,PROMPT2_ICL_entailment
191,76,19,19,0,1.0,7,6,1,0.8571428571428571,0.923076923076923,shc-gpt-4o,coral,breastca,PROMPT2_ICL_entailment
192,77,20,19,1,0.95,15,8,7,0.5333333333333333,0.6831460674157303,shc-gpt-4o,coral,breastca,PROMPT2_ICL_entailment
193,78,32,30,2,0.9375,8,7,1,0.875,0.9051724137931034,shc-gpt-4o,coral,breastca,PROMPT2_ICL_entailment
194,79,23,19,4,0.8260869565217391,8,8,0,1.0,0.9047619047619048,shc-gpt-4o,coral,breastca,PROMPT2_ICL_entailment
195,8,23,19,4,0.8260869565217391,9,9,0,1.0,0.9047619047619048,shc-gpt-4o,coral,breastca,PROMPT2_ICL_entailment
196,80,48,47,1,0.9791666666666666,24,16,8,0.6666666666666666,0.7932489451476792,shc-gpt-4o,coral,breastca,PROMPT2_ICL_entailment
197,81,38,36,2,0.9473684210526316,11,6,5,0.5454545454545454,0.6923076923076923,shc-gpt-4o,coral,breastca,PROMPT2_ICL_entailment
198,82,14,13,1,0.9285714285714286,6,6,0,1.0,0.962962962962963,shc-gpt-4o,coral,breastca,PROMPT2_ICL_entailment
199,83,21,21,0,1.0,6,6,0,1.0,1.0,shc-gpt-4o,coral,breastca,PROMPT2_ICL_entailment
200,84,41,37,4,0.902439024390244,11,9,2,0.8181818181818182,0.8582474226804124,shc-gpt-4o,coral,breastca,PROMPT2_ICL_entailment
201,85,23,23,0,1.0,7,7,0,1.0,1.0,shc-gpt-4o,coral,breastca,PROMPT2_ICL_entailment
202,86,37,30,7,0.8108108108108109,16,13,3,0.8125,0.8116545265348595,shc-gpt-4o,coral,breastca,PROMPT2_ICL_entailment
203,87,24,24,0,1.0,8,7,1,0.875,0.9333333333333332,shc-gpt-4o,coral,breastca,PROMPT2_ICL_entailment
204,88,11,10,1,0.9090909090909092,8,8,0,1.0,0.9523809523809524,shc-gpt-4o,coral,breastca,PROMPT2_ICL_entailment
205,89,21,20,1,0.9523809523809524,11,10,1,0.9090909090909092,0.9302325581395348,shc-gpt-4o,coral,breastca,PROMPT2_ICL_entailment
206,9,26,25,1,0.9615384615384616,6,6,0,1.0,0.9803921568627452,shc-gpt-4o,coral,breastca,PROMPT2_ICL_entailment
207,90,122,82,40,0.6721311475409836,17,10,7,0.5882352941176471,0.6273909716908952,shc-gpt-4o,coral,breastca,PROMPT2_ICL_entailment
208,91,30,26,4,0.8666666666666667,7,6,1,0.8571428571428571,0.861878453038674,shc-gpt-4o,coral,breastca,PROMPT2_ICL_entailment
209,92,10,10,0,1.0,2,2,0,1.0,1.0,shc-gpt-4o,coral,breastca,PROMPT2_ICL_entailment
210,93,83,75,8,0.9036144578313252,13,12,1,0.9230769230769232,0.9132420091324202,shc-gpt-4o,coral,breastca,PROMPT2_ICL_entailment
211,94,37,23,14,0.6216216216216216,25,19,6,0.76,0.6838810641627543,shc-gpt-4o,coral,breastca,PROMPT2_ICL_entailment
212,95,65,56,9,0.8615384615384616,13,6,7,0.4615384615384615,0.6010733452593917,shc-gpt-4o,coral,breastca,PROMPT2_ICL_entailment
213,96,25,23,2,0.92,10,10,0,1.0,0.9583333333333334,shc-gpt-4o,coral,breastca,PROMPT2_ICL_entailment
214,97,36,34,2,0.9444444444444444,11,8,3,0.7272727272727273,0.8217522658610271,shc-gpt-4o,coral,breastca,PROMPT2_ICL_entailment
215,98,15,15,0,1.0,2,2,0,1.0,1.0,shc-gpt-4o,coral,breastca,PROMPT2_ICL_entailment
216,99,50,48,2,0.96,15,9,6,0.6,0.7384615384615384,shc-gpt-4o,coral,breastca,PROMPT2_ICL_entailment
0,0,23,23,0,1.0,10,10,0,1.0,1.0,shc-gpt-4o,coral,breastca,PROMPT2_entailment
1,1,54,36,18,0.6666666666666666,12,10,2,0.8333333333333334,0.7407407407407408,shc-gpt-4o,coral,breastca,PROMPT2_entailment
2,10,21,21,0,1.0,10,9,1,0.9,0.9473684210526316,shc-gpt-4o,coral,breastca,PROMPT2_entailment
3,100,37,32,5,0.8648648648648649,26,8,18,0.3076923076923077,0.4539007092198581,shc-gpt-4o,coral,breastca,PROMPT2_entailment
4,101,61,56,5,0.918032786885246,18,11,7,0.6111111111111112,0.7337701012507445,shc-gpt-4o,coral,breastca,PROMPT2_entailment
5,102,14,14,0,1.0,7,6,1,0.8571428571428571,0.923076923076923,shc-gpt-4o,coral,breastca,PROMPT2_entailment
6,103,29,29,0,1.0,10,9,1,0.9,0.9473684210526316,shc-gpt-4o,coral,breastca,PROMPT2_entailment
7,104,52,42,10,0.8076923076923077,26,17,9,0.6538461538461539,0.7226720647773278,shc-gpt-4o,coral,breastca,PROMPT2_entailment
8,105,18,18,0,1.0,15,14,1,0.9333333333333332,0.9655172413793104,shc-gpt-4o,coral,breastca,PROMPT2_entailment
9,106,23,22,1,0.9565217391304348,9,9,0,1.0,0.9777777777777776,shc-gpt-4o,coral,breastca,PROMPT2_entailment
10,107,18,15,3,0.8333333333333334,9,9,0,1.0,0.9090909090909092,shc-gpt-4o,coral,breastca,PROMPT2_entailment
11,108,22,21,1,0.9545454545454546,11,11,0,1.0,0.9767441860465116,shc-gpt-4o,coral,breastca,PROMPT2_entailment
12,109,16,14,2,0.875,11,9,2,0.8181818181818182,0.8456375838926175,shc-gpt-4o,coral,breastca,PROMPT2_entailment
13,11,11,8,3,0.7272727272727273,3,3,0,1.0,0.8421052631578948,shc-gpt-4o,coral,breastca,PROMPT2_entailment
14,110,16,16,0,1.0,11,10,1,0.9090909090909092,0.9523809523809524,shc-gpt-4o,coral,breastca,PROMPT2_entailment
15,111,17,13,4,0.7647058823529411,10,10,0,1.0,0.8666666666666666,shc-gpt-4o,coral,breastca,PROMPT2_entailment
16,112,18,18,0,1.0,10,9,1,0.9,0.9473684210526316,shc-gpt-4o,coral,breastca,PROMPT2_entailment
17,113,41,33,8,0.8048780487804879,49,25,24,0.5102040816326531,0.6245268735806208,shc-gpt-4o,coral,breastca,PROMPT2_entailment
18,114,50,42,8,0.84,21,13,8,0.6190476190476191,0.7127937336814623,shc-gpt-4o,coral,breastca,PROMPT2_entailment
19,115,25,22,3,0.88,9,8,1,0.8888888888888888,0.8844221105527638,shc-gpt-4o,coral,breastca,PROMPT2_entailment
20,116,31,25,6,0.8064516129032258,14,11,3,0.7857142857142857,0.7959479015918958,shc-gpt-4o,coral,breastca,PROMPT2_entailment
21,117,8,6,2,0.75,2,2,0,1.0,0.8571428571428571,shc-gpt-4o,coral,breastca,PROMPT2_entailment
22,118,18,18,0,1.0,19,5,14,0.2631578947368421,0.4166666666666667,shc-gpt-4o,coral,breastca,PROMPT2_entailment
23,119,17,16,1,0.9411764705882352,10,9,1,0.9,0.9201277955271564,shc-gpt-4o,coral,breastca,PROMPT2_entailment
24,12,24,24,0,1.0,10,8,2,0.8,0.888888888888889,shc-gpt-4o,coral,breastca,PROMPT2_entailment
25,120,24,22,2,0.9166666666666666,9,8,1,0.8888888888888888,0.9025641025641026,shc-gpt-4o,coral,breastca,PROMPT2_entailment
26,121,28,27,1,0.9642857142857144,10,7,3,0.7,0.8111587982832618,shc-gpt-4o,coral,breastca,PROMPT2_entailment
27,122,27,24,3,0.8888888888888888,9,6,3,0.6666666666666666,0.761904761904762,shc-gpt-4o,coral,breastca,PROMPT2_entailment
28,123,17,17,0,1.0,8,6,2,0.75,0.8571428571428571,shc-gpt-4o,coral,breastca,PROMPT2_entailment
29,124,20,20,0,1.0,10,10,0,1.0,1.0,shc-gpt-4o,coral,breastca,PROMPT2_entailment
30,125,25,25,0,1.0,11,10,1,0.9090909090909092,0.9523809523809524,shc-gpt-4o,coral,breastca,PROMPT2_entailment
31,126,19,19,0,1.0,10,9,1,0.9,0.9473684210526316,shc-gpt-4o,coral,breastca,PROMPT2_entailment
32,127,27,26,1,0.9629629629629628,10,9,1,0.9,0.930417495029821,shc-gpt-4o,coral,breastca,PROMPT2_entailment
33,128,29,29,0,1.0,11,10,1,0.9090909090909092,0.9523809523809524,shc-gpt-4o,coral,breastca,PROMPT2_entailment
34,129,26,23,3,0.8846153846153846,11,7,4,0.6363636363636364,0.7402298850574713,shc-gpt-4o,coral,breastca,PROMPT2_entailment
35,13,22,17,5,0.7727272727272727,10,9,1,0.9,0.8315217391304347,shc-gpt-4o,coral,breastca,PROMPT2_entailment
36,130,11,10,1,0.9090909090909092,7,6,1,0.8571428571428571,0.8823529411764706,shc-gpt-4o,coral,breastca,PROMPT2_entailment
37,131,42,41,1,0.9761904761904762,10,10,0,1.0,0.9879518072289156,shc-gpt-4o,coral,breastca,PROMPT2_entailment
38,132,16,15,1,0.9375,8,8,0,1.0,0.967741935483871,shc-gpt-4o,coral,breastca,PROMPT2_entailment
39,133,36,31,5,0.8611111111111112,29,22,7,0.7586206896551724,0.8066232998225902,shc-gpt-4o,coral,breastca,PROMPT2_entailment
40,134,31,9,22,0.2903225806451613,11,9,2,0.8181818181818182,0.4285714285714286,shc-gpt-4o,coral,breastca,PROMPT2_entailment
41,135,28,18,10,0.6428571428571429,16,11,5,0.6875,0.6644295302013423,shc-gpt-4o,coral,breastca,PROMPT2_entailment
42,136,24,22,2,0.9166666666666666,10,9,1,0.9,0.908256880733945,shc-gpt-4o,coral,breastca,PROMPT2_entailment
43,137,15,14,1,0.9333333333333332,10,9,1,0.9,0.9163636363636364,shc-gpt-4o,coral,breastca,PROMPT2_entailment
44,138,12,12,0,1.0,10,10,0,1.0,1.0,shc-gpt-4o,coral,breastca,PROMPT2_entailment
45,139,20,18,2,0.9,11,6,5,0.5454545454545454,0.679245283018868,shc-gpt-4o,coral,breastca,PROMPT2_entailment
46,14,69,45,24,0.6521739130434783,59,21,38,0.3559322033898305,0.4605263157894737,shc-gpt-4o,coral,breastca,PROMPT2_entailment
47,140,24,20,4,0.8333333333333334,9,8,1,0.8888888888888888,0.8602150537634408,shc-gpt-4o,coral,breastca,PROMPT2_entailment
48,141,14,9,5,0.6428571428571429,11,11,0,1.0,0.782608695652174,shc-gpt-4o,coral,breastca,PROMPT2_entailment
49,142,7,7,0,1.0,10,9,1,0.9,0.9473684210526316,shc-gpt-4o,coral,breastca,PROMPT2_entailment
50,143,11,10,1,0.9090909090909092,10,9,1,0.9,0.9045226130653266,shc-gpt-4o,coral,breastca,PROMPT2_entailment
51,144,17,17,0,1.0,5,5,0,1.0,1.0,shc-gpt-4o,coral,breastca,PROMPT2_entailment
52,145,13,13,0,1.0,5,4,1,0.8,0.888888888888889,shc-gpt-4o,coral,breastca,PROMPT2_entailment
53,146,20,20,0,1.0,9,7,2,0.7777777777777778,0.8750000000000001,shc-gpt-4o,coral,breastca,PROMPT2_entailment
54,147,27,27,0,1.0,5,5,0,1.0,1.0,shc-gpt-4o,coral,breastca,PROMPT2_entailment
55,148,27,22,5,0.8148148148148148,4,0,4,0.0,0.0,shc-gpt-4o,coral,breastca,PROMPT2_entailment
56,149,19,16,3,0.8421052631578947,1,1,0,1.0,0.9142857142857144,shc-gpt-4o,coral,breastca,PROMPT2_entailment
57,15,91,44,47,0.4835164835164835,16,14,2,0.875,0.6228513650151668,shc-gpt-4o,coral,breastca,PROMPT2_entailment
58,150,17,17,0,1.0,2,2,0,1.0,1.0,shc-gpt-4o,coral,breastca,PROMPT2_entailment
59,151,15,15,0,1.0,9,9,0,1.0,1.0,shc-gpt-4o,coral,breastca,PROMPT2_entailment
60,152,17,17,0,1.0,16,13,3,0.8125,0.896551724137931,shc-gpt-4o,coral,breastca,PROMPT2_entailment
61,153,11,11,0,1.0,1,1,0,1.0,1.0,shc-gpt-4o,coral,breastca,PROMPT2_entailment
62,154,16,16,0,1.0,10,10,0,1.0,1.0,shc-gpt-4o,coral,breastca,PROMPT2_entailment
63,155,29,28,1,0.9655172413793104,9,9,0,1.0,0.9824561403508772,shc-gpt-4o,coral,breastca,PROMPT2_entailment
64,156,23,23,0,1.0,8,8,0,1.0,1.0,shc-gpt-4o,coral,breastca,PROMPT2_entailment
65,157,22,22,0,1.0,9,9,0,1.0,1.0,shc-gpt-4o,coral,breastca,PROMPT2_entailment
66,158,53,41,12,0.7735849056603774,16,15,1,0.9375,0.8476912474155754,shc-gpt-4o,coral,breastca,PROMPT2_entailment
67,159,32,21,11,0.65625,29,15,14,0.5172413793103449,0.578512396694215,shc-gpt-4o,coral,breastca,PROMPT2_entailment
68,16,24,23,1,0.9583333333333334,10,9,1,0.9,0.9282511210762332,shc-gpt-4o,coral,breastca,PROMPT2_entailment
69,160,116,93,23,0.8017241379310345,18,13,5,0.7222222222222222,0.759899434318039,shc-gpt-4o,coral,breastca,PROMPT2_entailment
70,161,38,36,2,0.9473684210526316,11,10,1,0.9090909090909092,0.9278350515463918,shc-gpt-4o,coral,breastca,PROMPT2_entailment
71,162,26,22,4,0.8461538461538461,16,14,2,0.875,0.8603351955307262,shc-gpt-4o,coral,breastca,PROMPT2_entailment
72,163,19,19,0,1.0,11,11,0,1.0,1.0,shc-gpt-4o,coral,breastca,PROMPT2_entailment
73,164,19,19,0,1.0,8,7,1,0.875,0.9333333333333332,shc-gpt-4o,coral,breastca,PROMPT2_entailment
74,165,24,24,0,1.0,12,8,4,0.6666666666666666,0.8,shc-gpt-4o,coral,breastca,PROMPT2_entailment
75,166,19,18,1,0.9473684210526316,10,6,4,0.6,0.7346938775510204,shc-gpt-4o,coral,breastca,PROMPT2_entailment
76,167,23,22,1,0.9565217391304348,7,6,1,0.8571428571428571,0.904109589041096,shc-gpt-4o,coral,breastca,PROMPT2_entailment
77,168,14,13,1,0.9285714285714286,7,5,2,0.7142857142857143,0.8074534161490684,shc-gpt-4o,coral,breastca,PROMPT2_entailment
78,169,15,14,1,0.9333333333333332,11,6,5,0.5454545454545454,0.6885245901639344,shc-gpt-4o,coral,breastca,PROMPT2_entailment
79,17,9,9,0,1.0,3,3,0,1.0,1.0,shc-gpt-4o,coral,breastca,PROMPT2_entailment
80,170,19,19,0,1.0,10,10,0,1.0,1.0,shc-gpt-4o,coral,breastca,PROMPT2_entailment
81,171,29,28,1,0.9655172413793104,9,9,0,1.0,0.9824561403508772,shc-gpt-4o,coral,breastca,PROMPT2_entailment
82,172,52,50,2,0.9615384615384616,32,24,8,0.75,0.8426966292134831,shc-gpt-4o,coral,breastca,PROMPT2_entailment
83,173,18,18,0,1.0,11,10,1,0.9090909090909092,0.9523809523809524,shc-gpt-4o,coral,breastca,PROMPT2_entailment
84,174,17,15,2,0.8823529411764706,7,6,1,0.8571428571428571,0.8695652173913043,shc-gpt-4o,coral,breastca,PROMPT2_entailment
85,175,15,14,1,0.9333333333333332,10,10,0,1.0,0.9655172413793104,shc-gpt-4o,coral,breastca,PROMPT2_entailment
86,176,23,23,0,1.0,10,10,0,1.0,1.0,shc-gpt-4o,coral,breastca,PROMPT2_entailment
87,177,17,17,0,1.0,9,8,1,0.8888888888888888,0.9411764705882352,shc-gpt-4o,coral,breastca,PROMPT2_entailment
88,178,31,27,4,0.8709677419354839,10,8,2,0.8,0.833976833976834,shc-gpt-4o,coral,breastca,PROMPT2_entailment
89,179,23,21,2,0.9130434782608696,9,9,0,1.0,0.9545454545454544,shc-gpt-4o,coral,breastca,PROMPT2_entailment
90,18,27,27,0,1.0,8,8,0,1.0,1.0,shc-gpt-4o,coral,breastca,PROMPT2_entailment
91,180,20,18,2,0.9,10,9,1,0.9,0.9,shc-gpt-4o,coral,breastca,PROMPT2_entailment
92,181,14,14,0,1.0,9,9,0,1.0,1.0,shc-gpt-4o,coral,breastca,PROMPT2_entailment
93,182,23,23,0,1.0,9,7,2,0.7777777777777778,0.8750000000000001,shc-gpt-4o,coral,breastca,PROMPT2_entailment
94,183,16,16,0,1.0,10,9,1,0.9,0.9473684210526316,shc-gpt-4o,coral,breastca,PROMPT2_entailment
95,184,29,29,0,1.0,9,8,1,0.8888888888888888,0.9411764705882352,shc-gpt-4o,coral,breastca,PROMPT2_entailment
96,185,26,26,0,1.0,10,10,0,1.0,1.0,shc-gpt-4o,coral,breastca,PROMPT2_entailment
97,186,9,9,0,1.0,5,4,1,0.8,0.888888888888889,shc-gpt-4o,coral,breastca,PROMPT2_entailment
98,187,46,37,9,0.8043478260869565,26,17,9,0.6538461538461539,0.7213302752293579,shc-gpt-4o,coral,breastca,PROMPT2_entailment
99,188,17,17,0,1.0,9,9,0,1.0,1.0,shc-gpt-4o,coral,breastca,PROMPT2_entailment
100,189,18,18,0,1.0,9,7,2,0.7777777777777778,0.8750000000000001,shc-gpt-4o,coral,breastca,PROMPT2_entailment
101,19,18,15,3,0.8333333333333334,8,7,1,0.875,0.8536585365853658,shc-gpt-4o,coral,breastca,PROMPT2_entailment
102,190,54,18,36,0.3333333333333333,30,10,20,0.3333333333333333,0.3333333333333333,shc-gpt-4o,coral,breastca,PROMPT2_entailment
103,191,68,47,21,0.6911764705882353,14,9,5,0.6428571428571429,0.6661417322834645,shc-gpt-4o,coral,breastca,PROMPT2_entailment
104,192,21,21,0,1.0,12,11,1,0.9166666666666666,0.9565217391304348,shc-gpt-4o,coral,breastca,PROMPT2_entailment
105,193,10,10,0,1.0,2,2,0,1.0,1.0,shc-gpt-4o,coral,breastca,PROMPT2_entailment
106,194,31,30,1,0.967741935483871,15,12,3,0.8,0.8759124087591241,shc-gpt-4o,coral,breastca,PROMPT2_entailment
107,195,20,20,0,1.0,13,13,0,1.0,1.0,shc-gpt-4o,coral,breastca,PROMPT2_entailment
108,196,40,36,4,0.9,30,20,10,0.6666666666666666,0.7659574468085106,shc-gpt-4o,coral,breastca,PROMPT2_entailment
109,197,76,63,13,0.8289473684210527,14,10,4,0.7142857142857143,0.7673568818514007,shc-gpt-4o,coral,breastca,PROMPT2_entailment
110,198,33,29,4,0.8787878787878788,11,10,1,0.9090909090909092,0.8936825885978428,shc-gpt-4o,coral,breastca,PROMPT2_entailment
111,199,5,5,0,1.0,2,2,0,1.0,1.0,shc-gpt-4o,coral,breastca,PROMPT2_entailment
112,2,36,29,7,0.8055555555555556,10,8,2,0.8,0.8027681660899654,shc-gpt-4o,coral,breastca,PROMPT2_entailment
113,20,34,26,8,0.7647058823529411,17,11,6,0.6470588235294118,0.7009803921568628,shc-gpt-4o,coral,breastca,PROMPT2_entailment
114,200,51,47,4,0.9215686274509804,15,13,2,0.8666666666666667,0.8932748538011696,shc-gpt-4o,coral,breastca,PROMPT2_entailment
115,201,24,21,3,0.875,26,17,9,0.6538461538461539,0.7484276729559749,shc-gpt-4o,coral,breastca,PROMPT2_entailment
116,202,22,22,0,1.0,17,15,2,0.8823529411764706,0.9375,shc-gpt-4o,coral,breastca,PROMPT2_entailment
117,203,74,62,12,0.8378378378378378,27,21,6,0.7777777777777778,0.8066914498141263,shc-gpt-4o,coral,breastca,PROMPT2_entailment
118,204,25,25,0,1.0,11,10,1,0.9090909090909092,0.9523809523809524,shc-gpt-4o,coral,breastca,PROMPT2_entailment
119,205,20,20,0,1.0,11,11,0,1.0,1.0,shc-gpt-4o,coral,breastca,PROMPT2_entailment
120,206,21,21,0,1.0,4,4,0,1.0,1.0,shc-gpt-4o,coral,breastca,PROMPT2_entailment
121,207,25,24,1,0.96,12,10,2,0.8333333333333334,0.8921933085501859,shc-gpt-4o,coral,breastca,PROMPT2_entailment
122,208,25,25,0,1.0,9,9,0,1.0,1.0,shc-gpt-4o,coral,breastca,PROMPT2_entailment
123,209,49,48,1,0.979591836734694,11,10,1,0.9090909090909092,0.9430255402750491,shc-gpt-4o,coral,breastca,PROMPT2_entailment
124,21,104,62,42,0.5961538461538461,27,17,10,0.6296296296296297,0.6124346310284717,shc-gpt-4o,coral,breastca,PROMPT2_entailment
125,210,48,45,3,0.9375,13,10,3,0.7692307692307693,0.8450704225352113,shc-gpt-4o,coral,breastca,PROMPT2_entailment
126,211,34,30,4,0.8823529411764706,11,11,0,1.0,0.9375,shc-gpt-4o,coral,breastca,PROMPT2_entailment
127,212,15,14,1,0.9333333333333332,9,8,1,0.8888888888888888,0.9105691056910568,shc-gpt-4o,coral,breastca,PROMPT2_entailment
128,213,12,10,2,0.8333333333333334,11,10,1,0.9090909090909092,0.8695652173913043,shc-gpt-4o,coral,breastca,PROMPT2_entailment
129,214,29,15,14,0.5172413793103449,28,13,15,0.4642857142857143,0.4893350062735257,shc-gpt-4o,coral,breastca,PROMPT2_entailment
130,215,69,41,28,0.5942028985507246,37,18,19,0.4864864864864865,0.5349764407393984,shc-gpt-4o,coral,breastca,PROMPT2_entailment
131,216,34,30,4,0.8823529411764706,15,13,2,0.8666666666666667,0.8744394618834082,shc-gpt-4o,coral,breastca,PROMPT2_entailment
132,22,24,14,10,0.5833333333333334,7,4,3,0.5714285714285714,0.577319587628866,shc-gpt-4o,coral,breastca,PROMPT2_entailment
133,23,20,19,1,0.95,9,8,1,0.8888888888888888,0.918429003021148,shc-gpt-4o,coral,breastca,PROMPT2_entailment
134,24,18,17,1,0.9444444444444444,10,10,0,1.0,0.9714285714285714,shc-gpt-4o,coral,breastca,PROMPT2_entailment
135,25,27,26,1,0.9629629629629628,8,8,0,1.0,0.981132075471698,shc-gpt-4o,coral,breastca,PROMPT2_entailment
136,26,20,18,2,0.9,11,8,3,0.7272727272727273,0.8044692737430167,shc-gpt-4o,coral,breastca,PROMPT2_entailment
137,27,22,20,2,0.9090909090909092,12,11,1,0.9166666666666666,0.9128630705394192,shc-gpt-4o,coral,breastca,PROMPT2_entailment
138,28,30,24,6,0.8,18,14,4,0.7777777777777778,0.7887323943661971,shc-gpt-4o,coral,breastca,PROMPT2_entailment
139,29,24,22,2,0.9166666666666666,9,5,4,0.5555555555555556,0.6918238993710691,shc-gpt-4o,coral,breastca,PROMPT2_entailment
140,3,26,16,10,0.6153846153846154,11,5,6,0.4545454545454545,0.5228758169934641,shc-gpt-4o,coral,breastca,PROMPT2_entailment
141,30,80,57,23,0.7125,18,11,7,0.6111111111111112,0.6579223504721932,shc-gpt-4o,coral,breastca,PROMPT2_entailment
142,31,21,14,7,0.6666666666666666,13,10,3,0.7692307692307693,0.7142857142857142,shc-gpt-4o,coral,breastca,PROMPT2_entailment
143,32,19,16,3,0.8421052631578947,9,8,1,0.8888888888888888,0.8648648648648649,shc-gpt-4o,coral,breastca,PROMPT2_entailment
144,33,20,16,4,0.8,8,6,2,0.75,0.7741935483870969,shc-gpt-4o,coral,breastca,PROMPT2_entailment
145,34,10,10,0,1.0,10,9,1,0.9,0.9473684210526316,shc-gpt-4o,coral,breastca,PROMPT2_entailment
146,35,21,16,5,0.7619047619047619,12,11,1,0.9166666666666666,0.8321513002364067,shc-gpt-4o,coral,breastca,PROMPT2_entailment
147,36,20,20,0,1.0,11,11,0,1.0,1.0,shc-gpt-4o,coral,breastca,PROMPT2_entailment
148,37,19,16,3,0.8421052631578947,11,10,1,0.9090909090909092,0.8743169398907102,shc-gpt-4o,coral,breastca,PROMPT2_entailment
149,38,27,26,1,0.9629629629629628,11,9,2,0.8181818181818182,0.8846880907372401,shc-gpt-4o,coral,breastca,PROMPT2_entailment
150,39,18,18,0,1.0,11,10,1,0.9090909090909092,0.9523809523809524,shc-gpt-4o,coral,breastca,PROMPT2_entailment
151,4,80,45,35,0.5625,59,34,25,0.576271186440678,0.5693023255813954,shc-gpt-4o,coral,breastca,PROMPT2_entailment
152,40,16,15,1,0.9375,9,8,1,0.8888888888888888,0.9125475285171102,shc-gpt-4o,coral,breastca,PROMPT2_entailment
153,41,20,18,2,0.9,14,12,2,0.8571428571428571,0.8780487804878048,shc-gpt-4o,coral,breastca,PROMPT2_entailment
154,42,26,21,5,0.8076923076923077,9,7,2,0.7777777777777778,0.7924528301886792,shc-gpt-4o,coral,breastca,PROMPT2_entailment
155,43,27,25,2,0.925925925925926,9,8,1,0.8888888888888888,0.9070294784580496,shc-gpt-4o,coral,breastca,PROMPT2_entailment
156,44,17,14,3,0.8235294117647058,9,9,0,1.0,0.9032258064516128,shc-gpt-4o,coral,breastca,PROMPT2_entailment
157,45,4,3,1,0.75,2,2,0,1.0,0.8571428571428571,shc-gpt-4o,coral,breastca,PROMPT2_entailment
158,46,17,17,0,1.0,5,4,1,0.8,0.888888888888889,shc-gpt-4o,coral,breastca,PROMPT2_entailment
159,47,16,14,2,0.875,2,2,0,1.0,0.9333333333333332,shc-gpt-4o,coral,breastca,PROMPT2_entailment
160,48,10,10,0,1.0,5,3,2,0.6,0.7499999999999999,shc-gpt-4o,coral,breastca,PROMPT2_entailment
161,49,35,26,9,0.7428571428571429,16,12,4,0.75,0.7464114832535885,shc-gpt-4o,coral,breastca,PROMPT2_entailment
162,5,45,33,12,0.7333333333333333,12,10,2,0.8333333333333334,0.7801418439716311,shc-gpt-4o,coral,breastca,PROMPT2_entailment
163,50,58,39,19,0.6724137931034483,16,8,8,0.5,0.5735294117647058,shc-gpt-4o,coral,breastca,PROMPT2_entailment
164,51,39,38,1,0.9743589743589745,11,10,1,0.9090909090909092,0.9405940594059408,shc-gpt-4o,coral,breastca,PROMPT2_entailment
165,52,24,23,1,0.9583333333333334,10,10,0,1.0,0.9787234042553192,shc-gpt-4o,coral,breastca,PROMPT2_entailment
166,53,24,21,3,0.875,10,9,1,0.9,0.8873239436619719,shc-gpt-4o,coral,breastca,PROMPT2_entailment
167,54,35,33,2,0.9428571428571428,9,7,2,0.7777777777777778,0.8523985239852397,shc-gpt-4o,coral,breastca,PROMPT2_entailment
168,55,3,3,0,1.0,1,1,0,1.0,1.0,shc-gpt-4o,coral,breastca,PROMPT2_entailment
169,56,9,8,1,0.8888888888888888,18,5,13,0.2777777777777778,0.4232804232804233,shc-gpt-4o,coral,breastca,PROMPT2_entailment
170,57,38,34,4,0.8947368421052632,10,10,0,1.0,0.9444444444444444,shc-gpt-4o,coral,breastca,PROMPT2_entailment
171,58,21,21,0,1.0,10,8,2,0.8,0.888888888888889,shc-gpt-4o,coral,breastca,PROMPT2_entailment
172,59,18,17,1,0.9444444444444444,9,7,2,0.7777777777777778,0.8530465949820788,shc-gpt-4o,coral,breastca,PROMPT2_entailment
173,6,19,17,2,0.8947368421052632,8,8,0,1.0,0.9444444444444444,shc-gpt-4o,coral,breastca,PROMPT2_entailment
174,60,19,18,1,0.9473684210526316,10,9,1,0.9,0.9230769230769232,shc-gpt-4o,coral,breastca,PROMPT2_entailment
175,61,19,18,1,0.9473684210526316,11,11,0,1.0,0.972972972972973,shc-gpt-4o,coral,breastca,PROMPT2_entailment
176,62,22,20,2,0.9090909090909092,10,9,1,0.9,0.9045226130653266,shc-gpt-4o,coral,breastca,PROMPT2_entailment
177,63,18,18,0,1.0,11,11,0,1.0,1.0,shc-gpt-4o,coral,breastca,PROMPT2_entailment
178,64,8,8,0,1.0,17,10,7,0.5882352941176471,0.7407407407407407,shc-gpt-4o,coral,breastca,PROMPT2_entailment
179,65,27,25,2,0.925925925925926,6,6,0,1.0,0.9615384615384616,shc-gpt-4o,coral,breastca,PROMPT2_entailment
180,66,28,27,1,0.9642857142857144,10,10,0,1.0,0.9818181818181818,shc-gpt-4o,coral,breastca,PROMPT2_entailment
181,67,65,34,31,0.5230769230769231,49,17,32,0.3469387755102041,0.4171779141104294,shc-gpt-4o,coral,breastca,PROMPT2_entailment
182,68,19,19,0,1.0,8,7,1,0.875,0.9333333333333332,shc-gpt-4o,coral,breastca,PROMPT2_entailment
183,69,36,20,16,0.5555555555555556,12,2,10,0.1666666666666666,0.2564102564102564,shc-gpt-4o,coral,breastca,PROMPT2_entailment
184,7,21,20,1,0.9523809523809524,11,11,0,1.0,0.975609756097561,shc-gpt-4o,coral,breastca,PROMPT2_entailment
185,70,160,109,51,0.68125,51,26,25,0.5098039215686274,0.5831875707377303,shc-gpt-4o,coral,breastca,PROMPT2_entailment
186,71,16,15,1,0.9375,5,4,1,0.8,0.8633093525179856,shc-gpt-4o,coral,breastca,PROMPT2_entailment
187,72,13,13,0,1.0,3,2,1,0.6666666666666666,0.8,shc-gpt-4o,coral,breastca,PROMPT2_entailment
188,73,12,12,0,1.0,1,1,0,1.0,1.0,shc-gpt-4o,coral,breastca,PROMPT2_entailment
189,74,17,15,2,0.8823529411764706,2,1,1,0.5,0.6382978723404256,shc-gpt-4o,coral,breastca,PROMPT2_entailment
190,75,21,20,1,0.9523809523809524,6,6,0,1.0,0.975609756097561,shc-gpt-4o,coral,breastca,PROMPT2_entailment
191,76,15,15,0,1.0,7,7,0,1.0,1.0,shc-gpt-4o,coral,breastca,PROMPT2_entailment
192,77,21,19,2,0.9047619047619048,15,13,2,0.8666666666666667,0.8853046594982079,shc-gpt-4o,coral,breastca,PROMPT2_entailment
193,78,22,21,1,0.9545454545454546,8,7,1,0.875,0.9130434782608696,shc-gpt-4o,coral,breastca,PROMPT2_entailment
194,79,20,17,3,0.85,8,7,1,0.875,0.8623188405797101,shc-gpt-4o,coral,breastca,PROMPT2_entailment
195,8,14,10,4,0.7142857142857143,9,8,1,0.8888888888888888,0.792079207920792,shc-gpt-4o,coral,breastca,PROMPT2_entailment
196,80,40,39,1,0.975,24,16,8,0.6666666666666666,0.7918781725888324,shc-gpt-4o,coral,breastca,PROMPT2_entailment
197,81,24,21,3,0.875,11,8,3,0.7272727272727273,0.7943262411347517,shc-gpt-4o,coral,breastca,PROMPT2_entailment
198,82,13,11,2,0.8461538461538461,6,6,0,1.0,0.9166666666666666,shc-gpt-4o,coral,breastca,PROMPT2_entailment
199,83,17,15,2,0.8823529411764706,6,6,0,1.0,0.9375,shc-gpt-4o,coral,breastca,PROMPT2_entailment
200,84,29,24,5,0.8275862068965517,11,10,1,0.9090909090909092,0.8664259927797834,shc-gpt-4o,coral,breastca,PROMPT2_entailment
201,85,18,16,2,0.8888888888888888,7,7,0,1.0,0.9411764705882352,shc-gpt-4o,coral,breastca,PROMPT2_entailment
202,86,38,28,10,0.7368421052631579,16,14,2,0.875,0.7999999999999999,shc-gpt-4o,coral,breastca,PROMPT2_entailment
203,87,14,13,1,0.9285714285714286,8,8,0,1.0,0.962962962962963,shc-gpt-4o,coral,breastca,PROMPT2_entailment
204,88,11,11,0,1.0,8,8,0,1.0,1.0,shc-gpt-4o,coral,breastca,PROMPT2_entailment
205,89,16,16,0,1.0,11,9,2,0.8181818181818182,0.9,shc-gpt-4o,coral,breastca,PROMPT2_entailment
206,9,18,14,4,0.7777777777777778,6,6,0,1.0,0.8750000000000001,shc-gpt-4o,coral,breastca,PROMPT2_entailment
207,90,75,51,24,0.68,17,14,3,0.8235294117647058,0.7449139280125197,shc-gpt-4o,coral,breastca,PROMPT2_entailment
208,91,24,17,7,0.7083333333333334,7,4,3,0.5714285714285714,0.6325581395348838,shc-gpt-4o,coral,breastca,PROMPT2_entailment
209,92,7,6,1,0.8571428571428571,2,2,0,1.0,0.923076923076923,shc-gpt-4o,coral,breastca,PROMPT2_entailment
210,93,31,29,2,0.935483870967742,13,11,2,0.8461538461538461,0.8885793871866294,shc-gpt-4o,coral,breastca,PROMPT2_entailment
211,94,26,21,5,0.8076923076923077,25,19,6,0.76,0.7831207065750736,shc-gpt-4o,coral,breastca,PROMPT2_entailment
212,95,60,46,14,0.7666666666666667,13,8,5,0.6153846153846154,0.6827458256029686,shc-gpt-4o,coral,breastca,PROMPT2_entailment
213,96,21,19,2,0.9047619047619048,10,9,1,0.9,0.9023746701846964,shc-gpt-4o,coral,breastca,PROMPT2_entailment
214,97,32,31,1,0.96875,11,7,4,0.6363636363636364,0.768141592920354,shc-gpt-4o,coral,breastca,PROMPT2_entailment
215,98,12,12,0,1.0,2,1,1,0.5,0.6666666666666666,shc-gpt-4o,coral,breastca,PROMPT2_entailment
216,99,30,30,0,1.0,15,9,6,0.6,0.7499999999999999,shc-gpt-4o,coral,breastca,PROMPT2_entailment
0,0,11,10,1,0.9090909090909092,11,11,0,1.0,0.9523809523809524,shc-gpt-4o,mimiciii,nursing_note,PROMPT1_entailment
1,1,19,16,3,0.8421052631578947,31,29,2,0.935483870967742,0.8863419293218718,shc-gpt-4o,mimiciii,nursing_note,PROMPT1_entailment
2,10,20,17,3,0.85,18,14,4,0.7777777777777778,0.8122866894197952,shc-gpt-4o,mimiciii,nursing_note,PROMPT1_entailment
3,100,11,11,0,1.0,6,6,0,1.0,1.0,shc-gpt-4o,mimiciii,nursing_note,PROMPT1_entailment
4,101,37,31,6,0.8378378378378378,27,26,1,0.9629629629629628,0.8960533629794329,shc-gpt-4o,mimiciii,nursing_note,PROMPT1_entailment
5,102,31,29,2,0.935483870967742,26,22,4,0.8461538461538461,0.8885793871866294,shc-gpt-4o,mimiciii,nursing_note,PROMPT1_entailment
6,103,24,24,0,1.0,22,21,1,0.9545454545454546,0.9767441860465116,shc-gpt-4o,mimiciii,nursing_note,PROMPT1_entailment
7,104,27,26,1,0.9629629629629628,20,20,0,1.0,0.981132075471698,shc-gpt-4o,mimiciii,nursing_note,PROMPT1_entailment
8,105,14,14,0,1.0,20,19,1,0.95,0.9743589743589745,shc-gpt-4o,mimiciii,nursing_note,PROMPT1_entailment
9,106,7,7,0,1.0,4,4,0,1.0,1.0,shc-gpt-4o,mimiciii,nursing_note,PROMPT1_entailment
10,107,56,50,6,0.8928571428571429,49,38,11,0.7755102040816326,0.8300567933595457,shc-gpt-4o,mimiciii,nursing_note,PROMPT1_entailment
11,108,10,9,1,0.9,28,26,2,0.9285714285714286,0.9140625,shc-gpt-4o,mimiciii,nursing_note,PROMPT1_entailment
12,109,4,3,1,0.75,4,4,0,1.0,0.8571428571428571,shc-gpt-4o,mimiciii,nursing_note,PROMPT1_entailment
13,11,4,4,0,1.0,2,2,0,1.0,1.0,shc-gpt-4o,mimiciii,nursing_note,PROMPT1_entailment
14,110,15,15,0,1.0,13,13,0,1.0,1.0,shc-gpt-4o,mimiciii,nursing_note,PROMPT1_entailment
15,111,32,30,2,0.9375,32,31,1,0.96875,0.9528688524590164,shc-gpt-4o,mimiciii,nursing_note,PROMPT1_entailment
16,112,8,7,1,0.875,37,36,1,0.972972972972973,0.9213893967093236,shc-gpt-4o,mimiciii,nursing_note,PROMPT1_entailment
17,113,6,6,0,1.0,5,5,0,1.0,1.0,shc-gpt-4o,mimiciii,nursing_note,PROMPT1_entailment
18,114,22,18,4,0.8181818181818182,19,16,3,0.8421052631578947,0.829971181556196,shc-gpt-4o,mimiciii,nursing_note,PROMPT1_entailment
19,115,11,10,1,0.9090909090909092,7,7,0,1.0,0.9523809523809524,shc-gpt-4o,mimiciii,nursing_note,PROMPT1_entailment
20,116,45,39,6,0.8666666666666667,31,27,4,0.8709677419354839,0.8688118811881188,shc-gpt-4o,mimiciii,nursing_note,PROMPT1_entailment
21,117,13,12,1,0.9230769230769232,18,17,1,0.9444444444444444,0.9336384439359268,shc-gpt-4o,mimiciii,nursing_note,PROMPT1_entailment
22,118,27,24,3,0.8888888888888888,25,21,4,0.84,0.8637532133676092,shc-gpt-4o,mimiciii,nursing_note,PROMPT1_entailment
23,119,29,27,2,0.9310344827586208,26,23,3,0.8846153846153846,0.9072315558802044,shc-gpt-4o,mimiciii,nursing_note,PROMPT1_entailment
24,12,25,24,1,0.96,18,14,4,0.7777777777777778,0.8593350383631715,shc-gpt-4o,mimiciii,nursing_note,PROMPT1_entailment
25,120,9,9,0,1.0,18,17,1,0.9444444444444444,0.9714285714285714,shc-gpt-4o,mimiciii,nursing_note,PROMPT1_entailment
26,121,41,37,4,0.902439024390244,37,32,5,0.8648648648648649,0.8832525177172698,shc-gpt-4o,mimiciii,nursing_note,PROMPT1_entailment
27,122,26,24,2,0.9230769230769232,11,9,2,0.8181818181818182,0.8674698795180724,shc-gpt-4o,mimiciii,nursing_note,PROMPT1_entailment
28,123,5,5,0,1.0,6,6,0,1.0,1.0,shc-gpt-4o,mimiciii,nursing_note,PROMPT1_entailment
29,124,8,8,0,1.0,5,4,1,0.8,0.888888888888889,shc-gpt-4o,mimiciii,nursing_note,PROMPT1_entailment
30,125,22,22,0,1.0,43,39,4,0.9069767441860463,0.951219512195122,shc-gpt-4o,mimiciii,nursing_note,PROMPT1_entailment
31,126,12,11,1,0.9166666666666666,28,24,4,0.8571428571428571,0.8859060402684563,shc-gpt-4o,mimiciii,nursing_note,PROMPT1_entailment
32,127,20,20,0,1.0,10,9,1,0.9,0.9473684210526316,shc-gpt-4o,mimiciii,nursing_note,PROMPT1_entailment
33,128,27,26,1,0.9629629629629628,17,14,3,0.8235294117647058,0.8878048780487804,shc-gpt-4o,mimiciii,nursing_note,PROMPT1_entailment
34,129,32,31,1,0.96875,29,25,4,0.8620689655172413,0.9123013537374924,shc-gpt-4o,mimiciii,nursing_note,PROMPT1_entailment
35,13,10,10,0,1.0,34,32,2,0.9411764705882352,0.9696969696969696,shc-gpt-4o,mimiciii,nursing_note,PROMPT1_entailment
36,130,41,36,5,0.8780487804878049,33,28,5,0.8484848484848485,0.863013698630137,shc-gpt-4o,mimiciii,nursing_note,PROMPT1_entailment
37,131,33,31,2,0.9393939393939394,31,26,5,0.8387096774193549,0.8862012094557449,shc-gpt-4o,mimiciii,nursing_note,PROMPT1_entailment
38,132,11,11,0,1.0,17,15,2,0.8823529411764706,0.9375,shc-gpt-4o,mimiciii,nursing_note,PROMPT1_entailment
39,133,6,5,1,0.8333333333333334,10,10,0,1.0,0.9090909090909092,shc-gpt-4o,mimiciii,nursing_note,PROMPT1_entailment
40,134,9,5,4,0.5555555555555556,30,19,11,0.6333333333333333,0.5919003115264798,shc-gpt-4o,mimiciii,nursing_note,PROMPT1_entailment
41,135,12,11,1,0.9166666666666666,42,39,3,0.9285714285714286,0.9225806451612902,shc-gpt-4o,mimiciii,nursing_note,PROMPT1_entailment
42,136,63,58,5,0.9206349206349206,41,40,1,0.975609756097561,0.9473254389546756,shc-gpt-4o,mimiciii,nursing_note,PROMPT1_entailment
43,137,4,4,0,1.0,2,2,0,1.0,1.0,shc-gpt-4o,mimiciii,nursing_note,PROMPT1_entailment
44,138,5,5,0,1.0,5,4,1,0.8,0.888888888888889,shc-gpt-4o,mimiciii,nursing_note,PROMPT1_entailment
45,139,7,6,1,0.8571428571428571,4,3,1,0.75,0.7999999999999999,shc-gpt-4o,mimiciii,nursing_note,PROMPT1_entailment
46,14,30,30,0,1.0,25,24,1,0.96,0.979591836734694,shc-gpt-4o,mimiciii,nursing_note,PROMPT1_entailment
47,140,34,31,3,0.9117647058823528,24,24,0,1.0,0.953846153846154,shc-gpt-4o,mimiciii,nursing_note,PROMPT1_entailment
48,141,16,15,1,0.9375,11,11,0,1.0,0.967741935483871,shc-gpt-4o,mimiciii,nursing_note,PROMPT1_entailment
49,142,35,30,5,0.8571428571428571,8,7,1,0.875,0.8659793814432989,shc-gpt-4o,mimiciii,nursing_note,PROMPT1_entailment
50,143,15,12,3,0.8,2,1,1,0.5,0.6153846153846154,shc-gpt-4o,mimiciii,nursing_note,PROMPT1_entailment
51,144,8,7,1,0.875,5,5,0,1.0,0.9333333333333332,shc-gpt-4o,mimiciii,nursing_note,PROMPT1_entailment
52,145,8,8,0,1.0,19,19,0,1.0,1.0,shc-gpt-4o,mimiciii,nursing_note,PROMPT1_entailment
53,146,9,9,0,1.0,6,6,0,1.0,1.0,shc-gpt-4o,mimiciii,nursing_note,PROMPT1_entailment
54,147,34,29,5,0.8529411764705882,26,25,1,0.9615384615384616,0.9039900249376558,shc-gpt-4o,mimiciii,nursing_note,PROMPT1_entailment
55,148,11,9,2,0.8181818181818182,7,7,0,1.0,0.9,shc-gpt-4o,mimiciii,nursing_note,PROMPT1_entailment
56,149,13,11,2,0.8461538461538461,36,34,2,0.9444444444444444,0.8926014319809069,shc-gpt-4o,mimiciii,nursing_note,PROMPT1_entailment
57,15,31,27,4,0.8709677419354839,33,24,9,0.7272727272727273,0.7926605504587156,shc-gpt-4o,mimiciii,nursing_note,PROMPT1_entailment
58,150,14,13,1,0.9285714285714286,8,8,0,1.0,0.962962962962963,shc-gpt-4o,mimiciii,nursing_note,PROMPT1_entailment
59,151,40,32,8,0.8,26,24,2,0.9230769230769232,0.8571428571428571,shc-gpt-4o,mimiciii,nursing_note,PROMPT1_entailment
60,152,29,27,2,0.9310344827586208,44,36,8,0.8181818181818182,0.8709677419354839,shc-gpt-4o,mimiciii,nursing_note,PROMPT1_entailment
61,153,4,4,0,1.0,4,4,0,1.0,1.0,shc-gpt-4o,mimiciii,nursing_note,PROMPT1_entailment
62,154,42,35,7,0.8333333333333334,34,32,2,0.9411764705882352,0.8839779005524863,shc-gpt-4o,mimiciii,nursing_note,PROMPT1_entailment
63,155,43,42,1,0.9767441860465116,51,49,2,0.9607843137254902,0.9686985172981878,shc-gpt-4o,mimiciii,nursing_note,PROMPT1_entailment
64,156,25,23,2,0.92,26,18,8,0.6923076923076923,0.7900763358778625,shc-gpt-4o,mimiciii,nursing_note,PROMPT1_entailment
65,157,6,6,0,1.0,5,4,1,0.8,0.888888888888889,shc-gpt-4o,mimiciii,nursing_note,PROMPT1_entailment
66,158,35,32,3,0.9142857142857144,22,19,3,0.8636363636363636,0.8882395909422935,shc-gpt-4o,mimiciii,nursing_note,PROMPT1_entailment
67,159,11,11,0,1.0,8,8,0,1.0,1.0,shc-gpt-4o,mimiciii,nursing_note,PROMPT1_entailment
68,16,44,42,2,0.9545454545454546,30,25,5,0.8333333333333334,0.8898305084745762,shc-gpt-4o,mimiciii,nursing_note,PROMPT1_entailment
69,160,9,9,0,1.0,21,20,1,0.9523809523809524,0.975609756097561,shc-gpt-4o,mimiciii,nursing_note,PROMPT1_entailment
70,161,5,5,0,1.0,6,5,1,0.8333333333333334,0.9090909090909092,shc-gpt-4o,mimiciii,nursing_note,PROMPT1_entailment
71,162,43,33,10,0.7674418604651163,31,28,3,0.9032258064516128,0.8298158958239784,shc-gpt-4o,mimiciii,nursing_note,PROMPT1_entailment
72,163,8,8,0,1.0,4,4,0,1.0,1.0,shc-gpt-4o,mimiciii,nursing_note,PROMPT1_entailment
73,164,17,17,0,1.0,13,11,2,0.8461538461538461,0.9166666666666666,shc-gpt-4o,mimiciii,nursing_note,PROMPT1_entailment
74,165,29,28,1,0.9655172413793104,24,20,4,0.8333333333333334,0.8945686900958466,shc-gpt-4o,mimiciii,nursing_note,PROMPT1_entailment
75,166,12,12,0,1.0,3,3,0,1.0,1.0,shc-gpt-4o,mimiciii,nursing_note,PROMPT1_entailment
76,167,37,37,0,1.0,16,16,0,1.0,1.0,shc-gpt-4o,mimiciii,nursing_note,PROMPT1_entailment
77,168,29,20,9,0.6896551724137931,25,20,5,0.8,0.7407407407407408,shc-gpt-4o,mimiciii,nursing_note,PROMPT1_entailment
78,169,26,26,0,1.0,12,12,0,1.0,1.0,shc-gpt-4o,mimiciii,nursing_note,PROMPT1_entailment
79,17,32,31,1,0.96875,39,35,4,0.8974358974358975,0.9317303563761272,shc-gpt-4o,mimiciii,nursing_note,PROMPT1_entailment
80,170,9,8,1,0.8888888888888888,21,18,3,0.8571428571428571,0.8727272727272727,shc-gpt-4o,mimiciii,nursing_note,PROMPT1_entailment
81,171,9,7,2,0.7777777777777778,8,7,1,0.875,0.823529411764706,shc-gpt-4o,mimiciii,nursing_note,PROMPT1_entailment
82,172,41,37,4,0.902439024390244,38,28,10,0.7368421052631579,0.8112764291307752,shc-gpt-4o,mimiciii,nursing_note,PROMPT1_entailment
83,173,24,24,0,1.0,19,19,0,1.0,1.0,shc-gpt-4o,mimiciii,nursing_note,PROMPT1_entailment
84,174,9,9,0,1.0,8,6,2,0.75,0.8571428571428571,shc-gpt-4o,mimiciii,nursing_note,PROMPT1_entailment
85,175,5,5,0,1.0,4,4,0,1.0,1.0,shc-gpt-4o,mimiciii,nursing_note,PROMPT1_entailment
86,176,18,18,0,1.0,13,10,3,0.7692307692307693,0.8695652173913044,shc-gpt-4o,mimiciii,nursing_note,PROMPT1_entailment
87,177,41,40,1,0.975609756097561,38,33,5,0.868421052631579,0.9189001044204664,shc-gpt-4o,mimiciii,nursing_note,PROMPT1_entailment
88,178,8,8,0,1.0,25,23,2,0.92,0.9583333333333334,shc-gpt-4o,mimiciii,nursing_note,PROMPT1_entailment
89,179,44,39,5,0.8863636363636364,22,19,3,0.8636363636363636,0.8748524203069658,shc-gpt-4o,mimiciii,nursing_note,PROMPT1_entailment
90,18,7,7,0,1.0,25,19,6,0.76,0.8636363636363636,shc-gpt-4o,mimiciii,nursing_note,PROMPT1_entailment
91,180,33,32,1,0.9696969696969696,27,23,4,0.8518518518518519,0.906962415280345,shc-gpt-4o,mimiciii,nursing_note,PROMPT1_entailment
92,181,9,9,0,1.0,25,24,1,0.96,0.979591836734694,shc-gpt-4o,mimiciii,nursing_note,PROMPT1_entailment
93,182,23,21,2,0.9130434782608696,10,7,3,0.7,0.7924528301886793,shc-gpt-4o,mimiciii,nursing_note,PROMPT1_entailment
94,183,6,6,0,1.0,5,4,1,0.8,0.888888888888889,shc-gpt-4o,mimiciii,nursing_note,PROMPT1_entailment
95,184,16,16,0,1.0,1,1,0,1.0,1.0,shc-gpt-4o,mimiciii,nursing_note,PROMPT1_entailment
96,185,9,9,0,1.0,30,26,4,0.8666666666666667,0.9285714285714286,shc-gpt-4o,mimiciii,nursing_note,PROMPT1_entailment
97,186,6,5,1,0.8333333333333334,4,3,1,0.75,0.7894736842105262,shc-gpt-4o,mimiciii,nursing_note,PROMPT1_entailment
98,187,30,29,1,0.9666666666666668,37,32,5,0.8648648648648649,0.912936546974914,shc-gpt-4o,mimiciii,nursing_note,PROMPT1_entailment
99,188,4,4,0,1.0,2,2,0,1.0,1.0,shc-gpt-4o,mimiciii,nursing_note,PROMPT1_entailment
100,189,14,14,0,1.0,21,20,1,0.9523809523809524,0.975609756097561,shc-gpt-4o,mimiciii,nursing_note,PROMPT1_entailment
101,19,38,26,12,0.6842105263157895,45,29,16,0.6444444444444445,0.6637323943661971,shc-gpt-4o,mimiciii,nursing_note,PROMPT1_entailment
102,190,28,28,0,1.0,24,21,3,0.875,0.9333333333333332,shc-gpt-4o,mimiciii,nursing_note,PROMPT1_entailment
103,191,6,6,0,1.0,29,23,6,0.7931034482758621,0.8846153846153846,shc-gpt-4o,mimiciii,nursing_note,PROMPT1_entailment
104,192,15,15,0,1.0,15,14,1,0.9333333333333332,0.9655172413793104,shc-gpt-4o,mimiciii,nursing_note,PROMPT1_entailment
105,193,7,7,0,1.0,36,30,6,0.8333333333333334,0.9090909090909092,shc-gpt-4o,mimiciii,nursing_note,PROMPT1_entailment
106,194,13,13,0,1.0,11,10,1,0.9090909090909092,0.9523809523809524,shc-gpt-4o,mimiciii,nursing_note,PROMPT1_entailment
107,195,8,8,0,1.0,7,7,0,1.0,1.0,shc-gpt-4o,mimiciii,nursing_note,PROMPT1_entailment
108,196,11,11,0,1.0,34,30,4,0.8823529411764706,0.9375,shc-gpt-4o,mimiciii,nursing_note,PROMPT1_entailment
109,197,28,22,6,0.7857142857142857,27,26,1,0.9629629629629628,0.8653555219364598,shc-gpt-4o,mimiciii,nursing_note,PROMPT1_entailment
110,198,12,12,0,1.0,38,30,8,0.7894736842105263,0.8823529411764706,shc-gpt-4o,mimiciii,nursing_note,PROMPT1_entailment
111,199,13,13,0,1.0,14,13,1,0.9285714285714286,0.962962962962963,shc-gpt-4o,mimiciii,nursing_note,PROMPT1_entailment
112,2,50,25,25,0.5,43,32,11,0.7441860465116279,0.5981308411214953,shc-gpt-4o,mimiciii,nursing_note,PROMPT1_entailment
113,20,41,33,8,0.8048780487804879,46,41,5,0.8913043478260869,0.8458893404188809,shc-gpt-4o,mimiciii,nursing_note,PROMPT1_entailment
114,200,15,12,3,0.8,44,34,10,0.7727272727272727,0.7861271676300577,shc-gpt-4o,mimiciii,nursing_note,PROMPT1_entailment
115,201,24,24,0,1.0,29,28,1,0.9655172413793104,0.9824561403508772,shc-gpt-4o,mimiciii,nursing_note,PROMPT1_entailment
116,202,9,9,0,1.0,9,8,1,0.8888888888888888,0.9411764705882352,shc-gpt-4o,mimiciii,nursing_note,PROMPT1_entailment
117,203,8,8,0,1.0,7,7,0,1.0,1.0,shc-gpt-4o,mimiciii,nursing_note,PROMPT1_entailment
118,204,38,32,6,0.8421052631578947,24,22,2,0.9166666666666666,0.8778054862842893,shc-gpt-4o,mimiciii,nursing_note,PROMPT1_entailment
119,205,46,45,1,0.9782608695652174,47,37,10,0.7872340425531915,0.872412889703956,shc-gpt-4o,mimiciii,nursing_note,PROMPT1_entailment
120,206,6,6,0,1.0,6,6,0,1.0,1.0,shc-gpt-4o,mimiciii,nursing_note,PROMPT1_entailment
121,207,9,9,0,1.0,29,22,7,0.7586206896551724,0.8627450980392156,shc-gpt-4o,mimiciii,nursing_note,PROMPT1_entailment
122,208,12,12,0,1.0,7,7,0,1.0,1.0,shc-gpt-4o,mimiciii,nursing_note,PROMPT1_entailment
123,209,6,6,0,1.0,2,2,0,1.0,1.0,shc-gpt-4o,mimiciii,nursing_note,PROMPT1_entailment
124,21,6,6,0,1.0,6,5,1,0.8333333333333334,0.9090909090909092,shc-gpt-4o,mimiciii,nursing_note,PROMPT1_entailment
125,210,25,20,5,0.8,22,22,0,1.0,0.888888888888889,shc-gpt-4o,mimiciii,nursing_note,PROMPT1_entailment
126,211,3,3,0,1.0,4,4,0,1.0,1.0,shc-gpt-4o,mimiciii,nursing_note,PROMPT1_entailment
127,212,55,52,3,0.9454545454545454,37,35,2,0.945945945945946,0.9457001818654196,shc-gpt-4o,mimiciii,nursing_note,PROMPT1_entailment
128,213,19,17,2,0.8947368421052632,18,16,2,0.8888888888888888,0.8918032786885245,shc-gpt-4o,mimiciii,nursing_note,PROMPT1_entailment
129,214,8,8,0,1.0,3,3,0,1.0,1.0,shc-gpt-4o,mimiciii,nursing_note,PROMPT1_entailment
130,215,7,7,0,1.0,7,7,0,1.0,1.0,shc-gpt-4o,mimiciii,nursing_note,PROMPT1_entailment
131,216,26,22,4,0.8461538461538461,13,9,4,0.6923076923076923,0.7615384615384616,shc-gpt-4o,mimiciii,nursing_note,PROMPT1_entailment
132,217,17,16,1,0.9411764705882352,25,24,1,0.96,0.9504950495049505,shc-gpt-4o,mimiciii,nursing_note,PROMPT1_entailment
133,218,20,17,3,0.85,18,18,0,1.0,0.9189189189189187,shc-gpt-4o,mimiciii,nursing_note,PROMPT1_entailment
134,219,32,29,3,0.90625,14,14,0,1.0,0.9508196721311476,shc-gpt-4o,mimiciii,nursing_note,PROMPT1_entailment
135,22,7,7,0,1.0,26,22,4,0.8461538461538461,0.9166666666666666,shc-gpt-4o,mimiciii,nursing_note,PROMPT1_entailment
136,220,11,9,2,0.8181818181818182,5,4,1,0.8,0.8089887640449439,shc-gpt-4o,mimiciii,nursing_note,PROMPT1_entailment
137,221,29,26,3,0.896551724137931,35,28,7,0.8,0.8455284552845529,shc-gpt-4o,mimiciii,nursing_note,PROMPT1_entailment
138,222,5,5,0,1.0,3,3,0,1.0,1.0,shc-gpt-4o,mimiciii,nursing_note,PROMPT1_entailment
139,223,10,6,4,0.6,30,27,3,0.9,0.7200000000000001,shc-gpt-4o,mimiciii,nursing_note,PROMPT1_entailment
140,224,10,8,2,0.8,6,6,0,1.0,0.888888888888889,shc-gpt-4o,mimiciii,nursing_note,PROMPT1_entailment
141,225,59,35,24,0.5932203389830508,45,43,2,0.9555555555555556,0.7320038910505837,shc-gpt-4o,mimiciii,nursing_note,PROMPT1_entailment
142,226,23,22,1,0.9565217391304348,20,19,1,0.95,0.9532497149372862,shc-gpt-4o,mimiciii,nursing_note,PROMPT1_entailment
143,227,20,18,2,0.9,15,14,1,0.9333333333333332,0.9163636363636364,shc-gpt-4o,mimiciii,nursing_note,PROMPT1_entailment
144,228,36,31,5,0.8611111111111112,38,34,4,0.8947368421052632,0.877601998334721,shc-gpt-4o,mimiciii,nursing_note,PROMPT1_entailment
145,229,24,22,2,0.9166666666666666,22,21,1,0.9545454545454546,0.9352226720647774,shc-gpt-4o,mimiciii,nursing_note,PROMPT1_entailment
146,23,10,7,3,0.7,35,31,4,0.8857142857142857,0.7819819819819819,shc-gpt-4o,mimiciii,nursing_note,PROMPT1_entailment
147,230,13,13,0,1.0,7,6,1,0.8571428571428571,0.923076923076923,shc-gpt-4o,mimiciii,nursing_note,PROMPT1_entailment
148,231,48,47,1,0.9791666666666666,15,14,1,0.9333333333333332,0.9557007988380536,shc-gpt-4o,mimiciii,nursing_note,PROMPT1_entailment
149,232,10,10,0,1.0,2,2,0,1.0,1.0,shc-gpt-4o,mimiciii,nursing_note,PROMPT1_entailment
150,233,29,28,1,0.9655172413793104,33,27,6,0.8181818181818182,0.8857644991212654,shc-gpt-4o,mimiciii,nursing_note,PROMPT1_entailment
151,234,36,36,0,1.0,32,27,5,0.84375,0.9152542372881356,shc-gpt-4o,mimiciii,nursing_note,PROMPT1_entailment
152,235,14,14,0,1.0,10,10,0,1.0,1.0,shc-gpt-4o,mimiciii,nursing_note,PROMPT1_entailment
153,236,13,11,2,0.8461538461538461,7,6,1,0.8571428571428571,0.8516129032258064,shc-gpt-4o,mimiciii,nursing_note,PROMPT1_entailment
154,237,37,32,5,0.8648648648648649,35,28,7,0.8,0.8311688311688312,shc-gpt-4o,mimiciii,nursing_note,PROMPT1_entailment
155,238,52,43,9,0.8269230769230769,42,36,6,0.8571428571428571,0.8417618270799347,shc-gpt-4o,mimiciii,nursing_note,PROMPT1_entailment
156,239,8,7,1,0.875,21,21,0,1.0,0.9333333333333332,shc-gpt-4o,mimiciii,nursing_note,PROMPT1_entailment
157,24,8,8,0,1.0,5,5,0,1.0,1.0,shc-gpt-4o,mimiciii,nursing_note,PROMPT1_entailment
158,240,34,32,2,0.9411764705882352,42,34,8,0.8095238095238095,0.8704,shc-gpt-4o,mimiciii,nursing_note,PROMPT1_entailment
159,241,25,21,4,0.84,21,19,2,0.9047619047619048,0.87117903930131,shc-gpt-4o,mimiciii,nursing_note,PROMPT1_entailment
160,242,31,27,4,0.8709677419354839,16,13,3,0.8125,0.8407185628742514,shc-gpt-4o,mimiciii,nursing_note,PROMPT1_entailment
161,243,7,7,0,1.0,5,3,2,0.6,0.7499999999999999,shc-gpt-4o,mimiciii,nursing_note,PROMPT1_entailment
162,244,36,30,6,0.8333333333333334,16,14,2,0.875,0.8536585365853658,shc-gpt-4o,mimiciii,nursing_note,PROMPT1_entailment
163,245,29,27,2,0.9310344827586208,37,36,1,0.972972972972973,0.9515418502202644,shc-gpt-4o,mimiciii,nursing_note,PROMPT1_entailment
164,246,32,29,3,0.90625,10,8,2,0.8,0.8498168498168499,shc-gpt-4o,mimiciii,nursing_note,PROMPT1_entailment
165,247,8,8,0,1.0,6,4,2,0.6666666666666666,0.8,shc-gpt-4o,mimiciii,nursing_note,PROMPT1_entailment
166,248,55,51,4,0.9272727272727272,42,38,4,0.9047619047619048,0.9158790170132324,shc-gpt-4o,mimiciii,nursing_note,PROMPT1_entailment
167,249,42,36,6,0.8571428571428571,39,33,6,0.8461538461538461,0.8516129032258064,shc-gpt-4o,mimiciii,nursing_note,PROMPT1_entailment
168,25,37,34,3,0.918918918918919,23,21,2,0.9130434782608696,0.9159717767799872,shc-gpt-4o,mimiciii,nursing_note,PROMPT1_entailment
169,26,38,37,1,0.9736842105263158,35,32,3,0.9142857142857144,0.9430505774591796,shc-gpt-4o,mimiciii,nursing_note,PROMPT1_entailment
170,27,5,5,0,1.0,3,2,1,0.6666666666666666,0.8,shc-gpt-4o,mimiciii,nursing_note,PROMPT1_entailment
171,28,50,42,8,0.84,16,14,2,0.875,0.8571428571428572,shc-gpt-4o,mimiciii,nursing_note,PROMPT1_entailment
172,29,36,33,3,0.9166666666666666,33,29,4,0.8787878787878788,0.8973277074542897,shc-gpt-4o,mimiciii,nursing_note,PROMPT1_entailment
173,3,11,9,2,0.8181818181818182,6,5,1,0.8333333333333334,0.8256880733944955,shc-gpt-4o,mimiciii,nursing_note,PROMPT1_entailment
174,30,15,15,0,1.0,13,10,3,0.7692307692307693,0.8695652173913044,shc-gpt-4o,mimiciii,nursing_note,PROMPT1_entailment
175,31,22,21,1,0.9545454545454546,19,16,3,0.8421052631578947,0.8948069241011983,shc-gpt-4o,mimiciii,nursing_note,PROMPT1_entailment
176,32,52,51,1,0.9807692307692308,44,41,3,0.9318181818181818,0.9556672760511884,shc-gpt-4o,mimiciii,nursing_note,PROMPT1_entailment
177,33,8,8,0,1.0,5,5,0,1.0,1.0,shc-gpt-4o,mimiciii,nursing_note,PROMPT1_entailment
178,34,3,3,0,1.0,3,3,0,1.0,1.0,shc-gpt-4o,mimiciii,nursing_note,PROMPT1_entailment
179,35,16,16,0,1.0,7,7,0,1.0,1.0,shc-gpt-4o,mimiciii,nursing_note,PROMPT1_entailment
180,36,73,64,9,0.8767123287671232,62,53,9,0.8548387096774194,0.8656373612351665,shc-gpt-4o,mimiciii,nursing_note,PROMPT1_entailment
181,37,36,27,9,0.75,38,35,3,0.9210526315789472,0.8267716535433071,shc-gpt-4o,mimiciii,nursing_note,PROMPT1_entailment
182,38,29,21,8,0.7241379310344828,26,24,2,0.9230769230769232,0.8115942028985507,shc-gpt-4o,mimiciii,nursing_note,PROMPT1_entailment
183,39,21,21,0,1.0,3,2,1,0.6666666666666666,0.8,shc-gpt-4o,mimiciii,nursing_note,PROMPT1_entailment
184,4,35,32,3,0.9142857142857144,26,21,5,0.8076923076923077,0.8576898532227186,shc-gpt-4o,mimiciii,nursing_note,PROMPT1_entailment
185,40,7,6,1,0.8571428571428571,3,3,0,1.0,0.923076923076923,shc-gpt-4o,mimiciii,nursing_note,PROMPT1_entailment
186,41,43,40,3,0.9302325581395348,50,42,8,0.84,0.882816605359958,shc-gpt-4o,mimiciii,nursing_note,PROMPT1_entailment
187,42,27,23,4,0.8518518518518519,7,7,0,1.0,0.92,shc-gpt-4o,mimiciii,nursing_note,PROMPT1_entailment
188,43,24,21,3,0.875,14,13,1,0.9285714285714286,0.900990099009901,shc-gpt-4o,mimiciii,nursing_note,PROMPT1_entailment
189,44,6,6,0,1.0,3,3,0,1.0,1.0,shc-gpt-4o,mimiciii,nursing_note,PROMPT1_entailment
190,45,10,9,1,0.9,34,29,5,0.8529411764705882,0.8758389261744965,shc-gpt-4o,mimiciii,nursing_note,PROMPT1_entailment
191,46,9,8,1,0.8888888888888888,31,21,10,0.6774193548387096,0.7688787185354691,shc-gpt-4o,mimiciii,nursing_note,PROMPT1_entailment
192,47,32,29,3,0.90625,14,13,1,0.9285714285714286,0.9172749391727496,shc-gpt-4o,mimiciii,nursing_note,PROMPT1_entailment
193,48,13,13,0,1.0,9,8,1,0.8888888888888888,0.9411764705882352,shc-gpt-4o,mimiciii,nursing_note,PROMPT1_entailment
194,49,7,7,0,1.0,3,2,1,0.6666666666666666,0.8,shc-gpt-4o,mimiciii,nursing_note,PROMPT1_entailment
195,5,11,10,1,0.9090909090909092,15,15,0,1.0,0.9523809523809524,shc-gpt-4o,mimiciii,nursing_note,PROMPT1_entailment
196,50,23,19,4,0.8260869565217391,16,12,4,0.75,0.786206896551724,shc-gpt-4o,mimiciii,nursing_note,PROMPT1_entailment
197,51,9,9,0,1.0,6,5,1,0.8333333333333334,0.9090909090909092,shc-gpt-4o,mimiciii,nursing_note,PROMPT1_entailment
198,52,39,33,6,0.8461538461538461,38,29,9,0.7631578947368421,0.8025157232704403,shc-gpt-4o,mimiciii,nursing_note,PROMPT1_entailment
199,53,8,7,1,0.875,6,5,1,0.8333333333333334,0.8536585365853658,shc-gpt-4o,mimiciii,nursing_note,PROMPT1_entailment
200,54,43,37,6,0.8604651162790697,37,28,9,0.7567567567567568,0.8052856587640886,shc-gpt-4o,mimiciii,nursing_note,PROMPT1_entailment
201,55,8,7,1,0.875,35,30,5,0.8571428571428571,0.8659793814432989,shc-gpt-4o,mimiciii,nursing_note,PROMPT1_entailment
202,56,9,9,0,1.0,2,2,0,1.0,1.0,shc-gpt-4o,mimiciii,nursing_note,PROMPT1_entailment
203,57,61,52,9,0.8524590163934426,17,15,2,0.8823529411764706,0.867148415786548,shc-gpt-4o,mimiciii,nursing_note,PROMPT1_entailment
204,58,41,39,2,0.951219512195122,25,20,5,0.8,0.8690807799442897,shc-gpt-4o,mimiciii,nursing_note,PROMPT1_entailment
205,59,12,12,0,1.0,8,7,1,0.875,0.9333333333333332,shc-gpt-4o,mimiciii,nursing_note,PROMPT1_entailment
206,6,10,10,0,1.0,8,8,0,1.0,1.0,shc-gpt-4o,mimiciii,nursing_note,PROMPT1_entailment
207,60,44,38,6,0.8636363636363636,27,20,7,0.7407407407407407,0.7974816369359916,shc-gpt-4o,mimiciii,nursing_note,PROMPT1_entailment
208,61,24,17,7,0.7083333333333334,20,17,3,0.85,0.7727272727272727,shc-gpt-4o,mimiciii,nursing_note,PROMPT1_entailment
209,62,34,29,5,0.8529411764705882,37,31,6,0.8378378378378378,0.845322049835449,shc-gpt-4o,mimiciii,nursing_note,PROMPT1_entailment
210,63,8,7,1,0.875,5,5,0,1.0,0.9333333333333332,shc-gpt-4o,mimiciii,nursing_note,PROMPT1_entailment
211,64,43,43,0,1.0,27,25,2,0.925925925925926,0.9615384615384616,shc-gpt-4o,mimiciii,nursing_note,PROMPT1_entailment
212,65,15,15,0,1.0,19,16,3,0.8421052631578947,0.9142857142857144,shc-gpt-4o,mimiciii,nursing_note,PROMPT1_entailment
213,66,6,6,0,1.0,1,1,0,1.0,1.0,shc-gpt-4o,mimiciii,nursing_note,PROMPT1_entailment
214,67,10,9,1,0.9,7,4,3,0.5714285714285714,0.6990291262135921,shc-gpt-4o,mimiciii,nursing_note,PROMPT1_entailment
215,68,28,27,1,0.9642857142857144,18,15,3,0.8333333333333334,0.8940397350993378,shc-gpt-4o,mimiciii,nursing_note,PROMPT1_entailment
216,69,37,32,5,0.8648648648648649,25,23,2,0.92,0.8915808600847972,shc-gpt-4o,mimiciii,nursing_note,PROMPT1_entailment
217,7,5,5,0,1.0,2,2,0,1.0,1.0,shc-gpt-4o,mimiciii,nursing_note,PROMPT1_entailment
218,70,11,11,0,1.0,45,36,9,0.8,0.888888888888889,shc-gpt-4o,mimiciii,nursing_note,PROMPT1_entailment
219,71,47,32,15,0.6808510638297872,51,43,8,0.8431372549019608,0.7533534081576786,shc-gpt-4o,mimiciii,nursing_note,PROMPT1_entailment
220,72,18,18,0,1.0,12,9,3,0.75,0.8571428571428571,shc-gpt-4o,mimiciii,nursing_note,PROMPT1_entailment
221,73,16,16,0,1.0,38,29,9,0.7631578947368421,0.8656716417910448,shc-gpt-4o,mimiciii,nursing_note,PROMPT1_entailment
222,74,7,7,0,1.0,7,6,1,0.8571428571428571,0.923076923076923,shc-gpt-4o,mimiciii,nursing_note,PROMPT1_entailment
223,75,29,25,4,0.8620689655172413,27,23,4,0.8518518518518519,0.856929955290611,shc-gpt-4o,mimiciii,nursing_note,PROMPT1_entailment
224,76,4,4,0,1.0,1,1,0,1.0,1.0,shc-gpt-4o,mimiciii,nursing_note,PROMPT1_entailment
225,77,64,49,15,0.765625,59,49,10,0.8305084745762712,0.7967479674796748,shc-gpt-4o,mimiciii,nursing_note,PROMPT1_entailment
226,78,10,8,2,0.8,20,18,2,0.9,0.8470588235294118,shc-gpt-4o,mimiciii,nursing_note,PROMPT1_entailment
227,79,9,8,1,0.8888888888888888,30,27,3,0.9,0.8944099378881988,shc-gpt-4o,mimiciii,nursing_note,PROMPT1_entailment
228,8,13,12,1,0.9230769230769232,11,9,2,0.8181818181818182,0.8674698795180724,shc-gpt-4o,mimiciii,nursing_note,PROMPT1_entailment
229,80,36,34,2,0.9444444444444444,22,20,2,0.9090909090909092,0.9264305177111716,shc-gpt-4o,mimiciii,nursing_note,PROMPT1_entailment
230,81,11,10,1,0.9090909090909092,22,19,3,0.8636363636363636,0.8857808857808858,shc-gpt-4o,mimiciii,nursing_note,PROMPT1_entailment
231,82,26,21,5,0.8076923076923077,17,14,3,0.8235294117647058,0.8155339805825242,shc-gpt-4o,mimiciii,nursing_note,PROMPT1_entailment
232,83,20,16,4,0.8,28,25,3,0.8928571428571429,0.8438818565400844,shc-gpt-4o,mimiciii,nursing_note,PROMPT1_entailment
233,84,10,10,0,1.0,6,5,1,0.8333333333333334,0.9090909090909092,shc-gpt-4o,mimiciii,nursing_note,PROMPT1_entailment
234,85,42,35,7,0.8333333333333334,24,20,4,0.8333333333333334,0.8333333333333334,shc-gpt-4o,mimiciii,nursing_note,PROMPT1_entailment
235,86,45,41,4,0.9111111111111112,40,37,3,0.925,0.918003025718608,shc-gpt-4o,mimiciii,nursing_note,PROMPT1_entailment
236,87,23,22,1,0.9565217391304348,15,12,3,0.8,0.8712871287128713,shc-gpt-4o,mimiciii,nursing_note,PROMPT1_entailment
237,88,53,41,12,0.7735849056603774,15,15,0,1.0,0.8723404255319149,shc-gpt-4o,mimiciii,nursing_note,PROMPT1_entailment
238,89,11,11,0,1.0,29,28,1,0.9655172413793104,0.9824561403508772,shc-gpt-4o,mimiciii,nursing_note,PROMPT1_entailment
239,9,38,38,0,1.0,17,14,3,0.8235294117647058,0.9032258064516128,shc-gpt-4o,mimiciii,nursing_note,PROMPT1_entailment
240,90,31,28,3,0.9032258064516128,14,12,2,0.8571428571428571,0.8795811518324608,shc-gpt-4o,mimiciii,nursing_note,PROMPT1_entailment
241,91,7,6,1,0.8571428571428571,24,20,4,0.8333333333333334,0.8450704225352113,shc-gpt-4o,mimiciii,nursing_note,PROMPT1_entailment
242,92,9,9,0,1.0,28,26,2,0.9285714285714286,0.962962962962963,shc-gpt-4o,mimiciii,nursing_note,PROMPT1_entailment
243,93,29,28,1,0.9655172413793104,23,22,1,0.9565217391304348,0.9609984399375976,shc-gpt-4o,mimiciii,nursing_note,PROMPT1_entailment
244,94,7,7,0,1.0,5,5,0,1.0,1.0,shc-gpt-4o,mimiciii,nursing_note,PROMPT1_entailment
245,95,29,27,2,0.9310344827586208,14,11,3,0.7857142857142857,0.8522238163558106,shc-gpt-4o,mimiciii,nursing_note,PROMPT1_entailment
246,96,6,6,0,1.0,6,6,0,1.0,1.0,shc-gpt-4o,mimiciii,nursing_note,PROMPT1_entailment
247,97,10,10,0,1.0,10,10,0,1.0,1.0,shc-gpt-4o,mimiciii,nursing_note,PROMPT1_entailment
248,98,13,12,1,0.9230769230769232,13,11,2,0.8461538461538461,0.8829431438127091,shc-gpt-4o,mimiciii,nursing_note,PROMPT1_entailment
249,99,54,44,10,0.8148148148148148,44,40,4,0.9090909090909092,0.859375,shc-gpt-4o,mimiciii,nursing_note,PROMPT1_entailment
0,0,22,21,1,0.9545454545454546,11,11,0,1.0,0.9767441860465116,shc-gpt-4o,mimiciii,nursing_note,PROMPT1_ICL_entailment
1,1,49,31,18,0.6326530612244898,31,26,5,0.8387096774193549,0.7212527964205816,shc-gpt-4o,mimiciii,nursing_note,PROMPT1_ICL_entailment
2,10,27,23,4,0.8518518518518519,18,14,4,0.7777777777777778,0.813131313131313,shc-gpt-4o,mimiciii,nursing_note,PROMPT1_ICL_entailment
3,100,12,12,0,1.0,6,6,0,1.0,1.0,shc-gpt-4o,mimiciii,nursing_note,PROMPT1_ICL_entailment
4,101,42,35,7,0.8333333333333334,27,26,1,0.9629629629629628,0.8934707903780069,shc-gpt-4o,mimiciii,nursing_note,PROMPT1_ICL_entailment
5,102,39,36,3,0.9230769230769232,26,23,3,0.8846153846153846,0.9034369885433716,shc-gpt-4o,mimiciii,nursing_note,PROMPT1_ICL_entailment
6,103,28,27,1,0.9642857142857144,22,22,0,1.0,0.9818181818181818,shc-gpt-4o,mimiciii,nursing_note,PROMPT1_ICL_entailment
7,104,31,30,1,0.967741935483871,20,20,0,1.0,0.9836065573770492,shc-gpt-4o,mimiciii,nursing_note,PROMPT1_ICL_entailment
8,105,48,45,3,0.9375,20,18,2,0.9,0.9183673469387756,shc-gpt-4o,mimiciii,nursing_note,PROMPT1_ICL_entailment
9,106,6,6,0,1.0,4,4,0,1.0,1.0,shc-gpt-4o,mimiciii,nursing_note,PROMPT1_ICL_entailment
10,107,79,72,7,0.9113924050632912,49,43,6,0.8775510204081632,0.8941516245487365,shc-gpt-4o,mimiciii,nursing_note,PROMPT1_ICL_entailment
11,108,52,51,1,0.9807692307692308,28,25,3,0.8928571428571429,0.93475073313783,shc-gpt-4o,mimiciii,nursing_note,PROMPT1_ICL_entailment
12,109,6,6,0,1.0,4,4,0,1.0,1.0,shc-gpt-4o,mimiciii,nursing_note,PROMPT1_ICL_entailment
13,11,4,4,0,1.0,2,2,0,1.0,1.0,shc-gpt-4o,mimiciii,nursing_note,PROMPT1_ICL_entailment
14,110,20,20,0,1.0,13,13,0,1.0,1.0,shc-gpt-4o,mimiciii,nursing_note,PROMPT1_ICL_entailment
15,111,40,34,6,0.85,32,28,4,0.875,0.8623188405797101,shc-gpt-4o,mimiciii,nursing_note,PROMPT1_ICL_entailment
16,112,59,51,8,0.864406779661017,37,31,6,0.8378378378378378,0.8509149623250807,shc-gpt-4o,mimiciii,nursing_note,PROMPT1_ICL_entailment
17,113,8,7,1,0.875,5,5,0,1.0,0.9333333333333332,shc-gpt-4o,mimiciii,nursing_note,PROMPT1_ICL_entailment
18,114,26,21,5,0.8076923076923077,19,17,2,0.8947368421052632,0.8489892984542212,shc-gpt-4o,mimiciii,nursing_note,PROMPT1_ICL_entailment
19,115,15,13,2,0.8666666666666667,7,5,2,0.7142857142857143,0.7831325301204819,shc-gpt-4o,mimiciii,nursing_note,PROMPT1_ICL_entailment
20,116,42,41,1,0.9761904761904762,31,29,2,0.935483870967742,0.9554037766171152,shc-gpt-4o,mimiciii,nursing_note,PROMPT1_ICL_entailment
21,117,47,39,8,0.8297872340425532,18,14,4,0.7777777777777778,0.8029411764705883,shc-gpt-4o,mimiciii,nursing_note,PROMPT1_ICL_entailment
22,118,38,32,6,0.8421052631578947,25,21,4,0.84,0.8410513141426784,shc-gpt-4o,mimiciii,nursing_note,PROMPT1_ICL_entailment
23,119,39,38,1,0.9743589743589745,26,21,5,0.8076923076923077,0.8832318760376315,shc-gpt-4o,mimiciii,nursing_note,PROMPT1_ICL_entailment
24,12,33,31,2,0.9393939393939394,18,15,3,0.8333333333333334,0.8831908831908831,shc-gpt-4o,mimiciii,nursing_note,PROMPT1_ICL_entailment
25,120,29,28,1,0.9655172413793104,18,18,0,1.0,0.9824561403508772,shc-gpt-4o,mimiciii,nursing_note,PROMPT1_ICL_entailment
26,121,66,60,6,0.9090909090909092,37,31,6,0.8378378378378378,0.8720112517580871,shc-gpt-4o,mimiciii,nursing_note,PROMPT1_ICL_entailment
27,122,36,35,1,0.9722222222222222,11,10,1,0.9090909090909092,0.9395973154362416,shc-gpt-4o,mimiciii,nursing_note,PROMPT1_ICL_entailment
28,123,8,8,0,1.0,6,6,0,1.0,1.0,shc-gpt-4o,mimiciii,nursing_note,PROMPT1_ICL_entailment
29,124,10,10,0,1.0,5,5,0,1.0,1.0,shc-gpt-4o,mimiciii,nursing_note,PROMPT1_ICL_entailment
30,125,62,59,3,0.9516129032258064,43,40,3,0.9302325581395348,0.9408012756627468,shc-gpt-4o,mimiciii,nursing_note,PROMPT1_ICL_entailment
31,126,42,34,8,0.8095238095238095,28,20,8,0.7142857142857143,0.7589285714285714,shc-gpt-4o,mimiciii,nursing_note,PROMPT1_ICL_entailment
32,127,26,23,3,0.8846153846153846,10,9,1,0.9,0.8922413793103449,shc-gpt-4o,mimiciii,nursing_note,PROMPT1_ICL_entailment
33,128,36,35,1,0.9722222222222222,17,17,0,1.0,0.9859154929577464,shc-gpt-4o,mimiciii,nursing_note,PROMPT1_ICL_entailment
34,129,39,36,3,0.9230769230769232,6,5,1,0.8333333333333334,0.8759124087591241,shc-gpt-4o,mimiciii,nursing_note,PROMPT1_ICL_entailment
35,13,71,66,5,0.9295774647887324,34,30,4,0.8823529411764706,0.9053497942386832,shc-gpt-4o,mimiciii,nursing_note,PROMPT1_ICL_entailment
36,130,56,50,6,0.8928571428571429,33,30,3,0.9090909090909092,0.9009009009009008,shc-gpt-4o,mimiciii,nursing_note,PROMPT1_ICL_entailment
37,131,44,42,2,0.9545454545454546,31,26,5,0.8387096774193549,0.892886345053148,shc-gpt-4o,mimiciii,nursing_note,PROMPT1_ICL_entailment
38,132,47,44,3,0.9361702127659576,17,16,1,0.9411764705882352,0.9386666666666666,shc-gpt-4o,mimiciii,nursing_note,PROMPT1_ICL_entailment
39,133,20,17,3,0.85,10,10,0,1.0,0.9189189189189187,shc-gpt-4o,mimiciii,nursing_note,PROMPT1_ICL_entailment
40,134,67,40,27,0.5970149253731343,30,23,7,0.7666666666666667,0.6712878511492156,shc-gpt-4o,mimiciii,nursing_note,PROMPT1_ICL_entailment
41,135,92,77,15,0.8369565217391305,42,38,4,0.9047619047619048,0.8695393759286776,shc-gpt-4o,mimiciii,nursing_note,PROMPT1_ICL_entailment
42,136,66,61,5,0.9242424242424242,41,40,1,0.975609756097561,0.9492316669908576,shc-gpt-4o,mimiciii,nursing_note,PROMPT1_ICL_entailment
43,137,5,4,1,0.8,2,2,0,1.0,0.888888888888889,shc-gpt-4o,mimiciii,nursing_note,PROMPT1_ICL_entailment
44,138,8,8,0,1.0,5,5,0,1.0,1.0,shc-gpt-4o,mimiciii,nursing_note,PROMPT1_ICL_entailment
45,139,10,7,3,0.7,4,4,0,1.0,0.8235294117647058,shc-gpt-4o,mimiciii,nursing_note,PROMPT1_ICL_entailment
46,14,40,39,1,0.975,25,24,1,0.96,0.9674418604651162,shc-gpt-4o,mimiciii,nursing_note,PROMPT1_ICL_entailment
47,140,46,42,4,0.9130434782608696,24,20,4,0.8333333333333334,0.871369294605809,shc-gpt-4o,mimiciii,nursing_note,PROMPT1_ICL_entailment
48,141,18,17,1,0.9444444444444444,11,10,1,0.9090909090909092,0.9264305177111716,shc-gpt-4o,mimiciii,nursing_note,PROMPT1_ICL_entailment
49,142,61,52,9,0.8524590163934426,8,8,0,1.0,0.9203539823008848,shc-gpt-4o,mimiciii,nursing_note,PROMPT1_ICL_entailment
50,143,18,17,1,0.9444444444444444,2,2,0,1.0,0.9714285714285714,shc-gpt-4o,mimiciii,nursing_note,PROMPT1_ICL_entailment
51,144,9,9,0,1.0,5,5,0,1.0,1.0,shc-gpt-4o,mimiciii,nursing_note,PROMPT1_ICL_entailment
52,145,44,43,1,0.9772727272727272,19,15,4,0.7894736842105263,0.8733920108327692,shc-gpt-4o,mimiciii,nursing_note,PROMPT1_ICL_entailment
53,146,12,11,1,0.9166666666666666,6,6,0,1.0,0.9565217391304348,shc-gpt-4o,mimiciii,nursing_note,PROMPT1_ICL_entailment
54,147,47,41,6,0.8723404255319149,26,23,3,0.8846153846153846,0.8784350256171403,shc-gpt-4o,mimiciii,nursing_note,PROMPT1_ICL_entailment
55,148,17,15,2,0.8823529411764706,7,7,0,1.0,0.9375,shc-gpt-4o,mimiciii,nursing_note,PROMPT1_ICL_entailment
56,149,56,45,11,0.8035714285714286,36,30,6,0.8333333333333334,0.8181818181818182,shc-gpt-4o,mimiciii,nursing_note,PROMPT1_ICL_entailment
57,15,35,30,5,0.8571428571428571,33,25,8,0.7575757575757576,0.804289544235925,shc-gpt-4o,mimiciii,nursing_note,PROMPT1_ICL_entailment
58,150,16,15,1,0.9375,8,8,0,1.0,0.967741935483871,shc-gpt-4o,mimiciii,nursing_note,PROMPT1_ICL_entailment
59,151,39,34,5,0.8717948717948718,26,25,1,0.9615384615384616,0.914470145239376,shc-gpt-4o,mimiciii,nursing_note,PROMPT1_ICL_entailment
60,152,56,49,7,0.875,44,32,12,0.7272727272727273,0.7943262411347517,shc-gpt-4o,mimiciii,nursing_note,PROMPT1_ICL_entailment
61,153,6,6,0,1.0,4,4,0,1.0,1.0,shc-gpt-4o,mimiciii,nursing_note,PROMPT1_ICL_entailment
62,154,42,39,3,0.9285714285714286,34,31,3,0.9117647058823528,0.9200913242009132,shc-gpt-4o,mimiciii,nursing_note,PROMPT1_ICL_entailment
63,155,65,61,4,0.9384615384615383,51,45,6,0.8823529411764706,0.9095427435387672,shc-gpt-4o,mimiciii,nursing_note,PROMPT1_ICL_entailment
64,156,29,28,1,0.9655172413793104,26,21,5,0.8076923076923077,0.8795811518324608,shc-gpt-4o,mimiciii,nursing_note,PROMPT1_ICL_entailment
65,157,9,9,0,1.0,5,4,1,0.8,0.888888888888889,shc-gpt-4o,mimiciii,nursing_note,PROMPT1_ICL_entailment
66,158,40,39,1,0.975,22,21,1,0.9545454545454546,0.9646643109540636,shc-gpt-4o,mimiciii,nursing_note,PROMPT1_ICL_entailment
67,159,19,16,3,0.8421052631578947,8,7,1,0.875,0.8582375478927203,shc-gpt-4o,mimiciii,nursing_note,PROMPT1_ICL_entailment
68,16,55,49,6,0.8909090909090909,30,29,1,0.9666666666666668,0.9272430668841762,shc-gpt-4o,mimiciii,nursing_note,PROMPT1_ICL_entailment
69,160,46,43,3,0.9347826086956522,21,20,1,0.9523809523809524,0.943499725726824,shc-gpt-4o,mimiciii,nursing_note,PROMPT1_ICL_entailment
70,161,7,7,0,1.0,6,5,1,0.8333333333333334,0.9090909090909092,shc-gpt-4o,mimiciii,nursing_note,PROMPT1_ICL_entailment
71,162,43,39,4,0.9069767441860463,31,23,8,0.7419354838709677,0.816196542311192,shc-gpt-4o,mimiciii,nursing_note,PROMPT1_ICL_entailment
72,163,12,12,0,1.0,4,4,0,1.0,1.0,shc-gpt-4o,mimiciii,nursing_note,PROMPT1_ICL_entailment
73,164,23,23,0,1.0,13,12,1,0.9230769230769232,0.96,shc-gpt-4o,mimiciii,nursing_note,PROMPT1_ICL_entailment
74,165,56,50,6,0.8928571428571429,24,20,4,0.8333333333333334,0.8620689655172413,shc-gpt-4o,mimiciii,nursing_note,PROMPT1_ICL_entailment
75,166,17,17,0,1.0,3,3,0,1.0,1.0,shc-gpt-4o,mimiciii,nursing_note,PROMPT1_ICL_entailment
76,167,38,38,0,1.0,16,16,0,1.0,1.0,shc-gpt-4o,mimiciii,nursing_note,PROMPT1_ICL_entailment
77,168,46,37,9,0.8043478260869565,25,17,8,0.68,0.7369654364381956,shc-gpt-4o,mimiciii,nursing_note,PROMPT1_ICL_entailment
78,169,27,27,0,1.0,12,12,0,1.0,1.0,shc-gpt-4o,mimiciii,nursing_note,PROMPT1_ICL_entailment
79,17,42,41,1,0.9761904761904762,39,33,6,0.8461538461538461,0.9065326633165828,shc-gpt-4o,mimiciii,nursing_note,PROMPT1_ICL_entailment
80,170,50,46,4,0.92,21,20,1,0.9523809523809524,0.935910478128179,shc-gpt-4o,mimiciii,nursing_note,PROMPT1_ICL_entailment
81,171,10,9,1,0.9,8,7,1,0.875,0.8873239436619719,shc-gpt-4o,mimiciii,nursing_note,PROMPT1_ICL_entailment
82,172,58,54,4,0.9310344827586208,38,33,5,0.868421052631579,0.8986384266263238,shc-gpt-4o,mimiciii,nursing_note,PROMPT1_ICL_entailment
83,173,31,30,1,0.967741935483871,19,18,1,0.9473684210526316,0.9574468085106383,shc-gpt-4o,mimiciii,nursing_note,PROMPT1_ICL_entailment
84,174,11,10,1,0.9090909090909092,8,6,2,0.75,0.821917808219178,shc-gpt-4o,mimiciii,nursing_note,PROMPT1_ICL_entailment
85,175,5,3,2,0.6,4,4,0,1.0,0.7499999999999999,shc-gpt-4o,mimiciii,nursing_note,PROMPT1_ICL_entailment
86,176,26,24,2,0.9230769230769232,13,11,2,0.8461538461538461,0.8829431438127091,shc-gpt-4o,mimiciii,nursing_note,PROMPT1_ICL_entailment
87,177,62,57,5,0.9193548387096774,38,34,4,0.8947368421052632,0.9068788020589612,shc-gpt-4o,mimiciii,nursing_note,PROMPT1_ICL_entailment
88,178,49,48,1,0.979591836734694,25,23,2,0.92,0.9488611946712504,shc-gpt-4o,mimiciii,nursing_note,PROMPT1_ICL_entailment
89,179,41,40,1,0.975609756097561,22,19,3,0.8636363636363636,0.916214587100663,shc-gpt-4o,mimiciii,nursing_note,PROMPT1_ICL_entailment
90,18,48,44,4,0.9166666666666666,25,19,6,0.76,0.831013916500994,shc-gpt-4o,mimiciii,nursing_note,PROMPT1_ICL_entailment
91,180,47,43,4,0.9148936170212766,27,23,4,0.8518518518518519,0.8822479928635146,shc-gpt-4o,mimiciii,nursing_note,PROMPT1_ICL_entailment
92,181,38,35,3,0.9210526315789472,25,24,1,0.96,0.940123111359821,shc-gpt-4o,mimiciii,nursing_note,PROMPT1_ICL_entailment
93,182,32,31,1,0.96875,10,8,2,0.8,0.8763250883392226,shc-gpt-4o,mimiciii,nursing_note,PROMPT1_ICL_entailment
94,183,8,8,0,1.0,5,4,1,0.8,0.888888888888889,shc-gpt-4o,mimiciii,nursing_note,PROMPT1_ICL_entailment
95,184,21,20,1,0.9523809523809524,1,1,0,1.0,0.975609756097561,shc-gpt-4o,mimiciii,nursing_note,PROMPT1_ICL_entailment
96,185,37,32,5,0.8648648648648649,30,27,3,0.9,0.88208269525268,shc-gpt-4o,mimiciii,nursing_note,PROMPT1_ICL_entailment
97,186,7,7,0,1.0,4,4,0,1.0,1.0,shc-gpt-4o,mimiciii,nursing_note,PROMPT1_ICL_entailment
98,187,49,48,1,0.979591836734694,37,28,9,0.7567567567567568,0.8538754764930115,shc-gpt-4o,mimiciii,nursing_note,PROMPT1_ICL_entailment
99,188,6,6,0,1.0,2,2,0,1.0,1.0,shc-gpt-4o,mimiciii,nursing_note,PROMPT1_ICL_entailment
100,189,44,43,1,0.9772727272727272,21,20,1,0.9523809523809524,0.9646662927650028,shc-gpt-4o,mimiciii,nursing_note,PROMPT1_ICL_entailment
101,19,74,54,20,0.7297297297297297,45,36,9,0.8,0.7632508833922262,shc-gpt-4o,mimiciii,nursing_note,PROMPT1_ICL_entailment
102,190,42,39,3,0.9285714285714286,24,23,1,0.9583333333333334,0.943217665615142,shc-gpt-4o,mimiciii,nursing_note,PROMPT1_ICL_entailment
103,191,37,37,0,1.0,29,24,5,0.8275862068965517,0.9056603773584906,shc-gpt-4o,mimiciii,nursing_note,PROMPT1_ICL_entailment
104,192,24,24,0,1.0,15,15,0,1.0,1.0,shc-gpt-4o,mimiciii,nursing_note,PROMPT1_ICL_entailment
105,193,61,59,2,0.9672131147540984,36,34,2,0.9444444444444444,0.9556931872320152,shc-gpt-4o,mimiciii,nursing_note,PROMPT1_ICL_entailment
106,194,16,15,1,0.9375,11,10,1,0.9090909090909092,0.923076923076923,shc-gpt-4o,mimiciii,nursing_note,PROMPT1_ICL_entailment
107,195,9,7,2,0.7777777777777778,7,7,0,1.0,0.8750000000000001,shc-gpt-4o,mimiciii,nursing_note,PROMPT1_ICL_entailment
108,196,47,42,5,0.8936170212765957,34,30,4,0.8823529411764706,0.8879492600422833,shc-gpt-4o,mimiciii,nursing_note,PROMPT1_ICL_entailment
109,197,53,47,6,0.8867924528301887,27,24,3,0.8888888888888888,0.8878394332939787,shc-gpt-4o,mimiciii,nursing_note,PROMPT1_ICL_entailment
110,198,56,47,9,0.8392857142857143,38,36,2,0.9473684210526316,0.8900578642819569,shc-gpt-4o,mimiciii,nursing_note,PROMPT1_ICL_entailment
111,199,20,17,3,0.85,14,13,1,0.9285714285714286,0.8875502008032129,shc-gpt-4o,mimiciii,nursing_note,PROMPT1_ICL_entailment
112,2,64,47,17,0.734375,43,40,3,0.9302325581395348,0.8207814887579131,shc-gpt-4o,mimiciii,nursing_note,PROMPT1_ICL_entailment
113,20,69,57,12,0.8260869565217391,46,36,10,0.782608695652174,0.8037602820211517,shc-gpt-4o,mimiciii,nursing_note,PROMPT1_ICL_entailment
114,200,59,44,15,0.7457627118644068,44,43,1,0.9772727272727272,0.8459646769505925,shc-gpt-4o,mimiciii,nursing_note,PROMPT1_ICL_entailment
115,201,38,31,7,0.8157894736842105,29,23,6,0.7931034482758621,0.8042865200225605,shc-gpt-4o,mimiciii,nursing_note,PROMPT1_ICL_entailment
116,202,11,10,1,0.9090909090909092,9,8,1,0.8888888888888888,0.8988764044943819,shc-gpt-4o,mimiciii,nursing_note,PROMPT1_ICL_entailment
117,203,15,15,0,1.0,7,7,0,1.0,1.0,shc-gpt-4o,mimiciii,nursing_note,PROMPT1_ICL_entailment
118,204,44,40,4,0.9090909090909092,24,22,2,0.9166666666666666,0.9128630705394192,shc-gpt-4o,mimiciii,nursing_note,PROMPT1_ICL_entailment
119,205,58,55,3,0.9482758620689656,47,43,4,0.9148936170212766,0.9312856861586926,shc-gpt-4o,mimiciii,nursing_note,PROMPT1_ICL_entailment
120,206,12,12,0,1.0,6,6,0,1.0,1.0,shc-gpt-4o,mimiciii,nursing_note,PROMPT1_ICL_entailment
121,207,67,59,8,0.8805970149253731,29,28,1,0.9655172413793104,0.921103986618344,shc-gpt-4o,mimiciii,nursing_note,PROMPT1_ICL_entailment
122,208,14,13,1,0.9285714285714286,7,7,0,1.0,0.962962962962963,shc-gpt-4o,mimiciii,nursing_note,PROMPT1_ICL_entailment
123,209,9,5,4,0.5555555555555556,2,1,1,0.5,0.5263157894736842,shc-gpt-4o,mimiciii,nursing_note,PROMPT1_ICL_entailment
124,21,7,7,0,1.0,6,5,1,0.8333333333333334,0.9090909090909092,shc-gpt-4o,mimiciii,nursing_note,PROMPT1_ICL_entailment
125,210,34,30,4,0.8823529411764706,22,22,0,1.0,0.9375,shc-gpt-4o,mimiciii,nursing_note,PROMPT1_ICL_entailment
126,211,5,5,0,1.0,4,4,0,1.0,1.0,shc-gpt-4o,mimiciii,nursing_note,PROMPT1_ICL_entailment
127,212,50,48,2,0.96,37,33,4,0.8918918918918919,0.924693520140105,shc-gpt-4o,mimiciii,nursing_note,PROMPT1_ICL_entailment
128,213,32,29,3,0.90625,18,18,0,1.0,0.9508196721311476,shc-gpt-4o,mimiciii,nursing_note,PROMPT1_ICL_entailment
129,214,10,10,0,1.0,3,3,0,1.0,1.0,shc-gpt-4o,mimiciii,nursing_note,PROMPT1_ICL_entailment
130,215,9,9,0,1.0,7,6,1,0.8571428571428571,0.923076923076923,shc-gpt-4o,mimiciii,nursing_note,PROMPT1_ICL_entailment
131,216,27,22,5,0.8148148148148148,13,10,3,0.7692307692307693,0.7913669064748201,shc-gpt-4o,mimiciii,nursing_note,PROMPT1_ICL_entailment
132,217,49,45,4,0.9183673469387756,25,22,3,0.88,0.8987743985474353,shc-gpt-4o,mimiciii,nursing_note,PROMPT1_ICL_entailment
133,218,26,25,1,0.9615384615384616,18,15,3,0.8333333333333334,0.8928571428571429,shc-gpt-4o,mimiciii,nursing_note,PROMPT1_ICL_entailment
134,219,41,34,7,0.8292682926829268,14,13,1,0.9285714285714286,0.8761149653121902,shc-gpt-4o,mimiciii,nursing_note,PROMPT1_ICL_entailment
135,22,44,41,3,0.9318181818181818,26,25,1,0.9615384615384616,0.9464450600184672,shc-gpt-4o,mimiciii,nursing_note,PROMPT1_ICL_entailment
136,220,15,13,2,0.8666666666666667,5,4,1,0.8,0.832,shc-gpt-4o,mimiciii,nursing_note,PROMPT1_ICL_entailment
137,221,35,24,11,0.6857142857142857,35,29,6,0.8285714285714286,0.7504043126684636,shc-gpt-4o,mimiciii,nursing_note,PROMPT1_ICL_entailment
138,222,6,6,0,1.0,3,1,2,0.3333333333333333,0.5,shc-gpt-4o,mimiciii,nursing_note,PROMPT1_ICL_entailment
139,223,39,30,9,0.7692307692307693,30,26,4,0.8666666666666667,0.8150470219435738,shc-gpt-4o,mimiciii,nursing_note,PROMPT1_ICL_entailment
140,224,11,11,0,1.0,6,6,0,1.0,1.0,shc-gpt-4o,mimiciii,nursing_note,PROMPT1_ICL_entailment
141,225,64,42,22,0.65625,45,37,8,0.8222222222222222,0.7299201503053077,shc-gpt-4o,mimiciii,nursing_note,PROMPT1_ICL_entailment
142,226,57,56,1,0.9824561403508772,20,20,0,1.0,0.991150442477876,shc-gpt-4o,mimiciii,nursing_note,PROMPT1_ICL_entailment
143,227,21,20,1,0.9523809523809524,15,14,1,0.9333333333333332,0.9427609427609428,shc-gpt-4o,mimiciii,nursing_note,PROMPT1_ICL_entailment
144,228,60,45,15,0.75,38,34,4,0.8947368421052632,0.816,shc-gpt-4o,mimiciii,nursing_note,PROMPT1_ICL_entailment
145,229,31,28,3,0.9032258064516128,22,21,1,0.9545454545454546,0.9281767955801103,shc-gpt-4o,mimiciii,nursing_note,PROMPT1_ICL_entailment
146,23,68,60,8,0.8823529411764706,35,34,1,0.9714285714285714,0.9247506799637352,shc-gpt-4o,mimiciii,nursing_note,PROMPT1_ICL_entailment
147,230,15,14,1,0.9333333333333332,7,6,1,0.8571428571428571,0.8936170212765957,shc-gpt-4o,mimiciii,nursing_note,PROMPT1_ICL_entailment
148,231,67,62,5,0.9253731343283582,15,14,1,0.9333333333333332,0.9293361884368307,shc-gpt-4o,mimiciii,nursing_note,PROMPT1_ICL_entailment
149,232,11,10,1,0.9090909090909092,2,2,0,1.0,0.9523809523809524,shc-gpt-4o,mimiciii,nursing_note,PROMPT1_ICL_entailment
150,233,37,27,10,0.7297297297297297,33,31,2,0.9393939393939394,0.8213935230618253,shc-gpt-4o,mimiciii,nursing_note,PROMPT1_ICL_entailment
151,234,58,57,1,0.9827586206896552,32,30,2,0.9375,0.9595959595959596,shc-gpt-4o,mimiciii,nursing_note,PROMPT1_ICL_entailment
152,235,18,16,2,0.8888888888888888,10,9,1,0.9,0.8944099378881988,shc-gpt-4o,mimiciii,nursing_note,PROMPT1_ICL_entailment
153,236,17,16,1,0.9411764705882352,7,6,1,0.8571428571428571,0.897196261682243,shc-gpt-4o,mimiciii,nursing_note,PROMPT1_ICL_entailment
154,237,65,58,7,0.8923076923076924,35,31,4,0.8857142857142857,0.8889987639060569,shc-gpt-4o,mimiciii,nursing_note,PROMPT1_ICL_entailment
155,238,69,57,12,0.8260869565217391,42,40,2,0.9523809523809524,0.8847497089639116,shc-gpt-4o,mimiciii,nursing_note,PROMPT1_ICL_entailment
156,239,51,38,13,0.7450980392156863,21,21,0,1.0,0.8539325842696629,shc-gpt-4o,mimiciii,nursing_note,PROMPT1_ICL_entailment
157,24,12,12,0,1.0,5,5,0,1.0,1.0,shc-gpt-4o,mimiciii,nursing_note,PROMPT1_ICL_entailment
158,240,44,42,2,0.9545454545454546,42,32,10,0.7619047619047619,0.8474148802017655,shc-gpt-4o,mimiciii,nursing_note,PROMPT1_ICL_entailment
159,241,32,26,6,0.8125,21,21,0,1.0,0.896551724137931,shc-gpt-4o,mimiciii,nursing_note,PROMPT1_ICL_entailment
160,242,48,42,6,0.875,16,13,3,0.8125,0.8425925925925926,shc-gpt-4o,mimiciii,nursing_note,PROMPT1_ICL_entailment
161,243,14,13,1,0.9285714285714286,5,3,2,0.6,0.7289719626168225,shc-gpt-4o,mimiciii,nursing_note,PROMPT1_ICL_entailment
162,244,45,32,13,0.7111111111111111,16,16,0,1.0,0.8311688311688311,shc-gpt-4o,mimiciii,nursing_note,PROMPT1_ICL_entailment
163,245,48,42,6,0.875,37,31,6,0.8378378378378378,0.8560157790927022,shc-gpt-4o,mimiciii,nursing_note,PROMPT1_ICL_entailment
164,246,37,32,5,0.8648648648648649,10,9,1,0.9,0.88208269525268,shc-gpt-4o,mimiciii,nursing_note,PROMPT1_ICL_entailment
165,247,9,9,0,1.0,6,4,2,0.6666666666666666,0.8,shc-gpt-4o,mimiciii,nursing_note,PROMPT1_ICL_entailment
166,248,57,51,6,0.8947368421052632,42,33,9,0.7857142857142857,0.83668903803132,shc-gpt-4o,mimiciii,nursing_note,PROMPT1_ICL_entailment
167,249,51,42,9,0.8235294117647058,39,33,6,0.8461538461538461,0.8346883468834688,shc-gpt-4o,mimiciii,nursing_note,PROMPT1_ICL_entailment
168,25,46,38,8,0.8260869565217391,23,22,1,0.9565217391304348,0.8865323435843054,shc-gpt-4o,mimiciii,nursing_note,PROMPT1_ICL_entailment
169,26,68,61,7,0.8970588235294118,35,33,2,0.9428571428571428,0.9193879881251428,shc-gpt-4o,mimiciii,nursing_note,PROMPT1_ICL_entailment
170,27,6,5,1,0.8333333333333334,3,2,1,0.6666666666666666,0.7407407407407408,shc-gpt-4o,mimiciii,nursing_note,PROMPT1_ICL_entailment
171,28,52,48,4,0.9230769230769232,16,14,2,0.875,0.8983957219251337,shc-gpt-4o,mimiciii,nursing_note,PROMPT1_ICL_entailment
172,29,44,43,1,0.9772727272727272,33,29,4,0.8787878787878788,0.925417439703154,shc-gpt-4o,mimiciii,nursing_note,PROMPT1_ICL_entailment
173,3,13,11,2,0.8461538461538461,6,5,1,0.8333333333333334,0.8396946564885497,shc-gpt-4o,mimiciii,nursing_note,PROMPT1_ICL_entailment
174,30,21,21,0,1.0,13,11,2,0.8461538461538461,0.9166666666666666,shc-gpt-4o,mimiciii,nursing_note,PROMPT1_ICL_entailment
175,31,28,25,3,0.8928571428571429,19,16,3,0.8421052631578947,0.866738894907909,shc-gpt-4o,mimiciii,nursing_note,PROMPT1_ICL_entailment
176,32,69,66,3,0.9565217391304348,44,42,2,0.9545454545454546,0.9555325749741468,shc-gpt-4o,mimiciii,nursing_note,PROMPT1_ICL_entailment
177,33,10,10,0,1.0,5,5,0,1.0,1.0,shc-gpt-4o,mimiciii,nursing_note,PROMPT1_ICL_entailment
178,34,7,7,0,1.0,3,3,0,1.0,1.0,shc-gpt-4o,mimiciii,nursing_note,PROMPT1_ICL_entailment
179,35,22,21,1,0.9545454545454546,7,7,0,1.0,0.9767441860465116,shc-gpt-4o,mimiciii,nursing_note,PROMPT1_ICL_entailment
180,36,101,84,17,0.8316831683168316,62,55,7,0.8870967741935484,0.8584967016631051,shc-gpt-4o,mimiciii,nursing_note,PROMPT1_ICL_entailment
181,37,50,41,9,0.82,38,34,4,0.8947368421052632,0.8557397176181706,shc-gpt-4o,mimiciii,nursing_note,PROMPT1_ICL_entailment
182,38,40,35,5,0.875,26,20,6,0.7692307692307693,0.8187134502923977,shc-gpt-4o,mimiciii,nursing_note,PROMPT1_ICL_entailment
183,39,23,23,0,1.0,3,3,0,1.0,1.0,shc-gpt-4o,mimiciii,nursing_note,PROMPT1_ICL_entailment
184,4,32,29,3,0.90625,26,21,5,0.8076923076923077,0.8541374474053296,shc-gpt-4o,mimiciii,nursing_note,PROMPT1_ICL_entailment
185,40,11,10,1,0.9090909090909092,3,2,1,0.6666666666666666,0.7692307692307692,shc-gpt-4o,mimiciii,nursing_note,PROMPT1_ICL_entailment
186,41,74,69,5,0.9324324324324323,50,42,8,0.84,0.8838060384263495,shc-gpt-4o,mimiciii,nursing_note,PROMPT1_ICL_entailment
187,42,41,36,5,0.8780487804878049,7,7,0,1.0,0.9350649350649352,shc-gpt-4o,mimiciii,nursing_note,PROMPT1_ICL_entailment
188,43,40,33,7,0.825,14,14,0,1.0,0.9041095890410958,shc-gpt-4o,mimiciii,nursing_note,PROMPT1_ICL_entailment
189,44,11,11,0,1.0,3,3,0,1.0,1.0,shc-gpt-4o,mimiciii,nursing_note,PROMPT1_ICL_entailment
190,45,60,59,1,0.9833333333333332,34,28,6,0.8235294117647058,0.8963646228974498,shc-gpt-4o,mimiciii,nursing_note,PROMPT1_ICL_entailment
191,46,66,63,3,0.9545454545454546,31,26,5,0.8387096774193549,0.892886345053148,shc-gpt-4o,mimiciii,nursing_note,PROMPT1_ICL_entailment
192,47,37,36,1,0.972972972972973,14,14,0,1.0,0.9863013698630138,shc-gpt-4o,mimiciii,nursing_note,PROMPT1_ICL_entailment
193,48,32,30,2,0.9375,9,9,0,1.0,0.967741935483871,shc-gpt-4o,mimiciii,nursing_note,PROMPT1_ICL_entailment
194,49,8,8,0,1.0,3,2,1,0.6666666666666666,0.8,shc-gpt-4o,mimiciii,nursing_note,PROMPT1_ICL_entailment
195,5,39,35,4,0.8974358974358975,15,13,2,0.8666666666666667,0.8817829457364341,shc-gpt-4o,mimiciii,nursing_note,PROMPT1_ICL_entailment
196,50,29,29,0,1.0,16,14,2,0.875,0.9333333333333332,shc-gpt-4o,mimiciii,nursing_note,PROMPT1_ICL_entailment
197,51,10,10,0,1.0,6,6,0,1.0,1.0,shc-gpt-4o,mimiciii,nursing_note,PROMPT1_ICL_entailment
198,52,43,35,8,0.813953488372093,38,36,2,0.9473684210526316,0.8756080611535789,shc-gpt-4o,mimiciii,nursing_note,PROMPT1_ICL_entailment
199,53,10,9,1,0.9,6,5,1,0.8333333333333334,0.8653846153846153,shc-gpt-4o,mimiciii,nursing_note,PROMPT1_ICL_entailment
200,54,46,43,3,0.9347826086956522,37,31,6,0.8378378378378378,0.8836592641697051,shc-gpt-4o,mimiciii,nursing_note,PROMPT1_ICL_entailment
201,55,59,53,6,0.8983050847457628,35,26,9,0.7428571428571429,0.8132192387134849,shc-gpt-4o,mimiciii,nursing_note,PROMPT1_ICL_entailment
202,56,13,12,1,0.9230769230769232,2,2,0,1.0,0.96,shc-gpt-4o,mimiciii,nursing_note,PROMPT1_ICL_entailment
203,57,57,57,0,1.0,17,14,3,0.8235294117647058,0.9032258064516128,shc-gpt-4o,mimiciii,nursing_note,PROMPT1_ICL_entailment
204,58,71,66,5,0.9295774647887324,25,24,1,0.96,0.9445438282647584,shc-gpt-4o,mimiciii,nursing_note,PROMPT1_ICL_entailment
205,59,13,13,0,1.0,8,8,0,1.0,1.0,shc-gpt-4o,mimiciii,nursing_note,PROMPT1_ICL_entailment
206,6,16,15,1,0.9375,8,8,0,1.0,0.967741935483871,shc-gpt-4o,mimiciii,nursing_note,PROMPT1_ICL_entailment
207,60,50,43,7,0.86,27,25,2,0.925925925925926,0.891746163417669,shc-gpt-4o,mimiciii,nursing_note,PROMPT1_ICL_entailment
208,61,38,27,11,0.7105263157894737,20,16,4,0.8,0.7526132404181184,shc-gpt-4o,mimiciii,nursing_note,PROMPT1_ICL_entailment
209,62,44,35,9,0.7954545454545454,37,24,13,0.6486486486486487,0.7145895363675032,shc-gpt-4o,mimiciii,nursing_note,PROMPT1_ICL_entailment
210,63,8,7,1,0.875,5,5,0,1.0,0.9333333333333332,shc-gpt-4o,mimiciii,nursing_note,PROMPT1_ICL_entailment
211,64,60,56,4,0.9333333333333332,27,26,1,0.9629629629629628,0.9479166666666664,shc-gpt-4o,mimiciii,nursing_note,PROMPT1_ICL_entailment
212,65,26,24,2,0.9230769230769232,19,15,4,0.7894736842105263,0.8510638297872342,shc-gpt-4o,mimiciii,nursing_note,PROMPT1_ICL_entailment
213,66,15,15,0,1.0,1,1,0,1.0,1.0,shc-gpt-4o,mimiciii,nursing_note,PROMPT1_ICL_entailment
214,67,14,11,3,0.7857142857142857,7,7,0,1.0,0.88,shc-gpt-4o,mimiciii,nursing_note,PROMPT1_ICL_entailment
215,68,39,37,2,0.9487179487179488,18,14,4,0.7777777777777778,0.8547854785478548,shc-gpt-4o,mimiciii,nursing_note,PROMPT1_ICL_entailment
216,69,44,35,9,0.7954545454545454,25,21,4,0.84,0.8171206225680934,shc-gpt-4o,mimiciii,nursing_note,PROMPT1_ICL_entailment
217,7,6,5,1,0.8333333333333334,2,2,0,1.0,0.9090909090909092,shc-gpt-4o,mimiciii,nursing_note,PROMPT1_ICL_entailment
218,70,61,59,2,0.9672131147540984,45,35,10,0.7777777777777778,0.862212943632568,shc-gpt-4o,mimiciii,nursing_note,PROMPT1_ICL_entailment
219,71,88,51,37,0.5795454545454546,51,41,10,0.803921568627451,0.6735384119826059,shc-gpt-4o,mimiciii,nursing_note,PROMPT1_ICL_entailment
220,72,26,24,2,0.9230769230769232,12,9,3,0.75,0.8275862068965517,shc-gpt-4o,mimiciii,nursing_note,PROMPT1_ICL_entailment
221,73,43,39,4,0.9069767441860463,38,29,9,0.7631578947368421,0.8288750458043239,shc-gpt-4o,mimiciii,nursing_note,PROMPT1_ICL_entailment
222,74,11,11,0,1.0,7,6,1,0.8571428571428571,0.923076923076923,shc-gpt-4o,mimiciii,nursing_note,PROMPT1_ICL_entailment
223,75,52,46,6,0.8846153846153846,27,23,4,0.8518518518518519,0.8679245283018868,shc-gpt-4o,mimiciii,nursing_note,PROMPT1_ICL_entailment
224,76,5,3,2,0.6,1,1,0,1.0,0.7499999999999999,shc-gpt-4o,mimiciii,nursing_note,PROMPT1_ICL_entailment
225,77,92,77,15,0.8369565217391305,59,50,9,0.847457627118644,0.8421743410259216,shc-gpt-4o,mimiciii,nursing_note,PROMPT1_ICL_entailment
226,78,48,40,8,0.8333333333333334,20,17,3,0.85,0.8415841584158417,shc-gpt-4o,mimiciii,nursing_note,PROMPT1_ICL_entailment
227,79,43,43,0,1.0,30,28,2,0.9333333333333332,0.9655172413793104,shc-gpt-4o,mimiciii,nursing_note,PROMPT1_ICL_entailment
228,8,17,16,1,0.9411764705882352,11,9,2,0.8181818181818182,0.8753799392097266,shc-gpt-4o,mimiciii,nursing_note,PROMPT1_ICL_entailment
229,80,44,40,4,0.9090909090909092,22,21,1,0.9545454545454546,0.9312638580931264,shc-gpt-4o,mimiciii,nursing_note,PROMPT1_ICL_entailment
230,81,37,32,5,0.8648648648648649,22,22,0,1.0,0.927536231884058,shc-gpt-4o,mimiciii,nursing_note,PROMPT1_ICL_entailment
231,82,47,39,8,0.8297872340425532,17,12,5,0.7058823529411765,0.762836185819071,shc-gpt-4o,mimiciii,nursing_note,PROMPT1_ICL_entailment
232,83,26,24,2,0.9230769230769232,28,25,3,0.8928571428571429,0.907715582450832,shc-gpt-4o,mimiciii,nursing_note,PROMPT1_ICL_entailment
233,84,15,15,0,1.0,6,5,1,0.8333333333333334,0.9090909090909092,shc-gpt-4o,mimiciii,nursing_note,PROMPT1_ICL_entailment
234,85,47,43,4,0.9148936170212766,24,21,3,0.875,0.8945022288261516,shc-gpt-4o,mimiciii,nursing_note,PROMPT1_ICL_entailment
235,86,56,46,10,0.8214285714285714,40,35,5,0.875,0.8473684210526315,shc-gpt-4o,mimiciii,nursing_note,PROMPT1_ICL_entailment
236,87,27,25,2,0.925925925925926,15,12,3,0.8,0.8583690987124465,shc-gpt-4o,mimiciii,nursing_note,PROMPT1_ICL_entailment
237,88,52,45,7,0.8653846153846154,15,15,0,1.0,0.9278350515463918,shc-gpt-4o,mimiciii,nursing_note,PROMPT1_ICL_entailment
238,89,35,35,0,1.0,29,27,2,0.9310344827586208,0.9642857142857144,shc-gpt-4o,mimiciii,nursing_note,PROMPT1_ICL_entailment
239,9,43,41,2,0.9534883720930232,17,17,0,1.0,0.9761904761904764,shc-gpt-4o,mimiciii,nursing_note,PROMPT1_ICL_entailment
240,90,37,34,3,0.918918918918919,14,12,2,0.8571428571428571,0.8869565217391304,shc-gpt-4o,mimiciii,nursing_note,PROMPT1_ICL_entailment
241,91,33,30,3,0.9090909090909092,24,24,0,1.0,0.9523809523809524,shc-gpt-4o,mimiciii,nursing_note,PROMPT1_ICL_entailment
242,92,43,43,0,1.0,28,27,1,0.9642857142857144,0.9818181818181818,shc-gpt-4o,mimiciii,nursing_note,PROMPT1_ICL_entailment
243,93,39,37,2,0.9487179487179488,23,21,2,0.9130434782608696,0.9305389221556886,shc-gpt-4o,mimiciii,nursing_note,PROMPT1_ICL_entailment
244,94,8,7,1,0.875,5,5,0,1.0,0.9333333333333332,shc-gpt-4o,mimiciii,nursing_note,PROMPT1_ICL_entailment
245,95,35,32,3,0.9142857142857144,14,13,1,0.9285714285714286,0.9213732004429678,shc-gpt-4o,mimiciii,nursing_note,PROMPT1_ICL_entailment
246,96,15,14,1,0.9333333333333332,6,6,0,1.0,0.9655172413793104,shc-gpt-4o,mimiciii,nursing_note,PROMPT1_ICL_entailment
247,97,18,17,1,0.9444444444444444,10,10,0,1.0,0.9714285714285714,shc-gpt-4o,mimiciii,nursing_note,PROMPT1_ICL_entailment
248,98,61,54,7,0.8852459016393442,13,11,2,0.8461538461538461,0.8652585579024036,shc-gpt-4o,mimiciii,nursing_note,PROMPT1_ICL_entailment
249,99,59,54,5,0.9152542372881356,44,40,4,0.9090909090909092,0.9121621621621622,shc-gpt-4o,mimiciii,nursing_note,PROMPT1_ICL_entailment
0,0,21,19,2,0.9047619047619048,11,10,1,0.9090909090909092,0.9069212410501194,shc-gpt-4o,mimiciii,nursing_note,PROMPT2_ICL_entailment
1,1,54,30,24,0.5555555555555556,31,25,6,0.8064516129032258,0.6578947368421053,shc-gpt-4o,mimiciii,nursing_note,PROMPT2_ICL_entailment
2,10,30,24,6,0.8,18,13,5,0.7222222222222222,0.759124087591241,shc-gpt-4o,mimiciii,nursing_note,PROMPT2_ICL_entailment
3,100,18,18,0,1.0,6,6,0,1.0,1.0,shc-gpt-4o,mimiciii,nursing_note,PROMPT2_ICL_entailment
4,101,48,41,7,0.8541666666666666,27,26,1,0.9629629629629628,0.9053078556263268,shc-gpt-4o,mimiciii,nursing_note,PROMPT2_ICL_entailment
5,102,36,33,3,0.9166666666666666,26,20,6,0.7692307692307693,0.8365019011406845,shc-gpt-4o,mimiciii,nursing_note,PROMPT2_ICL_entailment
6,103,36,34,2,0.9444444444444444,22,22,0,1.0,0.9714285714285714,shc-gpt-4o,mimiciii,nursing_note,PROMPT2_ICL_entailment
7,104,33,31,2,0.9393939393939394,20,19,1,0.95,0.9446672012830796,shc-gpt-4o,mimiciii,nursing_note,PROMPT2_ICL_entailment
8,105,45,38,7,0.8444444444444444,20,17,3,0.85,0.8472131147540983,shc-gpt-4o,mimiciii,nursing_note,PROMPT2_ICL_entailment
9,106,11,11,0,1.0,4,4,0,1.0,1.0,shc-gpt-4o,mimiciii,nursing_note,PROMPT2_ICL_entailment
10,107,78,71,7,0.9102564102564102,49,44,5,0.8979591836734694,0.9040659817681956,shc-gpt-4o,mimiciii,nursing_note,PROMPT2_ICL_entailment
11,108,62,56,6,0.9032258064516128,28,21,7,0.75,0.8195121951219512,shc-gpt-4o,mimiciii,nursing_note,PROMPT2_ICL_entailment
12,109,5,5,0,1.0,4,3,1,0.75,0.8571428571428571,shc-gpt-4o,mimiciii,nursing_note,PROMPT2_ICL_entailment
13,11,2,2,0,1.0,2,2,0,1.0,1.0,shc-gpt-4o,mimiciii,nursing_note,PROMPT2_ICL_entailment
14,110,23,22,1,0.9565217391304348,13,12,1,0.9230769230769232,0.9395017793594308,shc-gpt-4o,mimiciii,nursing_note,PROMPT2_ICL_entailment
15,111,44,40,4,0.9090909090909092,32,27,5,0.84375,0.8752025931928686,shc-gpt-4o,mimiciii,nursing_note,PROMPT2_ICL_entailment
16,112,74,63,11,0.8513513513513513,37,36,1,0.972972972972973,0.908108108108108,shc-gpt-4o,mimiciii,nursing_note,PROMPT2_ICL_entailment
17,113,7,7,0,1.0,5,5,0,1.0,1.0,shc-gpt-4o,mimiciii,nursing_note,PROMPT2_ICL_entailment
18,114,28,21,7,0.75,19,15,4,0.7894736842105263,0.7692307692307692,shc-gpt-4o,mimiciii,nursing_note,PROMPT2_ICL_entailment
19,115,14,14,0,1.0,7,7,0,1.0,1.0,shc-gpt-4o,mimiciii,nursing_note,PROMPT2_ICL_entailment
20,116,45,44,1,0.9777777777777776,31,27,4,0.8709677419354839,0.9212873206669252,shc-gpt-4o,mimiciii,nursing_note,PROMPT2_ICL_entailment
21,117,57,46,11,0.8070175438596491,18,15,3,0.8333333333333334,0.8199643493761141,shc-gpt-4o,mimiciii,nursing_note,PROMPT2_ICL_entailment
22,118,44,33,11,0.75,25,22,3,0.88,0.8098159509202455,shc-gpt-4o,mimiciii,nursing_note,PROMPT2_ICL_entailment
23,119,52,51,1,0.9807692307692308,26,18,8,0.6923076923076923,0.8116710875331565,shc-gpt-4o,mimiciii,nursing_note,PROMPT2_ICL_entailment
24,12,36,34,2,0.9444444444444444,18,15,3,0.8333333333333334,0.8854166666666667,shc-gpt-4o,mimiciii,nursing_note,PROMPT2_ICL_entailment
25,120,31,30,1,0.967741935483871,18,17,1,0.9444444444444444,0.9559512652296156,shc-gpt-4o,mimiciii,nursing_note,PROMPT2_ICL_entailment
26,121,68,58,10,0.8529411764705882,37,32,5,0.8648648648648649,0.8588616381304951,shc-gpt-4o,mimiciii,nursing_note,PROMPT2_ICL_entailment
27,122,37,36,1,0.972972972972973,11,10,1,0.9090909090909092,0.9399477806788512,shc-gpt-4o,mimiciii,nursing_note,PROMPT2_ICL_entailment
28,123,8,8,0,1.0,6,6,0,1.0,1.0,shc-gpt-4o,mimiciii,nursing_note,PROMPT2_ICL_entailment
29,124,10,10,0,1.0,5,4,1,0.8,0.888888888888889,shc-gpt-4o,mimiciii,nursing_note,PROMPT2_ICL_entailment
30,125,56,54,2,0.9642857142857144,43,36,7,0.8372093023255814,0.8962655601659751,shc-gpt-4o,mimiciii,nursing_note,PROMPT2_ICL_entailment
31,126,40,33,7,0.825,28,21,7,0.75,0.7857142857142856,shc-gpt-4o,mimiciii,nursing_note,PROMPT2_ICL_entailment
32,127,26,22,4,0.8461538461538461,10,10,0,1.0,0.9166666666666666,shc-gpt-4o,mimiciii,nursing_note,PROMPT2_ICL_entailment
33,128,39,36,3,0.9230769230769232,17,15,2,0.8823529411764706,0.9022556390977444,shc-gpt-4o,mimiciii,nursing_note,PROMPT2_ICL_entailment
34,129,43,38,5,0.8837209302325582,29,25,4,0.8620689655172413,0.8727606798346349,shc-gpt-4o,mimiciii,nursing_note,PROMPT2_ICL_entailment
35,13,81,73,8,0.9012345679012346,34,30,4,0.8823529411764706,0.8916938110749186,shc-gpt-4o,mimiciii,nursing_note,PROMPT2_ICL_entailment
36,130,65,59,6,0.9076923076923076,33,26,7,0.7878787878787878,0.8435523783337915,shc-gpt-4o,mimiciii,nursing_note,PROMPT2_ICL_entailment
37,131,49,44,5,0.8979591836734694,31,27,4,0.8709677419354839,0.8842575362858207,shc-gpt-4o,mimiciii,nursing_note,PROMPT2_ICL_entailment
38,132,55,42,13,0.7636363636363637,17,12,5,0.7058823529411765,0.7336244541484715,shc-gpt-4o,mimiciii,nursing_note,PROMPT2_ICL_entailment
39,133,25,19,6,0.76,10,10,0,1.0,0.8636363636363636,shc-gpt-4o,mimiciii,nursing_note,PROMPT2_ICL_entailment
40,134,69,41,28,0.5942028985507246,30,27,3,0.9,0.7158098933074686,shc-gpt-4o,mimiciii,nursing_note,PROMPT2_ICL_entailment
41,135,96,80,16,0.8333333333333334,42,37,5,0.8809523809523809,0.8564814814814815,shc-gpt-4o,mimiciii,nursing_note,PROMPT2_ICL_entailment
42,136,78,73,5,0.935897435897436,41,40,1,0.975609756097561,0.9553410763945688,shc-gpt-4o,mimiciii,nursing_note,PROMPT2_ICL_entailment
43,137,6,5,1,0.8333333333333334,2,1,1,0.5,0.625,shc-gpt-4o,mimiciii,nursing_note,PROMPT2_ICL_entailment
44,138,8,8,0,1.0,5,5,0,1.0,1.0,shc-gpt-4o,mimiciii,nursing_note,PROMPT2_ICL_entailment
45,139,7,7,0,1.0,4,3,1,0.75,0.8571428571428571,shc-gpt-4o,mimiciii,nursing_note,PROMPT2_ICL_entailment
46,14,46,44,2,0.9565217391304348,25,20,5,0.8,0.8712871287128713,shc-gpt-4o,mimiciii,nursing_note,PROMPT2_ICL_entailment
47,140,60,44,16,0.7333333333333333,24,21,3,0.875,0.7979274611398963,shc-gpt-4o,mimiciii,nursing_note,PROMPT2_ICL_entailment
48,141,22,20,2,0.9090909090909092,11,10,1,0.9090909090909092,0.9090909090909092,shc-gpt-4o,mimiciii,nursing_note,PROMPT2_ICL_entailment
49,142,60,50,10,0.8333333333333334,8,7,1,0.875,0.8536585365853658,shc-gpt-4o,mimiciii,nursing_note,PROMPT2_ICL_entailment
50,143,23,22,1,0.9565217391304348,2,1,1,0.5,0.6567164179104478,shc-gpt-4o,mimiciii,nursing_note,PROMPT2_ICL_entailment
51,144,10,9,1,0.9,5,5,0,1.0,0.9473684210526316,shc-gpt-4o,mimiciii,nursing_note,PROMPT2_ICL_entailment
52,145,44,39,5,0.8863636363636364,19,16,3,0.8421052631578947,0.8636678200692042,shc-gpt-4o,mimiciii,nursing_note,PROMPT2_ICL_entailment
53,146,13,13,0,1.0,6,5,1,0.8333333333333334,0.9090909090909092,shc-gpt-4o,mimiciii,nursing_note,PROMPT2_ICL_entailment
54,147,51,46,5,0.9019607843137256,26,21,5,0.8076923076923077,0.8522276135862373,shc-gpt-4o,mimiciii,nursing_note,PROMPT2_ICL_entailment
55,148,17,16,1,0.9411764705882352,7,7,0,1.0,0.9696969696969696,shc-gpt-4o,mimiciii,nursing_note,PROMPT2_ICL_entailment
56,149,67,55,12,0.8208955223880597,36,29,7,0.8055555555555556,0.8131531990823349,shc-gpt-4o,mimiciii,nursing_note,PROMPT2_ICL_entailment
57,15,40,29,11,0.725,33,28,5,0.8484848484848485,0.7818969667790081,shc-gpt-4o,mimiciii,nursing_note,PROMPT2_ICL_entailment
58,150,17,16,1,0.9411764705882352,8,7,1,0.875,0.9068825910931174,shc-gpt-4o,mimiciii,nursing_note,PROMPT2_ICL_entailment
59,151,44,36,8,0.8181818181818182,26,22,4,0.8461538461538461,0.8319327731092436,shc-gpt-4o,mimiciii,nursing_note,PROMPT2_ICL_entailment
60,152,67,63,4,0.9402985074626866,44,33,11,0.75,0.8344370860927153,shc-gpt-4o,mimiciii,nursing_note,PROMPT2_ICL_entailment
61,153,9,9,0,1.0,4,3,1,0.75,0.8571428571428571,shc-gpt-4o,mimiciii,nursing_note,PROMPT2_ICL_entailment
62,154,51,48,3,0.9411764705882352,34,28,6,0.8235294117647058,0.8784313725490196,shc-gpt-4o,mimiciii,nursing_note,PROMPT2_ICL_entailment
63,155,83,74,9,0.891566265060241,51,45,6,0.8823529411764706,0.8869356771873751,shc-gpt-4o,mimiciii,nursing_note,PROMPT2_ICL_entailment
64,156,29,28,1,0.9655172413793104,26,19,7,0.7307692307692307,0.8318999218139171,shc-gpt-4o,mimiciii,nursing_note,PROMPT2_ICL_entailment
65,157,7,7,0,1.0,5,5,0,1.0,1.0,shc-gpt-4o,mimiciii,nursing_note,PROMPT2_ICL_entailment
66,158,46,43,3,0.9347826086956522,22,19,3,0.8636363636363636,0.8978021978021978,shc-gpt-4o,mimiciii,nursing_note,PROMPT2_ICL_entailment
67,159,16,16,0,1.0,8,7,1,0.875,0.9333333333333332,shc-gpt-4o,mimiciii,nursing_note,PROMPT2_ICL_entailment
68,16,59,52,7,0.8813559322033898,30,25,5,0.8333333333333334,0.85667215815486,shc-gpt-4o,mimiciii,nursing_note,PROMPT2_ICL_entailment
69,160,54,48,6,0.8888888888888888,21,18,3,0.8571428571428571,0.8727272727272727,shc-gpt-4o,mimiciii,nursing_note,PROMPT2_ICL_entailment
70,161,7,6,1,0.8571428571428571,6,5,1,0.8333333333333334,0.8450704225352113,shc-gpt-4o,mimiciii,nursing_note,PROMPT2_ICL_entailment
71,162,57,48,9,0.8421052631578947,31,23,8,0.7419354838709677,0.7888531618435156,shc-gpt-4o,mimiciii,nursing_note,PROMPT2_ICL_entailment
72,163,11,11,0,1.0,4,4,0,1.0,1.0,shc-gpt-4o,mimiciii,nursing_note,PROMPT2_ICL_entailment
73,164,26,24,2,0.9230769230769232,13,11,2,0.8461538461538461,0.8829431438127091,shc-gpt-4o,mimiciii,nursing_note,PROMPT2_ICL_entailment
74,165,55,46,9,0.8363636363636363,24,20,4,0.8333333333333334,0.8348457350272231,shc-gpt-4o,mimiciii,nursing_note,PROMPT2_ICL_entailment
75,166,17,17,0,1.0,3,3,0,1.0,1.0,shc-gpt-4o,mimiciii,nursing_note,PROMPT2_ICL_entailment
76,167,48,44,4,0.9166666666666666,16,14,2,0.875,0.8953488372093024,shc-gpt-4o,mimiciii,nursing_note,PROMPT2_ICL_entailment
77,168,45,33,12,0.7333333333333333,25,18,7,0.72,0.7266055045871559,shc-gpt-4o,mimiciii,nursing_note,PROMPT2_ICL_entailment
78,169,30,28,2,0.9333333333333332,12,12,0,1.0,0.9655172413793104,shc-gpt-4o,mimiciii,nursing_note,PROMPT2_ICL_entailment
79,17,43,40,3,0.9302325581395348,39,33,6,0.8461538461538461,0.8862034239677744,shc-gpt-4o,mimiciii,nursing_note,PROMPT2_ICL_entailment
80,170,55,51,4,0.9272727272727272,21,19,2,0.9047619047619048,0.9158790170132324,shc-gpt-4o,mimiciii,nursing_note,PROMPT2_ICL_entailment
81,171,13,12,1,0.9230769230769232,8,4,4,0.5,0.6486486486486487,shc-gpt-4o,mimiciii,nursing_note,PROMPT2_ICL_entailment
82,172,57,51,6,0.8947368421052632,38,26,12,0.6842105263157895,0.7754385964912281,shc-gpt-4o,mimiciii,nursing_note,PROMPT2_ICL_entailment
83,173,39,33,6,0.8461538461538461,19,15,4,0.7894736842105263,0.8168316831683169,shc-gpt-4o,mimiciii,nursing_note,PROMPT2_ICL_entailment
84,174,11,11,0,1.0,8,7,1,0.875,0.9333333333333332,shc-gpt-4o,mimiciii,nursing_note,PROMPT2_ICL_entailment
85,175,5,5,0,1.0,4,4,0,1.0,1.0,shc-gpt-4o,mimiciii,nursing_note,PROMPT2_ICL_entailment
86,176,28,28,0,1.0,13,11,2,0.8461538461538461,0.9166666666666666,shc-gpt-4o,mimiciii,nursing_note,PROMPT2_ICL_entailment
87,177,72,63,9,0.875,38,34,4,0.8947368421052632,0.8847583643122676,shc-gpt-4o,mimiciii,nursing_note,PROMPT2_ICL_entailment
88,178,54,53,1,0.9814814814814816,25,22,3,0.88,0.927974532431357,shc-gpt-4o,mimiciii,nursing_note,PROMPT2_ICL_entailment
89,179,42,37,5,0.8809523809523809,22,18,4,0.8181818181818182,0.8484076433121019,shc-gpt-4o,mimiciii,nursing_note,PROMPT2_ICL_entailment
90,18,51,44,7,0.8627450980392157,25,19,6,0.76,0.8081198646689223,shc-gpt-4o,mimiciii,nursing_note,PROMPT2_ICL_entailment
91,180,52,43,9,0.8269230769230769,27,21,6,0.7777777777777778,0.8015978695073235,shc-gpt-4o,mimiciii,nursing_note,PROMPT2_ICL_entailment
92,181,41,39,2,0.951219512195122,25,25,0,1.0,0.975,shc-gpt-4o,mimiciii,nursing_note,PROMPT2_ICL_entailment
93,182,35,30,5,0.8571428571428571,10,9,1,0.9,0.8780487804878048,shc-gpt-4o,mimiciii,nursing_note,PROMPT2_ICL_entailment
94,183,8,8,0,1.0,5,4,1,0.8,0.888888888888889,shc-gpt-4o,mimiciii,nursing_note,PROMPT2_ICL_entailment
95,184,17,17,0,1.0,1,1,0,1.0,1.0,shc-gpt-4o,mimiciii,nursing_note,PROMPT2_ICL_entailment
96,185,35,31,4,0.8857142857142857,30,27,3,0.9,0.8928,shc-gpt-4o,mimiciii,nursing_note,PROMPT2_ICL_entailment
97,186,9,7,2,0.7777777777777778,4,3,1,0.75,0.7636363636363638,shc-gpt-4o,mimiciii,nursing_note,PROMPT2_ICL_entailment
98,187,52,49,3,0.9423076923076924,37,32,5,0.8648648648648649,0.901926948518838,shc-gpt-4o,mimiciii,nursing_note,PROMPT2_ICL_entailment
99,188,5,5,0,1.0,2,1,1,0.5,0.6666666666666666,shc-gpt-4o,mimiciii,nursing_note,PROMPT2_ICL_entailment
100,189,55,52,3,0.9454545454545454,21,20,1,0.9523809523809524,0.948905109489051,shc-gpt-4o,mimiciii,nursing_note,PROMPT2_ICL_entailment
101,19,81,63,18,0.7777777777777778,45,38,7,0.8444444444444444,0.8097412480974124,shc-gpt-4o,mimiciii,nursing_note,PROMPT2_ICL_entailment
102,190,54,53,1,0.9814814814814816,24,20,4,0.8333333333333334,0.9013605442176872,shc-gpt-4o,mimiciii,nursing_note,PROMPT2_ICL_entailment
103,191,40,38,2,0.95,29,22,7,0.7586206896551724,0.8435923309788091,shc-gpt-4o,mimiciii,nursing_note,PROMPT2_ICL_entailment
104,192,25,25,0,1.0,15,14,1,0.9333333333333332,0.9655172413793104,shc-gpt-4o,mimiciii,nursing_note,PROMPT2_ICL_entailment
105,193,66,61,5,0.9242424242424242,36,36,0,1.0,0.9606299212598424,shc-gpt-4o,mimiciii,nursing_note,PROMPT2_ICL_entailment
106,194,18,18,0,1.0,11,11,0,1.0,1.0,shc-gpt-4o,mimiciii,nursing_note,PROMPT2_ICL_entailment
107,195,10,10,0,1.0,7,7,0,1.0,1.0,shc-gpt-4o,mimiciii,nursing_note,PROMPT2_ICL_entailment
108,196,50,44,6,0.88,34,30,4,0.8823529411764706,0.8811748998664888,shc-gpt-4o,mimiciii,nursing_note,PROMPT2_ICL_entailment
109,197,56,45,11,0.8035714285714286,27,24,3,0.8888888888888888,0.8440797186400938,shc-gpt-4o,mimiciii,nursing_note,PROMPT2_ICL_entailment
110,198,59,53,6,0.8983050847457628,38,33,5,0.868421052631579,0.8831103256753345,shc-gpt-4o,mimiciii,nursing_note,PROMPT2_ICL_entailment
111,199,23,21,2,0.9130434782608696,14,13,1,0.9285714285714286,0.9207419898819562,shc-gpt-4o,mimiciii,nursing_note,PROMPT2_ICL_entailment
112,2,73,47,26,0.6438356164383562,43,40,3,0.9302325581395348,0.7609795587937664,shc-gpt-4o,mimiciii,nursing_note,PROMPT2_ICL_entailment
113,20,93,69,24,0.7419354838709677,46,35,11,0.7608695652173914,0.7512832477834811,shc-gpt-4o,mimiciii,nursing_note,PROMPT2_ICL_entailment
114,200,64,52,12,0.8125,44,35,9,0.7954545454545454,0.8038869257950529,shc-gpt-4o,mimiciii,nursing_note,PROMPT2_ICL_entailment
115,201,40,37,3,0.925,29,23,6,0.7931034482758621,0.8539889613647768,shc-gpt-4o,mimiciii,nursing_note,PROMPT2_ICL_entailment
116,202,11,11,0,1.0,9,8,1,0.8888888888888888,0.9411764705882352,shc-gpt-4o,mimiciii,nursing_note,PROMPT2_ICL_entailment
117,203,13,13,0,1.0,7,6,1,0.8571428571428571,0.923076923076923,shc-gpt-4o,mimiciii,nursing_note,PROMPT2_ICL_entailment
118,204,55,48,7,0.8727272727272727,24,19,5,0.7916666666666666,0.8302230314064633,shc-gpt-4o,mimiciii,nursing_note,PROMPT2_ICL_entailment
119,205,60,59,1,0.9833333333333332,47,37,10,0.7872340425531915,0.87442419387142,shc-gpt-4o,mimiciii,nursing_note,PROMPT2_ICL_entailment
120,206,12,12,0,1.0,6,4,2,0.6666666666666666,0.8,shc-gpt-4o,mimiciii,nursing_note,PROMPT2_ICL_entailment
121,207,67,62,5,0.9253731343283582,29,23,6,0.7931034482758621,0.8541479484875711,shc-gpt-4o,mimiciii,nursing_note,PROMPT2_ICL_entailment
122,208,21,20,1,0.9523809523809524,7,7,0,1.0,0.975609756097561,shc-gpt-4o,mimiciii,nursing_note,PROMPT2_ICL_entailment
123,209,5,5,0,1.0,2,2,0,1.0,1.0,shc-gpt-4o,mimiciii,nursing_note,PROMPT2_ICL_entailment
124,21,12,12,0,1.0,6,5,1,0.8333333333333334,0.9090909090909092,shc-gpt-4o,mimiciii,nursing_note,PROMPT2_ICL_entailment
125,210,32,30,2,0.9375,22,20,2,0.9090909090909092,0.923076923076923,shc-gpt-4o,mimiciii,nursing_note,PROMPT2_ICL_entailment
126,211,9,8,1,0.8888888888888888,4,3,1,0.75,0.8135593220338982,shc-gpt-4o,mimiciii,nursing_note,PROMPT2_ICL_entailment
127,212,55,52,3,0.9454545454545454,37,29,8,0.7837837837837838,0.8570616652458085,shc-gpt-4o,mimiciii,nursing_note,PROMPT2_ICL_entailment
128,213,37,33,4,0.8918918918918919,18,18,0,1.0,0.9428571428571428,shc-gpt-4o,mimiciii,nursing_note,PROMPT2_ICL_entailment
129,214,17,16,1,0.9411764705882352,3,3,0,1.0,0.9696969696969696,shc-gpt-4o,mimiciii,nursing_note,PROMPT2_ICL_entailment
130,215,13,13,0,1.0,7,6,1,0.8571428571428571,0.923076923076923,shc-gpt-4o,mimiciii,nursing_note,PROMPT2_ICL_entailment
131,216,31,23,8,0.7419354838709677,13,10,3,0.7692307692307693,0.7553366174055829,shc-gpt-4o,mimiciii,nursing_note,PROMPT2_ICL_entailment
132,217,61,54,7,0.8852459016393442,25,23,2,0.92,0.9022884126407557,shc-gpt-4o,mimiciii,nursing_note,PROMPT2_ICL_entailment
133,218,31,30,1,0.967741935483871,18,15,3,0.8333333333333334,0.8955223880597015,shc-gpt-4o,mimiciii,nursing_note,PROMPT2_ICL_entailment
134,219,45,31,14,0.6888888888888889,14,11,3,0.7857142857142857,0.7341227125941872,shc-gpt-4o,mimiciii,nursing_note,PROMPT2_ICL_entailment
135,22,44,42,2,0.9545454545454546,26,23,3,0.8846153846153846,0.918250950570342,shc-gpt-4o,mimiciii,nursing_note,PROMPT2_ICL_entailment
136,220,17,16,1,0.9411764705882352,5,4,1,0.8,0.8648648648648648,shc-gpt-4o,mimiciii,nursing_note,PROMPT2_ICL_entailment
137,221,36,28,8,0.7777777777777778,35,29,6,0.8285714285714286,0.8023715415019763,shc-gpt-4o,mimiciii,nursing_note,PROMPT2_ICL_entailment
138,222,6,6,0,1.0,3,3,0,1.0,1.0,shc-gpt-4o,mimiciii,nursing_note,PROMPT2_ICL_entailment
139,223,39,35,4,0.8974358974358975,30,28,2,0.9333333333333332,0.915032679738562,shc-gpt-4o,mimiciii,nursing_note,PROMPT2_ICL_entailment
140,224,12,12,0,1.0,6,6,0,1.0,1.0,shc-gpt-4o,mimiciii,nursing_note,PROMPT2_ICL_entailment
141,225,80,56,24,0.7,45,38,7,0.8444444444444444,0.7654676258992805,shc-gpt-4o,mimiciii,nursing_note,PROMPT2_ICL_entailment
142,226,47,46,1,0.9787234042553192,20,17,3,0.85,0.9098312972658522,shc-gpt-4o,mimiciii,nursing_note,PROMPT2_ICL_entailment
143,227,21,21,0,1.0,15,14,1,0.9333333333333332,0.9655172413793104,shc-gpt-4o,mimiciii,nursing_note,PROMPT2_ICL_entailment
144,228,74,66,8,0.8918918918918919,38,35,3,0.9210526315789472,0.90623774029031,shc-gpt-4o,mimiciii,nursing_note,PROMPT2_ICL_entailment
145,229,40,35,5,0.875,22,19,3,0.8636363636363636,0.869281045751634,shc-gpt-4o,mimiciii,nursing_note,PROMPT2_ICL_entailment
146,23,74,68,6,0.918918918918919,35,32,3,0.9142857142857144,0.9165964616680708,shc-gpt-4o,mimiciii,nursing_note,PROMPT2_ICL_entailment
147,230,17,15,2,0.8823529411764706,7,6,1,0.8571428571428571,0.8695652173913043,shc-gpt-4o,mimiciii,nursing_note,PROMPT2_ICL_entailment
148,231,69,63,6,0.9130434782608696,15,13,2,0.8666666666666667,0.8892508143322475,shc-gpt-4o,mimiciii,nursing_note,PROMPT2_ICL_entailment
149,232,10,8,2,0.8,2,2,0,1.0,0.888888888888889,shc-gpt-4o,mimiciii,nursing_note,PROMPT2_ICL_entailment
150,233,38,34,4,0.8947368421052632,33,25,8,0.7575757575757576,0.8204633204633205,shc-gpt-4o,mimiciii,nursing_note,PROMPT2_ICL_entailment
151,234,53,51,2,0.9622641509433962,32,26,6,0.8125,0.881063122923588,shc-gpt-4o,mimiciii,nursing_note,PROMPT2_ICL_entailment
152,235,26,22,4,0.8461538461538461,10,10,0,1.0,0.9166666666666666,shc-gpt-4o,mimiciii,nursing_note,PROMPT2_ICL_entailment
153,236,22,20,2,0.9090909090909092,7,7,0,1.0,0.9523809523809524,shc-gpt-4o,mimiciii,nursing_note,PROMPT2_ICL_entailment
154,237,51,49,2,0.9607843137254902,35,31,4,0.8857142857142857,0.9217233009708736,shc-gpt-4o,mimiciii,nursing_note,PROMPT2_ICL_entailment
155,238,84,66,18,0.7857142857142857,42,34,8,0.8095238095238095,0.7974413646055437,shc-gpt-4o,mimiciii,nursing_note,PROMPT2_ICL_entailment
156,239,54,44,10,0.8148148148148148,21,14,7,0.6666666666666666,0.7333333333333333,shc-gpt-4o,mimiciii,nursing_note,PROMPT2_ICL_entailment
157,24,14,14,0,1.0,5,5,0,1.0,1.0,shc-gpt-4o,mimiciii,nursing_note,PROMPT2_ICL_entailment
158,240,48,47,1,0.9791666666666666,42,33,9,0.7857142857142857,0.8718381112984822,shc-gpt-4o,mimiciii,nursing_note,PROMPT2_ICL_entailment
159,241,35,29,6,0.8285714285714286,21,20,1,0.9523809523809524,0.8861726508785333,shc-gpt-4o,mimiciii,nursing_note,PROMPT2_ICL_entailment
160,242,51,43,8,0.8431372549019608,16,14,2,0.875,0.8587731811697575,shc-gpt-4o,mimiciii,nursing_note,PROMPT2_ICL_entailment
161,243,14,12,2,0.8571428571428571,5,3,2,0.6,0.7058823529411764,shc-gpt-4o,mimiciii,nursing_note,PROMPT2_ICL_entailment
162,244,44,37,7,0.8409090909090909,16,15,1,0.9375,0.8865814696485623,shc-gpt-4o,mimiciii,nursing_note,PROMPT2_ICL_entailment
163,245,55,43,12,0.7818181818181819,37,31,6,0.8378378378378378,0.8088592233009708,shc-gpt-4o,mimiciii,nursing_note,PROMPT2_ICL_entailment
164,246,44,41,3,0.9318181818181818,10,10,0,1.0,0.9647058823529412,shc-gpt-4o,mimiciii,nursing_note,PROMPT2_ICL_entailment
165,247,9,9,0,1.0,6,4,2,0.6666666666666666,0.8,shc-gpt-4o,mimiciii,nursing_note,PROMPT2_ICL_entailment
166,248,62,54,8,0.8709677419354839,42,35,7,0.8333333333333334,0.8517350157728707,shc-gpt-4o,mimiciii,nursing_note,PROMPT2_ICL_entailment
167,249,54,39,15,0.7222222222222222,39,32,7,0.8205128205128205,0.7682363804247461,shc-gpt-4o,mimiciii,nursing_note,PROMPT2_ICL_entailment
168,25,45,35,10,0.7777777777777778,23,21,2,0.9130434782608696,0.84,shc-gpt-4o,mimiciii,nursing_note,PROMPT2_ICL_entailment
169,26,59,55,4,0.9322033898305084,35,30,5,0.8571428571428571,0.8930987821380243,shc-gpt-4o,mimiciii,nursing_note,PROMPT2_ICL_entailment
170,27,7,7,0,1.0,3,2,1,0.6666666666666666,0.8,shc-gpt-4o,mimiciii,nursing_note,PROMPT2_ICL_entailment
171,28,61,53,8,0.8688524590163934,16,10,6,0.625,0.7270233196159123,shc-gpt-4o,mimiciii,nursing_note,PROMPT2_ICL_entailment
172,29,48,42,6,0.875,33,25,8,0.7575757575757576,0.8120649651972157,shc-gpt-4o,mimiciii,nursing_note,PROMPT2_ICL_entailment
173,3,12,10,2,0.8333333333333334,6,5,1,0.8333333333333334,0.8333333333333334,shc-gpt-4o,mimiciii,nursing_note,PROMPT2_ICL_entailment
174,30,18,18,0,1.0,13,10,3,0.7692307692307693,0.8695652173913044,shc-gpt-4o,mimiciii,nursing_note,PROMPT2_ICL_entailment
175,31,36,33,3,0.9166666666666666,19,17,2,0.8947368421052632,0.9055690072639224,shc-gpt-4o,mimiciii,nursing_note,PROMPT2_ICL_entailment
176,32,75,71,4,0.9466666666666668,44,44,0,1.0,0.9726027397260272,shc-gpt-4o,mimiciii,nursing_note,PROMPT2_ICL_entailment
177,33,13,13,0,1.0,5,5,0,1.0,1.0,shc-gpt-4o,mimiciii,nursing_note,PROMPT2_ICL_entailment
178,34,6,6,0,1.0,3,2,1,0.6666666666666666,0.8,shc-gpt-4o,mimiciii,nursing_note,PROMPT2_ICL_entailment
179,35,19,19,0,1.0,7,7,0,1.0,1.0,shc-gpt-4o,mimiciii,nursing_note,PROMPT2_ICL_entailment
180,36,108,92,16,0.8518518518518519,62,58,4,0.935483870967742,0.8917112299465242,shc-gpt-4o,mimiciii,nursing_note,PROMPT2_ICL_entailment
181,37,49,34,15,0.6938775510204082,38,25,13,0.6578947368421053,0.6754072308303537,shc-gpt-4o,mimiciii,nursing_note,PROMPT2_ICL_entailment
182,38,43,31,12,0.7209302325581395,26,17,9,0.6538461538461539,0.6857514638906962,shc-gpt-4o,mimiciii,nursing_note,PROMPT2_ICL_entailment
183,39,27,23,4,0.8518518518518519,3,3,0,1.0,0.92,shc-gpt-4o,mimiciii,nursing_note,PROMPT2_ICL_entailment
184,4,41,39,2,0.951219512195122,26,21,5,0.8076923076923077,0.8736,shc-gpt-4o,mimiciii,nursing_note,PROMPT2_ICL_entailment
185,40,13,12,1,0.9230769230769232,3,3,0,1.0,0.96,shc-gpt-4o,mimiciii,nursing_note,PROMPT2_ICL_entailment
186,41,77,74,3,0.961038961038961,50,43,7,0.86,0.9077164455855083,shc-gpt-4o,mimiciii,nursing_note,PROMPT2_ICL_entailment
187,42,47,42,5,0.8936170212765957,7,6,1,0.8571428571428571,0.875,shc-gpt-4o,mimiciii,nursing_note,PROMPT2_ICL_entailment
188,43,38,32,6,0.8421052631578947,14,12,2,0.8571428571428571,0.8495575221238938,shc-gpt-4o,mimiciii,nursing_note,PROMPT2_ICL_entailment
189,44,11,11,0,1.0,3,3,0,1.0,1.0,shc-gpt-4o,mimiciii,nursing_note,PROMPT2_ICL_entailment
190,45,66,59,7,0.8939393939393939,34,32,2,0.9411764705882352,0.9169499757163672,shc-gpt-4o,mimiciii,nursing_note,PROMPT2_ICL_entailment
191,46,73,66,7,0.9041095890410958,31,26,5,0.8387096774193549,0.8701825557809331,shc-gpt-4o,mimiciii,nursing_note,PROMPT2_ICL_entailment
192,47,39,37,2,0.9487179487179488,14,12,2,0.8571428571428571,0.9006085192697768,shc-gpt-4o,mimiciii,nursing_note,PROMPT2_ICL_entailment
193,48,30,28,2,0.9333333333333332,9,8,1,0.8888888888888888,0.9105691056910568,shc-gpt-4o,mimiciii,nursing_note,PROMPT2_ICL_entailment
194,49,8,7,1,0.875,3,2,1,0.6666666666666666,0.7567567567567567,shc-gpt-4o,mimiciii,nursing_note,PROMPT2_ICL_entailment
195,5,43,41,2,0.9534883720930232,15,12,3,0.8,0.870026525198939,shc-gpt-4o,mimiciii,nursing_note,PROMPT2_ICL_entailment
196,50,37,29,8,0.7837837837837838,16,14,2,0.875,0.8268839103869653,shc-gpt-4o,mimiciii,nursing_note,PROMPT2_ICL_entailment
197,51,10,10,0,1.0,6,6,0,1.0,1.0,shc-gpt-4o,mimiciii,nursing_note,PROMPT2_ICL_entailment
198,52,43,30,13,0.6976744186046512,38,34,4,0.8947368421052632,0.7840122982321291,shc-gpt-4o,mimiciii,nursing_note,PROMPT2_ICL_entailment
199,53,10,9,1,0.9,6,5,1,0.8333333333333334,0.8653846153846153,shc-gpt-4o,mimiciii,nursing_note,PROMPT2_ICL_entailment
200,54,47,42,5,0.8936170212765957,37,23,14,0.6216216216216216,0.7332068311195445,shc-gpt-4o,mimiciii,nursing_note,PROMPT2_ICL_entailment
201,55,63,58,5,0.9206349206349206,35,25,10,0.7142857142857143,0.8044382801664356,shc-gpt-4o,mimiciii,nursing_note,PROMPT2_ICL_entailment
202,56,15,14,1,0.9333333333333332,2,2,0,1.0,0.9655172413793104,shc-gpt-4o,mimiciii,nursing_note,PROMPT2_ICL_entailment
203,57,55,52,3,0.9454545454545454,17,11,6,0.6470588235294118,0.7683008730691739,shc-gpt-4o,mimiciii,nursing_note,PROMPT2_ICL_entailment
204,58,74,66,8,0.8918918918918919,25,23,2,0.92,0.905727923627685,shc-gpt-4o,mimiciii,nursing_note,PROMPT2_ICL_entailment
205,59,13,12,1,0.9230769230769232,8,7,1,0.875,0.8983957219251337,shc-gpt-4o,mimiciii,nursing_note,PROMPT2_ICL_entailment
206,6,16,16,0,1.0,8,8,0,1.0,1.0,shc-gpt-4o,mimiciii,nursing_note,PROMPT2_ICL_entailment
207,60,56,45,11,0.8035714285714286,27,18,9,0.6666666666666666,0.7287449392712549,shc-gpt-4o,mimiciii,nursing_note,PROMPT2_ICL_entailment
208,61,42,34,8,0.8095238095238095,20,15,5,0.75,0.7786259541984734,shc-gpt-4o,mimiciii,nursing_note,PROMPT2_ICL_entailment
209,62,57,50,7,0.8771929824561403,37,28,9,0.7567567567567568,0.812536273940801,shc-gpt-4o,mimiciii,nursing_note,PROMPT2_ICL_entailment
210,63,7,7,0,1.0,5,5,0,1.0,1.0,shc-gpt-4o,mimiciii,nursing_note,PROMPT2_ICL_entailment
211,64,76,73,3,0.9605263157894736,27,24,3,0.8888888888888888,0.9233201581027668,shc-gpt-4o,mimiciii,nursing_note,PROMPT2_ICL_entailment
212,65,29,28,1,0.9655172413793104,19,16,3,0.8421052631578947,0.8995983935742972,shc-gpt-4o,mimiciii,nursing_note,PROMPT2_ICL_entailment
213,66,15,15,0,1.0,1,1,0,1.0,1.0,shc-gpt-4o,mimiciii,nursing_note,PROMPT2_ICL_entailment
214,67,15,12,3,0.8,7,6,1,0.8571428571428571,0.8275862068965518,shc-gpt-4o,mimiciii,nursing_note,PROMPT2_ICL_entailment
215,68,45,42,3,0.9333333333333332,18,15,3,0.8333333333333334,0.8805031446540881,shc-gpt-4o,mimiciii,nursing_note,PROMPT2_ICL_entailment
216,69,45,35,10,0.7777777777777778,25,22,3,0.88,0.8257372654155496,shc-gpt-4o,mimiciii,nursing_note,PROMPT2_ICL_entailment
217,7,5,5,0,1.0,2,2,0,1.0,1.0,shc-gpt-4o,mimiciii,nursing_note,PROMPT2_ICL_entailment
218,70,63,59,4,0.9365079365079364,45,36,9,0.8,0.8628884826325411,shc-gpt-4o,mimiciii,nursing_note,PROMPT2_ICL_entailment
219,71,97,56,41,0.5773195876288659,51,42,9,0.8235294117647058,0.6787878787878787,shc-gpt-4o,mimiciii,nursing_note,PROMPT2_ICL_entailment
220,72,25,22,3,0.88,12,8,4,0.6666666666666666,0.7586206896551725,shc-gpt-4o,mimiciii,nursing_note,PROMPT2_ICL_entailment
221,73,45,41,4,0.9111111111111112,38,29,9,0.7631578947368421,0.8305972755850506,shc-gpt-4o,mimiciii,nursing_note,PROMPT2_ICL_entailment
222,74,12,12,0,1.0,7,6,1,0.8571428571428571,0.923076923076923,shc-gpt-4o,mimiciii,nursing_note,PROMPT2_ICL_entailment
223,75,62,54,8,0.8709677419354839,27,21,6,0.7777777777777778,0.8217391304347826,shc-gpt-4o,mimiciii,nursing_note,PROMPT2_ICL_entailment
224,76,3,2,1,0.6666666666666666,1,1,0,1.0,0.8,shc-gpt-4o,mimiciii,nursing_note,PROMPT2_ICL_entailment
225,77,108,90,18,0.8333333333333334,59,53,6,0.8983050847457628,0.8646003262642741,shc-gpt-4o,mimiciii,nursing_note,PROMPT2_ICL_entailment
226,78,49,40,9,0.8163265306122449,20,18,2,0.9,0.8561236623067777,shc-gpt-4o,mimiciii,nursing_note,PROMPT2_ICL_entailment
227,79,50,50,0,1.0,30,29,1,0.9666666666666668,0.983050847457627,shc-gpt-4o,mimiciii,nursing_note,PROMPT2_ICL_entailment
228,8,17,17,0,1.0,11,10,1,0.9090909090909092,0.9523809523809524,shc-gpt-4o,mimiciii,nursing_note,PROMPT2_ICL_entailment
229,80,48,44,4,0.9166666666666666,22,19,3,0.8636363636363636,0.8893617021276595,shc-gpt-4o,mimiciii,nursing_note,PROMPT2_ICL_entailment
230,81,40,37,3,0.925,22,22,0,1.0,0.961038961038961,shc-gpt-4o,mimiciii,nursing_note,PROMPT2_ICL_entailment
231,82,51,43,8,0.8431372549019608,17,10,7,0.5882352941176471,0.6929895245769541,shc-gpt-4o,mimiciii,nursing_note,PROMPT2_ICL_entailment
232,83,29,20,9,0.6896551724137931,28,22,6,0.7857142857142857,0.7345575959933223,shc-gpt-4o,mimiciii,nursing_note,PROMPT2_ICL_entailment
233,84,15,15,0,1.0,6,5,1,0.8333333333333334,0.9090909090909092,shc-gpt-4o,mimiciii,nursing_note,PROMPT2_ICL_entailment
234,85,51,50,1,0.9803921568627452,24,19,5,0.7916666666666666,0.8759797141539879,shc-gpt-4o,mimiciii,nursing_note,PROMPT2_ICL_entailment
235,86,68,57,11,0.8382352941176471,40,35,5,0.875,0.8562231759656652,shc-gpt-4o,mimiciii,nursing_note,PROMPT2_ICL_entailment
236,87,28,26,2,0.9285714285714286,15,12,3,0.8,0.859504132231405,shc-gpt-4o,mimiciii,nursing_note,PROMPT2_ICL_entailment
237,88,53,45,8,0.8490566037735849,15,11,4,0.7333333333333333,0.7869634340222574,shc-gpt-4o,mimiciii,nursing_note,PROMPT2_ICL_entailment
238,89,48,46,2,0.9583333333333334,29,27,2,0.9310344827586208,0.9444866920152092,shc-gpt-4o,mimiciii,nursing_note,PROMPT2_ICL_entailment
239,9,48,48,0,1.0,17,16,1,0.9411764705882352,0.9696969696969696,shc-gpt-4o,mimiciii,nursing_note,PROMPT2_ICL_entailment
240,90,39,36,3,0.9230769230769232,14,11,3,0.7857142857142857,0.8488745980707394,shc-gpt-4o,mimiciii,nursing_note,PROMPT2_ICL_entailment
241,91,38,34,4,0.8947368421052632,24,20,4,0.8333333333333334,0.8629441624365481,shc-gpt-4o,mimiciii,nursing_note,PROMPT2_ICL_entailment
242,92,54,46,8,0.8518518518518519,28,26,2,0.9285714285714286,0.8885586924219911,shc-gpt-4o,mimiciii,nursing_note,PROMPT2_ICL_entailment
243,93,42,41,1,0.9761904761904762,23,19,4,0.8260869565217391,0.8948879954049397,shc-gpt-4o,mimiciii,nursing_note,PROMPT2_ICL_entailment
244,94,8,8,0,1.0,5,5,0,1.0,1.0,shc-gpt-4o,mimiciii,nursing_note,PROMPT2_ICL_entailment
245,95,39,34,5,0.8717948717948718,14,12,2,0.8571428571428571,0.864406779661017,shc-gpt-4o,mimiciii,nursing_note,PROMPT2_ICL_entailment
246,96,15,14,1,0.9333333333333332,6,6,0,1.0,0.9655172413793104,shc-gpt-4o,mimiciii,nursing_note,PROMPT2_ICL_entailment
247,97,19,18,1,0.9473684210526316,10,10,0,1.0,0.972972972972973,shc-gpt-4o,mimiciii,nursing_note,PROMPT2_ICL_entailment
248,98,68,58,10,0.8529411764705882,13,13,0,1.0,0.9206349206349206,shc-gpt-4o,mimiciii,nursing_note,PROMPT2_ICL_entailment
249,99,60,57,3,0.95,44,38,6,0.8636363636363636,0.9047619047619048,shc-gpt-4o,mimiciii,nursing_note,PROMPT2_ICL_entailment
0,0,19,19,0,1.0,11,10,1,0.9090909090909092,0.9523809523809524,shc-gpt-4o,mimiciii,nursing_note,PROMPT2_entailment
1,1,43,31,12,0.7209302325581395,31,25,6,0.8064516129032258,0.7612966601178781,shc-gpt-4o,mimiciii,nursing_note,PROMPT2_entailment
2,10,24,18,6,0.75,18,14,4,0.7777777777777778,0.7636363636363638,shc-gpt-4o,mimiciii,nursing_note,PROMPT2_entailment
3,100,13,13,0,1.0,6,6,0,1.0,1.0,shc-gpt-4o,mimiciii,nursing_note,PROMPT2_entailment
4,101,44,33,11,0.75,27,24,3,0.8888888888888888,0.8135593220338982,shc-gpt-4o,mimiciii,nursing_note,PROMPT2_entailment
5,102,35,33,2,0.9428571428571428,26,22,4,0.8461538461538461,0.8918918918918919,shc-gpt-4o,mimiciii,nursing_note,PROMPT2_entailment
6,103,31,30,1,0.967741935483871,22,21,1,0.9545454545454546,0.9610983981693364,shc-gpt-4o,mimiciii,nursing_note,PROMPT2_entailment
7,104,28,27,1,0.9642857142857144,20,19,1,0.95,0.957089552238806,shc-gpt-4o,mimiciii,nursing_note,PROMPT2_entailment
8,105,35,27,8,0.7714285714285715,20,18,2,0.9,0.8307692307692307,shc-gpt-4o,mimiciii,nursing_note,PROMPT2_entailment
9,106,7,7,0,1.0,4,4,0,1.0,1.0,shc-gpt-4o,mimiciii,nursing_note,PROMPT2_entailment
10,107,73,63,10,0.863013698630137,49,36,13,0.7346938775510204,0.7937007874015749,shc-gpt-4o,mimiciii,nursing_note,PROMPT2_entailment
11,108,53,51,2,0.9622641509433962,28,15,13,0.5357142857142857,0.688259109311741,shc-gpt-4o,mimiciii,nursing_note,PROMPT2_entailment
12,109,5,5,0,1.0,4,4,0,1.0,1.0,shc-gpt-4o,mimiciii,nursing_note,PROMPT2_entailment
13,11,3,3,0,1.0,2,2,0,1.0,1.0,shc-gpt-4o,mimiciii,nursing_note,PROMPT2_entailment
14,110,19,19,0,1.0,13,11,2,0.8461538461538461,0.9166666666666666,shc-gpt-4o,mimiciii,nursing_note,PROMPT2_entailment
15,111,38,31,7,0.8157894736842105,32,28,4,0.875,0.8443579766536964,shc-gpt-4o,mimiciii,nursing_note,PROMPT2_entailment
16,112,60,53,7,0.8833333333333333,37,28,9,0.7567567567567568,0.8151606701455645,shc-gpt-4o,mimiciii,nursing_note,PROMPT2_entailment
17,113,6,6,0,1.0,5,5,0,1.0,1.0,shc-gpt-4o,mimiciii,nursing_note,PROMPT2_entailment
18,114,24,21,3,0.875,19,12,7,0.631578947368421,0.7336244541484715,shc-gpt-4o,mimiciii,nursing_note,PROMPT2_entailment
19,115,14,14,0,1.0,7,7,0,1.0,1.0,shc-gpt-4o,mimiciii,nursing_note,PROMPT2_entailment
20,116,34,33,1,0.9705882352941176,31,27,4,0.8709677419354839,0.9180834621329212,shc-gpt-4o,mimiciii,nursing_note,PROMPT2_entailment
21,117,48,45,3,0.9375,18,15,3,0.8333333333333334,0.8823529411764706,shc-gpt-4o,mimiciii,nursing_note,PROMPT2_entailment
22,118,33,27,6,0.8181818181818182,25,19,6,0.76,0.7880184331797235,shc-gpt-4o,mimiciii,nursing_note,PROMPT2_entailment
23,119,39,38,1,0.9743589743589745,26,21,5,0.8076923076923077,0.8832318760376315,shc-gpt-4o,mimiciii,nursing_note,PROMPT2_entailment
24,12,32,30,2,0.9375,18,16,2,0.8888888888888888,0.9125475285171102,shc-gpt-4o,mimiciii,nursing_note,PROMPT2_entailment
25,120,27,24,3,0.8888888888888888,18,18,0,1.0,0.9411764705882352,shc-gpt-4o,mimiciii,nursing_note,PROMPT2_entailment
26,121,64,49,15,0.765625,37,27,10,0.7297297297297297,0.7472465405252753,shc-gpt-4o,mimiciii,nursing_note,PROMPT2_entailment
27,122,32,32,0,1.0,11,8,3,0.7272727272727273,0.8421052631578948,shc-gpt-4o,mimiciii,nursing_note,PROMPT2_entailment
28,123,7,7,0,1.0,6,6,0,1.0,1.0,shc-gpt-4o,mimiciii,nursing_note,PROMPT2_entailment
29,124,7,7,0,1.0,5,4,1,0.8,0.888888888888889,shc-gpt-4o,mimiciii,nursing_note,PROMPT2_entailment
30,125,48,44,4,0.9166666666666666,43,30,13,0.6976744186046512,0.7923169267707083,shc-gpt-4o,mimiciii,nursing_note,PROMPT2_entailment
31,126,39,35,4,0.8974358974358975,28,21,7,0.75,0.8171206225680935,shc-gpt-4o,mimiciii,nursing_note,PROMPT2_entailment
32,127,21,20,1,0.9523809523809524,10,10,0,1.0,0.975609756097561,shc-gpt-4o,mimiciii,nursing_note,PROMPT2_entailment
33,128,31,28,3,0.9032258064516128,17,15,2,0.8823529411764706,0.8926673751328373,shc-gpt-4o,mimiciii,nursing_note,PROMPT2_entailment
34,129,39,37,2,0.9487179487179488,29,25,4,0.8620689655172413,0.9033203125,shc-gpt-4o,mimiciii,nursing_note,PROMPT2_entailment
35,13,59,58,1,0.9830508474576272,34,31,3,0.9117647058823528,0.9460668245198632,shc-gpt-4o,mimiciii,nursing_note,PROMPT2_entailment
36,130,55,51,4,0.9272727272727272,33,29,4,0.8787878787878788,0.9023794996949358,shc-gpt-4o,mimiciii,nursing_note,PROMPT2_entailment
37,131,42,38,4,0.9047619047619048,31,26,5,0.8387096774193549,0.8704845814977974,shc-gpt-4o,mimiciii,nursing_note,PROMPT2_entailment
38,132,43,39,4,0.9069767441860463,17,14,3,0.8235294117647058,0.8632411067193675,shc-gpt-4o,mimiciii,nursing_note,PROMPT2_entailment
39,133,17,16,1,0.9411764705882352,10,7,3,0.7,0.8028673835125448,shc-gpt-4o,mimiciii,nursing_note,PROMPT2_entailment
40,134,57,29,28,0.5087719298245614,30,27,3,0.9,0.6500622665006226,shc-gpt-4o,mimiciii,nursing_note,PROMPT2_entailment
41,135,61,53,8,0.8688524590163934,42,39,3,0.9285714285714286,0.8977198697068404,shc-gpt-4o,mimiciii,nursing_note,PROMPT2_entailment
42,136,59,55,4,0.9322033898305084,41,37,4,0.902439024390244,0.9170797656602072,shc-gpt-4o,mimiciii,nursing_note,PROMPT2_entailment
43,137,4,4,0,1.0,2,2,0,1.0,1.0,shc-gpt-4o,mimiciii,nursing_note,PROMPT2_entailment
44,138,4,4,0,1.0,5,4,1,0.8,0.888888888888889,shc-gpt-4o,mimiciii,nursing_note,PROMPT2_entailment
45,139,8,7,1,0.875,4,2,2,0.5,0.6363636363636364,shc-gpt-4o,mimiciii,nursing_note,PROMPT2_entailment
46,14,32,32,0,1.0,25,24,1,0.96,0.979591836734694,shc-gpt-4o,mimiciii,nursing_note,PROMPT2_entailment
47,140,36,31,5,0.8611111111111112,24,24,0,1.0,0.9253731343283582,shc-gpt-4o,mimiciii,nursing_note,PROMPT2_entailment
48,141,16,15,1,0.9375,11,11,0,1.0,0.967741935483871,shc-gpt-4o,mimiciii,nursing_note,PROMPT2_entailment
49,142,58,48,10,0.8275862068965517,8,7,1,0.875,0.8506329113924052,shc-gpt-4o,mimiciii,nursing_note,PROMPT2_entailment
50,143,18,17,1,0.9444444444444444,2,1,1,0.5,0.6538461538461539,shc-gpt-4o,mimiciii,nursing_note,PROMPT2_entailment
51,144,8,7,1,0.875,5,5,0,1.0,0.9333333333333332,shc-gpt-4o,mimiciii,nursing_note,PROMPT2_entailment
52,145,41,37,4,0.902439024390244,19,16,3,0.8421052631578947,0.8712288447387786,shc-gpt-4o,mimiciii,nursing_note,PROMPT2_entailment
53,146,11,11,0,1.0,6,5,1,0.8333333333333334,0.9090909090909092,shc-gpt-4o,mimiciii,nursing_note,PROMPT2_entailment
54,147,40,36,4,0.9,26,24,2,0.9230769230769232,0.9113924050632912,shc-gpt-4o,mimiciii,nursing_note,PROMPT2_entailment
55,148,12,12,0,1.0,7,7,0,1.0,1.0,shc-gpt-4o,mimiciii,nursing_note,PROMPT2_entailment
56,149,48,41,7,0.8541666666666666,36,28,8,0.7777777777777778,0.8141843971631206,shc-gpt-4o,mimiciii,nursing_note,PROMPT2_entailment
57,15,36,31,5,0.8611111111111112,33,27,6,0.8181818181818182,0.8390977443609022,shc-gpt-4o,mimiciii,nursing_note,PROMPT2_entailment
58,150,13,13,0,1.0,8,6,2,0.75,0.8571428571428571,shc-gpt-4o,mimiciii,nursing_note,PROMPT2_entailment
59,151,39,34,5,0.8717948717948718,26,23,3,0.8846153846153846,0.8781583380123525,shc-gpt-4o,mimiciii,nursing_note,PROMPT2_entailment
60,152,47,43,4,0.9148936170212766,44,36,8,0.8181818181818182,0.8638392857142857,shc-gpt-4o,mimiciii,nursing_note,PROMPT2_entailment
61,153,5,5,0,1.0,4,3,1,0.75,0.8571428571428571,shc-gpt-4o,mimiciii,nursing_note,PROMPT2_entailment
62,154,38,37,1,0.9736842105263158,34,28,6,0.8235294117647058,0.892334194659776,shc-gpt-4o,mimiciii,nursing_note,PROMPT2_entailment
63,155,59,54,5,0.9152542372881356,51,45,6,0.8823529411764706,0.8985024958402662,shc-gpt-4o,mimiciii,nursing_note,PROMPT2_entailment
64,156,27,27,0,1.0,26,18,8,0.6923076923076923,0.8181818181818181,shc-gpt-4o,mimiciii,nursing_note,PROMPT2_entailment
65,157,6,6,0,1.0,5,5,0,1.0,1.0,shc-gpt-4o,mimiciii,nursing_note,PROMPT2_entailment
66,158,47,44,3,0.9361702127659576,22,19,3,0.8636363636363636,0.8984416980118216,shc-gpt-4o,mimiciii,nursing_note,PROMPT2_entailment
67,159,12,12,0,1.0,8,7,1,0.875,0.9333333333333332,shc-gpt-4o,mimiciii,nursing_note,PROMPT2_entailment
68,16,55,49,6,0.8909090909090909,30,17,13,0.5666666666666667,0.6927234927234927,shc-gpt-4o,mimiciii,nursing_note,PROMPT2_entailment
69,160,44,41,3,0.9318181818181818,21,19,2,0.9047619047619048,0.9180907483794932,shc-gpt-4o,mimiciii,nursing_note,PROMPT2_entailment
70,161,6,6,0,1.0,6,5,1,0.8333333333333334,0.9090909090909092,shc-gpt-4o,mimiciii,nursing_note,PROMPT2_entailment
71,162,39,34,5,0.8717948717948718,31,24,7,0.7741935483870968,0.8201005025125628,shc-gpt-4o,mimiciii,nursing_note,PROMPT2_entailment
72,163,10,10,0,1.0,4,4,0,1.0,1.0,shc-gpt-4o,mimiciii,nursing_note,PROMPT2_entailment
73,164,21,21,0,1.0,13,12,1,0.9230769230769232,0.96,shc-gpt-4o,mimiciii,nursing_note,PROMPT2_entailment
74,165,53,47,6,0.8867924528301887,24,21,3,0.875,0.8808567603748326,shc-gpt-4o,mimiciii,nursing_note,PROMPT2_entailment
75,166,13,13,0,1.0,3,3,0,1.0,1.0,shc-gpt-4o,mimiciii,nursing_note,PROMPT2_entailment
76,167,41,40,1,0.975609756097561,16,16,0,1.0,0.9876543209876544,shc-gpt-4o,mimiciii,nursing_note,PROMPT2_entailment
77,168,30,23,7,0.7666666666666667,25,20,5,0.8,0.7829787234042553,shc-gpt-4o,mimiciii,nursing_note,PROMPT2_entailment
78,169,29,27,2,0.9310344827586208,12,12,0,1.0,0.9642857142857144,shc-gpt-4o,mimiciii,nursing_note,PROMPT2_entailment
79,17,38,35,3,0.9210526315789472,39,32,7,0.8205128205128205,0.8678806664083688,shc-gpt-4o,mimiciii,nursing_note,PROMPT2_entailment
80,170,48,44,4,0.9166666666666666,21,15,6,0.7142857142857143,0.8029197080291971,shc-gpt-4o,mimiciii,nursing_note,PROMPT2_entailment
81,171,8,7,1,0.875,8,6,2,0.75,0.8076923076923077,shc-gpt-4o,mimiciii,nursing_note,PROMPT2_entailment
82,172,47,45,2,0.9574468085106383,38,29,9,0.7631578947368421,0.8493328994467947,shc-gpt-4o,mimiciii,nursing_note,PROMPT2_entailment
83,173,33,31,2,0.9393939393939394,19,16,3,0.8421052631578947,0.8880931065353626,shc-gpt-4o,mimiciii,nursing_note,PROMPT2_entailment
84,174,9,9,0,1.0,8,6,2,0.75,0.8571428571428571,shc-gpt-4o,mimiciii,nursing_note,PROMPT2_entailment
85,175,4,3,1,0.75,4,4,0,1.0,0.8571428571428571,shc-gpt-4o,mimiciii,nursing_note,PROMPT2_entailment
86,176,28,28,0,1.0,13,10,3,0.7692307692307693,0.8695652173913044,shc-gpt-4o,mimiciii,nursing_note,PROMPT2_entailment
87,177,60,52,8,0.8666666666666667,38,36,2,0.9473684210526316,0.9052224371373307,shc-gpt-4o,mimiciii,nursing_note,PROMPT2_entailment
88,178,47,45,2,0.9574468085106383,25,20,5,0.8,0.8716707021791769,shc-gpt-4o,mimiciii,nursing_note,PROMPT2_entailment
89,179,36,33,3,0.9166666666666666,22,16,6,0.7272727272727273,0.8110599078341013,shc-gpt-4o,mimiciii,nursing_note,PROMPT2_entailment
90,18,42,39,3,0.9285714285714286,25,17,8,0.68,0.7850799289520427,shc-gpt-4o,mimiciii,nursing_note,PROMPT2_entailment
91,180,47,37,10,0.7872340425531915,27,24,3,0.8888888888888888,0.8349788434414669,shc-gpt-4o,mimiciii,nursing_note,PROMPT2_entailment
92,181,35,31,4,0.8857142857142857,25,24,1,0.96,0.9213622291021673,shc-gpt-4o,mimiciii,nursing_note,PROMPT2_entailment
93,182,36,30,6,0.8333333333333334,10,8,2,0.8,0.816326530612245,shc-gpt-4o,mimiciii,nursing_note,PROMPT2_entailment
94,183,7,7,0,1.0,5,4,1,0.8,0.888888888888889,shc-gpt-4o,mimiciii,nursing_note,PROMPT2_entailment
95,184,17,17,0,1.0,1,1,0,1.0,1.0,shc-gpt-4o,mimiciii,nursing_note,PROMPT2_entailment
96,185,33,26,7,0.7878787878787878,30,24,6,0.8,0.7938931297709925,shc-gpt-4o,mimiciii,nursing_note,PROMPT2_entailment
97,186,5,5,0,1.0,4,3,1,0.75,0.8571428571428571,shc-gpt-4o,mimiciii,nursing_note,PROMPT2_entailment
98,187,43,43,0,1.0,37,32,5,0.8648648648648649,0.927536231884058,shc-gpt-4o,mimiciii,nursing_note,PROMPT2_entailment
99,188,2,2,0,1.0,2,0,2,0.0,0.0,shc-gpt-4o,mimiciii,nursing_note,PROMPT2_entailment
100,189,42,42,0,1.0,21,19,2,0.9047619047619048,0.95,shc-gpt-4o,mimiciii,nursing_note,PROMPT2_entailment
101,19,67,52,15,0.7761194029850746,45,41,4,0.9111111111111112,0.8382150579909574,shc-gpt-4o,mimiciii,nursing_note,PROMPT2_entailment
102,190,39,37,2,0.9487179487179488,24,21,3,0.875,0.9103690685413004,shc-gpt-4o,mimiciii,nursing_note,PROMPT2_entailment
103,191,34,28,6,0.8235294117647058,29,25,4,0.8620689655172413,0.8423586040914561,shc-gpt-4o,mimiciii,nursing_note,PROMPT2_entailment
104,192,17,17,0,1.0,15,15,0,1.0,1.0,shc-gpt-4o,mimiciii,nursing_note,PROMPT2_entailment
105,193,57,56,1,0.9824561403508772,36,34,2,0.9444444444444444,0.9630753667172484,shc-gpt-4o,mimiciii,nursing_note,PROMPT2_entailment
106,194,12,12,0,1.0,11,11,0,1.0,1.0,shc-gpt-4o,mimiciii,nursing_note,PROMPT2_entailment
107,195,9,8,1,0.8888888888888888,7,7,0,1.0,0.9411764705882352,shc-gpt-4o,mimiciii,nursing_note,PROMPT2_entailment
108,196,42,39,3,0.9285714285714286,34,30,4,0.8823529411764706,0.9048723897911832,shc-gpt-4o,mimiciii,nursing_note,PROMPT2_entailment
109,197,44,36,8,0.8181818181818182,27,25,2,0.925925925925926,0.8687258687258688,shc-gpt-4o,mimiciii,nursing_note,PROMPT2_entailment
110,198,50,45,5,0.9,38,31,7,0.8157894736842105,0.8558282208588956,shc-gpt-4o,mimiciii,nursing_note,PROMPT2_entailment
111,199,19,18,1,0.9473684210526316,14,13,1,0.9285714285714286,0.937875751503006,shc-gpt-4o,mimiciii,nursing_note,PROMPT2_entailment
112,2,60,34,26,0.5666666666666667,43,31,12,0.7209302325581395,0.6345574954846478,shc-gpt-4o,mimiciii,nursing_note,PROMPT2_entailment
113,20,61,45,16,0.7377049180327869,46,35,11,0.7608695652173914,0.7491082045184306,shc-gpt-4o,mimiciii,nursing_note,PROMPT2_entailment
114,200,54,45,9,0.8333333333333334,44,35,9,0.7954545454545454,0.8139534883720929,shc-gpt-4o,mimiciii,nursing_note,PROMPT2_entailment
115,201,34,33,1,0.9705882352941176,29,22,7,0.7586206896551724,0.8516129032258065,shc-gpt-4o,mimiciii,nursing_note,PROMPT2_entailment
116,202,11,11,0,1.0,9,7,2,0.7777777777777778,0.8750000000000001,shc-gpt-4o,mimiciii,nursing_note,PROMPT2_entailment
117,203,13,13,0,1.0,7,6,1,0.8571428571428571,0.923076923076923,shc-gpt-4o,mimiciii,nursing_note,PROMPT2_entailment
118,204,41,36,5,0.8780487804878049,24,17,7,0.7083333333333334,0.7841127482383088,shc-gpt-4o,mimiciii,nursing_note,PROMPT2_entailment
119,205,51,47,4,0.9215686274509804,47,41,6,0.8723404255319149,0.896279069767442,shc-gpt-4o,mimiciii,nursing_note,PROMPT2_entailment
120,206,7,7,0,1.0,6,5,1,0.8333333333333334,0.9090909090909092,shc-gpt-4o,mimiciii,nursing_note,PROMPT2_entailment
121,207,55,49,6,0.8909090909090909,29,26,3,0.896551724137931,0.8937215012276394,shc-gpt-4o,mimiciii,nursing_note,PROMPT2_entailment
122,208,16,16,0,1.0,7,7,0,1.0,1.0,shc-gpt-4o,mimiciii,nursing_note,PROMPT2_entailment
123,209,4,4,0,1.0,2,2,0,1.0,1.0,shc-gpt-4o,mimiciii,nursing_note,PROMPT2_entailment
124,21,6,6,0,1.0,6,5,1,0.8333333333333334,0.9090909090909092,shc-gpt-4o,mimiciii,nursing_note,PROMPT2_entailment
125,210,30,26,4,0.8666666666666667,22,19,3,0.8636363636363636,0.8651488616462346,shc-gpt-4o,mimiciii,nursing_note,PROMPT2_entailment
126,211,4,4,0,1.0,4,4,0,1.0,1.0,shc-gpt-4o,mimiciii,nursing_note,PROMPT2_entailment
127,212,49,47,2,0.9591836734693876,37,31,6,0.8378378378378378,0.894413750767342,shc-gpt-4o,mimiciii,nursing_note,PROMPT2_entailment
128,213,20,18,2,0.9,18,16,2,0.8888888888888888,0.8944099378881988,shc-gpt-4o,mimiciii,nursing_note,PROMPT2_entailment
129,214,14,11,3,0.7857142857142857,3,2,1,0.6666666666666666,0.721311475409836,shc-gpt-4o,mimiciii,nursing_note,PROMPT2_entailment
130,215,8,8,0,1.0,7,6,1,0.8571428571428571,0.923076923076923,shc-gpt-4o,mimiciii,nursing_note,PROMPT2_entailment
131,216,28,22,6,0.7857142857142857,13,10,3,0.7692307692307693,0.7773851590106008,shc-gpt-4o,mimiciii,nursing_note,PROMPT2_entailment
132,217,38,34,4,0.8947368421052632,25,22,3,0.88,0.8873072360616845,shc-gpt-4o,mimiciii,nursing_note,PROMPT2_entailment
133,218,27,25,2,0.925925925925926,18,15,3,0.8333333333333334,0.8771929824561403,shc-gpt-4o,mimiciii,nursing_note,PROMPT2_entailment
134,219,39,30,9,0.7692307692307693,14,10,4,0.7142857142857143,0.7407407407407408,shc-gpt-4o,mimiciii,nursing_note,PROMPT2_entailment
135,22,48,43,5,0.8958333333333334,26,26,0,1.0,0.945054945054945,shc-gpt-4o,mimiciii,nursing_note,PROMPT2_entailment
136,220,14,13,1,0.9285714285714286,5,3,2,0.6,0.7289719626168225,shc-gpt-4o,mimiciii,nursing_note,PROMPT2_entailment
137,221,36,31,5,0.8611111111111112,35,25,10,0.7142857142857143,0.7808564231738034,shc-gpt-4o,mimiciii,nursing_note,PROMPT2_entailment
138,222,5,5,0,1.0,3,3,0,1.0,1.0,shc-gpt-4o,mimiciii,nursing_note,PROMPT2_entailment
139,223,38,33,5,0.868421052631579,30,26,4,0.8666666666666667,0.8675429726996966,shc-gpt-4o,mimiciii,nursing_note,PROMPT2_entailment
140,224,9,9,0,1.0,6,5,1,0.8333333333333334,0.9090909090909092,shc-gpt-4o,mimiciii,nursing_note,PROMPT2_entailment
141,225,65,43,22,0.6615384615384615,45,33,12,0.7333333333333333,0.6955882352941176,shc-gpt-4o,mimiciii,nursing_note,PROMPT2_entailment
142,226,25,24,1,0.96,20,17,3,0.85,0.901657458563536,shc-gpt-4o,mimiciii,nursing_note,PROMPT2_entailment
143,227,22,22,0,1.0,15,14,1,0.9333333333333332,0.9655172413793104,shc-gpt-4o,mimiciii,nursing_note,PROMPT2_entailment
144,228,50,40,10,0.8,38,33,5,0.868421052631579,0.832807570977918,shc-gpt-4o,mimiciii,nursing_note,PROMPT2_entailment
145,229,34,30,4,0.8823529411764706,22,21,1,0.9545454545454546,0.9170305676855895,shc-gpt-4o,mimiciii,nursing_note,PROMPT2_entailment
146,23,56,49,7,0.875,35,31,4,0.8857142857142857,0.8803245436105476,shc-gpt-4o,mimiciii,nursing_note,PROMPT2_entailment
147,230,15,15,0,1.0,7,6,1,0.8571428571428571,0.923076923076923,shc-gpt-4o,mimiciii,nursing_note,PROMPT2_entailment
148,231,65,62,3,0.953846153846154,15,12,3,0.8,0.8701754385964914,shc-gpt-4o,mimiciii,nursing_note,PROMPT2_entailment
149,232,9,7,2,0.7777777777777778,2,2,0,1.0,0.8750000000000001,shc-gpt-4o,mimiciii,nursing_note,PROMPT2_entailment
150,233,35,28,7,0.8,33,24,9,0.7272727272727273,0.761904761904762,shc-gpt-4o,mimiciii,nursing_note,PROMPT2_entailment
151,234,50,49,1,0.98,32,26,6,0.8125,0.8884239888423989,shc-gpt-4o,mimiciii,nursing_note,PROMPT2_entailment
152,235,21,20,1,0.9523809523809524,10,8,2,0.8,0.8695652173913043,shc-gpt-4o,mimiciii,nursing_note,PROMPT2_entailment
153,236,16,15,1,0.9375,7,6,1,0.8571428571428571,0.8955223880597014,shc-gpt-4o,mimiciii,nursing_note,PROMPT2_entailment
154,237,53,50,3,0.9433962264150944,35,28,7,0.8,0.8658008658008658,shc-gpt-4o,mimiciii,nursing_note,PROMPT2_entailment
155,238,51,38,13,0.7450980392156863,42,38,4,0.9047619047619048,0.8172043010752689,shc-gpt-4o,mimiciii,nursing_note,PROMPT2_entailment
156,239,45,41,4,0.9111111111111112,21,18,3,0.8571428571428571,0.8833034111310591,shc-gpt-4o,mimiciii,nursing_note,PROMPT2_entailment
157,24,10,10,0,1.0,5,5,0,1.0,1.0,shc-gpt-4o,mimiciii,nursing_note,PROMPT2_entailment
158,240,34,31,3,0.9117647058823528,42,30,12,0.7142857142857143,0.8010335917312662,shc-gpt-4o,mimiciii,nursing_note,PROMPT2_entailment
159,241,33,25,8,0.7575757575757576,21,20,1,0.9523809523809524,0.8438818565400843,shc-gpt-4o,mimiciii,nursing_note,PROMPT2_entailment
160,242,40,30,10,0.75,16,11,5,0.6875,0.717391304347826,shc-gpt-4o,mimiciii,nursing_note,PROMPT2_entailment
161,243,11,9,2,0.8181818181818182,5,3,2,0.6,0.6923076923076923,shc-gpt-4o,mimiciii,nursing_note,PROMPT2_entailment
162,244,44,33,11,0.75,16,13,3,0.8125,0.78,shc-gpt-4o,mimiciii,nursing_note,PROMPT2_entailment
163,245,42,35,7,0.8333333333333334,37,28,9,0.7567567567567568,0.793201133144476,shc-gpt-4o,mimiciii,nursing_note,PROMPT2_entailment
164,246,34,30,4,0.8823529411764706,10,10,0,1.0,0.9375,shc-gpt-4o,mimiciii,nursing_note,PROMPT2_entailment
165,247,8,8,0,1.0,6,4,2,0.6666666666666666,0.8,shc-gpt-4o,mimiciii,nursing_note,PROMPT2_entailment
166,248,55,48,7,0.8727272727272727,42,36,6,0.8571428571428571,0.8648648648648648,shc-gpt-4o,mimiciii,nursing_note,PROMPT2_entailment
167,249,44,37,7,0.8409090909090909,39,27,12,0.6923076923076923,0.7594070695553021,shc-gpt-4o,mimiciii,nursing_note,PROMPT2_entailment
168,25,42,35,7,0.8333333333333334,23,19,4,0.8260869565217391,0.8296943231441049,shc-gpt-4o,mimiciii,nursing_note,PROMPT2_entailment
169,26,55,50,5,0.9090909090909092,35,29,6,0.8285714285714286,0.866965620328849,shc-gpt-4o,mimiciii,nursing_note,PROMPT2_entailment
170,27,4,4,0,1.0,3,2,1,0.6666666666666666,0.8,shc-gpt-4o,mimiciii,nursing_note,PROMPT2_entailment
171,28,51,47,4,0.9215686274509804,16,11,5,0.6875,0.7875095201827875,shc-gpt-4o,mimiciii,nursing_note,PROMPT2_entailment
172,29,42,34,8,0.8095238095238095,33,26,7,0.7878787878787878,0.7985546522131888,shc-gpt-4o,mimiciii,nursing_note,PROMPT2_entailment
173,3,11,9,2,0.8181818181818182,6,6,0,1.0,0.9,shc-gpt-4o,mimiciii,nursing_note,PROMPT2_entailment
174,30,16,15,1,0.9375,13,11,2,0.8461538461538461,0.8894878706199459,shc-gpt-4o,mimiciii,nursing_note,PROMPT2_entailment
175,31,21,20,1,0.9523809523809524,19,16,3,0.8421052631578947,0.8938547486033519,shc-gpt-4o,mimiciii,nursing_note,PROMPT2_entailment
176,32,59,56,3,0.9491525423728814,44,43,1,0.9772727272727272,0.963007398520296,shc-gpt-4o,mimiciii,nursing_note,PROMPT2_entailment
177,33,9,9,0,1.0,5,5,0,1.0,1.0,shc-gpt-4o,mimiciii,nursing_note,PROMPT2_entailment
178,34,5,5,0,1.0,3,3,0,1.0,1.0,shc-gpt-4o,mimiciii,nursing_note,PROMPT2_entailment
179,35,15,15,0,1.0,7,7,0,1.0,1.0,shc-gpt-4o,mimiciii,nursing_note,PROMPT2_entailment
180,36,90,73,17,0.8111111111111111,62,50,12,0.8064516129032258,0.8087746510081986,shc-gpt-4o,mimiciii,nursing_note,PROMPT2_entailment
181,37,42,32,10,0.7619047619047619,38,33,5,0.868421052631579,0.8116833205226748,shc-gpt-4o,mimiciii,nursing_note,PROMPT2_entailment
182,38,31,24,7,0.7741935483870968,26,24,2,0.9230769230769232,0.8421052631578947,shc-gpt-4o,mimiciii,nursing_note,PROMPT2_entailment
183,39,20,18,2,0.9,3,1,2,0.3333333333333333,0.4864864864864864,shc-gpt-4o,mimiciii,nursing_note,PROMPT2_entailment
184,4,27,25,2,0.925925925925926,26,22,4,0.8461538461538461,0.8842443729903537,shc-gpt-4o,mimiciii,nursing_note,PROMPT2_entailment
185,40,11,11,0,1.0,3,3,0,1.0,1.0,shc-gpt-4o,mimiciii,nursing_note,PROMPT2_entailment
186,41,52,51,1,0.9807692307692308,50,39,11,0.78,0.8689384010484928,shc-gpt-4o,mimiciii,nursing_note,PROMPT2_entailment
187,42,39,36,3,0.9230769230769232,7,6,1,0.8571428571428571,0.888888888888889,shc-gpt-4o,mimiciii,nursing_note,PROMPT2_entailment
188,43,29,27,2,0.9310344827586208,14,12,2,0.8571428571428571,0.8925619834710743,shc-gpt-4o,mimiciii,nursing_note,PROMPT2_entailment
189,44,8,8,0,1.0,3,3,0,1.0,1.0,shc-gpt-4o,mimiciii,nursing_note,PROMPT2_entailment
190,45,58,56,2,0.9655172413793104,34,28,6,0.8235294117647058,0.888888888888889,shc-gpt-4o,mimiciii,nursing_note,PROMPT2_entailment
191,46,51,48,3,0.9411764705882352,31,21,10,0.6774193548387096,0.7878077373974208,shc-gpt-4o,mimiciii,nursing_note,PROMPT2_entailment
192,47,33,27,6,0.8181818181818182,14,13,1,0.9285714285714286,0.8698884758364314,shc-gpt-4o,mimiciii,nursing_note,PROMPT2_entailment
193,48,27,25,2,0.925925925925926,9,9,0,1.0,0.9615384615384616,shc-gpt-4o,mimiciii,nursing_note,PROMPT2_entailment
194,49,7,6,1,0.8571428571428571,3,3,0,1.0,0.923076923076923,shc-gpt-4o,mimiciii,nursing_note,PROMPT2_entailment
195,5,37,32,5,0.8648648648648649,15,11,4,0.7333333333333333,0.7936865839909807,shc-gpt-4o,mimiciii,nursing_note,PROMPT2_entailment
196,50,27,25,2,0.925925925925926,16,14,2,0.875,0.8997429305912596,shc-gpt-4o,mimiciii,nursing_note,PROMPT2_entailment
197,51,8,8,0,1.0,6,6,0,1.0,1.0,shc-gpt-4o,mimiciii,nursing_note,PROMPT2_entailment
198,52,42,33,9,0.7857142857142857,38,32,6,0.8421052631578947,0.8129330254041571,shc-gpt-4o,mimiciii,nursing_note,PROMPT2_entailment
199,53,7,7,0,1.0,6,5,1,0.8333333333333334,0.9090909090909092,shc-gpt-4o,mimiciii,nursing_note,PROMPT2_entailment
200,54,39,38,1,0.9743589743589745,37,24,13,0.6486486486486487,0.7788215200683176,shc-gpt-4o,mimiciii,nursing_note,PROMPT2_entailment
201,55,53,49,4,0.9245283018867924,35,23,12,0.6571428571428571,0.7682344921608726,shc-gpt-4o,mimiciii,nursing_note,PROMPT2_entailment
202,56,16,16,0,1.0,2,2,0,1.0,1.0,shc-gpt-4o,mimiciii,nursing_note,PROMPT2_entailment
203,57,54,54,0,1.0,17,8,9,0.4705882352941176,0.6399999999999999,shc-gpt-4o,mimiciii,nursing_note,PROMPT2_entailment
204,58,62,56,6,0.9032258064516128,25,20,5,0.8,0.8484848484848486,shc-gpt-4o,mimiciii,nursing_note,PROMPT2_entailment
205,59,12,12,0,1.0,8,7,1,0.875,0.9333333333333332,shc-gpt-4o,mimiciii,nursing_note,PROMPT2_entailment
206,6,14,14,0,1.0,8,7,1,0.875,0.9333333333333332,shc-gpt-4o,mimiciii,nursing_note,PROMPT2_entailment
207,60,48,40,8,0.8333333333333334,27,21,6,0.7777777777777778,0.8045977011494253,shc-gpt-4o,mimiciii,nursing_note,PROMPT2_entailment
208,61,34,27,7,0.7941176470588235,20,16,4,0.8,0.7970479704797047,shc-gpt-4o,mimiciii,nursing_note,PROMPT2_entailment
209,62,42,34,8,0.8095238095238095,37,27,10,0.7297297297297297,0.7675585284280938,shc-gpt-4o,mimiciii,nursing_note,PROMPT2_entailment
210,63,7,7,0,1.0,5,4,1,0.8,0.888888888888889,shc-gpt-4o,mimiciii,nursing_note,PROMPT2_entailment
211,64,56,54,2,0.9642857142857144,27,26,1,0.9629629629629628,0.9636238846945778,shc-gpt-4o,mimiciii,nursing_note,PROMPT2_entailment
212,65,22,20,2,0.9090909090909092,19,15,4,0.7894736842105263,0.8450704225352113,shc-gpt-4o,mimiciii,nursing_note,PROMPT2_entailment
213,66,14,14,0,1.0,1,1,0,1.0,1.0,shc-gpt-4o,mimiciii,nursing_note,PROMPT2_entailment
214,67,12,9,3,0.75,7,4,3,0.5714285714285714,0.6486486486486486,shc-gpt-4o,mimiciii,nursing_note,PROMPT2_entailment
215,68,35,33,2,0.9428571428571428,18,15,3,0.8333333333333334,0.8847184986595175,shc-gpt-4o,mimiciii,nursing_note,PROMPT2_entailment
216,69,39,29,10,0.7435897435897436,25,22,3,0.88,0.8060644346178144,shc-gpt-4o,mimiciii,nursing_note,PROMPT2_entailment
217,7,5,5,0,1.0,2,1,1,0.5,0.6666666666666666,shc-gpt-4o,mimiciii,nursing_note,PROMPT2_entailment
218,70,54,45,9,0.8333333333333334,45,28,17,0.6222222222222222,0.712468193384224,shc-gpt-4o,mimiciii,nursing_note,PROMPT2_entailment
219,71,57,41,16,0.7192982456140351,51,39,12,0.7647058823529411,0.741307371349096,shc-gpt-4o,mimiciii,nursing_note,PROMPT2_entailment
220,72,24,22,2,0.9166666666666666,12,9,3,0.75,0.8250000000000001,shc-gpt-4o,mimiciii,nursing_note,PROMPT2_entailment
221,73,43,39,4,0.9069767441860463,38,31,7,0.8157894736842105,0.8589698046181171,shc-gpt-4o,mimiciii,nursing_note,PROMPT2_entailment
222,74,11,11,0,1.0,7,5,2,0.7142857142857143,0.8333333333333333,shc-gpt-4o,mimiciii,nursing_note,PROMPT2_entailment
223,75,60,53,7,0.8833333333333333,27,23,4,0.8518518518518519,0.8673070081821416,shc-gpt-4o,mimiciii,nursing_note,PROMPT2_entailment
224,76,3,3,0,1.0,1,1,0,1.0,1.0,shc-gpt-4o,mimiciii,nursing_note,PROMPT2_entailment
225,77,77,64,13,0.8311688311688312,59,47,12,0.7966101694915254,0.8135226504394862,shc-gpt-4o,mimiciii,nursing_note,PROMPT2_entailment
226,78,51,44,7,0.8627450980392157,20,17,3,0.85,0.8563251287922152,shc-gpt-4o,mimiciii,nursing_note,PROMPT2_entailment
227,79,43,42,1,0.9767441860465116,30,29,1,0.9666666666666668,0.971679297965696,shc-gpt-4o,mimiciii,nursing_note,PROMPT2_entailment
228,8,13,11,2,0.8461538461538461,11,10,1,0.9090909090909092,0.8764940239043824,shc-gpt-4o,mimiciii,nursing_note,PROMPT2_entailment
229,80,42,41,1,0.9761904761904762,22,18,4,0.8181818181818182,0.8902291917973462,shc-gpt-4o,mimiciii,nursing_note,PROMPT2_entailment
230,81,34,30,4,0.8823529411764706,22,19,3,0.8636363636363636,0.8728943338437978,shc-gpt-4o,mimiciii,nursing_note,PROMPT2_entailment
231,82,34,29,5,0.8529411764705882,17,13,4,0.7647058823529411,0.8064171122994651,shc-gpt-4o,mimiciii,nursing_note,PROMPT2_entailment
232,83,24,21,3,0.875,28,19,9,0.6785714285714286,0.764367816091954,shc-gpt-4o,mimiciii,nursing_note,PROMPT2_entailment
233,84,14,14,0,1.0,6,5,1,0.8333333333333334,0.9090909090909092,shc-gpt-4o,mimiciii,nursing_note,PROMPT2_entailment
234,85,43,42,1,0.9767441860465116,24,22,2,0.9166666666666666,0.9457523029682702,shc-gpt-4o,mimiciii,nursing_note,PROMPT2_entailment
235,86,53,45,8,0.8490566037735849,40,29,11,0.725,0.782139646388972,shc-gpt-4o,mimiciii,nursing_note,PROMPT2_entailment
236,87,22,21,1,0.9545454545454546,15,11,4,0.7333333333333333,0.8294434470377019,shc-gpt-4o,mimiciii,nursing_note,PROMPT2_entailment
237,88,47,42,5,0.8936170212765957,15,13,2,0.8666666666666667,0.8799355358581789,shc-gpt-4o,mimiciii,nursing_note,PROMPT2_entailment
238,89,38,36,2,0.9473684210526316,29,24,5,0.8275862068965517,0.8834355828220859,shc-gpt-4o,mimiciii,nursing_note,PROMPT2_entailment
239,9,43,40,3,0.9302325581395348,17,13,4,0.7647058823529411,0.8393866020984666,shc-gpt-4o,mimiciii,nursing_note,PROMPT2_entailment
240,90,35,33,2,0.9428571428571428,14,14,0,1.0,0.9705882352941176,shc-gpt-4o,mimiciii,nursing_note,PROMPT2_entailment
241,91,29,26,3,0.896551724137931,24,21,3,0.875,0.8856447688564477,shc-gpt-4o,mimiciii,nursing_note,PROMPT2_entailment
242,92,49,44,5,0.8979591836734694,28,28,0,1.0,0.9462365591397848,shc-gpt-4o,mimiciii,nursing_note,PROMPT2_entailment
243,93,39,37,2,0.9487179487179488,23,22,1,0.9565217391304348,0.9526038619075484,shc-gpt-4o,mimiciii,nursing_note,PROMPT2_entailment
244,94,7,7,0,1.0,5,5,0,1.0,1.0,shc-gpt-4o,mimiciii,nursing_note,PROMPT2_entailment
245,95,33,29,4,0.8787878787878788,14,13,1,0.9285714285714286,0.902994011976048,shc-gpt-4o,mimiciii,nursing_note,PROMPT2_entailment
246,96,9,9,0,1.0,6,6,0,1.0,1.0,shc-gpt-4o,mimiciii,nursing_note,PROMPT2_entailment
247,97,13,13,0,1.0,10,10,0,1.0,1.0,shc-gpt-4o,mimiciii,nursing_note,PROMPT2_entailment
248,98,55,46,9,0.8363636363636363,13,10,3,0.7692307692307693,0.8013937282229965,shc-gpt-4o,mimiciii,nursing_note,PROMPT2_entailment
249,99,62,55,7,0.8870967741935484,44,37,7,0.8409090909090909,0.8633856597369538,shc-gpt-4o,mimiciii,nursing_note,PROMPT2_entailment
0,0,14,13,1,0.9285714285714286,21,17,4,0.8095238095238095,0.8649706457925637,shc-gpt-4o,mimiciii,radiology_report,PROMPT1_entailment
1,1,8,8,0,1.0,15,12,3,0.8,0.888888888888889,shc-gpt-4o,mimiciii,radiology_report,PROMPT1_entailment
2,10,12,10,2,0.8333333333333334,18,15,3,0.8333333333333334,0.8333333333333334,shc-gpt-4o,mimiciii,radiology_report,PROMPT1_entailment
3,100,8,8,0,1.0,9,8,1,0.8888888888888888,0.9411764705882352,shc-gpt-4o,mimiciii,radiology_report,PROMPT1_entailment
4,101,11,11,0,1.0,15,13,2,0.8666666666666667,0.9285714285714286,shc-gpt-4o,mimiciii,radiology_report,PROMPT1_entailment
5,102,13,13,0,1.0,16,12,4,0.75,0.8571428571428571,shc-gpt-4o,mimiciii,radiology_report,PROMPT1_entailment
6,103,12,11,1,0.9166666666666666,19,16,3,0.8421052631578947,0.8778054862842893,shc-gpt-4o,mimiciii,radiology_report,PROMPT1_entailment
7,104,13,13,0,1.0,17,15,2,0.8823529411764706,0.9375,shc-gpt-4o,mimiciii,radiology_report,PROMPT1_entailment
8,105,6,6,0,1.0,8,7,1,0.875,0.9333333333333332,shc-gpt-4o,mimiciii,radiology_report,PROMPT1_entailment
9,106,12,12,0,1.0,12,9,3,0.75,0.8571428571428571,shc-gpt-4o,mimiciii,radiology_report,PROMPT1_entailment
10,107,14,13,1,0.9285714285714286,19,14,5,0.7368421052631579,0.8216704288939053,shc-gpt-4o,mimiciii,radiology_report,PROMPT1_entailment
11,108,9,9,0,1.0,13,12,1,0.9230769230769232,0.96,shc-gpt-4o,mimiciii,radiology_report,PROMPT1_entailment
12,109,15,13,2,0.8666666666666667,20,17,3,0.85,0.858252427184466,shc-gpt-4o,mimiciii,radiology_report,PROMPT1_entailment
13,11,16,15,1,0.9375,20,16,4,0.8,0.8633093525179856,shc-gpt-4o,mimiciii,radiology_report,PROMPT1_entailment
14,110,10,9,1,0.9,17,16,1,0.9411764705882352,0.9201277955271564,shc-gpt-4o,mimiciii,radiology_report,PROMPT1_entailment
15,111,11,11,0,1.0,20,16,4,0.8,0.888888888888889,shc-gpt-4o,mimiciii,radiology_report,PROMPT1_entailment
16,112,9,8,1,0.8888888888888888,14,13,1,0.9285714285714286,0.9082969432314412,shc-gpt-4o,mimiciii,radiology_report,PROMPT1_entailment
17,113,18,11,7,0.6111111111111112,20,16,4,0.8,0.6929133858267716,shc-gpt-4o,mimiciii,radiology_report,PROMPT1_entailment
18,114,16,7,9,0.4375,23,19,4,0.8260869565217391,0.5720430107526882,shc-gpt-4o,mimiciii,radiology_report,PROMPT1_entailment
19,115,13,12,1,0.9230769230769232,20,18,2,0.9,0.9113924050632912,shc-gpt-4o,mimiciii,radiology_report,PROMPT1_entailment
20,116,10,9,1,0.9,13,12,1,0.9230769230769232,0.9113924050632912,shc-gpt-4o,mimiciii,radiology_report,PROMPT1_entailment
21,117,14,14,0,1.0,16,11,5,0.6875,0.8148148148148148,shc-gpt-4o,mimiciii,radiology_report,PROMPT1_entailment
22,118,14,13,1,0.9285714285714286,24,22,2,0.9166666666666666,0.9225806451612902,shc-gpt-4o,mimiciii,radiology_report,PROMPT1_entailment
23,119,14,14,0,1.0,17,15,2,0.8823529411764706,0.9375,shc-gpt-4o,mimiciii,radiology_report,PROMPT1_entailment
24,12,12,12,0,1.0,17,14,3,0.8235294117647058,0.9032258064516128,shc-gpt-4o,mimiciii,radiology_report,PROMPT1_entailment
25,120,17,16,1,0.9411764705882352,16,13,3,0.8125,0.8721174004192872,shc-gpt-4o,mimiciii,radiology_report,PROMPT1_entailment
26,121,15,12,3,0.8,26,20,6,0.7692307692307693,0.7843137254901961,shc-gpt-4o,mimiciii,radiology_report,PROMPT1_entailment
27,122,14,13,1,0.9285714285714286,20,17,3,0.85,0.8875502008032129,shc-gpt-4o,mimiciii,radiology_report,PROMPT1_entailment
28,123,10,10,0,1.0,13,11,2,0.8461538461538461,0.9166666666666666,shc-gpt-4o,mimiciii,radiology_report,PROMPT1_entailment
29,124,9,9,0,1.0,12,9,3,0.75,0.8571428571428571,shc-gpt-4o,mimiciii,radiology_report,PROMPT1_entailment
30,125,19,16,3,0.8421052631578947,23,18,5,0.782608695652174,0.8112676056338028,shc-gpt-4o,mimiciii,radiology_report,PROMPT1_entailment
31,126,9,9,0,1.0,9,8,1,0.8888888888888888,0.9411764705882352,shc-gpt-4o,mimiciii,radiology_report,PROMPT1_entailment
32,127,23,23,0,1.0,43,32,11,0.7441860465116279,0.8533333333333333,shc-gpt-4o,mimiciii,radiology_report,PROMPT1_entailment
33,128,11,8,3,0.7272727272727273,14,10,4,0.7142857142857143,0.7207207207207208,shc-gpt-4o,mimiciii,radiology_report,PROMPT1_entailment
34,129,10,10,0,1.0,16,13,3,0.8125,0.896551724137931,shc-gpt-4o,mimiciii,radiology_report,PROMPT1_entailment
35,13,11,11,0,1.0,17,15,2,0.8823529411764706,0.9375,shc-gpt-4o,mimiciii,radiology_report,PROMPT1_entailment
36,130,14,13,1,0.9285714285714286,25,18,7,0.72,0.8110918544194108,shc-gpt-4o,mimiciii,radiology_report,PROMPT1_entailment
37,131,14,13,1,0.9285714285714286,32,23,9,0.71875,0.8102981029810298,shc-gpt-4o,mimiciii,radiology_report,PROMPT1_entailment
38,132,16,13,3,0.8125,23,20,3,0.8695652173913043,0.8400646203554121,shc-gpt-4o,mimiciii,radiology_report,PROMPT1_entailment
39,133,12,12,0,1.0,21,16,5,0.7619047619047619,0.8648648648648648,shc-gpt-4o,mimiciii,radiology_report,PROMPT1_entailment
40,134,10,8,2,0.8,23,20,3,0.8695652173913043,0.8333333333333333,shc-gpt-4o,mimiciii,radiology_report,PROMPT1_entailment
41,135,12,11,1,0.9166666666666666,20,15,5,0.75,0.8250000000000001,shc-gpt-4o,mimiciii,radiology_report,PROMPT1_entailment
42,136,4,3,1,0.75,14,11,3,0.7857142857142857,0.7674418604651163,shc-gpt-4o,mimiciii,radiology_report,PROMPT1_entailment
43,137,6,6,0,1.0,10,9,1,0.9,0.9473684210526316,shc-gpt-4o,mimiciii,radiology_report,PROMPT1_entailment
44,138,9,8,1,0.8888888888888888,14,12,2,0.8571428571428571,0.8727272727272727,shc-gpt-4o,mimiciii,radiology_report,PROMPT1_entailment
45,139,8,8,0,1.0,13,10,3,0.7692307692307693,0.8695652173913044,shc-gpt-4o,mimiciii,radiology_report,PROMPT1_entailment
46,14,7,7,0,1.0,12,8,4,0.6666666666666666,0.8,shc-gpt-4o,mimiciii,radiology_report,PROMPT1_entailment
47,140,12,12,0,1.0,18,17,1,0.9444444444444444,0.9714285714285714,shc-gpt-4o,mimiciii,radiology_report,PROMPT1_entailment
48,141,15,13,2,0.8666666666666667,16,10,6,0.625,0.7262569832402236,shc-gpt-4o,mimiciii,radiology_report,PROMPT1_entailment
49,142,12,12,0,1.0,14,11,3,0.7857142857142857,0.88,shc-gpt-4o,mimiciii,radiology_report,PROMPT1_entailment
50,143,17,15,2,0.8823529411764706,28,21,7,0.75,0.8108108108108107,shc-gpt-4o,mimiciii,radiology_report,PROMPT1_entailment
51,144,10,10,0,1.0,23,20,3,0.8695652173913043,0.9302325581395348,shc-gpt-4o,mimiciii,radiology_report,PROMPT1_entailment
52,145,16,16,0,1.0,18,16,2,0.8888888888888888,0.9411764705882352,shc-gpt-4o,mimiciii,radiology_report,PROMPT1_entailment
53,146,8,8,0,1.0,11,7,4,0.6363636363636364,0.7777777777777778,shc-gpt-4o,mimiciii,radiology_report,PROMPT1_entailment
54,147,8,8,0,1.0,10,8,2,0.8,0.888888888888889,shc-gpt-4o,mimiciii,radiology_report,PROMPT1_entailment
55,148,15,14,1,0.9333333333333332,26,26,0,1.0,0.9655172413793104,shc-gpt-4o,mimiciii,radiology_report,PROMPT1_entailment
56,149,11,10,1,0.9090909090909092,20,19,1,0.95,0.9290953545232272,shc-gpt-4o,mimiciii,radiology_report,PROMPT1_entailment
57,15,21,20,1,0.9523809523809524,29,23,6,0.7931034482758621,0.8654750705550329,shc-gpt-4o,mimiciii,radiology_report,PROMPT1_entailment
58,150,13,13,0,1.0,14,13,1,0.9285714285714286,0.962962962962963,shc-gpt-4o,mimiciii,radiology_report,PROMPT1_entailment
59,151,13,13,0,1.0,15,9,6,0.6,0.7499999999999999,shc-gpt-4o,mimiciii,radiology_report,PROMPT1_entailment
60,152,14,14,0,1.0,18,13,5,0.7222222222222222,0.8387096774193548,shc-gpt-4o,mimiciii,radiology_report,PROMPT1_entailment
61,153,14,13,1,0.9285714285714286,16,16,0,1.0,0.962962962962963,shc-gpt-4o,mimiciii,radiology_report,PROMPT1_entailment
62,154,13,12,1,0.9230769230769232,23,22,1,0.9565217391304348,0.9395017793594308,shc-gpt-4o,mimiciii,radiology_report,PROMPT1_entailment
63,155,27,27,0,1.0,47,37,10,0.7872340425531915,0.880952380952381,shc-gpt-4o,mimiciii,radiology_report,PROMPT1_entailment
64,156,15,14,1,0.9333333333333332,20,15,5,0.75,0.8316831683168316,shc-gpt-4o,mimiciii,radiology_report,PROMPT1_entailment
65,157,12,12,0,1.0,12,11,1,0.9166666666666666,0.9565217391304348,shc-gpt-4o,mimiciii,radiology_report,PROMPT1_entailment
66,158,7,6,1,0.8571428571428571,6,6,0,1.0,0.923076923076923,shc-gpt-4o,mimiciii,radiology_report,PROMPT1_entailment
67,159,10,9,1,0.9,13,11,2,0.8461538461538461,0.8722466960352422,shc-gpt-4o,mimiciii,radiology_report,PROMPT1_entailment
68,16,17,16,1,0.9411764705882352,17,15,2,0.8823529411764706,0.9108159392789372,shc-gpt-4o,mimiciii,radiology_report,PROMPT1_entailment
69,160,10,10,0,1.0,12,11,1,0.9166666666666666,0.9565217391304348,shc-gpt-4o,mimiciii,radiology_report,PROMPT1_entailment
70,161,13,13,0,1.0,13,11,2,0.8461538461538461,0.9166666666666666,shc-gpt-4o,mimiciii,radiology_report,PROMPT1_entailment
71,162,11,11,0,1.0,11,10,1,0.9090909090909092,0.9523809523809524,shc-gpt-4o,mimiciii,radiology_report,PROMPT1_entailment
72,163,9,9,0,1.0,8,5,3,0.625,0.7692307692307693,shc-gpt-4o,mimiciii,radiology_report,PROMPT1_entailment
73,164,9,8,1,0.8888888888888888,10,9,1,0.9,0.8944099378881988,shc-gpt-4o,mimiciii,radiology_report,PROMPT1_entailment
74,165,15,14,1,0.9333333333333332,28,23,5,0.8214285714285714,0.8738127544097692,shc-gpt-4o,mimiciii,radiology_report,PROMPT1_entailment
75,166,8,7,1,0.875,26,23,3,0.8846153846153846,0.8797814207650272,shc-gpt-4o,mimiciii,radiology_report,PROMPT1_entailment
76,167,9,8,1,0.8888888888888888,10,8,2,0.8,0.8421052631578948,shc-gpt-4o,mimiciii,radiology_report,PROMPT1_entailment
77,168,9,9,0,1.0,13,10,3,0.7692307692307693,0.8695652173913044,shc-gpt-4o,mimiciii,radiology_report,PROMPT1_entailment
78,169,16,16,0,1.0,22,20,2,0.9090909090909092,0.9523809523809524,shc-gpt-4o,mimiciii,radiology_report,PROMPT1_entailment
79,17,10,10,0,1.0,12,9,3,0.75,0.8571428571428571,shc-gpt-4o,mimiciii,radiology_report,PROMPT1_entailment
80,170,18,17,1,0.9444444444444444,24,20,4,0.8333333333333334,0.8854166666666667,shc-gpt-4o,mimiciii,radiology_report,PROMPT1_entailment
81,171,5,5,0,1.0,7,6,1,0.8571428571428571,0.923076923076923,shc-gpt-4o,mimiciii,radiology_report,PROMPT1_entailment
82,172,7,7,0,1.0,14,12,2,0.8571428571428571,0.923076923076923,shc-gpt-4o,mimiciii,radiology_report,PROMPT1_entailment
83,173,6,6,0,1.0,12,12,0,1.0,1.0,shc-gpt-4o,mimiciii,radiology_report,PROMPT1_entailment
84,174,13,12,1,0.9230769230769232,20,15,5,0.75,0.8275862068965517,shc-gpt-4o,mimiciii,radiology_report,PROMPT1_entailment
85,175,5,5,0,1.0,8,7,1,0.875,0.9333333333333332,shc-gpt-4o,mimiciii,radiology_report,PROMPT1_entailment
86,176,12,9,3,0.75,19,18,1,0.9473684210526316,0.8372093023255814,shc-gpt-4o,mimiciii,radiology_report,PROMPT1_entailment
87,177,16,16,0,1.0,16,14,2,0.875,0.9333333333333332,shc-gpt-4o,mimiciii,radiology_report,PROMPT1_entailment
88,178,12,11,1,0.9166666666666666,25,22,3,0.88,0.8979591836734694,shc-gpt-4o,mimiciii,radiology_report,PROMPT1_entailment
89,179,12,12,0,1.0,17,15,2,0.8823529411764706,0.9375,shc-gpt-4o,mimiciii,radiology_report,PROMPT1_entailment
90,18,15,15,0,1.0,17,13,4,0.7647058823529411,0.8666666666666666,shc-gpt-4o,mimiciii,radiology_report,PROMPT1_entailment
91,180,10,10,0,1.0,11,11,0,1.0,1.0,shc-gpt-4o,mimiciii,radiology_report,PROMPT1_entailment
92,181,17,12,5,0.7058823529411765,26,18,8,0.6923076923076923,0.6990291262135924,shc-gpt-4o,mimiciii,radiology_report,PROMPT1_entailment
93,182,14,14,0,1.0,23,19,4,0.8260869565217391,0.9047619047619048,shc-gpt-4o,mimiciii,radiology_report,PROMPT1_entailment
94,183,11,10,1,0.9090909090909092,17,13,4,0.7647058823529411,0.8306709265175718,shc-gpt-4o,mimiciii,radiology_report,PROMPT1_entailment
95,184,10,9,1,0.9,15,13,2,0.8666666666666667,0.8830188679245283,shc-gpt-4o,mimiciii,radiology_report,PROMPT1_entailment
96,185,8,7,1,0.875,6,5,1,0.8333333333333334,0.8536585365853658,shc-gpt-4o,mimiciii,radiology_report,PROMPT1_entailment
97,186,15,15,0,1.0,26,24,2,0.9230769230769232,0.96,shc-gpt-4o,mimiciii,radiology_report,PROMPT1_entailment
98,187,16,16,0,1.0,14,12,2,0.8571428571428571,0.923076923076923,shc-gpt-4o,mimiciii,radiology_report,PROMPT1_entailment
99,188,14,14,0,1.0,22,18,4,0.8181818181818182,0.9,shc-gpt-4o,mimiciii,radiology_report,PROMPT1_entailment
100,189,10,8,2,0.8,15,13,2,0.8666666666666667,0.832,shc-gpt-4o,mimiciii,radiology_report,PROMPT1_entailment
101,19,10,10,0,1.0,14,14,0,1.0,1.0,shc-gpt-4o,mimiciii,radiology_report,PROMPT1_entailment
102,190,13,11,2,0.8461538461538461,17,14,3,0.8235294117647058,0.8346883468834688,shc-gpt-4o,mimiciii,radiology_report,PROMPT1_entailment
103,191,14,13,1,0.9285714285714286,15,12,3,0.8,0.859504132231405,shc-gpt-4o,mimiciii,radiology_report,PROMPT1_entailment
104,192,23,22,1,0.9565217391304348,28,25,3,0.8928571428571429,0.9235936188077246,shc-gpt-4o,mimiciii,radiology_report,PROMPT1_entailment
105,193,14,14,0,1.0,14,13,1,0.9285714285714286,0.962962962962963,shc-gpt-4o,mimiciii,radiology_report,PROMPT1_entailment
106,194,24,22,2,0.9166666666666666,38,34,4,0.8947368421052632,0.9055690072639224,shc-gpt-4o,mimiciii,radiology_report,PROMPT1_entailment
107,195,17,15,2,0.8823529411764706,21,16,5,0.7619047619047619,0.817717206132879,shc-gpt-4o,mimiciii,radiology_report,PROMPT1_entailment
108,196,12,10,2,0.8333333333333334,18,12,6,0.6666666666666666,0.7407407407407408,shc-gpt-4o,mimiciii,radiology_report,PROMPT1_entailment
109,197,10,10,0,1.0,15,14,1,0.9333333333333332,0.9655172413793104,shc-gpt-4o,mimiciii,radiology_report,PROMPT1_entailment
110,198,6,6,0,1.0,9,8,1,0.8888888888888888,0.9411764705882352,shc-gpt-4o,mimiciii,radiology_report,PROMPT1_entailment
111,199,15,13,2,0.8666666666666667,23,21,2,0.9130434782608696,0.8892508143322475,shc-gpt-4o,mimiciii,radiology_report,PROMPT1_entailment
112,2,10,10,0,1.0,15,11,4,0.7333333333333333,0.846153846153846,shc-gpt-4o,mimiciii,radiology_report,PROMPT1_entailment
113,20,24,24,0,1.0,36,33,3,0.9166666666666666,0.9565217391304348,shc-gpt-4o,mimiciii,radiology_report,PROMPT1_entailment
114,200,10,10,0,1.0,14,14,0,1.0,1.0,shc-gpt-4o,mimiciii,radiology_report,PROMPT1_entailment
115,201,15,14,1,0.9333333333333332,18,16,2,0.8888888888888888,0.9105691056910568,shc-gpt-4o,mimiciii,radiology_report,PROMPT1_entailment
116,202,16,16,0,1.0,24,21,3,0.875,0.9333333333333332,shc-gpt-4o,mimiciii,radiology_report,PROMPT1_entailment
117,203,18,18,0,1.0,19,14,5,0.7368421052631579,0.8484848484848484,shc-gpt-4o,mimiciii,radiology_report,PROMPT1_entailment
118,204,5,5,0,1.0,23,20,3,0.8695652173913043,0.9302325581395348,shc-gpt-4o,mimiciii,radiology_report,PROMPT1_entailment
119,205,10,10,0,1.0,14,14,0,1.0,1.0,shc-gpt-4o,mimiciii,radiology_report,PROMPT1_entailment
120,206,13,13,0,1.0,13,12,1,0.9230769230769232,0.96,shc-gpt-4o,mimiciii,radiology_report,PROMPT1_entailment
121,207,8,8,0,1.0,9,6,3,0.6666666666666666,0.8,shc-gpt-4o,mimiciii,radiology_report,PROMPT1_entailment
122,208,14,13,1,0.9285714285714286,18,16,2,0.8888888888888888,0.9082969432314412,shc-gpt-4o,mimiciii,radiology_report,PROMPT1_entailment
123,209,12,11,1,0.9166666666666666,16,15,1,0.9375,0.9269662921348316,shc-gpt-4o,mimiciii,radiology_report,PROMPT1_entailment
124,21,17,16,1,0.9411764705882352,27,22,5,0.8148148148148148,0.8734491315136477,shc-gpt-4o,mimiciii,radiology_report,PROMPT1_entailment
125,210,11,11,0,1.0,14,10,4,0.7142857142857143,0.8333333333333333,shc-gpt-4o,mimiciii,radiology_report,PROMPT1_entailment
126,211,8,8,0,1.0,13,12,1,0.9230769230769232,0.96,shc-gpt-4o,mimiciii,radiology_report,PROMPT1_entailment
127,212,14,13,1,0.9285714285714286,19,17,2,0.8947368421052632,0.911340206185567,shc-gpt-4o,mimiciii,radiology_report,PROMPT1_entailment
128,213,14,13,1,0.9285714285714286,22,18,4,0.8181818181818182,0.8698884758364314,shc-gpt-4o,mimiciii,radiology_report,PROMPT1_entailment
129,214,20,16,4,0.8,23,18,5,0.782608695652174,0.7912087912087912,shc-gpt-4o,mimiciii,radiology_report,PROMPT1_entailment
130,215,8,8,0,1.0,10,8,2,0.8,0.888888888888889,shc-gpt-4o,mimiciii,radiology_report,PROMPT1_entailment
131,216,12,10,2,0.8333333333333334,19,15,4,0.7894736842105263,0.8108108108108109,shc-gpt-4o,mimiciii,radiology_report,PROMPT1_entailment
132,217,12,10,2,0.8333333333333334,20,19,1,0.95,0.8878504672897196,shc-gpt-4o,mimiciii,radiology_report,PROMPT1_entailment
133,218,16,15,1,0.9375,15,12,3,0.8,0.8633093525179856,shc-gpt-4o,mimiciii,radiology_report,PROMPT1_entailment
134,219,8,8,0,1.0,13,10,3,0.7692307692307693,0.8695652173913044,shc-gpt-4o,mimiciii,radiology_report,PROMPT1_entailment
135,22,11,11,0,1.0,19,17,2,0.8947368421052632,0.9444444444444444,shc-gpt-4o,mimiciii,radiology_report,PROMPT1_entailment
136,220,11,11,0,1.0,19,19,0,1.0,1.0,shc-gpt-4o,mimiciii,radiology_report,PROMPT1_entailment
137,221,17,16,1,0.9411764705882352,27,24,3,0.8888888888888888,0.9142857142857144,shc-gpt-4o,mimiciii,radiology_report,PROMPT1_entailment
138,222,10,10,0,1.0,16,12,4,0.75,0.8571428571428571,shc-gpt-4o,mimiciii,radiology_report,PROMPT1_entailment
139,223,15,15,0,1.0,21,19,2,0.9047619047619048,0.95,shc-gpt-4o,mimiciii,radiology_report,PROMPT1_entailment
140,224,16,16,0,1.0,17,14,3,0.8235294117647058,0.9032258064516128,shc-gpt-4o,mimiciii,radiology_report,PROMPT1_entailment
141,225,10,10,0,1.0,11,8,3,0.7272727272727273,0.8421052631578948,shc-gpt-4o,mimiciii,radiology_report,PROMPT1_entailment
142,226,12,11,1,0.9166666666666666,18,16,2,0.8888888888888888,0.9025641025641026,shc-gpt-4o,mimiciii,radiology_report,PROMPT1_entailment
143,227,12,12,0,1.0,18,17,1,0.9444444444444444,0.9714285714285714,shc-gpt-4o,mimiciii,radiology_report,PROMPT1_entailment
144,228,11,11,0,1.0,17,17,0,1.0,1.0,shc-gpt-4o,mimiciii,radiology_report,PROMPT1_entailment
145,229,30,29,1,0.9666666666666668,44,32,12,0.7272727272727273,0.8300536672629696,shc-gpt-4o,mimiciii,radiology_report,PROMPT1_entailment
146,23,17,16,1,0.9411764705882352,15,13,2,0.8666666666666667,0.9023861171366594,shc-gpt-4o,mimiciii,radiology_report,PROMPT1_entailment
147,230,10,9,1,0.9,17,17,0,1.0,0.9473684210526316,shc-gpt-4o,mimiciii,radiology_report,PROMPT1_entailment
148,231,10,10,0,1.0,13,12,1,0.9230769230769232,0.96,shc-gpt-4o,mimiciii,radiology_report,PROMPT1_entailment
149,232,11,11,0,1.0,18,18,0,1.0,1.0,shc-gpt-4o,mimiciii,radiology_report,PROMPT1_entailment
150,233,16,16,0,1.0,17,14,3,0.8235294117647058,0.9032258064516128,shc-gpt-4o,mimiciii,radiology_report,PROMPT1_entailment
151,234,8,8,0,1.0,11,9,2,0.8181818181818182,0.9,shc-gpt-4o,mimiciii,radiology_report,PROMPT1_entailment
152,235,10,10,0,1.0,14,13,1,0.9285714285714286,0.962962962962963,shc-gpt-4o,mimiciii,radiology_report,PROMPT1_entailment
153,236,10,10,0,1.0,11,11,0,1.0,1.0,shc-gpt-4o,mimiciii,radiology_report,PROMPT1_entailment
154,237,16,14,2,0.875,17,15,2,0.8823529411764706,0.8786610878661087,shc-gpt-4o,mimiciii,radiology_report,PROMPT1_entailment
155,238,12,12,0,1.0,20,17,3,0.85,0.9189189189189187,shc-gpt-4o,mimiciii,radiology_report,PROMPT1_entailment
156,239,12,12,0,1.0,17,12,5,0.7058823529411765,0.8275862068965517,shc-gpt-4o,mimiciii,radiology_report,PROMPT1_entailment
157,24,14,14,0,1.0,18,14,4,0.7777777777777778,0.8750000000000001,shc-gpt-4o,mimiciii,radiology_report,PROMPT1_entailment
158,240,11,10,1,0.9090909090909092,13,11,2,0.8461538461538461,0.8764940239043824,shc-gpt-4o,mimiciii,radiology_report,PROMPT1_entailment
159,241,11,11,0,1.0,16,13,3,0.8125,0.896551724137931,shc-gpt-4o,mimiciii,radiology_report,PROMPT1_entailment
160,242,11,11,0,1.0,18,15,3,0.8333333333333334,0.9090909090909092,shc-gpt-4o,mimiciii,radiology_report,PROMPT1_entailment
161,243,7,7,0,1.0,13,9,4,0.6923076923076923,0.8181818181818181,shc-gpt-4o,mimiciii,radiology_report,PROMPT1_entailment
162,244,13,13,0,1.0,17,17,0,1.0,1.0,shc-gpt-4o,mimiciii,radiology_report,PROMPT1_entailment
163,245,19,15,4,0.7894736842105263,28,24,4,0.8571428571428571,0.8219178082191781,shc-gpt-4o,mimiciii,radiology_report,PROMPT1_entailment
164,246,9,9,0,1.0,12,10,2,0.8333333333333334,0.9090909090909092,shc-gpt-4o,mimiciii,radiology_report,PROMPT1_entailment
165,247,10,10,0,1.0,12,8,4,0.6666666666666666,0.8,shc-gpt-4o,mimiciii,radiology_report,PROMPT1_entailment
166,248,11,11,0,1.0,17,13,4,0.7647058823529411,0.8666666666666666,shc-gpt-4o,mimiciii,radiology_report,PROMPT1_entailment
167,249,14,9,5,0.6428571428571429,23,19,4,0.8260869565217391,0.7230443974630022,shc-gpt-4o,mimiciii,radiology_report,PROMPT1_entailment
168,25,20,18,2,0.9,27,22,5,0.8148148148148148,0.855291576673866,shc-gpt-4o,mimiciii,radiology_report,PROMPT1_entailment
169,250,6,6,0,1.0,8,8,0,1.0,1.0,shc-gpt-4o,mimiciii,radiology_report,PROMPT1_entailment
170,251,16,13,3,0.8125,22,20,2,0.9090909090909092,0.858085808580858,shc-gpt-4o,mimiciii,radiology_report,PROMPT1_entailment
171,252,7,7,0,1.0,10,8,2,0.8,0.888888888888889,shc-gpt-4o,mimiciii,radiology_report,PROMPT1_entailment
172,253,11,11,0,1.0,24,23,1,0.9583333333333334,0.9787234042553192,shc-gpt-4o,mimiciii,radiology_report,PROMPT1_entailment
173,254,12,11,1,0.9166666666666666,13,10,3,0.7692307692307693,0.8365019011406845,shc-gpt-4o,mimiciii,radiology_report,PROMPT1_entailment
174,255,11,11,0,1.0,16,14,2,0.875,0.9333333333333332,shc-gpt-4o,mimiciii,radiology_report,PROMPT1_entailment
175,256,15,14,1,0.9333333333333332,19,18,1,0.9473684210526316,0.9402985074626864,shc-gpt-4o,mimiciii,radiology_report,PROMPT1_entailment
176,257,10,9,1,0.9,15,14,1,0.9333333333333332,0.9163636363636364,shc-gpt-4o,mimiciii,radiology_report,PROMPT1_entailment
177,258,13,12,1,0.9230769230769232,20,10,10,0.5,0.6486486486486487,shc-gpt-4o,mimiciii,radiology_report,PROMPT1_entailment
178,259,11,10,1,0.9090909090909092,17,13,4,0.7647058823529411,0.8306709265175718,shc-gpt-4o,mimiciii,radiology_report,PROMPT1_entailment
179,26,15,15,0,1.0,18,15,3,0.8333333333333334,0.9090909090909092,shc-gpt-4o,mimiciii,radiology_report,PROMPT1_entailment
180,260,16,15,1,0.9375,20,12,8,0.6,0.7317073170731707,shc-gpt-4o,mimiciii,radiology_report,PROMPT1_entailment
181,261,18,13,5,0.7222222222222222,30,27,3,0.9,0.8013698630136986,shc-gpt-4o,mimiciii,radiology_report,PROMPT1_entailment
182,262,15,15,0,1.0,23,21,2,0.9130434782608696,0.9545454545454544,shc-gpt-4o,mimiciii,radiology_report,PROMPT1_entailment
183,263,19,18,1,0.9473684210526316,27,22,5,0.8148148148148148,0.8761061946902655,shc-gpt-4o,mimiciii,radiology_report,PROMPT1_entailment
184,264,12,11,1,0.9166666666666666,20,18,2,0.9,0.908256880733945,shc-gpt-4o,mimiciii,radiology_report,PROMPT1_entailment
185,265,8,8,0,1.0,9,9,0,1.0,1.0,shc-gpt-4o,mimiciii,radiology_report,PROMPT1_entailment
186,266,13,11,2,0.8461538461538461,18,16,2,0.8888888888888888,0.8669950738916256,shc-gpt-4o,mimiciii,radiology_report,PROMPT1_entailment
187,267,4,4,0,1.0,16,15,1,0.9375,0.967741935483871,shc-gpt-4o,mimiciii,radiology_report,PROMPT1_entailment
188,268,15,15,0,1.0,20,16,4,0.8,0.888888888888889,shc-gpt-4o,mimiciii,radiology_report,PROMPT1_entailment
189,269,19,19,0,1.0,25,21,4,0.84,0.9130434782608696,shc-gpt-4o,mimiciii,radiology_report,PROMPT1_entailment
190,27,14,14,0,1.0,14,12,2,0.8571428571428571,0.923076923076923,shc-gpt-4o,mimiciii,radiology_report,PROMPT1_entailment
191,270,16,14,2,0.875,17,15,2,0.8823529411764706,0.8786610878661087,shc-gpt-4o,mimiciii,radiology_report,PROMPT1_entailment
192,271,14,14,0,1.0,17,15,2,0.8823529411764706,0.9375,shc-gpt-4o,mimiciii,radiology_report,PROMPT1_entailment
193,272,12,10,2,0.8333333333333334,17,16,1,0.9411764705882352,0.8839779005524863,shc-gpt-4o,mimiciii,radiology_report,PROMPT1_entailment
194,273,8,7,1,0.875,12,9,3,0.75,0.8076923076923077,shc-gpt-4o,mimiciii,radiology_report,PROMPT1_entailment
195,274,15,12,3,0.8,20,15,5,0.75,0.7741935483870969,shc-gpt-4o,mimiciii,radiology_report,PROMPT1_entailment
196,275,11,11,0,1.0,12,12,0,1.0,1.0,shc-gpt-4o,mimiciii,radiology_report,PROMPT1_entailment
197,276,18,17,1,0.9444444444444444,24,20,4,0.8333333333333334,0.8854166666666667,shc-gpt-4o,mimiciii,radiology_report,PROMPT1_entailment
198,277,22,20,2,0.9090909090909092,25,22,3,0.88,0.8943089430894309,shc-gpt-4o,mimiciii,radiology_report,PROMPT1_entailment
199,278,12,12,0,1.0,16,14,2,0.875,0.9333333333333332,shc-gpt-4o,mimiciii,radiology_report,PROMPT1_entailment
200,279,9,9,0,1.0,10,8,2,0.8,0.888888888888889,shc-gpt-4o,mimiciii,radiology_report,PROMPT1_entailment
201,28,13,13,0,1.0,30,27,3,0.9,0.9473684210526316,shc-gpt-4o,mimiciii,radiology_report,PROMPT1_entailment
202,280,10,10,0,1.0,12,11,1,0.9166666666666666,0.9565217391304348,shc-gpt-4o,mimiciii,radiology_report,PROMPT1_entailment
203,281,18,18,0,1.0,24,18,6,0.75,0.8571428571428571,shc-gpt-4o,mimiciii,radiology_report,PROMPT1_entailment
204,282,11,11,0,1.0,12,12,0,1.0,1.0,shc-gpt-4o,mimiciii,radiology_report,PROMPT1_entailment
205,283,19,18,1,0.9473684210526316,25,19,6,0.76,0.843403205918619,shc-gpt-4o,mimiciii,radiology_report,PROMPT1_entailment
206,284,15,15,0,1.0,14,12,2,0.8571428571428571,0.923076923076923,shc-gpt-4o,mimiciii,radiology_report,PROMPT1_entailment
207,285,11,11,0,1.0,18,18,0,1.0,1.0,shc-gpt-4o,mimiciii,radiology_report,PROMPT1_entailment
208,286,7,6,1,0.8571428571428571,6,6,0,1.0,0.923076923076923,shc-gpt-4o,mimiciii,radiology_report,PROMPT1_entailment
209,287,14,14,0,1.0,18,15,3,0.8333333333333334,0.9090909090909092,shc-gpt-4o,mimiciii,radiology_report,PROMPT1_entailment
210,288,21,17,4,0.8095238095238095,32,28,4,0.875,0.8409893992932863,shc-gpt-4o,mimiciii,radiology_report,PROMPT1_entailment
211,289,15,15,0,1.0,20,17,3,0.85,0.9189189189189187,shc-gpt-4o,mimiciii,radiology_report,PROMPT1_entailment
212,29,8,8,0,1.0,8,7,1,0.875,0.9333333333333332,shc-gpt-4o,mimiciii,radiology_report,PROMPT1_entailment
213,290,9,9,0,1.0,11,9,2,0.8181818181818182,0.9,shc-gpt-4o,mimiciii,radiology_report,PROMPT1_entailment
214,291,17,15,2,0.8823529411764706,23,17,6,0.7391304347826086,0.8044164037854888,shc-gpt-4o,mimiciii,radiology_report,PROMPT1_entailment
215,292,18,16,2,0.8888888888888888,21,17,4,0.8095238095238095,0.8473520249221184,shc-gpt-4o,mimiciii,radiology_report,PROMPT1_entailment
216,293,13,13,0,1.0,18,15,3,0.8333333333333334,0.9090909090909092,shc-gpt-4o,mimiciii,radiology_report,PROMPT1_entailment
217,294,13,11,2,0.8461538461538461,22,15,7,0.6818181818181818,0.7551487414187643,shc-gpt-4o,mimiciii,radiology_report,PROMPT1_entailment
218,295,18,16,2,0.8888888888888888,32,27,5,0.84375,0.8657314629258517,shc-gpt-4o,mimiciii,radiology_report,PROMPT1_entailment
219,296,14,13,1,0.9285714285714286,17,15,2,0.8823529411764706,0.9048723897911832,shc-gpt-4o,mimiciii,radiology_report,PROMPT1_entailment
220,297,15,13,2,0.8666666666666667,24,20,4,0.8333333333333334,0.8496732026143791,shc-gpt-4o,mimiciii,radiology_report,PROMPT1_entailment
221,298,14,14,0,1.0,20,16,4,0.8,0.888888888888889,shc-gpt-4o,mimiciii,radiology_report,PROMPT1_entailment
222,299,5,5,0,1.0,28,27,1,0.9642857142857144,0.9818181818181818,shc-gpt-4o,mimiciii,radiology_report,PROMPT1_entailment
223,3,14,14,0,1.0,20,17,3,0.85,0.9189189189189187,shc-gpt-4o,mimiciii,radiology_report,PROMPT1_entailment
224,30,11,11,0,1.0,21,20,1,0.9523809523809524,0.975609756097561,shc-gpt-4o,mimiciii,radiology_report,PROMPT1_entailment
225,300,15,15,0,1.0,13,9,4,0.6923076923076923,0.8181818181818181,shc-gpt-4o,mimiciii,radiology_report,PROMPT1_entailment
226,301,9,9,0,1.0,16,13,3,0.8125,0.896551724137931,shc-gpt-4o,mimiciii,radiology_report,PROMPT1_entailment
227,302,15,15,0,1.0,15,14,1,0.9333333333333332,0.9655172413793104,shc-gpt-4o,mimiciii,radiology_report,PROMPT1_entailment
228,303,13,11,2,0.8461538461538461,24,19,5,0.7916666666666666,0.8180039138943248,shc-gpt-4o,mimiciii,radiology_report,PROMPT1_entailment
229,304,15,15,0,1.0,19,19,0,1.0,1.0,shc-gpt-4o,mimiciii,radiology_report,PROMPT1_entailment
230,305,12,10,2,0.8333333333333334,24,19,5,0.7916666666666666,0.811965811965812,shc-gpt-4o,mimiciii,radiology_report,PROMPT1_entailment
231,306,12,10,2,0.8333333333333334,14,12,2,0.8571428571428571,0.8450704225352113,shc-gpt-4o,mimiciii,radiology_report,PROMPT1_entailment
232,307,15,15,0,1.0,17,13,4,0.7647058823529411,0.8666666666666666,shc-gpt-4o,mimiciii,radiology_report,PROMPT1_entailment
233,308,15,14,1,0.9333333333333332,15,11,4,0.7333333333333333,0.8213333333333334,shc-gpt-4o,mimiciii,radiology_report,PROMPT1_entailment
234,309,15,15,0,1.0,26,22,4,0.8461538461538461,0.9166666666666666,shc-gpt-4o,mimiciii,radiology_report,PROMPT1_entailment
235,31,11,11,0,1.0,19,15,4,0.7894736842105263,0.8823529411764706,shc-gpt-4o,mimiciii,radiology_report,PROMPT1_entailment
236,310,13,13,0,1.0,24,23,1,0.9583333333333334,0.9787234042553192,shc-gpt-4o,mimiciii,radiology_report,PROMPT1_entailment
237,311,11,11,0,1.0,15,14,1,0.9333333333333332,0.9655172413793104,shc-gpt-4o,mimiciii,radiology_report,PROMPT1_entailment
238,312,10,10,0,1.0,18,13,5,0.7222222222222222,0.8387096774193548,shc-gpt-4o,mimiciii,radiology_report,PROMPT1_entailment
239,313,12,11,1,0.9166666666666666,17,16,1,0.9411764705882352,0.9287598944591028,shc-gpt-4o,mimiciii,radiology_report,PROMPT1_entailment
240,314,4,3,1,0.75,15,13,2,0.8666666666666667,0.8041237113402062,shc-gpt-4o,mimiciii,radiology_report,PROMPT1_entailment
241,315,23,20,3,0.8695652173913043,25,19,6,0.76,0.8110992529348985,shc-gpt-4o,mimiciii,radiology_report,PROMPT1_entailment
242,316,8,8,0,1.0,10,9,1,0.9,0.9473684210526316,shc-gpt-4o,mimiciii,radiology_report,PROMPT1_entailment
243,317,19,16,3,0.8421052631578947,26,24,2,0.9230769230769232,0.8807339449541285,shc-gpt-4o,mimiciii,radiology_report,PROMPT1_entailment
244,318,12,9,3,0.75,21,20,1,0.9523809523809524,0.8391608391608391,shc-gpt-4o,mimiciii,radiology_report,PROMPT1_entailment
245,319,14,14,0,1.0,12,11,1,0.9166666666666666,0.9565217391304348,shc-gpt-4o,mimiciii,radiology_report,PROMPT1_entailment
246,32,12,12,0,1.0,15,11,4,0.7333333333333333,0.846153846153846,shc-gpt-4o,mimiciii,radiology_report,PROMPT1_entailment
247,320,7,7,0,1.0,11,8,3,0.7272727272727273,0.8421052631578948,shc-gpt-4o,mimiciii,radiology_report,PROMPT1_entailment
248,321,16,14,2,0.875,21,18,3,0.8571428571428571,0.8659793814432989,shc-gpt-4o,mimiciii,radiology_report,PROMPT1_entailment
249,322,8,8,0,1.0,8,8,0,1.0,1.0,shc-gpt-4o,mimiciii,radiology_report,PROMPT1_entailment
250,323,20,19,1,0.95,25,21,4,0.84,0.8916201117318435,shc-gpt-4o,mimiciii,radiology_report,PROMPT1_entailment
251,324,14,13,1,0.9285714285714286,18,14,4,0.7777777777777778,0.8465116279069766,shc-gpt-4o,mimiciii,radiology_report,PROMPT1_entailment
252,325,16,16,0,1.0,22,20,2,0.9090909090909092,0.9523809523809524,shc-gpt-4o,mimiciii,radiology_report,PROMPT1_entailment
253,326,11,10,1,0.9090909090909092,23,19,4,0.8260869565217391,0.8656036446469249,shc-gpt-4o,mimiciii,radiology_report,PROMPT1_entailment
254,327,8,8,0,1.0,9,9,0,1.0,1.0,shc-gpt-4o,mimiciii,radiology_report,PROMPT1_entailment
255,328,12,12,0,1.0,17,16,1,0.9411764705882352,0.9696969696969696,shc-gpt-4o,mimiciii,radiology_report,PROMPT1_entailment
256,329,16,16,0,1.0,24,17,7,0.7083333333333334,0.8292682926829268,shc-gpt-4o,mimiciii,radiology_report,PROMPT1_entailment
257,33,8,8,0,1.0,9,7,2,0.7777777777777778,0.8750000000000001,shc-gpt-4o,mimiciii,radiology_report,PROMPT1_entailment
258,330,12,10,2,0.8333333333333334,11,9,2,0.8181818181818182,0.8256880733944955,shc-gpt-4o,mimiciii,radiology_report,PROMPT1_entailment
259,331,11,10,1,0.9090909090909092,15,12,3,0.8,0.8510638297872342,shc-gpt-4o,mimiciii,radiology_report,PROMPT1_entailment
260,332,15,14,1,0.9333333333333332,20,16,4,0.8,0.8615384615384616,shc-gpt-4o,mimiciii,radiology_report,PROMPT1_entailment
261,333,10,10,0,1.0,13,11,2,0.8461538461538461,0.9166666666666666,shc-gpt-4o,mimiciii,radiology_report,PROMPT1_entailment
262,334,18,17,1,0.9444444444444444,20,20,0,1.0,0.9714285714285714,shc-gpt-4o,mimiciii,radiology_report,PROMPT1_entailment
263,335,11,11,0,1.0,17,14,3,0.8235294117647058,0.9032258064516128,shc-gpt-4o,mimiciii,radiology_report,PROMPT1_entailment
264,336,19,19,0,1.0,16,13,3,0.8125,0.896551724137931,shc-gpt-4o,mimiciii,radiology_report,PROMPT1_entailment
265,337,16,16,0,1.0,16,15,1,0.9375,0.967741935483871,shc-gpt-4o,mimiciii,radiology_report,PROMPT1_entailment
266,338,10,10,0,1.0,13,9,4,0.6923076923076923,0.8181818181818181,shc-gpt-4o,mimiciii,radiology_report,PROMPT1_entailment
267,339,15,14,1,0.9333333333333332,28,23,5,0.8214285714285714,0.8738127544097692,shc-gpt-4o,mimiciii,radiology_report,PROMPT1_entailment
268,34,8,8,0,1.0,14,12,2,0.8571428571428571,0.923076923076923,shc-gpt-4o,mimiciii,radiology_report,PROMPT1_entailment
269,340,24,19,5,0.7916666666666666,15,13,2,0.8666666666666667,0.8274706867671693,shc-gpt-4o,mimiciii,radiology_report,PROMPT1_entailment
270,341,5,5,0,1.0,6,6,0,1.0,1.0,shc-gpt-4o,mimiciii,radiology_report,PROMPT1_entailment
271,342,10,10,0,1.0,15,13,2,0.8666666666666667,0.9285714285714286,shc-gpt-4o,mimiciii,radiology_report,PROMPT1_entailment
272,343,11,10,1,0.9090909090909092,22,19,3,0.8636363636363636,0.8857808857808858,shc-gpt-4o,mimiciii,radiology_report,PROMPT1_entailment
273,344,14,14,0,1.0,19,16,3,0.8421052631578947,0.9142857142857144,shc-gpt-4o,mimiciii,radiology_report,PROMPT1_entailment
274,345,14,13,1,0.9285714285714286,22,19,3,0.8636363636363636,0.8949275362318841,shc-gpt-4o,mimiciii,radiology_report,PROMPT1_entailment
275,346,10,10,0,1.0,15,12,3,0.8,0.888888888888889,shc-gpt-4o,mimiciii,radiology_report,PROMPT1_entailment
276,347,14,14,0,1.0,15,14,1,0.9333333333333332,0.9655172413793104,shc-gpt-4o,mimiciii,radiology_report,PROMPT1_entailment
277,348,10,9,1,0.9,12,11,1,0.9166666666666666,0.908256880733945,shc-gpt-4o,mimiciii,radiology_report,PROMPT1_entailment
278,349,9,8,1,0.8888888888888888,16,14,2,0.875,0.8818897637795274,shc-gpt-4o,mimiciii,radiology_report,PROMPT1_entailment
279,35,14,13,1,0.9285714285714286,21,18,3,0.8571428571428571,0.8914285714285715,shc-gpt-4o,mimiciii,radiology_report,PROMPT1_entailment
280,350,16,12,4,0.75,21,16,5,0.7619047619047619,0.7559055118110236,shc-gpt-4o,mimiciii,radiology_report,PROMPT1_entailment
281,351,18,16,2,0.8888888888888888,21,18,3,0.8571428571428571,0.8727272727272727,shc-gpt-4o,mimiciii,radiology_report,PROMPT1_entailment
282,352,13,12,1,0.9230769230769232,22,18,4,0.8181818181818182,0.8674698795180724,shc-gpt-4o,mimiciii,radiology_report,PROMPT1_entailment
283,353,8,7,1,0.875,23,21,2,0.9130434782608696,0.8936170212765957,shc-gpt-4o,mimiciii,radiology_report,PROMPT1_entailment
284,354,15,14,1,0.9333333333333332,26,23,3,0.8846153846153846,0.9083215796897036,shc-gpt-4o,mimiciii,radiology_report,PROMPT1_entailment
285,355,13,13,0,1.0,18,16,2,0.8888888888888888,0.9411764705882352,shc-gpt-4o,mimiciii,radiology_report,PROMPT1_entailment
286,356,14,13,1,0.9285714285714286,22,19,3,0.8636363636363636,0.8949275362318841,shc-gpt-4o,mimiciii,radiology_report,PROMPT1_entailment
287,357,8,8,0,1.0,15,12,3,0.8,0.888888888888889,shc-gpt-4o,mimiciii,radiology_report,PROMPT1_entailment
288,358,16,16,0,1.0,12,8,4,0.6666666666666666,0.8,shc-gpt-4o,mimiciii,radiology_report,PROMPT1_entailment
289,359,11,11,0,1.0,18,16,2,0.8888888888888888,0.9411764705882352,shc-gpt-4o,mimiciii,radiology_report,PROMPT1_entailment
290,36,16,16,0,1.0,22,17,5,0.7727272727272727,0.8717948717948718,shc-gpt-4o,mimiciii,radiology_report,PROMPT1_entailment
291,360,14,13,1,0.9285714285714286,15,13,2,0.8666666666666667,0.896551724137931,shc-gpt-4o,mimiciii,radiology_report,PROMPT1_entailment
292,361,15,14,1,0.9333333333333332,23,18,5,0.782608695652174,0.8513513513513513,shc-gpt-4o,mimiciii,radiology_report,PROMPT1_entailment
293,362,16,15,1,0.9375,24,14,10,0.5833333333333334,0.7191780821917807,shc-gpt-4o,mimiciii,radiology_report,PROMPT1_entailment
294,363,16,15,1,0.9375,22,17,5,0.7727272727272727,0.8471760797342192,shc-gpt-4o,mimiciii,radiology_report,PROMPT1_entailment
295,364,7,7,0,1.0,11,10,1,0.9090909090909092,0.9523809523809524,shc-gpt-4o,mimiciii,radiology_report,PROMPT1_entailment
296,365,19,16,3,0.8421052631578947,29,18,11,0.6206896551724138,0.7146401985111662,shc-gpt-4o,mimiciii,radiology_report,PROMPT1_entailment
297,366,10,10,0,1.0,13,9,4,0.6923076923076923,0.8181818181818181,shc-gpt-4o,mimiciii,radiology_report,PROMPT1_entailment
298,367,15,14,1,0.9333333333333332,16,13,3,0.8125,0.8687350835322195,shc-gpt-4o,mimiciii,radiology_report,PROMPT1_entailment
299,368,14,11,3,0.7857142857142857,20,14,6,0.7,0.7403846153846153,shc-gpt-4o,mimiciii,radiology_report,PROMPT1_entailment
300,369,20,20,0,1.0,20,17,3,0.85,0.9189189189189187,shc-gpt-4o,mimiciii,radiology_report,PROMPT1_entailment
301,37,13,12,1,0.9230769230769232,21,15,6,0.7142857142857143,0.8053691275167787,shc-gpt-4o,mimiciii,radiology_report,PROMPT1_entailment
302,370,17,13,4,0.7647058823529411,19,14,5,0.7368421052631579,0.7505154639175257,shc-gpt-4o,mimiciii,radiology_report,PROMPT1_entailment
303,371,12,12,0,1.0,17,16,1,0.9411764705882352,0.9696969696969696,shc-gpt-4o,mimiciii,radiology_report,PROMPT1_entailment
304,372,13,12,1,0.9230769230769232,27,20,7,0.7407407407407407,0.8219178082191781,shc-gpt-4o,mimiciii,radiology_report,PROMPT1_entailment
305,373,18,18,0,1.0,23,19,4,0.8260869565217391,0.9047619047619048,shc-gpt-4o,mimiciii,radiology_report,PROMPT1_entailment
306,374,8,8,0,1.0,11,9,2,0.8181818181818182,0.9,shc-gpt-4o,mimiciii,radiology_report,PROMPT1_entailment
307,375,10,9,1,0.9,16,13,3,0.8125,0.854014598540146,shc-gpt-4o,mimiciii,radiology_report,PROMPT1_entailment
308,376,20,19,1,0.95,18,16,2,0.8888888888888888,0.918429003021148,shc-gpt-4o,mimiciii,radiology_report,PROMPT1_entailment
309,377,8,7,1,0.875,10,8,2,0.8,0.8358208955223881,shc-gpt-4o,mimiciii,radiology_report,PROMPT1_entailment
310,378,17,14,3,0.8235294117647058,24,20,4,0.8333333333333334,0.8284023668639053,shc-gpt-4o,mimiciii,radiology_report,PROMPT1_entailment
311,379,15,15,0,1.0,18,16,2,0.8888888888888888,0.9411764705882352,shc-gpt-4o,mimiciii,radiology_report,PROMPT1_entailment
312,38,13,12,1,0.9230769230769232,19,16,3,0.8421052631578947,0.8807339449541285,shc-gpt-4o,mimiciii,radiology_report,PROMPT1_entailment
313,380,7,7,0,1.0,8,6,2,0.75,0.8571428571428571,shc-gpt-4o,mimiciii,radiology_report,PROMPT1_entailment
314,381,9,9,0,1.0,14,11,3,0.7857142857142857,0.88,shc-gpt-4o,mimiciii,radiology_report,PROMPT1_entailment
315,382,9,9,0,1.0,13,12,1,0.9230769230769232,0.96,shc-gpt-4o,mimiciii,radiology_report,PROMPT1_entailment
316,383,14,11,3,0.7857142857142857,17,15,2,0.8823529411764706,0.8312342569269522,shc-gpt-4o,mimiciii,radiology_report,PROMPT1_entailment
317,384,9,9,0,1.0,13,12,1,0.9230769230769232,0.96,shc-gpt-4o,mimiciii,radiology_report,PROMPT1_entailment
318,385,18,17,1,0.9444444444444444,27,20,7,0.7407407407407407,0.8302808302808302,shc-gpt-4o,mimiciii,radiology_report,PROMPT1_entailment
319,386,13,13,0,1.0,18,16,2,0.8888888888888888,0.9411764705882352,shc-gpt-4o,mimiciii,radiology_report,PROMPT1_entailment
320,387,11,11,0,1.0,19,15,4,0.7894736842105263,0.8823529411764706,shc-gpt-4o,mimiciii,radiology_report,PROMPT1_entailment
321,388,17,15,2,0.8823529411764706,33,30,3,0.9090909090909092,0.8955223880597014,shc-gpt-4o,mimiciii,radiology_report,PROMPT1_entailment
322,389,13,12,1,0.9230769230769232,12,9,3,0.75,0.8275862068965517,shc-gpt-4o,mimiciii,radiology_report,PROMPT1_entailment
323,39,10,9,1,0.9,10,8,2,0.8,0.8470588235294118,shc-gpt-4o,mimiciii,radiology_report,PROMPT1_entailment
324,390,10,10,0,1.0,14,14,0,1.0,1.0,shc-gpt-4o,mimiciii,radiology_report,PROMPT1_entailment
325,391,11,11,0,1.0,13,9,4,0.6923076923076923,0.8181818181818181,shc-gpt-4o,mimiciii,radiology_report,PROMPT1_entailment
326,392,12,12,0,1.0,15,13,2,0.8666666666666667,0.9285714285714286,shc-gpt-4o,mimiciii,radiology_report,PROMPT1_entailment
327,393,18,18,0,1.0,19,17,2,0.8947368421052632,0.9444444444444444,shc-gpt-4o,mimiciii,radiology_report,PROMPT1_entailment
328,394,13,13,0,1.0,18,18,0,1.0,1.0,shc-gpt-4o,mimiciii,radiology_report,PROMPT1_entailment
329,395,12,11,1,0.9166666666666666,16,12,4,0.75,0.8250000000000001,shc-gpt-4o,mimiciii,radiology_report,PROMPT1_entailment
330,396,14,12,2,0.8571428571428571,19,15,4,0.7894736842105263,0.8219178082191781,shc-gpt-4o,mimiciii,radiology_report,PROMPT1_entailment
331,397,12,12,0,1.0,18,13,5,0.7222222222222222,0.8387096774193548,shc-gpt-4o,mimiciii,radiology_report,PROMPT1_entailment
332,398,19,19,0,1.0,21,19,2,0.9047619047619048,0.95,shc-gpt-4o,mimiciii,radiology_report,PROMPT1_entailment
333,399,14,14,0,1.0,19,15,4,0.7894736842105263,0.8823529411764706,shc-gpt-4o,mimiciii,radiology_report,PROMPT1_entailment
334,4,16,14,2,0.875,16,13,3,0.8125,0.8425925925925926,shc-gpt-4o,mimiciii,radiology_report,PROMPT1_entailment
335,40,14,14,0,1.0,17,14,3,0.8235294117647058,0.9032258064516128,shc-gpt-4o,mimiciii,radiology_report,PROMPT1_entailment
336,400,8,8,0,1.0,13,8,5,0.6153846153846154,0.761904761904762,shc-gpt-4o,mimiciii,radiology_report,PROMPT1_entailment
337,401,7,7,0,1.0,9,8,1,0.8888888888888888,0.9411764705882352,shc-gpt-4o,mimiciii,radiology_report,PROMPT1_entailment
338,402,16,13,3,0.8125,20,16,4,0.8,0.8062015503875969,shc-gpt-4o,mimiciii,radiology_report,PROMPT1_entailment
339,403,12,11,1,0.9166666666666666,18,16,2,0.8888888888888888,0.9025641025641026,shc-gpt-4o,mimiciii,radiology_report,PROMPT1_entailment
340,404,12,12,0,1.0,19,16,3,0.8421052631578947,0.9142857142857144,shc-gpt-4o,mimiciii,radiology_report,PROMPT1_entailment
341,405,14,14,0,1.0,14,12,2,0.8571428571428571,0.923076923076923,shc-gpt-4o,mimiciii,radiology_report,PROMPT1_entailment
342,406,17,17,0,1.0,25,21,4,0.84,0.9130434782608696,shc-gpt-4o,mimiciii,radiology_report,PROMPT1_entailment
343,407,15,14,1,0.9333333333333332,20,16,4,0.8,0.8615384615384616,shc-gpt-4o,mimiciii,radiology_report,PROMPT1_entailment
344,408,17,16,1,0.9411764705882352,20,15,5,0.75,0.8347826086956521,shc-gpt-4o,mimiciii,radiology_report,PROMPT1_entailment
345,409,19,19,0,1.0,18,17,1,0.9444444444444444,0.9714285714285714,shc-gpt-4o,mimiciii,radiology_report,PROMPT1_entailment
346,41,17,17,0,1.0,26,20,6,0.7692307692307693,0.8695652173913044,shc-gpt-4o,mimiciii,radiology_report,PROMPT1_entailment
347,410,11,11,0,1.0,20,14,6,0.7,0.8235294117647058,shc-gpt-4o,mimiciii,radiology_report,PROMPT1_entailment
348,411,7,6,1,0.8571428571428571,6,6,0,1.0,0.923076923076923,shc-gpt-4o,mimiciii,radiology_report,PROMPT1_entailment
349,412,12,11,1,0.9166666666666666,26,22,4,0.8461538461538461,0.8799999999999999,shc-gpt-4o,mimiciii,radiology_report,PROMPT1_entailment
350,413,12,12,0,1.0,14,11,3,0.7857142857142857,0.88,shc-gpt-4o,mimiciii,radiology_report,PROMPT1_entailment
351,414,20,18,2,0.9,28,23,5,0.8214285714285714,0.8589211618257261,shc-gpt-4o,mimiciii,radiology_report,PROMPT1_entailment
352,415,13,13,0,1.0,20,18,2,0.9,0.9473684210526316,shc-gpt-4o,mimiciii,radiology_report,PROMPT1_entailment
353,416,14,13,1,0.9285714285714286,17,14,3,0.8235294117647058,0.8729016786570742,shc-gpt-4o,mimiciii,radiology_report,PROMPT1_entailment
354,417,18,17,1,0.9444444444444444,20,18,2,0.9,0.9216867469879516,shc-gpt-4o,mimiciii,radiology_report,PROMPT1_entailment
355,418,11,11,0,1.0,14,11,3,0.7857142857142857,0.88,shc-gpt-4o,mimiciii,radiology_report,PROMPT1_entailment
356,419,11,11,0,1.0,16,14,2,0.875,0.9333333333333332,shc-gpt-4o,mimiciii,radiology_report,PROMPT1_entailment
357,42,12,12,0,1.0,14,11,3,0.7857142857142857,0.88,shc-gpt-4o,mimiciii,radiology_report,PROMPT1_entailment
358,420,13,12,1,0.9230769230769232,15,11,4,0.7333333333333333,0.8173374613003097,shc-gpt-4o,mimiciii,radiology_report,PROMPT1_entailment
359,421,13,12,1,0.9230769230769232,23,21,2,0.9130434782608696,0.918032786885246,shc-gpt-4o,mimiciii,radiology_report,PROMPT1_entailment
360,422,14,14,0,1.0,20,17,3,0.85,0.9189189189189187,shc-gpt-4o,mimiciii,radiology_report,PROMPT1_entailment
361,423,11,10,1,0.9090909090909092,12,10,2,0.8333333333333334,0.8695652173913043,shc-gpt-4o,mimiciii,radiology_report,PROMPT1_entailment
362,424,8,7,1,0.875,9,8,1,0.8888888888888888,0.8818897637795274,shc-gpt-4o,mimiciii,radiology_report,PROMPT1_entailment
363,425,15,15,0,1.0,19,15,4,0.7894736842105263,0.8823529411764706,shc-gpt-4o,mimiciii,radiology_report,PROMPT1_entailment
364,426,9,9,0,1.0,16,15,1,0.9375,0.967741935483871,shc-gpt-4o,mimiciii,radiology_report,PROMPT1_entailment
365,427,3,3,0,1.0,15,11,4,0.7333333333333333,0.846153846153846,shc-gpt-4o,mimiciii,radiology_report,PROMPT1_entailment
366,428,10,9,1,0.9,15,13,2,0.8666666666666667,0.8830188679245283,shc-gpt-4o,mimiciii,radiology_report,PROMPT1_entailment
367,429,13,11,2,0.8461538461538461,13,10,3,0.7692307692307693,0.8058608058608059,shc-gpt-4o,mimiciii,radiology_report,PROMPT1_entailment
368,43,7,7,0,1.0,7,6,1,0.8571428571428571,0.923076923076923,shc-gpt-4o,mimiciii,radiology_report,PROMPT1_entailment
369,430,6,6,0,1.0,7,5,2,0.7142857142857143,0.8333333333333333,shc-gpt-4o,mimiciii,radiology_report,PROMPT1_entailment
370,431,13,9,4,0.6923076923076923,18,15,3,0.8333333333333334,0.7563025210084034,shc-gpt-4o,mimiciii,radiology_report,PROMPT1_entailment
371,432,14,14,0,1.0,13,10,3,0.7692307692307693,0.8695652173913044,shc-gpt-4o,mimiciii,radiology_report,PROMPT1_entailment
372,433,13,13,0,1.0,18,15,3,0.8333333333333334,0.9090909090909092,shc-gpt-4o,mimiciii,radiology_report,PROMPT1_entailment
373,434,23,21,2,0.9130434782608696,27,23,4,0.8518518518518519,0.8813868613138687,shc-gpt-4o,mimiciii,radiology_report,PROMPT1_entailment
374,435,10,9,1,0.9,13,10,3,0.7692307692307693,0.8294930875576038,shc-gpt-4o,mimiciii,radiology_report,PROMPT1_entailment
375,436,16,15,1,0.9375,25,23,2,0.92,0.9286675639300136,shc-gpt-4o,mimiciii,radiology_report,PROMPT1_entailment
376,437,8,8,0,1.0,7,7,0,1.0,1.0,shc-gpt-4o,mimiciii,radiology_report,PROMPT1_entailment
377,438,13,13,0,1.0,19,17,2,0.8947368421052632,0.9444444444444444,shc-gpt-4o,mimiciii,radiology_report,PROMPT1_entailment
378,439,18,17,1,0.9444444444444444,22,18,4,0.8181818181818182,0.8767908309455588,shc-gpt-4o,mimiciii,radiology_report,PROMPT1_entailment
379,44,10,10,0,1.0,16,13,3,0.8125,0.896551724137931,shc-gpt-4o,mimiciii,radiology_report,PROMPT1_entailment
380,440,17,15,2,0.8823529411764706,19,14,5,0.7368421052631579,0.8030592734225621,shc-gpt-4o,mimiciii,radiology_report,PROMPT1_entailment
381,441,14,12,2,0.8571428571428571,17,16,1,0.9411764705882352,0.897196261682243,shc-gpt-4o,mimiciii,radiology_report,PROMPT1_entailment
382,442,13,13,0,1.0,12,8,4,0.6666666666666666,0.8,shc-gpt-4o,mimiciii,radiology_report,PROMPT1_entailment
383,443,13,11,2,0.8461538461538461,21,16,5,0.7619047619047619,0.8018223234624144,shc-gpt-4o,mimiciii,radiology_report,PROMPT1_entailment
384,444,8,8,0,1.0,8,6,2,0.75,0.8571428571428571,shc-gpt-4o,mimiciii,radiology_report,PROMPT1_entailment
385,445,17,14,3,0.8235294117647058,22,20,2,0.9090909090909092,0.8641975308641976,shc-gpt-4o,mimiciii,radiology_report,PROMPT1_entailment
386,446,13,9,4,0.6923076923076923,22,17,5,0.7727272727272727,0.7303102625298329,shc-gpt-4o,mimiciii,radiology_report,PROMPT1_entailment
387,447,14,14,0,1.0,14,14,0,1.0,1.0,shc-gpt-4o,mimiciii,radiology_report,PROMPT1_entailment
388,448,19,19,0,1.0,36,26,10,0.7222222222222222,0.8387096774193548,shc-gpt-4o,mimiciii,radiology_report,PROMPT1_entailment
389,449,11,11,0,1.0,9,9,0,1.0,1.0,shc-gpt-4o,mimiciii,radiology_report,PROMPT1_entailment
390,45,6,6,0,1.0,20,17,3,0.85,0.9189189189189187,shc-gpt-4o,mimiciii,radiology_report,PROMPT1_entailment
391,450,16,16,0,1.0,21,17,4,0.8095238095238095,0.8947368421052632,shc-gpt-4o,mimiciii,radiology_report,PROMPT1_entailment
392,451,6,6,0,1.0,10,8,2,0.8,0.888888888888889,shc-gpt-4o,mimiciii,radiology_report,PROMPT1_entailment
393,452,10,10,0,1.0,16,15,1,0.9375,0.967741935483871,shc-gpt-4o,mimiciii,radiology_report,PROMPT1_entailment
394,453,10,10,0,1.0,14,12,2,0.8571428571428571,0.923076923076923,shc-gpt-4o,mimiciii,radiology_report,PROMPT1_entailment
395,454,7,7,0,1.0,10,7,3,0.7,0.8235294117647058,shc-gpt-4o,mimiciii,radiology_report,PROMPT1_entailment
396,455,11,11,0,1.0,16,16,0,1.0,1.0,shc-gpt-4o,mimiciii,radiology_report,PROMPT1_entailment
397,456,15,13,2,0.8666666666666667,21,18,3,0.8571428571428571,0.861878453038674,shc-gpt-4o,mimiciii,radiology_report,PROMPT1_entailment
398,457,14,14,0,1.0,12,10,2,0.8333333333333334,0.9090909090909092,shc-gpt-4o,mimiciii,radiology_report,PROMPT1_entailment
399,458,12,12,0,1.0,16,15,1,0.9375,0.967741935483871,shc-gpt-4o,mimiciii,radiology_report,PROMPT1_entailment
400,459,14,14,0,1.0,13,10,3,0.7692307692307693,0.8695652173913044,shc-gpt-4o,mimiciii,radiology_report,PROMPT1_entailment
401,46,14,14,0,1.0,22,18,4,0.8181818181818182,0.9,shc-gpt-4o,mimiciii,radiology_report,PROMPT1_entailment
402,460,15,14,1,0.9333333333333332,20,15,5,0.75,0.8316831683168316,shc-gpt-4o,mimiciii,radiology_report,PROMPT1_entailment
403,461,13,11,2,0.8461538461538461,22,14,8,0.6363636363636364,0.7264150943396226,shc-gpt-4o,mimiciii,radiology_report,PROMPT1_entailment
404,462,19,17,2,0.8947368421052632,20,18,2,0.9,0.8973607038123168,shc-gpt-4o,mimiciii,radiology_report,PROMPT1_entailment
405,463,9,9,0,1.0,12,10,2,0.8333333333333334,0.9090909090909092,shc-gpt-4o,mimiciii,radiology_report,PROMPT1_entailment
406,464,18,18,0,1.0,25,22,3,0.88,0.9361702127659576,shc-gpt-4o,mimiciii,radiology_report,PROMPT1_entailment
407,465,14,13,1,0.9285714285714286,33,28,5,0.8484848484848485,0.8867235079171742,shc-gpt-4o,mimiciii,radiology_report,PROMPT1_entailment
408,466,15,13,2,0.8666666666666667,22,20,2,0.9090909090909092,0.887372013651877,shc-gpt-4o,mimiciii,radiology_report,PROMPT1_entailment
409,467,10,10,0,1.0,14,13,1,0.9285714285714286,0.962962962962963,shc-gpt-4o,mimiciii,radiology_report,PROMPT1_entailment
410,468,11,11,0,1.0,18,13,5,0.7222222222222222,0.8387096774193548,shc-gpt-4o,mimiciii,radiology_report,PROMPT1_entailment
411,469,16,15,1,0.9375,25,23,2,0.92,0.9286675639300136,shc-gpt-4o,mimiciii,radiology_report,PROMPT1_entailment
412,47,14,10,4,0.7142857142857143,15,12,3,0.8,0.7547169811320756,shc-gpt-4o,mimiciii,radiology_report,PROMPT1_entailment
413,470,8,8,0,1.0,15,13,2,0.8666666666666667,0.9285714285714286,shc-gpt-4o,mimiciii,radiology_report,PROMPT1_entailment
414,471,17,16,1,0.9411764705882352,18,14,4,0.7777777777777778,0.8517110266159694,shc-gpt-4o,mimiciii,radiology_report,PROMPT1_entailment
415,472,14,14,0,1.0,16,15,1,0.9375,0.967741935483871,shc-gpt-4o,mimiciii,radiology_report,PROMPT1_entailment
416,473,6,6,0,1.0,11,10,1,0.9090909090909092,0.9523809523809524,shc-gpt-4o,mimiciii,radiology_report,PROMPT1_entailment
417,474,16,16,0,1.0,25,23,2,0.92,0.9583333333333334,shc-gpt-4o,mimiciii,radiology_report,PROMPT1_entailment
418,475,6,6,0,1.0,7,6,1,0.8571428571428571,0.923076923076923,shc-gpt-4o,mimiciii,radiology_report,PROMPT1_entailment
419,476,14,14,0,1.0,12,11,1,0.9166666666666666,0.9565217391304348,shc-gpt-4o,mimiciii,radiology_report,PROMPT1_entailment
420,477,13,13,0,1.0,16,13,3,0.8125,0.896551724137931,shc-gpt-4o,mimiciii,radiology_report,PROMPT1_entailment
421,478,13,12,1,0.9230769230769232,21,13,8,0.6190476190476191,0.7410926365795725,shc-gpt-4o,mimiciii,radiology_report,PROMPT1_entailment
422,479,12,12,0,1.0,22,19,3,0.8636363636363636,0.9268292682926828,shc-gpt-4o,mimiciii,radiology_report,PROMPT1_entailment
423,48,14,13,1,0.9285714285714286,21,15,6,0.7142857142857143,0.8074534161490684,shc-gpt-4o,mimiciii,radiology_report,PROMPT1_entailment
424,480,10,9,1,0.9,10,7,3,0.7,0.7875,shc-gpt-4o,mimiciii,radiology_report,PROMPT1_entailment
425,481,15,14,1,0.9333333333333332,17,13,4,0.7647058823529411,0.8406466512702079,shc-gpt-4o,mimiciii,radiology_report,PROMPT1_entailment
426,482,17,16,1,0.9411764705882352,19,18,1,0.9473684210526316,0.9442622950819672,shc-gpt-4o,mimiciii,radiology_report,PROMPT1_entailment
427,483,17,17,0,1.0,23,20,3,0.8695652173913043,0.9302325581395348,shc-gpt-4o,mimiciii,radiology_report,PROMPT1_entailment
428,484,8,8,0,1.0,13,11,2,0.8461538461538461,0.9166666666666666,shc-gpt-4o,mimiciii,radiology_report,PROMPT1_entailment
429,485,15,15,0,1.0,24,21,3,0.875,0.9333333333333332,shc-gpt-4o,mimiciii,radiology_report,PROMPT1_entailment
430,486,12,11,1,0.9166666666666666,11,9,2,0.8181818181818182,0.8646288209606987,shc-gpt-4o,mimiciii,radiology_report,PROMPT1_entailment
431,487,11,11,0,1.0,20,15,5,0.75,0.8571428571428571,shc-gpt-4o,mimiciii,radiology_report,PROMPT1_entailment
432,488,11,9,2,0.8181818181818182,15,14,1,0.9333333333333332,0.8719723183391004,shc-gpt-4o,mimiciii,radiology_report,PROMPT1_entailment
433,489,19,19,0,1.0,18,15,3,0.8333333333333334,0.9090909090909092,shc-gpt-4o,mimiciii,radiology_report,PROMPT1_entailment
434,49,13,13,0,1.0,24,22,2,0.9166666666666666,0.9565217391304348,shc-gpt-4o,mimiciii,radiology_report,PROMPT1_entailment
435,490,7,6,1,0.8571428571428571,8,3,5,0.375,0.5217391304347825,shc-gpt-4o,mimiciii,radiology_report,PROMPT1_entailment
436,491,11,11,0,1.0,17,15,2,0.8823529411764706,0.9375,shc-gpt-4o,mimiciii,radiology_report,PROMPT1_entailment
437,492,7,6,1,0.8571428571428571,13,10,3,0.7692307692307693,0.8108108108108107,shc-gpt-4o,mimiciii,radiology_report,PROMPT1_entailment
438,493,9,9,0,1.0,9,6,3,0.6666666666666666,0.8,shc-gpt-4o,mimiciii,radiology_report,PROMPT1_entailment
439,494,8,8,0,1.0,8,6,2,0.75,0.8571428571428571,shc-gpt-4o,mimiciii,radiology_report,PROMPT1_entailment
440,495,9,9,0,1.0,12,11,1,0.9166666666666666,0.9565217391304348,shc-gpt-4o,mimiciii,radiology_report,PROMPT1_entailment
441,496,19,19,0,1.0,32,25,7,0.78125,0.8771929824561403,shc-gpt-4o,mimiciii,radiology_report,PROMPT1_entailment
442,497,15,13,2,0.8666666666666667,22,17,5,0.7727272727272727,0.8170055452865065,shc-gpt-4o,mimiciii,radiology_report,PROMPT1_entailment
443,498,17,16,1,0.9411764705882352,22,18,4,0.8181818181818182,0.8753799392097266,shc-gpt-4o,mimiciii,radiology_report,PROMPT1_entailment
444,499,16,16,0,1.0,17,14,3,0.8235294117647058,0.9032258064516128,shc-gpt-4o,mimiciii,radiology_report,PROMPT1_entailment
445,5,15,15,0,1.0,22,15,7,0.6818181818181818,0.8108108108108109,shc-gpt-4o,mimiciii,radiology_report,PROMPT1_entailment
446,50,13,13,0,1.0,15,10,5,0.6666666666666666,0.8,shc-gpt-4o,mimiciii,radiology_report,PROMPT1_entailment
447,51,11,11,0,1.0,13,10,3,0.7692307692307693,0.8695652173913044,shc-gpt-4o,mimiciii,radiology_report,PROMPT1_entailment
448,52,16,15,1,0.9375,21,18,3,0.8571428571428571,0.8955223880597014,shc-gpt-4o,mimiciii,radiology_report,PROMPT1_entailment
449,53,10,10,0,1.0,12,11,1,0.9166666666666666,0.9565217391304348,shc-gpt-4o,mimiciii,radiology_report,PROMPT1_entailment
450,54,9,8,1,0.8888888888888888,10,7,3,0.7,0.7832167832167831,shc-gpt-4o,mimiciii,radiology_report,PROMPT1_entailment
451,55,10,10,0,1.0,18,16,2,0.8888888888888888,0.9411764705882352,shc-gpt-4o,mimiciii,radiology_report,PROMPT1_entailment
452,56,15,12,3,0.8,21,14,7,0.6666666666666666,0.7272727272727272,shc-gpt-4o,mimiciii,radiology_report,PROMPT1_entailment
453,57,7,7,0,1.0,10,8,2,0.8,0.888888888888889,shc-gpt-4o,mimiciii,radiology_report,PROMPT1_entailment
454,58,11,11,0,1.0,16,13,3,0.8125,0.896551724137931,shc-gpt-4o,mimiciii,radiology_report,PROMPT1_entailment
455,59,11,11,0,1.0,16,15,1,0.9375,0.967741935483871,shc-gpt-4o,mimiciii,radiology_report,PROMPT1_entailment
456,6,6,6,0,1.0,8,6,2,0.75,0.8571428571428571,shc-gpt-4o,mimiciii,radiology_report,PROMPT1_entailment
457,60,14,13,1,0.9285714285714286,19,15,4,0.7894736842105263,0.8533916849015317,shc-gpt-4o,mimiciii,radiology_report,PROMPT1_entailment
458,61,15,15,0,1.0,22,18,4,0.8181818181818182,0.9,shc-gpt-4o,mimiciii,radiology_report,PROMPT1_entailment
459,62,16,15,1,0.9375,13,10,3,0.7692307692307693,0.8450704225352113,shc-gpt-4o,mimiciii,radiology_report,PROMPT1_entailment
460,63,10,10,0,1.0,15,12,3,0.8,0.888888888888889,shc-gpt-4o,mimiciii,radiology_report,PROMPT1_entailment
461,64,16,14,2,0.875,20,17,3,0.85,0.8623188405797101,shc-gpt-4o,mimiciii,radiology_report,PROMPT1_entailment
462,65,18,17,1,0.9444444444444444,18,14,4,0.7777777777777778,0.8530465949820788,shc-gpt-4o,mimiciii,radiology_report,PROMPT1_entailment
463,66,16,16,0,1.0,29,26,3,0.896551724137931,0.9454545454545454,shc-gpt-4o,mimiciii,radiology_report,PROMPT1_entailment
464,67,16,16,0,1.0,28,25,3,0.8928571428571429,0.9433962264150944,shc-gpt-4o,mimiciii,radiology_report,PROMPT1_entailment
465,68,21,19,2,0.9047619047619048,30,27,3,0.9,0.9023746701846964,shc-gpt-4o,mimiciii,radiology_report,PROMPT1_entailment
466,69,23,22,1,0.9565217391304348,31,26,5,0.8387096774193549,0.8937500000000002,shc-gpt-4o,mimiciii,radiology_report,PROMPT1_entailment
467,7,13,13,0,1.0,16,15,1,0.9375,0.967741935483871,shc-gpt-4o,mimiciii,radiology_report,PROMPT1_entailment
468,70,12,11,1,0.9166666666666666,17,15,2,0.8823529411764706,0.8991825613079019,shc-gpt-4o,mimiciii,radiology_report,PROMPT1_entailment
469,71,13,13,0,1.0,18,14,4,0.7777777777777778,0.8750000000000001,shc-gpt-4o,mimiciii,radiology_report,PROMPT1_entailment
470,72,8,8,0,1.0,13,12,1,0.9230769230769232,0.96,shc-gpt-4o,mimiciii,radiology_report,PROMPT1_entailment
471,73,21,20,1,0.9523809523809524,29,19,10,0.6551724137931034,0.7763023493360571,shc-gpt-4o,mimiciii,radiology_report,PROMPT1_entailment
472,74,13,13,0,1.0,18,14,4,0.7777777777777778,0.8750000000000001,shc-gpt-4o,mimiciii,radiology_report,PROMPT1_entailment
473,75,11,11,0,1.0,12,11,1,0.9166666666666666,0.9565217391304348,shc-gpt-4o,mimiciii,radiology_report,PROMPT1_entailment
474,76,9,9,0,1.0,14,12,2,0.8571428571428571,0.923076923076923,shc-gpt-4o,mimiciii,radiology_report,PROMPT1_entailment
475,77,18,17,1,0.9444444444444444,26,22,4,0.8461538461538461,0.8926014319809069,shc-gpt-4o,mimiciii,radiology_report,PROMPT1_entailment
476,78,19,15,4,0.7894736842105263,33,25,8,0.7575757575757576,0.7731958762886598,shc-gpt-4o,mimiciii,radiology_report,PROMPT1_entailment
477,79,12,12,0,1.0,17,13,4,0.7647058823529411,0.8666666666666666,shc-gpt-4o,mimiciii,radiology_report,PROMPT1_entailment
478,8,19,19,0,1.0,15,14,1,0.9333333333333332,0.9655172413793104,shc-gpt-4o,mimiciii,radiology_report,PROMPT1_entailment
479,80,19,17,2,0.8947368421052632,25,21,4,0.84,0.866504854368932,shc-gpt-4o,mimiciii,radiology_report,PROMPT1_entailment
480,81,11,10,1,0.9090909090909092,15,13,2,0.8666666666666667,0.887372013651877,shc-gpt-4o,mimiciii,radiology_report,PROMPT1_entailment
481,82,14,13,1,0.9285714285714286,14,13,1,0.9285714285714286,0.9285714285714286,shc-gpt-4o,mimiciii,radiology_report,PROMPT1_entailment
482,83,19,15,4,0.7894736842105263,17,16,1,0.9411764705882352,0.8586762075134169,shc-gpt-4o,mimiciii,radiology_report,PROMPT1_entailment
483,84,12,12,0,1.0,20,15,5,0.75,0.8571428571428571,shc-gpt-4o,mimiciii,radiology_report,PROMPT1_entailment
484,85,13,13,0,1.0,14,13,1,0.9285714285714286,0.962962962962963,shc-gpt-4o,mimiciii,radiology_report,PROMPT1_entailment
485,86,9,9,0,1.0,10,10,0,1.0,1.0,shc-gpt-4o,mimiciii,radiology_report,PROMPT1_entailment
486,87,11,11,0,1.0,14,12,2,0.8571428571428571,0.923076923076923,shc-gpt-4o,mimiciii,radiology_report,PROMPT1_entailment
487,88,18,17,1,0.9444444444444444,19,17,2,0.8947368421052632,0.918918918918919,shc-gpt-4o,mimiciii,radiology_report,PROMPT1_entailment
488,89,15,13,2,0.8666666666666667,18,16,2,0.8888888888888888,0.8776371308016878,shc-gpt-4o,mimiciii,radiology_report,PROMPT1_entailment
489,9,8,7,1,0.875,13,10,3,0.7692307692307693,0.8187134502923977,shc-gpt-4o,mimiciii,radiology_report,PROMPT1_entailment
490,90,12,12,0,1.0,14,14,0,1.0,1.0,shc-gpt-4o,mimiciii,radiology_report,PROMPT1_entailment
491,91,10,9,1,0.9,13,11,2,0.8461538461538461,0.8722466960352422,shc-gpt-4o,mimiciii,radiology_report,PROMPT1_entailment
492,92,16,15,1,0.9375,21,15,6,0.7142857142857143,0.8108108108108109,shc-gpt-4o,mimiciii,radiology_report,PROMPT1_entailment
493,93,18,18,0,1.0,15,12,3,0.8,0.888888888888889,shc-gpt-4o,mimiciii,radiology_report,PROMPT1_entailment
494,94,19,17,2,0.8947368421052632,28,23,5,0.8214285714285714,0.8565169769989048,shc-gpt-4o,mimiciii,radiology_report,PROMPT1_entailment
495,95,15,15,0,1.0,18,12,6,0.6666666666666666,0.8,shc-gpt-4o,mimiciii,radiology_report,PROMPT1_entailment
496,96,14,13,1,0.9285714285714286,21,15,6,0.7142857142857143,0.8074534161490684,shc-gpt-4o,mimiciii,radiology_report,PROMPT1_entailment
497,97,15,11,4,0.7333333333333333,23,19,4,0.8260869565217391,0.7769516728624535,shc-gpt-4o,mimiciii,radiology_report,PROMPT1_entailment
498,98,14,14,0,1.0,19,17,2,0.8947368421052632,0.9444444444444444,shc-gpt-4o,mimiciii,radiology_report,PROMPT1_entailment
499,99,16,16,0,1.0,13,13,0,1.0,1.0,shc-gpt-4o,mimiciii,radiology_report,PROMPT1_entailment
0,0,28,25,3,0.8928571428571429,21,17,4,0.8095238095238095,0.8491508491508492,shc-gpt-4o,mimiciii,radiology_report,PROMPT1_ICL_entailment
1,1,21,19,2,0.9047619047619048,15,10,5,0.6666666666666666,0.7676767676767676,shc-gpt-4o,mimiciii,radiology_report,PROMPT1_ICL_entailment
2,10,15,12,3,0.8,18,15,3,0.8333333333333334,0.816326530612245,shc-gpt-4o,mimiciii,radiology_report,PROMPT1_ICL_entailment
3,100,12,12,0,1.0,9,9,0,1.0,1.0,shc-gpt-4o,mimiciii,radiology_report,PROMPT1_ICL_entailment
4,101,17,17,0,1.0,15,14,1,0.9333333333333332,0.9655172413793104,shc-gpt-4o,mimiciii,radiology_report,PROMPT1_ICL_entailment
5,102,15,14,1,0.9333333333333332,16,13,3,0.8125,0.8687350835322195,shc-gpt-4o,mimiciii,radiology_report,PROMPT1_ICL_entailment
6,103,22,21,1,0.9545454545454546,19,15,4,0.7894736842105263,0.8641975308641975,shc-gpt-4o,mimiciii,radiology_report,PROMPT1_ICL_entailment
7,104,22,21,1,0.9545454545454546,17,15,2,0.8823529411764706,0.9170305676855895,shc-gpt-4o,mimiciii,radiology_report,PROMPT1_ICL_entailment
8,105,7,7,0,1.0,8,7,1,0.875,0.9333333333333332,shc-gpt-4o,mimiciii,radiology_report,PROMPT1_ICL_entailment
9,106,13,13,0,1.0,12,10,2,0.8333333333333334,0.9090909090909092,shc-gpt-4o,mimiciii,radiology_report,PROMPT1_ICL_entailment
10,107,15,13,2,0.8666666666666667,19,13,6,0.6842105263157895,0.7647058823529413,shc-gpt-4o,mimiciii,radiology_report,PROMPT1_ICL_entailment
11,108,14,14,0,1.0,13,11,2,0.8461538461538461,0.9166666666666666,shc-gpt-4o,mimiciii,radiology_report,PROMPT1_ICL_entailment
12,109,18,14,4,0.7777777777777778,20,18,2,0.9,0.8344370860927153,shc-gpt-4o,mimiciii,radiology_report,PROMPT1_ICL_entailment
13,11,18,17,1,0.9444444444444444,20,17,3,0.85,0.8947368421052632,shc-gpt-4o,mimiciii,radiology_report,PROMPT1_ICL_entailment
14,110,25,25,0,1.0,17,14,3,0.8235294117647058,0.9032258064516128,shc-gpt-4o,mimiciii,radiology_report,PROMPT1_ICL_entailment
15,111,21,21,0,1.0,20,17,3,0.85,0.9189189189189187,shc-gpt-4o,mimiciii,radiology_report,PROMPT1_ICL_entailment
16,112,15,15,0,1.0,14,13,1,0.9285714285714286,0.962962962962963,shc-gpt-4o,mimiciii,radiology_report,PROMPT1_ICL_entailment
17,113,20,12,8,0.6,20,18,2,0.9,0.7200000000000001,shc-gpt-4o,mimiciii,radiology_report,PROMPT1_ICL_entailment
18,114,22,17,5,0.7727272727272727,23,20,3,0.8695652173913043,0.8182912154031288,shc-gpt-4o,mimiciii,radiology_report,PROMPT1_ICL_entailment
19,115,16,16,0,1.0,20,17,3,0.85,0.9189189189189187,shc-gpt-4o,mimiciii,radiology_report,PROMPT1_ICL_entailment
20,116,14,13,1,0.9285714285714286,13,10,3,0.7692307692307693,0.8414239482200646,shc-gpt-4o,mimiciii,radiology_report,PROMPT1_ICL_entailment
21,117,16,16,0,1.0,16,13,3,0.8125,0.896551724137931,shc-gpt-4o,mimiciii,radiology_report,PROMPT1_ICL_entailment
22,118,20,19,1,0.95,24,19,5,0.7916666666666666,0.8636363636363635,shc-gpt-4o,mimiciii,radiology_report,PROMPT1_ICL_entailment
23,119,17,17,0,1.0,17,13,4,0.7647058823529411,0.8666666666666666,shc-gpt-4o,mimiciii,radiology_report,PROMPT1_ICL_entailment
24,12,12,12,0,1.0,17,14,3,0.8235294117647058,0.9032258064516128,shc-gpt-4o,mimiciii,radiology_report,PROMPT1_ICL_entailment
25,120,19,17,2,0.8947368421052632,16,11,5,0.6875,0.7775467775467776,shc-gpt-4o,mimiciii,radiology_report,PROMPT1_ICL_entailment
26,121,30,24,6,0.8,26,22,4,0.8461538461538461,0.8224299065420562,shc-gpt-4o,mimiciii,radiology_report,PROMPT1_ICL_entailment
27,122,13,13,0,1.0,20,17,3,0.85,0.9189189189189187,shc-gpt-4o,mimiciii,radiology_report,PROMPT1_ICL_entailment
28,123,15,15,0,1.0,13,12,1,0.9230769230769232,0.96,shc-gpt-4o,mimiciii,radiology_report,PROMPT1_ICL_entailment
29,124,10,10,0,1.0,12,9,3,0.75,0.8571428571428571,shc-gpt-4o,mimiciii,radiology_report,PROMPT1_ICL_entailment
30,125,21,20,1,0.9523809523809524,23,18,5,0.782608695652174,0.8591885441527446,shc-gpt-4o,mimiciii,radiology_report,PROMPT1_ICL_entailment
31,126,12,11,1,0.9166666666666666,9,8,1,0.8888888888888888,0.9025641025641026,shc-gpt-4o,mimiciii,radiology_report,PROMPT1_ICL_entailment
32,127,37,36,1,0.972972972972973,43,36,7,0.8372093023255814,0.9,shc-gpt-4o,mimiciii,radiology_report,PROMPT1_ICL_entailment
33,128,13,13,0,1.0,14,12,2,0.8571428571428571,0.923076923076923,shc-gpt-4o,mimiciii,radiology_report,PROMPT1_ICL_entailment
34,129,16,14,2,0.875,16,13,3,0.8125,0.8425925925925926,shc-gpt-4o,mimiciii,radiology_report,PROMPT1_ICL_entailment
35,13,14,13,1,0.9285714285714286,17,15,2,0.8823529411764706,0.9048723897911832,shc-gpt-4o,mimiciii,radiology_report,PROMPT1_ICL_entailment
36,130,16,16,0,1.0,25,18,7,0.72,0.8372093023255813,shc-gpt-4o,mimiciii,radiology_report,PROMPT1_ICL_entailment
37,131,12,11,1,0.9166666666666666,32,29,3,0.90625,0.9114285714285716,shc-gpt-4o,mimiciii,radiology_report,PROMPT1_ICL_entailment
38,132,16,11,5,0.6875,23,14,9,0.6086956521739131,0.6457023060796646,shc-gpt-4o,mimiciii,radiology_report,PROMPT1_ICL_entailment
39,133,21,18,3,0.8571428571428571,21,17,4,0.8095238095238095,0.8326530612244899,shc-gpt-4o,mimiciii,radiology_report,PROMPT1_ICL_entailment
40,134,17,16,1,0.9411764705882352,23,18,5,0.782608695652174,0.8545994065281899,shc-gpt-4o,mimiciii,radiology_report,PROMPT1_ICL_entailment
41,135,15,14,1,0.9333333333333332,20,16,4,0.8,0.8615384615384616,shc-gpt-4o,mimiciii,radiology_report,PROMPT1_ICL_entailment
42,136,11,10,1,0.9090909090909092,14,12,2,0.8571428571428571,0.8823529411764706,shc-gpt-4o,mimiciii,radiology_report,PROMPT1_ICL_entailment
43,137,11,11,0,1.0,10,9,1,0.9,0.9473684210526316,shc-gpt-4o,mimiciii,radiology_report,PROMPT1_ICL_entailment
44,138,16,16,0,1.0,14,12,2,0.8571428571428571,0.923076923076923,shc-gpt-4o,mimiciii,radiology_report,PROMPT1_ICL_entailment
45,139,14,13,1,0.9285714285714286,13,12,1,0.9230769230769232,0.9258160237388724,shc-gpt-4o,mimiciii,radiology_report,PROMPT1_ICL_entailment
46,14,12,12,0,1.0,12,11,1,0.9166666666666666,0.9565217391304348,shc-gpt-4o,mimiciii,radiology_report,PROMPT1_ICL_entailment
47,140,19,19,0,1.0,18,16,2,0.8888888888888888,0.9411764705882352,shc-gpt-4o,mimiciii,radiology_report,PROMPT1_ICL_entailment
48,141,13,13,0,1.0,16,10,6,0.625,0.7692307692307693,shc-gpt-4o,mimiciii,radiology_report,PROMPT1_ICL_entailment
49,142,14,14,0,1.0,14,13,1,0.9285714285714286,0.962962962962963,shc-gpt-4o,mimiciii,radiology_report,PROMPT1_ICL_entailment
50,143,27,24,3,0.8888888888888888,28,23,5,0.8214285714285714,0.8538283062645011,shc-gpt-4o,mimiciii,radiology_report,PROMPT1_ICL_entailment
51,144,22,19,3,0.8636363636363636,23,19,4,0.8260869565217391,0.8444444444444444,shc-gpt-4o,mimiciii,radiology_report,PROMPT1_ICL_entailment
52,145,23,23,0,1.0,18,14,4,0.7777777777777778,0.8750000000000001,shc-gpt-4o,mimiciii,radiology_report,PROMPT1_ICL_entailment
53,146,11,11,0,1.0,11,8,3,0.7272727272727273,0.8421052631578948,shc-gpt-4o,mimiciii,radiology_report,PROMPT1_ICL_entailment
54,147,11,11,0,1.0,10,10,0,1.0,1.0,shc-gpt-4o,mimiciii,radiology_report,PROMPT1_ICL_entailment
55,148,26,24,2,0.9230769230769232,26,22,4,0.8461538461538461,0.8829431438127091,shc-gpt-4o,mimiciii,radiology_report,PROMPT1_ICL_entailment
56,149,18,16,2,0.8888888888888888,20,18,2,0.9,0.8944099378881988,shc-gpt-4o,mimiciii,radiology_report,PROMPT1_ICL_entailment
57,15,31,28,3,0.9032258064516128,29,24,5,0.8275862068965517,0.8637532133676091,shc-gpt-4o,mimiciii,radiology_report,PROMPT1_ICL_entailment
58,150,18,17,1,0.9444444444444444,14,12,2,0.8571428571428571,0.8986784140969163,shc-gpt-4o,mimiciii,radiology_report,PROMPT1_ICL_entailment
59,151,19,17,2,0.8947368421052632,15,8,7,0.5333333333333333,0.6683046683046683,shc-gpt-4o,mimiciii,radiology_report,PROMPT1_ICL_entailment
60,152,18,18,0,1.0,18,12,6,0.6666666666666666,0.8,shc-gpt-4o,mimiciii,radiology_report,PROMPT1_ICL_entailment
61,153,17,15,2,0.8823529411764706,16,15,1,0.9375,0.9090909090909092,shc-gpt-4o,mimiciii,radiology_report,PROMPT1_ICL_entailment
62,154,20,18,2,0.9,23,21,2,0.9130434782608696,0.9064748201438848,shc-gpt-4o,mimiciii,radiology_report,PROMPT1_ICL_entailment
63,155,28,28,0,1.0,47,41,6,0.8723404255319149,0.931818181818182,shc-gpt-4o,mimiciii,radiology_report,PROMPT1_ICL_entailment
64,156,21,20,1,0.9523809523809524,20,16,4,0.8,0.8695652173913043,shc-gpt-4o,mimiciii,radiology_report,PROMPT1_ICL_entailment
65,157,14,13,1,0.9285714285714286,12,11,1,0.9166666666666666,0.9225806451612902,shc-gpt-4o,mimiciii,radiology_report,PROMPT1_ICL_entailment
66,158,9,9,0,1.0,6,5,1,0.8333333333333334,0.9090909090909092,shc-gpt-4o,mimiciii,radiology_report,PROMPT1_ICL_entailment
67,159,13,13,0,1.0,13,10,3,0.7692307692307693,0.8695652173913044,shc-gpt-4o,mimiciii,radiology_report,PROMPT1_ICL_entailment
68,16,15,15,0,1.0,17,14,3,0.8235294117647058,0.9032258064516128,shc-gpt-4o,mimiciii,radiology_report,PROMPT1_ICL_entailment
69,160,18,17,1,0.9444444444444444,12,10,2,0.8333333333333334,0.8854166666666667,shc-gpt-4o,mimiciii,radiology_report,PROMPT1_ICL_entailment
70,161,15,15,0,1.0,13,10,3,0.7692307692307693,0.8695652173913044,shc-gpt-4o,mimiciii,radiology_report,PROMPT1_ICL_entailment
71,162,15,15,0,1.0,11,11,0,1.0,1.0,shc-gpt-4o,mimiciii,radiology_report,PROMPT1_ICL_entailment
72,163,13,12,1,0.9230769230769232,8,6,2,0.75,0.8275862068965517,shc-gpt-4o,mimiciii,radiology_report,PROMPT1_ICL_entailment
73,164,15,14,1,0.9333333333333332,10,9,1,0.9,0.9163636363636364,shc-gpt-4o,mimiciii,radiology_report,PROMPT1_ICL_entailment
74,165,26,25,1,0.9615384615384616,28,26,2,0.9285714285714286,0.9447674418604652,shc-gpt-4o,mimiciii,radiology_report,PROMPT1_ICL_entailment
75,166,26,22,4,0.8461538461538461,26,22,4,0.8461538461538461,0.8461538461538461,shc-gpt-4o,mimiciii,radiology_report,PROMPT1_ICL_entailment
76,167,10,10,0,1.0,10,9,1,0.9,0.9473684210526316,shc-gpt-4o,mimiciii,radiology_report,PROMPT1_ICL_entailment
77,168,15,14,1,0.9333333333333332,13,9,4,0.6923076923076923,0.7949526813880127,shc-gpt-4o,mimiciii,radiology_report,PROMPT1_ICL_entailment
78,169,20,18,2,0.9,22,19,3,0.8636363636363636,0.8814432989690723,shc-gpt-4o,mimiciii,radiology_report,PROMPT1_ICL_entailment
79,17,9,9,0,1.0,12,9,3,0.75,0.8571428571428571,shc-gpt-4o,mimiciii,radiology_report,PROMPT1_ICL_entailment
80,170,22,22,0,1.0,24,20,4,0.8333333333333334,0.9090909090909092,shc-gpt-4o,mimiciii,radiology_report,PROMPT1_ICL_entailment
81,171,10,9,1,0.9,7,6,1,0.8571428571428571,0.8780487804878048,shc-gpt-4o,mimiciii,radiology_report,PROMPT1_ICL_entailment
82,172,13,13,0,1.0,14,12,2,0.8571428571428571,0.923076923076923,shc-gpt-4o,mimiciii,radiology_report,PROMPT1_ICL_entailment
83,173,13,13,0,1.0,12,10,2,0.8333333333333334,0.9090909090909092,shc-gpt-4o,mimiciii,radiology_report,PROMPT1_ICL_entailment
84,174,17,15,2,0.8823529411764706,20,17,3,0.85,0.865874363327674,shc-gpt-4o,mimiciii,radiology_report,PROMPT1_ICL_entailment
85,175,10,9,1,0.9,8,8,0,1.0,0.9473684210526316,shc-gpt-4o,mimiciii,radiology_report,PROMPT1_ICL_entailment
86,176,22,17,5,0.7727272727272727,19,16,3,0.8421052631578947,0.8059259259259259,shc-gpt-4o,mimiciii,radiology_report,PROMPT1_ICL_entailment
87,177,24,22,2,0.9166666666666666,16,14,2,0.875,0.8953488372093024,shc-gpt-4o,mimiciii,radiology_report,PROMPT1_ICL_entailment
88,178,24,19,5,0.7916666666666666,25,23,2,0.92,0.8510223953261927,shc-gpt-4o,mimiciii,radiology_report,PROMPT1_ICL_entailment
89,179,19,18,1,0.9473684210526316,17,12,5,0.7058823529411765,0.8089887640449439,shc-gpt-4o,mimiciii,radiology_report,PROMPT1_ICL_entailment
90,18,16,16,0,1.0,17,15,2,0.8823529411764706,0.9375,shc-gpt-4o,mimiciii,radiology_report,PROMPT1_ICL_entailment
91,180,16,16,0,1.0,11,11,0,1.0,1.0,shc-gpt-4o,mimiciii,radiology_report,PROMPT1_ICL_entailment
92,181,22,18,4,0.8181818181818182,26,21,5,0.8076923076923077,0.8129032258064518,shc-gpt-4o,mimiciii,radiology_report,PROMPT1_ICL_entailment
93,182,23,22,1,0.9565217391304348,23,19,4,0.8260869565217391,0.8865323435843054,shc-gpt-4o,mimiciii,radiology_report,PROMPT1_ICL_entailment
94,183,15,13,2,0.8666666666666667,17,15,2,0.8823529411764706,0.8744394618834082,shc-gpt-4o,mimiciii,radiology_report,PROMPT1_ICL_entailment
95,184,13,13,0,1.0,15,13,2,0.8666666666666667,0.9285714285714286,shc-gpt-4o,mimiciii,radiology_report,PROMPT1_ICL_entailment
96,185,11,11,0,1.0,6,5,1,0.8333333333333334,0.9090909090909092,shc-gpt-4o,mimiciii,radiology_report,PROMPT1_ICL_entailment
97,186,28,26,2,0.9285714285714286,26,22,4,0.8461538461538461,0.8854489164086687,shc-gpt-4o,mimiciii,radiology_report,PROMPT1_ICL_entailment
98,187,21,21,0,1.0,14,12,2,0.8571428571428571,0.923076923076923,shc-gpt-4o,mimiciii,radiology_report,PROMPT1_ICL_entailment
99,188,24,23,1,0.9583333333333334,22,17,5,0.7727272727272727,0.8555798687089716,shc-gpt-4o,mimiciii,radiology_report,PROMPT1_ICL_entailment
100,189,16,16,0,1.0,15,13,2,0.8666666666666667,0.9285714285714286,shc-gpt-4o,mimiciii,radiology_report,PROMPT1_ICL_entailment
101,19,15,14,1,0.9333333333333332,14,11,3,0.7857142857142857,0.8531855955678669,shc-gpt-4o,mimiciii,radiology_report,PROMPT1_ICL_entailment
102,190,15,15,0,1.0,17,14,3,0.8235294117647058,0.9032258064516128,shc-gpt-4o,mimiciii,radiology_report,PROMPT1_ICL_entailment
103,191,19,15,4,0.7894736842105263,15,12,3,0.8,0.794701986754967,shc-gpt-4o,mimiciii,radiology_report,PROMPT1_ICL_entailment
104,192,26,24,2,0.9230769230769232,28,22,6,0.7857142857142857,0.8488745980707394,shc-gpt-4o,mimiciii,radiology_report,PROMPT1_ICL_entailment
105,193,16,16,0,1.0,14,14,0,1.0,1.0,shc-gpt-4o,mimiciii,radiology_report,PROMPT1_ICL_entailment
106,194,30,28,2,0.9333333333333332,38,33,5,0.868421052631579,0.8997078870496593,shc-gpt-4o,mimiciii,radiology_report,PROMPT1_ICL_entailment
107,195,19,18,1,0.9473684210526316,21,18,3,0.8571428571428571,0.9,shc-gpt-4o,mimiciii,radiology_report,PROMPT1_ICL_entailment
108,196,18,16,2,0.8888888888888888,18,15,3,0.8333333333333334,0.8602150537634408,shc-gpt-4o,mimiciii,radiology_report,PROMPT1_ICL_entailment
109,197,12,10,2,0.8333333333333334,15,13,2,0.8666666666666667,0.8496732026143791,shc-gpt-4o,mimiciii,radiology_report,PROMPT1_ICL_entailment
110,198,7,7,0,1.0,9,8,1,0.8888888888888888,0.9411764705882352,shc-gpt-4o,mimiciii,radiology_report,PROMPT1_ICL_entailment
111,199,21,18,3,0.8571428571428571,23,20,3,0.8695652173913043,0.8633093525179856,shc-gpt-4o,mimiciii,radiology_report,PROMPT1_ICL_entailment
112,2,17,16,1,0.9411764705882352,15,9,6,0.6,0.7328244274809161,shc-gpt-4o,mimiciii,radiology_report,PROMPT1_ICL_entailment
113,20,20,20,0,1.0,36,33,3,0.9166666666666666,0.9565217391304348,shc-gpt-4o,mimiciii,radiology_report,PROMPT1_ICL_entailment
114,200,16,16,0,1.0,14,13,1,0.9285714285714286,0.962962962962963,shc-gpt-4o,mimiciii,radiology_report,PROMPT1_ICL_entailment
115,201,18,18,0,1.0,18,14,4,0.7777777777777778,0.8750000000000001,shc-gpt-4o,mimiciii,radiology_report,PROMPT1_ICL_entailment
116,202,17,17,0,1.0,24,16,8,0.6666666666666666,0.8,shc-gpt-4o,mimiciii,radiology_report,PROMPT1_ICL_entailment
117,203,25,22,3,0.88,19,18,1,0.9473684210526316,0.912442396313364,shc-gpt-4o,mimiciii,radiology_report,PROMPT1_ICL_entailment
118,204,19,16,3,0.8421052631578947,23,22,1,0.9565217391304348,0.8956743002544529,shc-gpt-4o,mimiciii,radiology_report,PROMPT1_ICL_entailment
119,205,23,22,1,0.9565217391304348,14,13,1,0.9285714285714286,0.942339373970346,shc-gpt-4o,mimiciii,radiology_report,PROMPT1_ICL_entailment
120,206,18,18,0,1.0,13,12,1,0.9230769230769232,0.96,shc-gpt-4o,mimiciii,radiology_report,PROMPT1_ICL_entailment
121,207,9,8,1,0.8888888888888888,9,7,2,0.7777777777777778,0.8296296296296296,shc-gpt-4o,mimiciii,radiology_report,PROMPT1_ICL_entailment
122,208,23,22,1,0.9565217391304348,18,16,2,0.8888888888888888,0.9214659685863874,shc-gpt-4o,mimiciii,radiology_report,PROMPT1_ICL_entailment
123,209,15,14,1,0.9333333333333332,16,16,0,1.0,0.9655172413793104,shc-gpt-4o,mimiciii,radiology_report,PROMPT1_ICL_entailment
124,21,25,23,2,0.92,27,21,6,0.7777777777777778,0.8429319371727749,shc-gpt-4o,mimiciii,radiology_report,PROMPT1_ICL_entailment
125,210,12,11,1,0.9166666666666666,14,8,6,0.5714285714285714,0.7039999999999998,shc-gpt-4o,mimiciii,radiology_report,PROMPT1_ICL_entailment
126,211,12,12,0,1.0,13,12,1,0.9230769230769232,0.96,shc-gpt-4o,mimiciii,radiology_report,PROMPT1_ICL_entailment
127,212,25,21,4,0.84,19,18,1,0.9473684210526316,0.8904593639575972,shc-gpt-4o,mimiciii,radiology_report,PROMPT1_ICL_entailment
128,213,18,18,0,1.0,22,19,3,0.8636363636363636,0.9268292682926828,shc-gpt-4o,mimiciii,radiology_report,PROMPT1_ICL_entailment
129,214,27,21,6,0.7777777777777778,23,19,4,0.8260869565217391,0.8012048192771084,shc-gpt-4o,mimiciii,radiology_report,PROMPT1_ICL_entailment
130,215,11,11,0,1.0,10,8,2,0.8,0.888888888888889,shc-gpt-4o,mimiciii,radiology_report,PROMPT1_ICL_entailment
131,216,19,19,0,1.0,19,16,3,0.8421052631578947,0.9142857142857144,shc-gpt-4o,mimiciii,radiology_report,PROMPT1_ICL_entailment
132,217,18,17,1,0.9444444444444444,20,13,7,0.65,0.7700348432055749,shc-gpt-4o,mimiciii,radiology_report,PROMPT1_ICL_entailment
133,218,16,16,0,1.0,15,12,3,0.8,0.888888888888889,shc-gpt-4o,mimiciii,radiology_report,PROMPT1_ICL_entailment
134,219,15,13,2,0.8666666666666667,13,10,3,0.7692307692307693,0.8150470219435738,shc-gpt-4o,mimiciii,radiology_report,PROMPT1_ICL_entailment
135,22,22,18,4,0.8181818181818182,19,18,1,0.9473684210526316,0.8780487804878049,shc-gpt-4o,mimiciii,radiology_report,PROMPT1_ICL_entailment
136,220,13,13,0,1.0,19,16,3,0.8421052631578947,0.9142857142857144,shc-gpt-4o,mimiciii,radiology_report,PROMPT1_ICL_entailment
137,221,28,24,4,0.8571428571428571,27,23,4,0.8518518518518519,0.8544891640866873,shc-gpt-4o,mimiciii,radiology_report,PROMPT1_ICL_entailment
138,222,15,15,0,1.0,16,12,4,0.75,0.8571428571428571,shc-gpt-4o,mimiciii,radiology_report,PROMPT1_ICL_entailment
139,223,23,22,1,0.9565217391304348,21,19,2,0.9047619047619048,0.9299221357063404,shc-gpt-4o,mimiciii,radiology_report,PROMPT1_ICL_entailment
140,224,28,26,2,0.9285714285714286,17,14,3,0.8235294117647058,0.8729016786570742,shc-gpt-4o,mimiciii,radiology_report,PROMPT1_ICL_entailment
141,225,12,12,0,1.0,11,9,2,0.8181818181818182,0.9,shc-gpt-4o,mimiciii,radiology_report,PROMPT1_ICL_entailment
142,226,14,14,0,1.0,18,16,2,0.8888888888888888,0.9411764705882352,shc-gpt-4o,mimiciii,radiology_report,PROMPT1_ICL_entailment
143,227,21,21,0,1.0,18,15,3,0.8333333333333334,0.9090909090909092,shc-gpt-4o,mimiciii,radiology_report,PROMPT1_ICL_entailment
144,228,16,15,1,0.9375,17,16,1,0.9411764705882352,0.9393346379647748,shc-gpt-4o,mimiciii,radiology_report,PROMPT1_ICL_entailment
145,229,43,41,2,0.9534883720930232,44,36,8,0.8181818181818182,0.8806682577565633,shc-gpt-4o,mimiciii,radiology_report,PROMPT1_ICL_entailment
146,23,17,16,1,0.9411764705882352,15,13,2,0.8666666666666667,0.9023861171366594,shc-gpt-4o,mimiciii,radiology_report,PROMPT1_ICL_entailment
147,230,15,13,2,0.8666666666666667,17,15,2,0.8823529411764706,0.8744394618834082,shc-gpt-4o,mimiciii,radiology_report,PROMPT1_ICL_entailment
148,231,11,11,0,1.0,13,11,2,0.8461538461538461,0.9166666666666666,shc-gpt-4o,mimiciii,radiology_report,PROMPT1_ICL_entailment
149,232,22,19,3,0.8636363636363636,18,15,3,0.8333333333333334,0.8482142857142857,shc-gpt-4o,mimiciii,radiology_report,PROMPT1_ICL_entailment
150,233,17,16,1,0.9411764705882352,17,12,5,0.7058823529411765,0.8067226890756304,shc-gpt-4o,mimiciii,radiology_report,PROMPT1_ICL_entailment
151,234,11,9,2,0.8181818181818182,11,10,1,0.9090909090909092,0.861244019138756,shc-gpt-4o,mimiciii,radiology_report,PROMPT1_ICL_entailment
152,235,17,17,0,1.0,14,12,2,0.8571428571428571,0.923076923076923,shc-gpt-4o,mimiciii,radiology_report,PROMPT1_ICL_entailment
153,236,18,16,2,0.8888888888888888,11,10,1,0.9090909090909092,0.8988764044943819,shc-gpt-4o,mimiciii,radiology_report,PROMPT1_ICL_entailment
154,237,19,19,0,1.0,17,15,2,0.8823529411764706,0.9375,shc-gpt-4o,mimiciii,radiology_report,PROMPT1_ICL_entailment
155,238,19,19,0,1.0,20,18,2,0.9,0.9473684210526316,shc-gpt-4o,mimiciii,radiology_report,PROMPT1_ICL_entailment
156,239,14,14,0,1.0,17,12,5,0.7058823529411765,0.8275862068965517,shc-gpt-4o,mimiciii,radiology_report,PROMPT1_ICL_entailment
157,24,16,16,0,1.0,18,15,3,0.8333333333333334,0.9090909090909092,shc-gpt-4o,mimiciii,radiology_report,PROMPT1_ICL_entailment
158,240,10,10,0,1.0,13,12,1,0.9230769230769232,0.96,shc-gpt-4o,mimiciii,radiology_report,PROMPT1_ICL_entailment
159,241,19,18,1,0.9473684210526316,16,13,3,0.8125,0.874766355140187,shc-gpt-4o,mimiciii,radiology_report,PROMPT1_ICL_entailment
160,242,20,20,0,1.0,18,16,2,0.8888888888888888,0.9411764705882352,shc-gpt-4o,mimiciii,radiology_report,PROMPT1_ICL_entailment
161,243,14,13,1,0.9285714285714286,13,9,4,0.6923076923076923,0.7932203389830509,shc-gpt-4o,mimiciii,radiology_report,PROMPT1_ICL_entailment
162,244,17,17,0,1.0,17,15,2,0.8823529411764706,0.9375,shc-gpt-4o,mimiciii,radiology_report,PROMPT1_ICL_entailment
163,245,27,22,5,0.8148148148148148,28,22,6,0.7857142857142857,0.7999999999999999,shc-gpt-4o,mimiciii,radiology_report,PROMPT1_ICL_entailment
164,246,11,11,0,1.0,12,9,3,0.75,0.8571428571428571,shc-gpt-4o,mimiciii,radiology_report,PROMPT1_ICL_entailment
165,247,13,11,2,0.8461538461538461,12,7,5,0.5833333333333334,0.6905829596412556,shc-gpt-4o,mimiciii,radiology_report,PROMPT1_ICL_entailment
166,248,17,16,1,0.9411764705882352,17,15,2,0.8823529411764706,0.9108159392789372,shc-gpt-4o,mimiciii,radiology_report,PROMPT1_ICL_entailment
167,249,20,15,5,0.75,23,16,7,0.6956521739130435,0.7218045112781954,shc-gpt-4o,mimiciii,radiology_report,PROMPT1_ICL_entailment
168,25,29,26,3,0.896551724137931,27,20,7,0.7407407407407407,0.8112324492979719,shc-gpt-4o,mimiciii,radiology_report,PROMPT1_ICL_entailment
169,250,10,10,0,1.0,8,8,0,1.0,1.0,shc-gpt-4o,mimiciii,radiology_report,PROMPT1_ICL_entailment
170,251,29,25,4,0.8620689655172413,22,20,2,0.9090909090909092,0.8849557522123893,shc-gpt-4o,mimiciii,radiology_report,PROMPT1_ICL_entailment
171,252,11,11,0,1.0,10,9,1,0.9,0.9473684210526316,shc-gpt-4o,mimiciii,radiology_report,PROMPT1_ICL_entailment
172,253,27,24,3,0.8888888888888888,24,21,3,0.875,0.8818897637795274,shc-gpt-4o,mimiciii,radiology_report,PROMPT1_ICL_entailment
173,254,14,14,0,1.0,13,10,3,0.7692307692307693,0.8695652173913044,shc-gpt-4o,mimiciii,radiology_report,PROMPT1_ICL_entailment
174,255,14,13,1,0.9285714285714286,16,14,2,0.875,0.900990099009901,shc-gpt-4o,mimiciii,radiology_report,PROMPT1_ICL_entailment
175,256,17,15,2,0.8823529411764706,19,14,5,0.7368421052631579,0.8030592734225621,shc-gpt-4o,mimiciii,radiology_report,PROMPT1_ICL_entailment
176,257,22,22,0,1.0,15,13,2,0.8666666666666667,0.9285714285714286,shc-gpt-4o,mimiciii,radiology_report,PROMPT1_ICL_entailment
177,258,16,16,0,1.0,20,16,4,0.8,0.888888888888889,shc-gpt-4o,mimiciii,radiology_report,PROMPT1_ICL_entailment
178,259,23,22,1,0.9565217391304348,17,13,4,0.7647058823529411,0.849925705794948,shc-gpt-4o,mimiciii,radiology_report,PROMPT1_ICL_entailment
179,26,18,18,0,1.0,18,14,4,0.7777777777777778,0.8750000000000001,shc-gpt-4o,mimiciii,radiology_report,PROMPT1_ICL_entailment
180,260,20,20,0,1.0,20,12,8,0.6,0.7499999999999999,shc-gpt-4o,mimiciii,radiology_report,PROMPT1_ICL_entailment
181,261,23,20,3,0.8695652173913043,30,27,3,0.9,0.8845208845208845,shc-gpt-4o,mimiciii,radiology_report,PROMPT1_ICL_entailment
182,262,20,19,1,0.95,23,19,4,0.8260869565217391,0.8837209302325583,shc-gpt-4o,mimiciii,radiology_report,PROMPT1_ICL_entailment
183,263,22,20,2,0.9090909090909092,27,23,4,0.8518518518518519,0.8795411089866157,shc-gpt-4o,mimiciii,radiology_report,PROMPT1_ICL_entailment
184,264,21,20,1,0.9523809523809524,20,18,2,0.9,0.9254498714652956,shc-gpt-4o,mimiciii,radiology_report,PROMPT1_ICL_entailment
185,265,12,12,0,1.0,9,9,0,1.0,1.0,shc-gpt-4o,mimiciii,radiology_report,PROMPT1_ICL_entailment
186,266,15,14,1,0.9333333333333332,18,14,4,0.7777777777777778,0.8484848484848485,shc-gpt-4o,mimiciii,radiology_report,PROMPT1_ICL_entailment
187,267,17,17,0,1.0,16,14,2,0.875,0.9333333333333332,shc-gpt-4o,mimiciii,radiology_report,PROMPT1_ICL_entailment
188,268,19,15,4,0.7894736842105263,20,11,9,0.55,0.6483300589390962,shc-gpt-4o,mimiciii,radiology_report,PROMPT1_ICL_entailment
189,269,22,22,0,1.0,25,21,4,0.84,0.9130434782608696,shc-gpt-4o,mimiciii,radiology_report,PROMPT1_ICL_entailment
190,27,17,17,0,1.0,14,12,2,0.8571428571428571,0.923076923076923,shc-gpt-4o,mimiciii,radiology_report,PROMPT1_ICL_entailment
191,270,19,17,2,0.8947368421052632,17,15,2,0.8823529411764706,0.8885017421602787,shc-gpt-4o,mimiciii,radiology_report,PROMPT1_ICL_entailment
192,271,19,19,0,1.0,17,14,3,0.8235294117647058,0.9032258064516128,shc-gpt-4o,mimiciii,radiology_report,PROMPT1_ICL_entailment
193,272,21,21,0,1.0,17,17,0,1.0,1.0,shc-gpt-4o,mimiciii,radiology_report,PROMPT1_ICL_entailment
194,273,14,11,3,0.7857142857142857,12,10,2,0.8333333333333334,0.8088235294117647,shc-gpt-4o,mimiciii,radiology_report,PROMPT1_ICL_entailment
195,274,17,16,1,0.9411764705882352,20,15,5,0.75,0.8347826086956521,shc-gpt-4o,mimiciii,radiology_report,PROMPT1_ICL_entailment
196,275,14,14,0,1.0,12,12,0,1.0,1.0,shc-gpt-4o,mimiciii,radiology_report,PROMPT1_ICL_entailment
197,276,21,21,0,1.0,24,19,5,0.7916666666666666,0.8837209302325582,shc-gpt-4o,mimiciii,radiology_report,PROMPT1_ICL_entailment
198,277,24,21,3,0.875,25,21,4,0.84,0.8571428571428572,shc-gpt-4o,mimiciii,radiology_report,PROMPT1_ICL_entailment
199,278,17,17,0,1.0,16,12,4,0.75,0.8571428571428571,shc-gpt-4o,mimiciii,radiology_report,PROMPT1_ICL_entailment
200,279,13,12,1,0.9230769230769232,10,9,1,0.9,0.9113924050632912,shc-gpt-4o,mimiciii,radiology_report,PROMPT1_ICL_entailment
201,28,28,23,5,0.8214285714285714,30,27,3,0.9,0.8589211618257261,shc-gpt-4o,mimiciii,radiology_report,PROMPT1_ICL_entailment
202,280,16,15,1,0.9375,12,11,1,0.9166666666666666,0.9269662921348316,shc-gpt-4o,mimiciii,radiology_report,PROMPT1_ICL_entailment
203,281,15,14,1,0.9333333333333332,24,14,10,0.5833333333333334,0.7179487179487181,shc-gpt-4o,mimiciii,radiology_report,PROMPT1_ICL_entailment
204,282,16,16,0,1.0,12,12,0,1.0,1.0,shc-gpt-4o,mimiciii,radiology_report,PROMPT1_ICL_entailment
205,283,30,27,3,0.9,25,21,4,0.84,0.8689655172413793,shc-gpt-4o,mimiciii,radiology_report,PROMPT1_ICL_entailment
206,284,16,16,0,1.0,14,12,2,0.8571428571428571,0.923076923076923,shc-gpt-4o,mimiciii,radiology_report,PROMPT1_ICL_entailment
207,285,17,17,0,1.0,18,17,1,0.9444444444444444,0.9714285714285714,shc-gpt-4o,mimiciii,radiology_report,PROMPT1_ICL_entailment
208,286,7,7,0,1.0,6,6,0,1.0,1.0,shc-gpt-4o,mimiciii,radiology_report,PROMPT1_ICL_entailment
209,287,19,19,0,1.0,18,16,2,0.8888888888888888,0.9411764705882352,shc-gpt-4o,mimiciii,radiology_report,PROMPT1_ICL_entailment
210,288,26,21,5,0.8076923076923077,32,25,7,0.78125,0.794251134644478,shc-gpt-4o,mimiciii,radiology_report,PROMPT1_ICL_entailment
211,289,23,23,0,1.0,20,17,3,0.85,0.9189189189189187,shc-gpt-4o,mimiciii,radiology_report,PROMPT1_ICL_entailment
212,29,9,9,0,1.0,8,6,2,0.75,0.8571428571428571,shc-gpt-4o,mimiciii,radiology_report,PROMPT1_ICL_entailment
213,290,13,11,2,0.8461538461538461,11,9,2,0.8181818181818182,0.8319327731092436,shc-gpt-4o,mimiciii,radiology_report,PROMPT1_ICL_entailment
214,291,22,19,3,0.8636363636363636,23,17,6,0.7391304347826086,0.7965474722564735,shc-gpt-4o,mimiciii,radiology_report,PROMPT1_ICL_entailment
215,292,24,21,3,0.875,21,19,2,0.9047619047619048,0.8896321070234113,shc-gpt-4o,mimiciii,radiology_report,PROMPT1_ICL_entailment
216,293,17,17,0,1.0,18,15,3,0.8333333333333334,0.9090909090909092,shc-gpt-4o,mimiciii,radiology_report,PROMPT1_ICL_entailment
217,294,23,20,3,0.8695652173913043,22,20,2,0.9090909090909092,0.888888888888889,shc-gpt-4o,mimiciii,radiology_report,PROMPT1_ICL_entailment
218,295,19,13,6,0.6842105263157895,32,25,7,0.78125,0.7295173961840629,shc-gpt-4o,mimiciii,radiology_report,PROMPT1_ICL_entailment
219,296,17,16,1,0.9411764705882352,17,15,2,0.8823529411764706,0.9108159392789372,shc-gpt-4o,mimiciii,radiology_report,PROMPT1_ICL_entailment
220,297,18,16,2,0.8888888888888888,24,21,3,0.875,0.8818897637795274,shc-gpt-4o,mimiciii,radiology_report,PROMPT1_ICL_entailment
221,298,21,21,0,1.0,20,15,5,0.75,0.8571428571428571,shc-gpt-4o,mimiciii,radiology_report,PROMPT1_ICL_entailment
222,299,26,25,1,0.9615384615384616,28,21,7,0.75,0.8426966292134831,shc-gpt-4o,mimiciii,radiology_report,PROMPT1_ICL_entailment
223,3,20,20,0,1.0,20,17,3,0.85,0.9189189189189187,shc-gpt-4o,mimiciii,radiology_report,PROMPT1_ICL_entailment
224,30,20,16,4,0.8,21,17,4,0.8095238095238095,0.8047337278106509,shc-gpt-4o,mimiciii,radiology_report,PROMPT1_ICL_entailment
225,300,14,14,0,1.0,13,9,4,0.6923076923076923,0.8181818181818181,shc-gpt-4o,mimiciii,radiology_report,PROMPT1_ICL_entailment
226,301,14,14,0,1.0,16,15,1,0.9375,0.967741935483871,shc-gpt-4o,mimiciii,radiology_report,PROMPT1_ICL_entailment
227,302,18,17,1,0.9444444444444444,15,13,2,0.8666666666666667,0.9038854805725972,shc-gpt-4o,mimiciii,radiology_report,PROMPT1_ICL_entailment
228,303,21,20,1,0.9523809523809524,24,21,3,0.875,0.9120521172638436,shc-gpt-4o,mimiciii,radiology_report,PROMPT1_ICL_entailment
229,304,21,19,2,0.9047619047619048,19,17,2,0.8947368421052632,0.8997214484679665,shc-gpt-4o,mimiciii,radiology_report,PROMPT1_ICL_entailment
230,305,22,21,1,0.9545454545454546,24,13,11,0.5416666666666666,0.6911392405063292,shc-gpt-4o,mimiciii,radiology_report,PROMPT1_ICL_entailment
231,306,16,14,2,0.875,14,12,2,0.8571428571428571,0.8659793814432989,shc-gpt-4o,mimiciii,radiology_report,PROMPT1_ICL_entailment
232,307,15,15,0,1.0,17,12,5,0.7058823529411765,0.8275862068965517,shc-gpt-4o,mimiciii,radiology_report,PROMPT1_ICL_entailment
233,308,13,13,0,1.0,15,11,4,0.7333333333333333,0.846153846153846,shc-gpt-4o,mimiciii,radiology_report,PROMPT1_ICL_entailment
234,309,19,19,0,1.0,26,24,2,0.9230769230769232,0.96,shc-gpt-4o,mimiciii,radiology_report,PROMPT1_ICL_entailment
235,31,17,14,3,0.8235294117647058,19,15,4,0.7894736842105263,0.8061420345489443,shc-gpt-4o,mimiciii,radiology_report,PROMPT1_ICL_entailment
236,310,19,18,1,0.9473684210526316,24,20,4,0.8333333333333334,0.8866995073891626,shc-gpt-4o,mimiciii,radiology_report,PROMPT1_ICL_entailment
237,311,13,13,0,1.0,15,14,1,0.9333333333333332,0.9655172413793104,shc-gpt-4o,mimiciii,radiology_report,PROMPT1_ICL_entailment
238,312,21,17,4,0.8095238095238095,18,14,4,0.7777777777777778,0.7933333333333333,shc-gpt-4o,mimiciii,radiology_report,PROMPT1_ICL_entailment
239,313,15,15,0,1.0,17,17,0,1.0,1.0,shc-gpt-4o,mimiciii,radiology_report,PROMPT1_ICL_entailment
240,314,20,20,0,1.0,15,14,1,0.9333333333333332,0.9655172413793104,shc-gpt-4o,mimiciii,radiology_report,PROMPT1_ICL_entailment
241,315,29,24,5,0.8275862068965517,25,19,6,0.76,0.7923544743701129,shc-gpt-4o,mimiciii,radiology_report,PROMPT1_ICL_entailment
242,316,11,11,0,1.0,10,9,1,0.9,0.9473684210526316,shc-gpt-4o,mimiciii,radiology_report,PROMPT1_ICL_entailment
243,317,23,19,4,0.8260869565217391,26,24,2,0.9230769230769232,0.8718929254302104,shc-gpt-4o,mimiciii,radiology_report,PROMPT1_ICL_entailment
244,318,16,15,1,0.9375,21,17,4,0.8095238095238095,0.868824531516184,shc-gpt-4o,mimiciii,radiology_report,PROMPT1_ICL_entailment
245,319,15,15,0,1.0,12,11,1,0.9166666666666666,0.9565217391304348,shc-gpt-4o,mimiciii,radiology_report,PROMPT1_ICL_entailment
246,32,16,14,2,0.875,15,12,3,0.8,0.8358208955223881,shc-gpt-4o,mimiciii,radiology_report,PROMPT1_ICL_entailment
247,320,8,8,0,1.0,11,11,0,1.0,1.0,shc-gpt-4o,mimiciii,radiology_report,PROMPT1_ICL_entailment
248,321,20,20,0,1.0,21,19,2,0.9047619047619048,0.95,shc-gpt-4o,mimiciii,radiology_report,PROMPT1_ICL_entailment
249,322,11,9,2,0.8181818181818182,8,8,0,1.0,0.9,shc-gpt-4o,mimiciii,radiology_report,PROMPT1_ICL_entailment
250,323,22,20,2,0.9090909090909092,25,20,5,0.8,0.8510638297872342,shc-gpt-4o,mimiciii,radiology_report,PROMPT1_ICL_entailment
251,324,24,21,3,0.875,18,15,3,0.8333333333333334,0.8536585365853658,shc-gpt-4o,mimiciii,radiology_report,PROMPT1_ICL_entailment
252,325,21,19,2,0.9047619047619048,22,18,4,0.8181818181818182,0.8592964824120602,shc-gpt-4o,mimiciii,radiology_report,PROMPT1_ICL_entailment
253,326,17,16,1,0.9411764705882352,23,21,2,0.9130434782608696,0.926896551724138,shc-gpt-4o,mimiciii,radiology_report,PROMPT1_ICL_entailment
254,327,10,10,0,1.0,9,8,1,0.8888888888888888,0.9411764705882352,shc-gpt-4o,mimiciii,radiology_report,PROMPT1_ICL_entailment
255,328,18,16,2,0.8888888888888888,17,13,4,0.7647058823529411,0.8221343873517786,shc-gpt-4o,mimiciii,radiology_report,PROMPT1_ICL_entailment
256,329,20,20,0,1.0,24,20,4,0.8333333333333334,0.9090909090909092,shc-gpt-4o,mimiciii,radiology_report,PROMPT1_ICL_entailment
257,33,11,10,1,0.9090909090909092,9,8,1,0.8888888888888888,0.8988764044943819,shc-gpt-4o,mimiciii,radiology_report,PROMPT1_ICL_entailment
258,330,14,13,1,0.9285714285714286,11,10,1,0.9090909090909092,0.9187279151943464,shc-gpt-4o,mimiciii,radiology_report,PROMPT1_ICL_entailment
259,331,12,11,1,0.9166666666666666,15,11,4,0.7333333333333333,0.8148148148148148,shc-gpt-4o,mimiciii,radiology_report,PROMPT1_ICL_entailment
260,332,20,17,3,0.85,20,17,3,0.85,0.85,shc-gpt-4o,mimiciii,radiology_report,PROMPT1_ICL_entailment
261,333,12,12,0,1.0,13,11,2,0.8461538461538461,0.9166666666666666,shc-gpt-4o,mimiciii,radiology_report,PROMPT1_ICL_entailment
262,334,24,23,1,0.9583333333333334,20,19,1,0.95,0.9541484716157206,shc-gpt-4o,mimiciii,radiology_report,PROMPT1_ICL_entailment
263,335,17,17,0,1.0,17,14,3,0.8235294117647058,0.9032258064516128,shc-gpt-4o,mimiciii,radiology_report,PROMPT1_ICL_entailment
264,336,23,23,0,1.0,16,15,1,0.9375,0.967741935483871,shc-gpt-4o,mimiciii,radiology_report,PROMPT1_ICL_entailment
265,337,21,21,0,1.0,16,16,0,1.0,1.0,shc-gpt-4o,mimiciii,radiology_report,PROMPT1_ICL_entailment
266,338,13,13,0,1.0,13,7,6,0.5384615384615384,0.7000000000000001,shc-gpt-4o,mimiciii,radiology_report,PROMPT1_ICL_entailment
267,339,29,26,3,0.896551724137931,28,25,3,0.8928571428571429,0.8947006194081213,shc-gpt-4o,mimiciii,radiology_report,PROMPT1_ICL_entailment
268,34,15,14,1,0.9333333333333332,14,12,2,0.8571428571428571,0.8936170212765957,shc-gpt-4o,mimiciii,radiology_report,PROMPT1_ICL_entailment
269,340,26,15,11,0.5769230769230769,15,11,4,0.7333333333333333,0.6457925636007827,shc-gpt-4o,mimiciii,radiology_report,PROMPT1_ICL_entailment
270,341,7,6,1,0.8571428571428571,6,6,0,1.0,0.923076923076923,shc-gpt-4o,mimiciii,radiology_report,PROMPT1_ICL_entailment
271,342,16,15,1,0.9375,15,15,0,1.0,0.967741935483871,shc-gpt-4o,mimiciii,radiology_report,PROMPT1_ICL_entailment
272,343,22,21,1,0.9545454545454546,22,20,2,0.9090909090909092,0.9312638580931264,shc-gpt-4o,mimiciii,radiology_report,PROMPT1_ICL_entailment
273,344,16,16,0,1.0,19,17,2,0.8947368421052632,0.9444444444444444,shc-gpt-4o,mimiciii,radiology_report,PROMPT1_ICL_entailment
274,345,25,24,1,0.96,22,20,2,0.9090909090909092,0.9338521400778208,shc-gpt-4o,mimiciii,radiology_report,PROMPT1_ICL_entailment
275,346,15,15,0,1.0,15,11,4,0.7333333333333333,0.846153846153846,shc-gpt-4o,mimiciii,radiology_report,PROMPT1_ICL_entailment
276,347,19,19,0,1.0,15,14,1,0.9333333333333332,0.9655172413793104,shc-gpt-4o,mimiciii,radiology_report,PROMPT1_ICL_entailment
277,348,12,11,1,0.9166666666666666,12,10,2,0.8333333333333334,0.8730158730158729,shc-gpt-4o,mimiciii,radiology_report,PROMPT1_ICL_entailment
278,349,17,16,1,0.9411764705882352,16,13,3,0.8125,0.8721174004192872,shc-gpt-4o,mimiciii,radiology_report,PROMPT1_ICL_entailment
279,35,16,15,1,0.9375,21,18,3,0.8571428571428571,0.8955223880597014,shc-gpt-4o,mimiciii,radiology_report,PROMPT1_ICL_entailment
280,350,19,16,3,0.8421052631578947,21,18,3,0.8571428571428571,0.8495575221238938,shc-gpt-4o,mimiciii,radiology_report,PROMPT1_ICL_entailment
281,351,22,17,5,0.7727272727272727,21,17,4,0.8095238095238095,0.7906976744186046,shc-gpt-4o,mimiciii,radiology_report,PROMPT1_ICL_entailment
282,352,14,14,0,1.0,22,17,5,0.7727272727272727,0.8717948717948718,shc-gpt-4o,mimiciii,radiology_report,PROMPT1_ICL_entailment
283,353,19,14,5,0.7368421052631579,23,21,2,0.9130434782608696,0.8155339805825242,shc-gpt-4o,mimiciii,radiology_report,PROMPT1_ICL_entailment
284,354,26,24,2,0.9230769230769232,26,20,6,0.7692307692307693,0.8391608391608392,shc-gpt-4o,mimiciii,radiology_report,PROMPT1_ICL_entailment
285,355,21,18,3,0.8571428571428571,18,15,3,0.8333333333333334,0.8450704225352113,shc-gpt-4o,mimiciii,radiology_report,PROMPT1_ICL_entailment
286,356,19,17,2,0.8947368421052632,22,18,4,0.8181818181818182,0.8547486033519553,shc-gpt-4o,mimiciii,radiology_report,PROMPT1_ICL_entailment
287,357,13,13,0,1.0,15,12,3,0.8,0.888888888888889,shc-gpt-4o,mimiciii,radiology_report,PROMPT1_ICL_entailment
288,358,18,18,0,1.0,12,7,5,0.5833333333333334,0.7368421052631579,shc-gpt-4o,mimiciii,radiology_report,PROMPT1_ICL_entailment
289,359,11,11,0,1.0,18,16,2,0.8888888888888888,0.9411764705882352,shc-gpt-4o,mimiciii,radiology_report,PROMPT1_ICL_entailment
290,36,25,23,2,0.92,22,19,3,0.8636363636363636,0.890927624872579,shc-gpt-4o,mimiciii,radiology_report,PROMPT1_ICL_entailment
291,360,20,18,2,0.9,15,11,4,0.7333333333333333,0.8081632653061224,shc-gpt-4o,mimiciii,radiology_report,PROMPT1_ICL_entailment
292,361,21,19,2,0.9047619047619048,23,19,4,0.8260869565217391,0.8636363636363636,shc-gpt-4o,mimiciii,radiology_report,PROMPT1_ICL_entailment
293,362,25,23,2,0.92,24,17,7,0.7083333333333334,0.8004094165813715,shc-gpt-4o,mimiciii,radiology_report,PROMPT1_ICL_entailment
294,363,24,22,2,0.9166666666666666,22,17,5,0.7727272727272727,0.8385650224215245,shc-gpt-4o,mimiciii,radiology_report,PROMPT1_ICL_entailment
295,364,10,9,1,0.9,11,10,1,0.9090909090909092,0.9045226130653266,shc-gpt-4o,mimiciii,radiology_report,PROMPT1_ICL_entailment
296,365,26,26,0,1.0,29,21,8,0.7241379310344828,0.8400000000000001,shc-gpt-4o,mimiciii,radiology_report,PROMPT1_ICL_entailment
297,366,13,12,1,0.9230769230769232,13,10,3,0.7692307692307693,0.8391608391608392,shc-gpt-4o,mimiciii,radiology_report,PROMPT1_ICL_entailment
298,367,18,15,3,0.8333333333333334,16,13,3,0.8125,0.8227848101265822,shc-gpt-4o,mimiciii,radiology_report,PROMPT1_ICL_entailment
299,368,18,15,3,0.8333333333333334,20,13,7,0.65,0.7303370786516855,shc-gpt-4o,mimiciii,radiology_report,PROMPT1_ICL_entailment
300,369,20,20,0,1.0,20,16,4,0.8,0.888888888888889,shc-gpt-4o,mimiciii,radiology_report,PROMPT1_ICL_entailment
301,37,21,19,2,0.9047619047619048,21,15,6,0.7142857142857143,0.7983193277310925,shc-gpt-4o,mimiciii,radiology_report,PROMPT1_ICL_entailment
302,370,22,18,4,0.8181818181818182,19,14,5,0.7368421052631579,0.7753846153846154,shc-gpt-4o,mimiciii,radiology_report,PROMPT1_ICL_entailment
303,371,14,14,0,1.0,17,16,1,0.9411764705882352,0.9696969696969696,shc-gpt-4o,mimiciii,radiology_report,PROMPT1_ICL_entailment
304,372,23,20,3,0.8695652173913043,27,21,6,0.7777777777777778,0.8211143695014663,shc-gpt-4o,mimiciii,radiology_report,PROMPT1_ICL_entailment
305,373,20,19,1,0.95,23,18,5,0.782608695652174,0.8582183186951067,shc-gpt-4o,mimiciii,radiology_report,PROMPT1_ICL_entailment
306,374,10,10,0,1.0,11,10,1,0.9090909090909092,0.9523809523809524,shc-gpt-4o,mimiciii,radiology_report,PROMPT1_ICL_entailment
307,375,12,12,0,1.0,16,13,3,0.8125,0.896551724137931,shc-gpt-4o,mimiciii,radiology_report,PROMPT1_ICL_entailment
308,376,21,19,2,0.9047619047619048,18,15,3,0.8333333333333334,0.867579908675799,shc-gpt-4o,mimiciii,radiology_report,PROMPT1_ICL_entailment
309,377,13,13,0,1.0,10,9,1,0.9,0.9473684210526316,shc-gpt-4o,mimiciii,radiology_report,PROMPT1_ICL_entailment
310,378,24,19,5,0.7916666666666666,24,18,6,0.75,0.7702702702702704,shc-gpt-4o,mimiciii,radiology_report,PROMPT1_ICL_entailment
311,379,21,21,0,1.0,18,17,1,0.9444444444444444,0.9714285714285714,shc-gpt-4o,mimiciii,radiology_report,PROMPT1_ICL_entailment
312,38,16,14,2,0.875,19,16,3,0.8421052631578947,0.8582375478927203,shc-gpt-4o,mimiciii,radiology_report,PROMPT1_ICL_entailment
313,380,12,12,0,1.0,8,6,2,0.75,0.8571428571428571,shc-gpt-4o,mimiciii,radiology_report,PROMPT1_ICL_entailment
314,381,10,10,0,1.0,14,13,1,0.9285714285714286,0.962962962962963,shc-gpt-4o,mimiciii,radiology_report,PROMPT1_ICL_entailment
315,382,16,15,1,0.9375,13,12,1,0.9230769230769232,0.9302325581395348,shc-gpt-4o,mimiciii,radiology_report,PROMPT1_ICL_entailment
316,383,16,14,2,0.875,17,13,4,0.7647058823529411,0.8161434977578476,shc-gpt-4o,mimiciii,radiology_report,PROMPT1_ICL_entailment
317,384,13,13,0,1.0,13,13,0,1.0,1.0,shc-gpt-4o,mimiciii,radiology_report,PROMPT1_ICL_entailment
318,385,24,22,2,0.9166666666666666,27,22,5,0.8148148148148148,0.8627450980392156,shc-gpt-4o,mimiciii,radiology_report,PROMPT1_ICL_entailment
319,386,21,20,1,0.9523809523809524,18,16,2,0.8888888888888888,0.9195402298850576,shc-gpt-4o,mimiciii,radiology_report,PROMPT1_ICL_entailment
320,387,20,20,0,1.0,19,15,4,0.7894736842105263,0.8823529411764706,shc-gpt-4o,mimiciii,radiology_report,PROMPT1_ICL_entailment
321,388,18,16,2,0.8888888888888888,33,25,8,0.7575757575757576,0.8179959100204498,shc-gpt-4o,mimiciii,radiology_report,PROMPT1_ICL_entailment
322,389,16,16,0,1.0,12,12,0,1.0,1.0,shc-gpt-4o,mimiciii,radiology_report,PROMPT1_ICL_entailment
323,39,13,13,0,1.0,10,8,2,0.8,0.888888888888889,shc-gpt-4o,mimiciii,radiology_report,PROMPT1_ICL_entailment
324,390,14,14,0,1.0,14,13,1,0.9285714285714286,0.962962962962963,shc-gpt-4o,mimiciii,radiology_report,PROMPT1_ICL_entailment
325,391,12,12,0,1.0,13,9,4,0.6923076923076923,0.8181818181818181,shc-gpt-4o,mimiciii,radiology_report,PROMPT1_ICL_entailment
326,392,16,16,0,1.0,15,13,2,0.8666666666666667,0.9285714285714286,shc-gpt-4o,mimiciii,radiology_report,PROMPT1_ICL_entailment
327,393,23,21,2,0.9130434782608696,19,16,3,0.8421052631578947,0.8761408083441982,shc-gpt-4o,mimiciii,radiology_report,PROMPT1_ICL_entailment
328,394,14,14,0,1.0,18,18,0,1.0,1.0,shc-gpt-4o,mimiciii,radiology_report,PROMPT1_ICL_entailment
329,395,15,15,0,1.0,16,12,4,0.75,0.8571428571428571,shc-gpt-4o,mimiciii,radiology_report,PROMPT1_ICL_entailment
330,396,18,17,1,0.9444444444444444,19,15,4,0.7894736842105263,0.8600337268128162,shc-gpt-4o,mimiciii,radiology_report,PROMPT1_ICL_entailment
331,397,16,16,0,1.0,18,12,6,0.6666666666666666,0.8,shc-gpt-4o,mimiciii,radiology_report,PROMPT1_ICL_entailment
332,398,29,27,2,0.9310344827586208,21,19,2,0.9047619047619048,0.9177101967799642,shc-gpt-4o,mimiciii,radiology_report,PROMPT1_ICL_entailment
333,399,17,17,0,1.0,19,16,3,0.8421052631578947,0.9142857142857144,shc-gpt-4o,mimiciii,radiology_report,PROMPT1_ICL_entailment
334,4,18,18,0,1.0,16,14,2,0.875,0.9333333333333332,shc-gpt-4o,mimiciii,radiology_report,PROMPT1_ICL_entailment
335,40,17,15,2,0.8823529411764706,17,12,5,0.7058823529411765,0.784313725490196,shc-gpt-4o,mimiciii,radiology_report,PROMPT1_ICL_entailment
336,400,13,13,0,1.0,13,10,3,0.7692307692307693,0.8695652173913044,shc-gpt-4o,mimiciii,radiology_report,PROMPT1_ICL_entailment
337,401,10,10,0,1.0,9,9,0,1.0,1.0,shc-gpt-4o,mimiciii,radiology_report,PROMPT1_ICL_entailment
338,402,23,18,5,0.782608695652174,20,17,3,0.85,0.81491344873502,shc-gpt-4o,mimiciii,radiology_report,PROMPT1_ICL_entailment
339,403,17,17,0,1.0,18,16,2,0.8888888888888888,0.9411764705882352,shc-gpt-4o,mimiciii,radiology_report,PROMPT1_ICL_entailment
340,404,18,18,0,1.0,19,16,3,0.8421052631578947,0.9142857142857144,shc-gpt-4o,mimiciii,radiology_report,PROMPT1_ICL_entailment
341,405,18,18,0,1.0,14,12,2,0.8571428571428571,0.923076923076923,shc-gpt-4o,mimiciii,radiology_report,PROMPT1_ICL_entailment
342,406,26,25,1,0.9615384615384616,25,20,5,0.8,0.8733624454148472,shc-gpt-4o,mimiciii,radiology_report,PROMPT1_ICL_entailment
343,407,26,23,3,0.8846153846153846,20,17,3,0.85,0.8669623059866962,shc-gpt-4o,mimiciii,radiology_report,PROMPT1_ICL_entailment
344,408,18,17,1,0.9444444444444444,20,15,5,0.75,0.8360655737704917,shc-gpt-4o,mimiciii,radiology_report,PROMPT1_ICL_entailment
345,409,22,21,1,0.9545454545454546,18,15,3,0.8333333333333334,0.8898305084745762,shc-gpt-4o,mimiciii,radiology_report,PROMPT1_ICL_entailment
346,41,25,19,6,0.76,26,20,6,0.7692307692307693,0.7645875251509054,shc-gpt-4o,mimiciii,radiology_report,PROMPT1_ICL_entailment
347,410,21,20,1,0.9523809523809524,20,14,6,0.7,0.8069164265129684,shc-gpt-4o,mimiciii,radiology_report,PROMPT1_ICL_entailment
348,411,9,8,1,0.8888888888888888,6,5,1,0.8333333333333334,0.8602150537634408,shc-gpt-4o,mimiciii,radiology_report,PROMPT1_ICL_entailment
349,412,27,24,3,0.8888888888888888,26,19,7,0.7307692307692307,0.8021108179419524,shc-gpt-4o,mimiciii,radiology_report,PROMPT1_ICL_entailment
350,413,13,13,0,1.0,14,13,1,0.9285714285714286,0.962962962962963,shc-gpt-4o,mimiciii,radiology_report,PROMPT1_ICL_entailment
351,414,21,21,0,1.0,28,24,4,0.8571428571428571,0.923076923076923,shc-gpt-4o,mimiciii,radiology_report,PROMPT1_ICL_entailment
352,415,18,18,0,1.0,20,18,2,0.9,0.9473684210526316,shc-gpt-4o,mimiciii,radiology_report,PROMPT1_ICL_entailment
353,416,19,19,0,1.0,17,15,2,0.8823529411764706,0.9375,shc-gpt-4o,mimiciii,radiology_report,PROMPT1_ICL_entailment
354,417,20,16,4,0.8,20,17,3,0.85,0.8242424242424243,shc-gpt-4o,mimiciii,radiology_report,PROMPT1_ICL_entailment
355,418,14,11,3,0.7857142857142857,14,13,1,0.9285714285714286,0.851190476190476,shc-gpt-4o,mimiciii,radiology_report,PROMPT1_ICL_entailment
356,419,18,15,3,0.8333333333333334,16,14,2,0.875,0.8536585365853658,shc-gpt-4o,mimiciii,radiology_report,PROMPT1_ICL_entailment
357,42,18,18,0,1.0,14,10,4,0.7142857142857143,0.8333333333333333,shc-gpt-4o,mimiciii,radiology_report,PROMPT1_ICL_entailment
358,420,15,13,2,0.8666666666666667,15,11,4,0.7333333333333333,0.7944444444444444,shc-gpt-4o,mimiciii,radiology_report,PROMPT1_ICL_entailment
359,421,22,18,4,0.8181818181818182,23,21,2,0.9130434782608696,0.863013698630137,shc-gpt-4o,mimiciii,radiology_report,PROMPT1_ICL_entailment
360,422,22,21,1,0.9545454545454546,20,19,1,0.95,0.9522673031026252,shc-gpt-4o,mimiciii,radiology_report,PROMPT1_ICL_entailment
361,423,12,12,0,1.0,12,11,1,0.9166666666666666,0.9565217391304348,shc-gpt-4o,mimiciii,radiology_report,PROMPT1_ICL_entailment
362,424,13,12,1,0.9230769230769232,9,9,0,1.0,0.96,shc-gpt-4o,mimiciii,radiology_report,PROMPT1_ICL_entailment
363,425,19,17,2,0.8947368421052632,19,14,5,0.7368421052631579,0.8081494057724957,shc-gpt-4o,mimiciii,radiology_report,PROMPT1_ICL_entailment
364,426,20,19,1,0.95,16,14,2,0.875,0.910958904109589,shc-gpt-4o,mimiciii,radiology_report,PROMPT1_ICL_entailment
365,427,14,14,0,1.0,15,13,2,0.8666666666666667,0.9285714285714286,shc-gpt-4o,mimiciii,radiology_report,PROMPT1_ICL_entailment
366,428,10,10,0,1.0,15,10,5,0.6666666666666666,0.8,shc-gpt-4o,mimiciii,radiology_report,PROMPT1_ICL_entailment
367,429,17,16,1,0.9411764705882352,13,11,2,0.8461538461538461,0.8911392405063291,shc-gpt-4o,mimiciii,radiology_report,PROMPT1_ICL_entailment
368,43,8,8,0,1.0,7,6,1,0.8571428571428571,0.923076923076923,shc-gpt-4o,mimiciii,radiology_report,PROMPT1_ICL_entailment
369,430,8,8,0,1.0,7,6,1,0.8571428571428571,0.923076923076923,shc-gpt-4o,mimiciii,radiology_report,PROMPT1_ICL_entailment
370,431,13,9,4,0.6923076923076923,18,15,3,0.8333333333333334,0.7563025210084034,shc-gpt-4o,mimiciii,radiology_report,PROMPT1_ICL_entailment
371,432,21,20,1,0.9523809523809524,13,12,1,0.9230769230769232,0.9375,shc-gpt-4o,mimiciii,radiology_report,PROMPT1_ICL_entailment
372,433,15,15,0,1.0,18,14,4,0.7777777777777778,0.8750000000000001,shc-gpt-4o,mimiciii,radiology_report,PROMPT1_ICL_entailment
373,434,28,27,1,0.9642857142857144,27,21,6,0.7777777777777778,0.8610478359908884,shc-gpt-4o,mimiciii,radiology_report,PROMPT1_ICL_entailment
374,435,13,13,0,1.0,13,13,0,1.0,1.0,shc-gpt-4o,mimiciii,radiology_report,PROMPT1_ICL_entailment
375,436,24,24,0,1.0,25,25,0,1.0,1.0,shc-gpt-4o,mimiciii,radiology_report,PROMPT1_ICL_entailment
376,437,10,10,0,1.0,7,7,0,1.0,1.0,shc-gpt-4o,mimiciii,radiology_report,PROMPT1_ICL_entailment
377,438,17,14,3,0.8235294117647058,19,16,3,0.8421052631578947,0.83271375464684,shc-gpt-4o,mimiciii,radiology_report,PROMPT1_ICL_entailment
378,439,22,18,4,0.8181818181818182,22,19,3,0.8636363636363636,0.8402948402948404,shc-gpt-4o,mimiciii,radiology_report,PROMPT1_ICL_entailment
379,44,15,15,0,1.0,16,11,5,0.6875,0.8148148148148148,shc-gpt-4o,mimiciii,radiology_report,PROMPT1_ICL_entailment
380,440,18,17,1,0.9444444444444444,19,12,7,0.631578947368421,0.7569573283858998,shc-gpt-4o,mimiciii,radiology_report,PROMPT1_ICL_entailment
381,441,19,15,4,0.7894736842105263,17,17,0,1.0,0.8823529411764706,shc-gpt-4o,mimiciii,radiology_report,PROMPT1_ICL_entailment
382,442,14,13,1,0.9285714285714286,12,9,3,0.75,0.8297872340425532,shc-gpt-4o,mimiciii,radiology_report,PROMPT1_ICL_entailment
383,443,19,15,4,0.7894736842105263,21,15,6,0.7142857142857143,0.7500000000000001,shc-gpt-4o,mimiciii,radiology_report,PROMPT1_ICL_entailment
384,444,11,10,1,0.9090909090909092,8,6,2,0.75,0.821917808219178,shc-gpt-4o,mimiciii,radiology_report,PROMPT1_ICL_entailment
385,445,23,19,4,0.8260869565217391,22,19,3,0.8636363636363636,0.8444444444444444,shc-gpt-4o,mimiciii,radiology_report,PROMPT1_ICL_entailment
386,446,27,23,4,0.8518518518518519,22,18,4,0.8181818181818182,0.8346774193548387,shc-gpt-4o,mimiciii,radiology_report,PROMPT1_ICL_entailment
387,447,18,18,0,1.0,14,13,1,0.9285714285714286,0.962962962962963,shc-gpt-4o,mimiciii,radiology_report,PROMPT1_ICL_entailment
388,448,29,28,1,0.9655172413793104,36,29,7,0.8055555555555556,0.8783126014061655,shc-gpt-4o,mimiciii,radiology_report,PROMPT1_ICL_entailment
389,449,15,15,0,1.0,9,8,1,0.8888888888888888,0.9411764705882352,shc-gpt-4o,mimiciii,radiology_report,PROMPT1_ICL_entailment
390,45,17,16,1,0.9411764705882352,20,16,4,0.8,0.8648648648648648,shc-gpt-4o,mimiciii,radiology_report,PROMPT1_ICL_entailment
391,450,20,17,3,0.85,21,20,1,0.9523809523809524,0.8982826948480845,shc-gpt-4o,mimiciii,radiology_report,PROMPT1_ICL_entailment
392,451,12,12,0,1.0,10,10,0,1.0,1.0,shc-gpt-4o,mimiciii,radiology_report,PROMPT1_ICL_entailment
393,452,16,16,0,1.0,16,15,1,0.9375,0.967741935483871,shc-gpt-4o,mimiciii,radiology_report,PROMPT1_ICL_entailment
394,453,18,17,1,0.9444444444444444,14,13,1,0.9285714285714286,0.9364406779661016,shc-gpt-4o,mimiciii,radiology_report,PROMPT1_ICL_entailment
395,454,11,9,2,0.8181818181818182,10,6,4,0.6,0.6923076923076923,shc-gpt-4o,mimiciii,radiology_report,PROMPT1_ICL_entailment
396,455,16,16,0,1.0,16,16,0,1.0,1.0,shc-gpt-4o,mimiciii,radiology_report,PROMPT1_ICL_entailment
397,456,16,15,1,0.9375,21,18,3,0.8571428571428571,0.8955223880597014,shc-gpt-4o,mimiciii,radiology_report,PROMPT1_ICL_entailment
398,457,15,15,0,1.0,12,9,3,0.75,0.8571428571428571,shc-gpt-4o,mimiciii,radiology_report,PROMPT1_ICL_entailment
399,458,17,17,0,1.0,16,16,0,1.0,1.0,shc-gpt-4o,mimiciii,radiology_report,PROMPT1_ICL_entailment
400,459,16,15,1,0.9375,13,10,3,0.7692307692307693,0.8450704225352113,shc-gpt-4o,mimiciii,radiology_report,PROMPT1_ICL_entailment
401,46,15,15,0,1.0,22,14,8,0.6363636363636364,0.7777777777777778,shc-gpt-4o,mimiciii,radiology_report,PROMPT1_ICL_entailment
402,460,21,20,1,0.9523809523809524,20,16,4,0.8,0.8695652173913043,shc-gpt-4o,mimiciii,radiology_report,PROMPT1_ICL_entailment
403,461,18,15,3,0.8333333333333334,22,15,7,0.6818181818181818,0.7499999999999999,shc-gpt-4o,mimiciii,radiology_report,PROMPT1_ICL_entailment
404,462,26,24,2,0.9230769230769232,20,17,3,0.85,0.8850325379609545,shc-gpt-4o,mimiciii,radiology_report,PROMPT1_ICL_entailment
405,463,14,14,0,1.0,12,12,0,1.0,1.0,shc-gpt-4o,mimiciii,radiology_report,PROMPT1_ICL_entailment
406,464,23,20,3,0.8695652173913043,25,22,3,0.88,0.874751491053678,shc-gpt-4o,mimiciii,radiology_report,PROMPT1_ICL_entailment
407,465,25,24,1,0.96,33,27,6,0.8181818181818182,0.8834355828220859,shc-gpt-4o,mimiciii,radiology_report,PROMPT1_ICL_entailment
408,466,22,21,1,0.9545454545454546,22,20,2,0.9090909090909092,0.9312638580931264,shc-gpt-4o,mimiciii,radiology_report,PROMPT1_ICL_entailment
409,467,12,12,0,1.0,14,14,0,1.0,1.0,shc-gpt-4o,mimiciii,radiology_report,PROMPT1_ICL_entailment
410,468,19,19,0,1.0,18,14,4,0.7777777777777778,0.8750000000000001,shc-gpt-4o,mimiciii,radiology_report,PROMPT1_ICL_entailment
411,469,22,20,2,0.9090909090909092,25,21,4,0.84,0.8731808731808731,shc-gpt-4o,mimiciii,radiology_report,PROMPT1_ICL_entailment
412,47,16,16,0,1.0,15,13,2,0.8666666666666667,0.9285714285714286,shc-gpt-4o,mimiciii,radiology_report,PROMPT1_ICL_entailment
413,470,12,12,0,1.0,15,12,3,0.8,0.888888888888889,shc-gpt-4o,mimiciii,radiology_report,PROMPT1_ICL_entailment
414,471,20,18,2,0.9,18,15,3,0.8333333333333334,0.8653846153846153,shc-gpt-4o,mimiciii,radiology_report,PROMPT1_ICL_entailment
415,472,14,14,0,1.0,16,13,3,0.8125,0.896551724137931,shc-gpt-4o,mimiciii,radiology_report,PROMPT1_ICL_entailment
416,473,14,14,0,1.0,11,11,0,1.0,1.0,shc-gpt-4o,mimiciii,radiology_report,PROMPT1_ICL_entailment
417,474,22,19,3,0.8636363636363636,25,20,5,0.8,0.8306010928961749,shc-gpt-4o,mimiciii,radiology_report,PROMPT1_ICL_entailment
418,475,7,7,0,1.0,7,6,1,0.8571428571428571,0.923076923076923,shc-gpt-4o,mimiciii,radiology_report,PROMPT1_ICL_entailment
419,476,18,18,0,1.0,12,12,0,1.0,1.0,shc-gpt-4o,mimiciii,radiology_report,PROMPT1_ICL_entailment
420,477,19,16,3,0.8421052631578947,16,15,1,0.9375,0.8872458410351202,shc-gpt-4o,mimiciii,radiology_report,PROMPT1_ICL_entailment
421,478,20,18,2,0.9,21,16,5,0.7619047619047619,0.8252148997134672,shc-gpt-4o,mimiciii,radiology_report,PROMPT1_ICL_entailment
422,479,14,14,0,1.0,22,18,4,0.8181818181818182,0.9,shc-gpt-4o,mimiciii,radiology_report,PROMPT1_ICL_entailment
423,48,16,15,1,0.9375,21,16,5,0.7619047619047619,0.8406304728546409,shc-gpt-4o,mimiciii,radiology_report,PROMPT1_ICL_entailment
424,480,11,9,2,0.8181818181818182,10,7,3,0.7,0.7544910179640719,shc-gpt-4o,mimiciii,radiology_report,PROMPT1_ICL_entailment
425,481,17,17,0,1.0,17,13,4,0.7647058823529411,0.8666666666666666,shc-gpt-4o,mimiciii,radiology_report,PROMPT1_ICL_entailment
426,482,23,23,0,1.0,19,17,2,0.8947368421052632,0.9444444444444444,shc-gpt-4o,mimiciii,radiology_report,PROMPT1_ICL_entailment
427,483,22,22,0,1.0,23,20,3,0.8695652173913043,0.9302325581395348,shc-gpt-4o,mimiciii,radiology_report,PROMPT1_ICL_entailment
428,484,12,12,0,1.0,13,11,2,0.8461538461538461,0.9166666666666666,shc-gpt-4o,mimiciii,radiology_report,PROMPT1_ICL_entailment
429,485,18,17,1,0.9444444444444444,24,19,5,0.7916666666666666,0.8613333333333333,shc-gpt-4o,mimiciii,radiology_report,PROMPT1_ICL_entailment
430,486,18,17,1,0.9444444444444444,11,9,2,0.8181818181818182,0.8767908309455588,shc-gpt-4o,mimiciii,radiology_report,PROMPT1_ICL_entailment
431,487,23,20,3,0.8695652173913043,20,16,4,0.8,0.8333333333333333,shc-gpt-4o,mimiciii,radiology_report,PROMPT1_ICL_entailment
432,488,15,14,1,0.9333333333333332,15,12,3,0.8,0.8615384615384616,shc-gpt-4o,mimiciii,radiology_report,PROMPT1_ICL_entailment
433,489,23,22,1,0.9565217391304348,18,15,3,0.8333333333333334,0.8906882591093118,shc-gpt-4o,mimiciii,radiology_report,PROMPT1_ICL_entailment
434,49,22,22,0,1.0,24,20,4,0.8333333333333334,0.9090909090909092,shc-gpt-4o,mimiciii,radiology_report,PROMPT1_ICL_entailment
435,490,10,9,1,0.9,8,5,3,0.625,0.7377049180327869,shc-gpt-4o,mimiciii,radiology_report,PROMPT1_ICL_entailment
436,491,16,16,0,1.0,17,14,3,0.8235294117647058,0.9032258064516128,shc-gpt-4o,mimiciii,radiology_report,PROMPT1_ICL_entailment
437,492,15,15,0,1.0,13,11,2,0.8461538461538461,0.9166666666666666,shc-gpt-4o,mimiciii,radiology_report,PROMPT1_ICL_entailment
438,493,16,16,0,1.0,9,8,1,0.8888888888888888,0.9411764705882352,shc-gpt-4o,mimiciii,radiology_report,PROMPT1_ICL_entailment
439,494,11,10,1,0.9090909090909092,8,7,1,0.875,0.8917197452229298,shc-gpt-4o,mimiciii,radiology_report,PROMPT1_ICL_entailment
440,495,14,14,0,1.0,12,12,0,1.0,1.0,shc-gpt-4o,mimiciii,radiology_report,PROMPT1_ICL_entailment
441,496,29,29,0,1.0,32,23,9,0.71875,0.8363636363636363,shc-gpt-4o,mimiciii,radiology_report,PROMPT1_ICL_entailment
442,497,20,17,3,0.85,22,18,4,0.8181818181818182,0.8337874659400545,shc-gpt-4o,mimiciii,radiology_report,PROMPT1_ICL_entailment
443,498,21,20,1,0.9523809523809524,22,19,3,0.8636363636363636,0.9058402860548272,shc-gpt-4o,mimiciii,radiology_report,PROMPT1_ICL_entailment
444,499,18,18,0,1.0,17,16,1,0.9411764705882352,0.9696969696969696,shc-gpt-4o,mimiciii,radiology_report,PROMPT1_ICL_entailment
445,5,15,15,0,1.0,22,15,7,0.6818181818181818,0.8108108108108109,shc-gpt-4o,mimiciii,radiology_report,PROMPT1_ICL_entailment
446,50,18,16,2,0.8888888888888888,15,10,5,0.6666666666666666,0.761904761904762,shc-gpt-4o,mimiciii,radiology_report,PROMPT1_ICL_entailment
447,51,14,13,1,0.9285714285714286,13,10,3,0.7692307692307693,0.8414239482200646,shc-gpt-4o,mimiciii,radiology_report,PROMPT1_ICL_entailment
448,52,17,17,0,1.0,21,18,3,0.8571428571428571,0.923076923076923,shc-gpt-4o,mimiciii,radiology_report,PROMPT1_ICL_entailment
449,53,13,12,1,0.9230769230769232,12,10,2,0.8333333333333334,0.8759124087591241,shc-gpt-4o,mimiciii,radiology_report,PROMPT1_ICL_entailment
450,54,11,11,0,1.0,10,6,4,0.6,0.7499999999999999,shc-gpt-4o,mimiciii,radiology_report,PROMPT1_ICL_entailment
451,55,18,18,0,1.0,18,14,4,0.7777777777777778,0.8750000000000001,shc-gpt-4o,mimiciii,radiology_report,PROMPT1_ICL_entailment
452,56,14,13,1,0.9285714285714286,21,14,7,0.6666666666666666,0.7761194029850746,shc-gpt-4o,mimiciii,radiology_report,PROMPT1_ICL_entailment
453,57,10,10,0,1.0,10,9,1,0.9,0.9473684210526316,shc-gpt-4o,mimiciii,radiology_report,PROMPT1_ICL_entailment
454,58,12,11,1,0.9166666666666666,16,12,4,0.75,0.8250000000000001,shc-gpt-4o,mimiciii,radiology_report,PROMPT1_ICL_entailment
455,59,16,16,0,1.0,16,14,2,0.875,0.9333333333333332,shc-gpt-4o,mimiciii,radiology_report,PROMPT1_ICL_entailment
456,6,10,9,1,0.9,8,6,2,0.75,0.8181818181818182,shc-gpt-4o,mimiciii,radiology_report,PROMPT1_ICL_entailment
457,60,19,19,0,1.0,19,16,3,0.8421052631578947,0.9142857142857144,shc-gpt-4o,mimiciii,radiology_report,PROMPT1_ICL_entailment
458,61,19,19,0,1.0,22,19,3,0.8636363636363636,0.9268292682926828,shc-gpt-4o,mimiciii,radiology_report,PROMPT1_ICL_entailment
459,62,16,16,0,1.0,13,10,3,0.7692307692307693,0.8695652173913044,shc-gpt-4o,mimiciii,radiology_report,PROMPT1_ICL_entailment
460,63,14,14,0,1.0,15,12,3,0.8,0.888888888888889,shc-gpt-4o,mimiciii,radiology_report,PROMPT1_ICL_entailment
461,64,26,23,3,0.8846153846153846,20,19,1,0.95,0.9161425576519916,shc-gpt-4o,mimiciii,radiology_report,PROMPT1_ICL_entailment
462,65,19,18,1,0.9473684210526316,18,15,3,0.8333333333333334,0.8866995073891626,shc-gpt-4o,mimiciii,radiology_report,PROMPT1_ICL_entailment
463,66,20,19,1,0.95,29,23,6,0.7931034482758621,0.864490603363007,shc-gpt-4o,mimiciii,radiology_report,PROMPT1_ICL_entailment
464,67,26,24,2,0.9230769230769232,28,24,4,0.8571428571428571,0.888888888888889,shc-gpt-4o,mimiciii,radiology_report,PROMPT1_ICL_entailment
465,68,28,26,2,0.9285714285714286,30,22,8,0.7333333333333333,0.8194842406876792,shc-gpt-4o,mimiciii,radiology_report,PROMPT1_ICL_entailment
466,69,20,19,1,0.95,31,28,3,0.9032258064516128,0.926022628372498,shc-gpt-4o,mimiciii,radiology_report,PROMPT1_ICL_entailment
467,7,13,13,0,1.0,16,14,2,0.875,0.9333333333333332,shc-gpt-4o,mimiciii,radiology_report,PROMPT1_ICL_entailment
468,70,8,8,0,1.0,17,14,3,0.8235294117647058,0.9032258064516128,shc-gpt-4o,mimiciii,radiology_report,PROMPT1_ICL_entailment
469,71,18,15,3,0.8333333333333334,18,15,3,0.8333333333333334,0.8333333333333334,shc-gpt-4o,mimiciii,radiology_report,PROMPT1_ICL_entailment
470,72,14,14,0,1.0,13,12,1,0.9230769230769232,0.96,shc-gpt-4o,mimiciii,radiology_report,PROMPT1_ICL_entailment
471,73,21,21,0,1.0,29,22,7,0.7586206896551724,0.8627450980392156,shc-gpt-4o,mimiciii,radiology_report,PROMPT1_ICL_entailment
472,74,21,19,2,0.9047619047619048,18,15,3,0.8333333333333334,0.867579908675799,shc-gpt-4o,mimiciii,radiology_report,PROMPT1_ICL_entailment
473,75,17,16,1,0.9411764705882352,12,12,0,1.0,0.9696969696969696,shc-gpt-4o,mimiciii,radiology_report,PROMPT1_ICL_entailment
474,76,14,12,2,0.8571428571428571,14,12,2,0.8571428571428571,0.8571428571428571,shc-gpt-4o,mimiciii,radiology_report,PROMPT1_ICL_entailment
475,77,26,19,7,0.7307692307692307,26,20,6,0.7692307692307693,0.7495069033530571,shc-gpt-4o,mimiciii,radiology_report,PROMPT1_ICL_entailment
476,78,25,17,8,0.68,33,28,5,0.8484848484848485,0.7549563838223632,shc-gpt-4o,mimiciii,radiology_report,PROMPT1_ICL_entailment
477,79,17,17,0,1.0,17,15,2,0.8823529411764706,0.9375,shc-gpt-4o,mimiciii,radiology_report,PROMPT1_ICL_entailment
478,8,20,19,1,0.95,15,14,1,0.9333333333333332,0.9415929203539822,shc-gpt-4o,mimiciii,radiology_report,PROMPT1_ICL_entailment
479,80,21,18,3,0.8571428571428571,25,21,4,0.84,0.8484848484848485,shc-gpt-4o,mimiciii,radiology_report,PROMPT1_ICL_entailment
480,81,23,23,0,1.0,15,13,2,0.8666666666666667,0.9285714285714286,shc-gpt-4o,mimiciii,radiology_report,PROMPT1_ICL_entailment
481,82,16,14,2,0.875,14,13,1,0.9285714285714286,0.900990099009901,shc-gpt-4o,mimiciii,radiology_report,PROMPT1_ICL_entailment
482,83,24,21,3,0.875,17,15,2,0.8823529411764706,0.8786610878661087,shc-gpt-4o,mimiciii,radiology_report,PROMPT1_ICL_entailment
483,84,17,16,1,0.9411764705882352,20,17,3,0.85,0.8932676518883416,shc-gpt-4o,mimiciii,radiology_report,PROMPT1_ICL_entailment
484,85,16,15,1,0.9375,14,14,0,1.0,0.967741935483871,shc-gpt-4o,mimiciii,radiology_report,PROMPT1_ICL_entailment
485,86,16,16,0,1.0,10,10,0,1.0,1.0,shc-gpt-4o,mimiciii,radiology_report,PROMPT1_ICL_entailment
486,87,15,15,0,1.0,14,11,3,0.7857142857142857,0.88,shc-gpt-4o,mimiciii,radiology_report,PROMPT1_ICL_entailment
487,88,18,18,0,1.0,19,19,0,1.0,1.0,shc-gpt-4o,mimiciii,radiology_report,PROMPT1_ICL_entailment
488,89,20,20,0,1.0,18,16,2,0.8888888888888888,0.9411764705882352,shc-gpt-4o,mimiciii,radiology_report,PROMPT1_ICL_entailment
489,9,12,12,0,1.0,13,11,2,0.8461538461538461,0.9166666666666666,shc-gpt-4o,mimiciii,radiology_report,PROMPT1_ICL_entailment
490,90,14,14,0,1.0,14,12,2,0.8571428571428571,0.923076923076923,shc-gpt-4o,mimiciii,radiology_report,PROMPT1_ICL_entailment
491,91,17,16,1,0.9411764705882352,13,10,3,0.7692307692307693,0.8465608465608465,shc-gpt-4o,mimiciii,radiology_report,PROMPT1_ICL_entailment
492,92,19,19,0,1.0,21,14,7,0.6666666666666666,0.8,shc-gpt-4o,mimiciii,radiology_report,PROMPT1_ICL_entailment
493,93,18,18,0,1.0,15,13,2,0.8666666666666667,0.9285714285714286,shc-gpt-4o,mimiciii,radiology_report,PROMPT1_ICL_entailment
494,94,25,20,5,0.8,28,22,6,0.7857142857142857,0.7927927927927927,shc-gpt-4o,mimiciii,radiology_report,PROMPT1_ICL_entailment
495,95,19,19,0,1.0,18,9,9,0.5,0.6666666666666666,shc-gpt-4o,mimiciii,radiology_report,PROMPT1_ICL_entailment
496,96,16,16,0,1.0,21,15,6,0.7142857142857143,0.8333333333333333,shc-gpt-4o,mimiciii,radiology_report,PROMPT1_ICL_entailment
497,97,15,13,2,0.8666666666666667,23,18,5,0.782608695652174,0.8224956063268895,shc-gpt-4o,mimiciii,radiology_report,PROMPT1_ICL_entailment
498,98,25,20,5,0.8,19,16,3,0.8421052631578947,0.8205128205128205,shc-gpt-4o,mimiciii,radiology_report,PROMPT1_ICL_entailment
499,99,20,18,2,0.9,13,12,1,0.9230769230769232,0.9113924050632912,shc-gpt-4o,mimiciii,radiology_report,PROMPT1_ICL_entailment
0,0,25,22,3,0.88,21,14,7,0.6666666666666666,0.7586206896551725,shc-gpt-4o,mimiciii,radiology_report,PROMPT2_ICL_entailment
1,1,17,17,0,1.0,15,13,2,0.8666666666666667,0.9285714285714286,shc-gpt-4o,mimiciii,radiology_report,PROMPT2_ICL_entailment
2,10,15,11,4,0.7333333333333333,18,15,3,0.8333333333333334,0.7801418439716311,shc-gpt-4o,mimiciii,radiology_report,PROMPT2_ICL_entailment
3,100,14,14,0,1.0,9,9,0,1.0,1.0,shc-gpt-4o,mimiciii,radiology_report,PROMPT2_ICL_entailment
4,101,21,21,0,1.0,15,10,5,0.6666666666666666,0.8,shc-gpt-4o,mimiciii,radiology_report,PROMPT2_ICL_entailment
5,102,15,15,0,1.0,16,13,3,0.8125,0.896551724137931,shc-gpt-4o,mimiciii,radiology_report,PROMPT2_ICL_entailment
6,103,19,17,2,0.8947368421052632,19,17,2,0.8947368421052632,0.8947368421052632,shc-gpt-4o,mimiciii,radiology_report,PROMPT2_ICL_entailment
7,104,20,19,1,0.95,17,14,3,0.8235294117647058,0.8822553897180762,shc-gpt-4o,mimiciii,radiology_report,PROMPT2_ICL_entailment
8,105,6,6,0,1.0,8,6,2,0.75,0.8571428571428571,shc-gpt-4o,mimiciii,radiology_report,PROMPT2_ICL_entailment
9,106,13,13,0,1.0,12,9,3,0.75,0.8571428571428571,shc-gpt-4o,mimiciii,radiology_report,PROMPT2_ICL_entailment
10,107,22,19,3,0.8636363636363636,19,13,6,0.6842105263157895,0.7635239567233385,shc-gpt-4o,mimiciii,radiology_report,PROMPT2_ICL_entailment
11,108,21,19,2,0.9047619047619048,13,11,2,0.8461538461538461,0.8744769874476986,shc-gpt-4o,mimiciii,radiology_report,PROMPT2_ICL_entailment
12,109,19,15,4,0.7894736842105263,20,17,3,0.85,0.8186195826645265,shc-gpt-4o,mimiciii,radiology_report,PROMPT2_ICL_entailment
13,11,18,18,0,1.0,20,16,4,0.8,0.888888888888889,shc-gpt-4o,mimiciii,radiology_report,PROMPT2_ICL_entailment
14,110,20,20,0,1.0,17,14,3,0.8235294117647058,0.9032258064516128,shc-gpt-4o,mimiciii,radiology_report,PROMPT2_ICL_entailment
15,111,20,20,0,1.0,20,17,3,0.85,0.9189189189189187,shc-gpt-4o,mimiciii,radiology_report,PROMPT2_ICL_entailment
16,112,17,17,0,1.0,14,14,0,1.0,1.0,shc-gpt-4o,mimiciii,radiology_report,PROMPT2_ICL_entailment
17,113,22,14,8,0.6363636363636364,20,14,6,0.7,0.6666666666666666,shc-gpt-4o,mimiciii,radiology_report,PROMPT2_ICL_entailment
18,114,18,11,7,0.6111111111111112,23,15,8,0.6521739130434783,0.6309751434034417,shc-gpt-4o,mimiciii,radiology_report,PROMPT2_ICL_entailment
19,115,18,18,0,1.0,20,16,4,0.8,0.888888888888889,shc-gpt-4o,mimiciii,radiology_report,PROMPT2_ICL_entailment
20,116,14,14,0,1.0,13,13,0,1.0,1.0,shc-gpt-4o,mimiciii,radiology_report,PROMPT2_ICL_entailment
21,117,18,16,2,0.8888888888888888,16,12,4,0.75,0.8135593220338982,shc-gpt-4o,mimiciii,radiology_report,PROMPT2_ICL_entailment
22,118,21,20,1,0.9523809523809524,24,20,4,0.8333333333333334,0.888888888888889,shc-gpt-4o,mimiciii,radiology_report,PROMPT2_ICL_entailment
23,119,19,19,0,1.0,17,12,5,0.7058823529411765,0.8275862068965517,shc-gpt-4o,mimiciii,radiology_report,PROMPT2_ICL_entailment
24,12,18,18,0,1.0,17,13,4,0.7647058823529411,0.8666666666666666,shc-gpt-4o,mimiciii,radiology_report,PROMPT2_ICL_entailment
25,120,23,21,2,0.9130434782608696,16,11,5,0.6875,0.7843803056027164,shc-gpt-4o,mimiciii,radiology_report,PROMPT2_ICL_entailment
26,121,27,21,6,0.7777777777777778,26,20,6,0.7692307692307693,0.7734806629834255,shc-gpt-4o,mimiciii,radiology_report,PROMPT2_ICL_entailment
27,122,18,17,1,0.9444444444444444,20,16,4,0.8,0.8662420382165604,shc-gpt-4o,mimiciii,radiology_report,PROMPT2_ICL_entailment
28,123,15,15,0,1.0,13,12,1,0.9230769230769232,0.96,shc-gpt-4o,mimiciii,radiology_report,PROMPT2_ICL_entailment
29,124,13,12,1,0.9230769230769232,12,7,5,0.5833333333333334,0.7148936170212767,shc-gpt-4o,mimiciii,radiology_report,PROMPT2_ICL_entailment
30,125,22,21,1,0.9545454545454546,23,16,7,0.6956521739130435,0.8047904191616767,shc-gpt-4o,mimiciii,radiology_report,PROMPT2_ICL_entailment
31,126,10,10,0,1.0,9,7,2,0.7777777777777778,0.8750000000000001,shc-gpt-4o,mimiciii,radiology_report,PROMPT2_ICL_entailment
32,127,43,40,3,0.9302325581395348,43,32,11,0.7441860465116279,0.82687338501292,shc-gpt-4o,mimiciii,radiology_report,PROMPT2_ICL_entailment
33,128,13,13,0,1.0,14,11,3,0.7857142857142857,0.88,shc-gpt-4o,mimiciii,radiology_report,PROMPT2_ICL_entailment
34,129,17,17,0,1.0,16,12,4,0.75,0.8571428571428571,shc-gpt-4o,mimiciii,radiology_report,PROMPT2_ICL_entailment
35,13,22,16,6,0.7272727272727273,17,17,0,1.0,0.8421052631578948,shc-gpt-4o,mimiciii,radiology_report,PROMPT2_ICL_entailment
36,130,22,21,1,0.9545454545454546,25,16,9,0.64,0.766248574686431,shc-gpt-4o,mimiciii,radiology_report,PROMPT2_ICL_entailment
37,131,14,11,3,0.7857142857142857,32,24,8,0.75,0.7674418604651163,shc-gpt-4o,mimiciii,radiology_report,PROMPT2_ICL_entailment
38,132,20,16,4,0.8,23,15,8,0.6521739130434783,0.718562874251497,shc-gpt-4o,mimiciii,radiology_report,PROMPT2_ICL_entailment
39,133,16,16,0,1.0,21,15,6,0.7142857142857143,0.8333333333333333,shc-gpt-4o,mimiciii,radiology_report,PROMPT2_ICL_entailment
40,134,21,15,6,0.7142857142857143,23,16,7,0.6956521739130435,0.7048458149779735,shc-gpt-4o,mimiciii,radiology_report,PROMPT2_ICL_entailment
41,135,18,17,1,0.9444444444444444,20,15,5,0.75,0.8360655737704917,shc-gpt-4o,mimiciii,radiology_report,PROMPT2_ICL_entailment
42,136,15,14,1,0.9333333333333332,14,9,5,0.6428571428571429,0.7613293051359517,shc-gpt-4o,mimiciii,radiology_report,PROMPT2_ICL_entailment
43,137,12,12,0,1.0,10,10,0,1.0,1.0,shc-gpt-4o,mimiciii,radiology_report,PROMPT2_ICL_entailment
44,138,13,13,0,1.0,14,11,3,0.7857142857142857,0.88,shc-gpt-4o,mimiciii,radiology_report,PROMPT2_ICL_entailment
45,139,11,10,1,0.9090909090909092,13,10,3,0.7692307692307693,0.8333333333333333,shc-gpt-4o,mimiciii,radiology_report,PROMPT2_ICL_entailment
46,14,10,10,0,1.0,12,9,3,0.75,0.8571428571428571,shc-gpt-4o,mimiciii,radiology_report,PROMPT2_ICL_entailment
47,140,14,14,0,1.0,18,15,3,0.8333333333333334,0.9090909090909092,shc-gpt-4o,mimiciii,radiology_report,PROMPT2_ICL_entailment
48,141,14,14,0,1.0,16,11,5,0.6875,0.8148148148148148,shc-gpt-4o,mimiciii,radiology_report,PROMPT2_ICL_entailment
49,142,15,14,1,0.9333333333333332,14,13,1,0.9285714285714286,0.9309462915601024,shc-gpt-4o,mimiciii,radiology_report,PROMPT2_ICL_entailment
50,143,26,23,3,0.8846153846153846,28,20,8,0.7142857142857143,0.7903780068728522,shc-gpt-4o,mimiciii,radiology_report,PROMPT2_ICL_entailment
51,144,19,18,1,0.9473684210526316,23,19,4,0.8260869565217391,0.8825806451612903,shc-gpt-4o,mimiciii,radiology_report,PROMPT2_ICL_entailment
52,145,20,20,0,1.0,18,14,4,0.7777777777777778,0.8750000000000001,shc-gpt-4o,mimiciii,radiology_report,PROMPT2_ICL_entailment
53,146,8,8,0,1.0,11,6,5,0.5454545454545454,0.7058823529411764,shc-gpt-4o,mimiciii,radiology_report,PROMPT2_ICL_entailment
54,147,10,10,0,1.0,10,8,2,0.8,0.888888888888889,shc-gpt-4o,mimiciii,radiology_report,PROMPT2_ICL_entailment
55,148,25,23,2,0.92,26,22,4,0.8461538461538461,0.8815331010452963,shc-gpt-4o,mimiciii,radiology_report,PROMPT2_ICL_entailment
56,149,19,17,2,0.8947368421052632,20,15,5,0.75,0.816,shc-gpt-4o,mimiciii,radiology_report,PROMPT2_ICL_entailment
57,15,26,18,8,0.6923076923076923,29,23,6,0.7931034482758621,0.7392857142857143,shc-gpt-4o,mimiciii,radiology_report,PROMPT2_ICL_entailment
58,150,22,20,2,0.9090909090909092,14,9,5,0.6428571428571429,0.7531380753138075,shc-gpt-4o,mimiciii,radiology_report,PROMPT2_ICL_entailment
59,151,24,17,7,0.7083333333333334,15,10,5,0.6666666666666666,0.6868686868686869,shc-gpt-4o,mimiciii,radiology_report,PROMPT2_ICL_entailment
60,152,17,17,0,1.0,18,13,5,0.7222222222222222,0.8387096774193548,shc-gpt-4o,mimiciii,radiology_report,PROMPT2_ICL_entailment
61,153,16,16,0,1.0,16,14,2,0.875,0.9333333333333332,shc-gpt-4o,mimiciii,radiology_report,PROMPT2_ICL_entailment
62,154,24,22,2,0.9166666666666666,23,20,3,0.8695652173913043,0.8924949290060852,shc-gpt-4o,mimiciii,radiology_report,PROMPT2_ICL_entailment
63,155,50,47,3,0.94,47,39,8,0.8297872340425532,0.8814618898773743,shc-gpt-4o,mimiciii,radiology_report,PROMPT2_ICL_entailment
64,156,18,17,1,0.9444444444444444,16,13,3,0.8125,0.8735177865612648,shc-gpt-4o,mimiciii,radiology_report,PROMPT2_ICL_entailment
65,157,13,13,0,1.0,12,10,2,0.8333333333333334,0.9090909090909092,shc-gpt-4o,mimiciii,radiology_report,PROMPT2_ICL_entailment
66,158,7,7,0,1.0,6,5,1,0.8333333333333334,0.9090909090909092,shc-gpt-4o,mimiciii,radiology_report,PROMPT2_ICL_entailment
67,159,13,12,1,0.9230769230769232,13,10,3,0.7692307692307693,0.8391608391608392,shc-gpt-4o,mimiciii,radiology_report,PROMPT2_ICL_entailment
68,16,15,15,0,1.0,17,13,4,0.7647058823529411,0.8666666666666666,shc-gpt-4o,mimiciii,radiology_report,PROMPT2_ICL_entailment
69,160,16,15,1,0.9375,12,10,2,0.8333333333333334,0.8823529411764706,shc-gpt-4o,mimiciii,radiology_report,PROMPT2_ICL_entailment
70,161,15,15,0,1.0,13,12,1,0.9230769230769232,0.96,shc-gpt-4o,mimiciii,radiology_report,PROMPT2_ICL_entailment
71,162,17,17,0,1.0,11,10,1,0.9090909090909092,0.9523809523809524,shc-gpt-4o,mimiciii,radiology_report,PROMPT2_ICL_entailment
72,163,10,10,0,1.0,8,5,3,0.625,0.7692307692307693,shc-gpt-4o,mimiciii,radiology_report,PROMPT2_ICL_entailment
73,164,14,14,0,1.0,10,9,1,0.9,0.9473684210526316,shc-gpt-4o,mimiciii,radiology_report,PROMPT2_ICL_entailment
74,165,18,15,3,0.8333333333333334,28,19,9,0.6785714285714286,0.7480314960629922,shc-gpt-4o,mimiciii,radiology_report,PROMPT2_ICL_entailment
75,166,22,20,2,0.9090909090909092,26,22,4,0.8461538461538461,0.8764940239043824,shc-gpt-4o,mimiciii,radiology_report,PROMPT2_ICL_entailment
76,167,7,7,0,1.0,10,9,1,0.9,0.9473684210526316,shc-gpt-4o,mimiciii,radiology_report,PROMPT2_ICL_entailment
77,168,15,13,2,0.8666666666666667,13,9,4,0.6923076923076923,0.7697368421052632,shc-gpt-4o,mimiciii,radiology_report,PROMPT2_ICL_entailment
78,169,18,18,0,1.0,22,18,4,0.8181818181818182,0.9,shc-gpt-4o,mimiciii,radiology_report,PROMPT2_ICL_entailment
79,17,9,9,0,1.0,12,8,4,0.6666666666666666,0.8,shc-gpt-4o,mimiciii,radiology_report,PROMPT2_ICL_entailment
80,170,27,26,1,0.9629629629629628,24,20,4,0.8333333333333334,0.8934707903780069,shc-gpt-4o,mimiciii,radiology_report,PROMPT2_ICL_entailment
81,171,11,10,1,0.9090909090909092,7,5,2,0.7142857142857143,0.8,shc-gpt-4o,mimiciii,radiology_report,PROMPT2_ICL_entailment
82,172,13,13,0,1.0,14,10,4,0.7142857142857143,0.8333333333333333,shc-gpt-4o,mimiciii,radiology_report,PROMPT2_ICL_entailment
83,173,18,18,0,1.0,12,10,2,0.8333333333333334,0.9090909090909092,shc-gpt-4o,mimiciii,radiology_report,PROMPT2_ICL_entailment
84,174,15,15,0,1.0,20,14,6,0.7,0.8235294117647058,shc-gpt-4o,mimiciii,radiology_report,PROMPT2_ICL_entailment
85,175,8,8,0,1.0,8,7,1,0.875,0.9333333333333332,shc-gpt-4o,mimiciii,radiology_report,PROMPT2_ICL_entailment
86,176,22,20,2,0.9090909090909092,19,16,3,0.8421052631578947,0.8743169398907102,shc-gpt-4o,mimiciii,radiology_report,PROMPT2_ICL_entailment
87,177,21,18,3,0.8571428571428571,16,12,4,0.75,0.7999999999999999,shc-gpt-4o,mimiciii,radiology_report,PROMPT2_ICL_entailment
88,178,28,25,3,0.8928571428571429,25,20,5,0.8,0.8438818565400844,shc-gpt-4o,mimiciii,radiology_report,PROMPT2_ICL_entailment
89,179,14,14,0,1.0,17,13,4,0.7647058823529411,0.8666666666666666,shc-gpt-4o,mimiciii,radiology_report,PROMPT2_ICL_entailment
90,18,19,19,0,1.0,17,12,5,0.7058823529411765,0.8275862068965517,shc-gpt-4o,mimiciii,radiology_report,PROMPT2_ICL_entailment
91,180,18,18,0,1.0,11,11,0,1.0,1.0,shc-gpt-4o,mimiciii,radiology_report,PROMPT2_ICL_entailment
92,181,36,29,7,0.8055555555555556,26,19,7,0.7307692307692307,0.7663421418636996,shc-gpt-4o,mimiciii,radiology_report,PROMPT2_ICL_entailment
93,182,21,21,0,1.0,23,18,5,0.782608695652174,0.878048780487805,shc-gpt-4o,mimiciii,radiology_report,PROMPT2_ICL_entailment
94,183,19,17,2,0.8947368421052632,17,13,4,0.7647058823529411,0.8246268656716417,shc-gpt-4o,mimiciii,radiology_report,PROMPT2_ICL_entailment
95,184,14,14,0,1.0,15,13,2,0.8666666666666667,0.9285714285714286,shc-gpt-4o,mimiciii,radiology_report,PROMPT2_ICL_entailment
96,185,8,7,1,0.875,6,4,2,0.6666666666666666,0.7567567567567567,shc-gpt-4o,mimiciii,radiology_report,PROMPT2_ICL_entailment
97,186,22,22,0,1.0,26,22,4,0.8461538461538461,0.9166666666666666,shc-gpt-4o,mimiciii,radiology_report,PROMPT2_ICL_entailment
98,187,21,20,1,0.9523809523809524,14,11,3,0.7857142857142857,0.8610567514677103,shc-gpt-4o,mimiciii,radiology_report,PROMPT2_ICL_entailment
99,188,28,27,1,0.9642857142857144,22,18,4,0.8181818181818182,0.8852459016393442,shc-gpt-4o,mimiciii,radiology_report,PROMPT2_ICL_entailment
100,189,14,14,0,1.0,15,12,3,0.8,0.888888888888889,shc-gpt-4o,mimiciii,radiology_report,PROMPT2_ICL_entailment
101,19,14,14,0,1.0,14,14,0,1.0,1.0,shc-gpt-4o,mimiciii,radiology_report,PROMPT2_ICL_entailment
102,190,15,15,0,1.0,17,11,6,0.6470588235294118,0.7857142857142858,shc-gpt-4o,mimiciii,radiology_report,PROMPT2_ICL_entailment
103,191,22,17,5,0.7727272727272727,15,13,2,0.8666666666666667,0.8170055452865065,shc-gpt-4o,mimiciii,radiology_report,PROMPT2_ICL_entailment
104,192,29,26,3,0.896551724137931,28,21,7,0.75,0.8167539267015707,shc-gpt-4o,mimiciii,radiology_report,PROMPT2_ICL_entailment
105,193,15,15,0,1.0,14,11,3,0.7857142857142857,0.88,shc-gpt-4o,mimiciii,radiology_report,PROMPT2_ICL_entailment
106,194,33,31,2,0.9393939393939394,38,27,11,0.7105263157894737,0.8090865152247462,shc-gpt-4o,mimiciii,radiology_report,PROMPT2_ICL_entailment
107,195,19,17,2,0.8947368421052632,21,17,4,0.8095238095238095,0.8500000000000001,shc-gpt-4o,mimiciii,radiology_report,PROMPT2_ICL_entailment
108,196,14,14,0,1.0,18,15,3,0.8333333333333334,0.9090909090909092,shc-gpt-4o,mimiciii,radiology_report,PROMPT2_ICL_entailment
109,197,12,12,0,1.0,15,12,3,0.8,0.888888888888889,shc-gpt-4o,mimiciii,radiology_report,PROMPT2_ICL_entailment
110,198,11,10,1,0.9090909090909092,9,7,2,0.7777777777777778,0.8383233532934132,shc-gpt-4o,mimiciii,radiology_report,PROMPT2_ICL_entailment
111,199,30,27,3,0.9,23,22,1,0.9565217391304348,0.9274004683840747,shc-gpt-4o,mimiciii,radiology_report,PROMPT2_ICL_entailment
112,2,16,16,0,1.0,15,11,4,0.7333333333333333,0.846153846153846,shc-gpt-4o,mimiciii,radiology_report,PROMPT2_ICL_entailment
113,20,28,28,0,1.0,36,28,8,0.7777777777777778,0.8750000000000001,shc-gpt-4o,mimiciii,radiology_report,PROMPT2_ICL_entailment
114,200,13,13,0,1.0,14,13,1,0.9285714285714286,0.962962962962963,shc-gpt-4o,mimiciii,radiology_report,PROMPT2_ICL_entailment
115,201,20,19,1,0.95,18,13,5,0.7222222222222222,0.8205980066445183,shc-gpt-4o,mimiciii,radiology_report,PROMPT2_ICL_entailment
116,202,23,22,1,0.9565217391304348,24,17,7,0.7083333333333334,0.8139281828073994,shc-gpt-4o,mimiciii,radiology_report,PROMPT2_ICL_entailment
117,203,26,23,3,0.8846153846153846,19,17,2,0.8947368421052632,0.8896473265073946,shc-gpt-4o,mimiciii,radiology_report,PROMPT2_ICL_entailment
118,204,20,18,2,0.9,23,19,4,0.8260869565217391,0.8614609571788413,shc-gpt-4o,mimiciii,radiology_report,PROMPT2_ICL_entailment
119,205,22,22,0,1.0,14,12,2,0.8571428571428571,0.923076923076923,shc-gpt-4o,mimiciii,radiology_report,PROMPT2_ICL_entailment
120,206,19,19,0,1.0,13,10,3,0.7692307692307693,0.8695652173913044,shc-gpt-4o,mimiciii,radiology_report,PROMPT2_ICL_entailment
121,207,9,8,1,0.8888888888888888,9,6,3,0.6666666666666666,0.761904761904762,shc-gpt-4o,mimiciii,radiology_report,PROMPT2_ICL_entailment
122,208,19,19,0,1.0,18,14,4,0.7777777777777778,0.8750000000000001,shc-gpt-4o,mimiciii,radiology_report,PROMPT2_ICL_entailment
123,209,16,15,1,0.9375,16,14,2,0.875,0.9051724137931034,shc-gpt-4o,mimiciii,radiology_report,PROMPT2_ICL_entailment
124,21,26,26,0,1.0,27,21,6,0.7777777777777778,0.8750000000000001,shc-gpt-4o,mimiciii,radiology_report,PROMPT2_ICL_entailment
125,210,13,12,1,0.9230769230769232,14,9,5,0.6428571428571429,0.7578947368421053,shc-gpt-4o,mimiciii,radiology_report,PROMPT2_ICL_entailment
126,211,14,13,1,0.9285714285714286,13,10,3,0.7692307692307693,0.8414239482200646,shc-gpt-4o,mimiciii,radiology_report,PROMPT2_ICL_entailment
127,212,19,14,5,0.7368421052631579,19,18,1,0.9473684210526316,0.8289473684210525,shc-gpt-4o,mimiciii,radiology_report,PROMPT2_ICL_entailment
128,213,19,19,0,1.0,22,15,7,0.6818181818181818,0.8108108108108109,shc-gpt-4o,mimiciii,radiology_report,PROMPT2_ICL_entailment
129,214,26,16,10,0.6153846153846154,23,20,3,0.8695652173913043,0.7207207207207207,shc-gpt-4o,mimiciii,radiology_report,PROMPT2_ICL_entailment
130,215,14,14,0,1.0,10,8,2,0.8,0.888888888888889,shc-gpt-4o,mimiciii,radiology_report,PROMPT2_ICL_entailment
131,216,17,17,0,1.0,19,11,8,0.5789473684210527,0.7333333333333334,shc-gpt-4o,mimiciii,radiology_report,PROMPT2_ICL_entailment
132,217,22,20,2,0.9090909090909092,20,16,4,0.8,0.8510638297872342,shc-gpt-4o,mimiciii,radiology_report,PROMPT2_ICL_entailment
133,218,17,16,1,0.9411764705882352,15,11,4,0.7333333333333333,0.8243559718969555,shc-gpt-4o,mimiciii,radiology_report,PROMPT2_ICL_entailment
134,219,20,20,0,1.0,13,10,3,0.7692307692307693,0.8695652173913044,shc-gpt-4o,mimiciii,radiology_report,PROMPT2_ICL_entailment
135,22,21,19,2,0.9047619047619048,19,18,1,0.9473684210526316,0.925575101488498,shc-gpt-4o,mimiciii,radiology_report,PROMPT2_ICL_entailment
136,220,12,12,0,1.0,19,10,9,0.5263157894736842,0.6896551724137931,shc-gpt-4o,mimiciii,radiology_report,PROMPT2_ICL_entailment
137,221,35,34,1,0.9714285714285714,27,22,5,0.8148148148148148,0.8862559241706162,shc-gpt-4o,mimiciii,radiology_report,PROMPT2_ICL_entailment
138,222,21,21,0,1.0,16,11,5,0.6875,0.8148148148148148,shc-gpt-4o,mimiciii,radiology_report,PROMPT2_ICL_entailment
139,223,27,25,2,0.925925925925926,21,18,3,0.8571428571428571,0.8902077151335311,shc-gpt-4o,mimiciii,radiology_report,PROMPT2_ICL_entailment
140,224,26,24,2,0.9230769230769232,17,14,3,0.8235294117647058,0.8704663212435233,shc-gpt-4o,mimiciii,radiology_report,PROMPT2_ICL_entailment
141,225,11,11,0,1.0,11,8,3,0.7272727272727273,0.8421052631578948,shc-gpt-4o,mimiciii,radiology_report,PROMPT2_ICL_entailment
142,226,16,15,1,0.9375,18,15,3,0.8333333333333334,0.8823529411764706,shc-gpt-4o,mimiciii,radiology_report,PROMPT2_ICL_entailment
143,227,23,20,3,0.8695652173913043,18,15,3,0.8333333333333334,0.851063829787234,shc-gpt-4o,mimiciii,radiology_report,PROMPT2_ICL_entailment
144,228,18,16,2,0.8888888888888888,17,16,1,0.9411764705882352,0.9142857142857144,shc-gpt-4o,mimiciii,radiology_report,PROMPT2_ICL_entailment
145,229,43,42,1,0.9767441860465116,44,32,12,0.7272727272727273,0.8337468982630273,shc-gpt-4o,mimiciii,radiology_report,PROMPT2_ICL_entailment
146,23,17,16,1,0.9411764705882352,15,14,1,0.9333333333333332,0.9372384937238494,shc-gpt-4o,mimiciii,radiology_report,PROMPT2_ICL_entailment
147,230,16,14,2,0.875,17,16,1,0.9411764705882352,0.9068825910931174,shc-gpt-4o,mimiciii,radiology_report,PROMPT2_ICL_entailment
148,231,14,14,0,1.0,13,10,3,0.7692307692307693,0.8695652173913044,shc-gpt-4o,mimiciii,radiology_report,PROMPT2_ICL_entailment
149,232,19,19,0,1.0,18,11,7,0.6111111111111112,0.7586206896551725,shc-gpt-4o,mimiciii,radiology_report,PROMPT2_ICL_entailment
150,233,20,19,1,0.95,17,13,4,0.7647058823529411,0.8473413379073755,shc-gpt-4o,mimiciii,radiology_report,PROMPT2_ICL_entailment
151,234,10,8,2,0.8,11,7,4,0.6363636363636364,0.7088607594936709,shc-gpt-4o,mimiciii,radiology_report,PROMPT2_ICL_entailment
152,235,10,10,0,1.0,14,10,4,0.7142857142857143,0.8333333333333333,shc-gpt-4o,mimiciii,radiology_report,PROMPT2_ICL_entailment
153,236,15,15,0,1.0,11,9,2,0.8181818181818182,0.9,shc-gpt-4o,mimiciii,radiology_report,PROMPT2_ICL_entailment
154,237,19,18,1,0.9473684210526316,17,12,5,0.7058823529411765,0.8089887640449439,shc-gpt-4o,mimiciii,radiology_report,PROMPT2_ICL_entailment
155,238,27,26,1,0.9629629629629628,20,19,1,0.95,0.956437560503388,shc-gpt-4o,mimiciii,radiology_report,PROMPT2_ICL_entailment
156,239,18,18,0,1.0,17,12,5,0.7058823529411765,0.8275862068965517,shc-gpt-4o,mimiciii,radiology_report,PROMPT2_ICL_entailment
157,24,17,17,0,1.0,18,14,4,0.7777777777777778,0.8750000000000001,shc-gpt-4o,mimiciii,radiology_report,PROMPT2_ICL_entailment
158,240,13,13,0,1.0,13,11,2,0.8461538461538461,0.9166666666666666,shc-gpt-4o,mimiciii,radiology_report,PROMPT2_ICL_entailment
159,241,18,16,2,0.8888888888888888,16,14,2,0.875,0.8818897637795274,shc-gpt-4o,mimiciii,radiology_report,PROMPT2_ICL_entailment
160,242,24,24,0,1.0,18,15,3,0.8333333333333334,0.9090909090909092,shc-gpt-4o,mimiciii,radiology_report,PROMPT2_ICL_entailment
161,243,16,16,0,1.0,13,10,3,0.7692307692307693,0.8695652173913044,shc-gpt-4o,mimiciii,radiology_report,PROMPT2_ICL_entailment
162,244,15,14,1,0.9333333333333332,17,12,5,0.7058823529411765,0.8038277511961724,shc-gpt-4o,mimiciii,radiology_report,PROMPT2_ICL_entailment
163,245,27,21,6,0.7777777777777778,28,25,3,0.8928571428571429,0.8313539192399051,shc-gpt-4o,mimiciii,radiology_report,PROMPT2_ICL_entailment
164,246,14,14,0,1.0,12,9,3,0.75,0.8571428571428571,shc-gpt-4o,mimiciii,radiology_report,PROMPT2_ICL_entailment
165,247,12,12,0,1.0,12,8,4,0.6666666666666666,0.8,shc-gpt-4o,mimiciii,radiology_report,PROMPT2_ICL_entailment
166,248,12,12,0,1.0,17,8,9,0.4705882352941176,0.6399999999999999,shc-gpt-4o,mimiciii,radiology_report,PROMPT2_ICL_entailment
167,249,22,20,2,0.9090909090909092,23,17,6,0.7391304347826086,0.8153477218225419,shc-gpt-4o,mimiciii,radiology_report,PROMPT2_ICL_entailment
168,25,26,22,4,0.8461538461538461,27,21,6,0.7777777777777778,0.8105263157894737,shc-gpt-4o,mimiciii,radiology_report,PROMPT2_ICL_entailment
169,250,9,9,0,1.0,8,6,2,0.75,0.8571428571428571,shc-gpt-4o,mimiciii,radiology_report,PROMPT2_ICL_entailment
170,251,27,25,2,0.925925925925926,22,18,4,0.8181818181818182,0.8687258687258688,shc-gpt-4o,mimiciii,radiology_report,PROMPT2_ICL_entailment
171,252,10,9,1,0.9,10,7,3,0.7,0.7875,shc-gpt-4o,mimiciii,radiology_report,PROMPT2_ICL_entailment
172,253,28,25,3,0.8928571428571429,24,22,2,0.9166666666666666,0.9046052631578948,shc-gpt-4o,mimiciii,radiology_report,PROMPT2_ICL_entailment
173,254,12,12,0,1.0,13,10,3,0.7692307692307693,0.8695652173913044,shc-gpt-4o,mimiciii,radiology_report,PROMPT2_ICL_entailment
174,255,12,12,0,1.0,16,10,6,0.625,0.7692307692307693,shc-gpt-4o,mimiciii,radiology_report,PROMPT2_ICL_entailment
175,256,21,19,2,0.9047619047619048,19,14,5,0.7368421052631579,0.8122137404580152,shc-gpt-4o,mimiciii,radiology_report,PROMPT2_ICL_entailment
176,257,17,16,1,0.9411764705882352,15,13,2,0.8666666666666667,0.9023861171366594,shc-gpt-4o,mimiciii,radiology_report,PROMPT2_ICL_entailment
177,258,15,15,0,1.0,20,14,6,0.7,0.8235294117647058,shc-gpt-4o,mimiciii,radiology_report,PROMPT2_ICL_entailment
178,259,19,18,1,0.9473684210526316,17,14,3,0.8235294117647058,0.881118881118881,shc-gpt-4o,mimiciii,radiology_report,PROMPT2_ICL_entailment
179,26,21,21,0,1.0,18,13,5,0.7222222222222222,0.8387096774193548,shc-gpt-4o,mimiciii,radiology_report,PROMPT2_ICL_entailment
180,260,22,22,0,1.0,20,12,8,0.6,0.7499999999999999,shc-gpt-4o,mimiciii,radiology_report,PROMPT2_ICL_entailment
181,261,32,28,4,0.875,30,25,5,0.8333333333333334,0.8536585365853658,shc-gpt-4o,mimiciii,radiology_report,PROMPT2_ICL_entailment
182,262,19,18,1,0.9473684210526316,23,18,5,0.782608695652174,0.8571428571428571,shc-gpt-4o,mimiciii,radiology_report,PROMPT2_ICL_entailment
183,263,23,20,3,0.8695652173913043,27,21,6,0.7777777777777778,0.8211143695014663,shc-gpt-4o,mimiciii,radiology_report,PROMPT2_ICL_entailment
184,264,21,18,3,0.8571428571428571,20,17,3,0.85,0.8535564853556485,shc-gpt-4o,mimiciii,radiology_report,PROMPT2_ICL_entailment
185,265,12,12,0,1.0,9,9,0,1.0,1.0,shc-gpt-4o,mimiciii,radiology_report,PROMPT2_ICL_entailment
186,266,16,14,2,0.875,18,14,4,0.7777777777777778,0.823529411764706,shc-gpt-4o,mimiciii,radiology_report,PROMPT2_ICL_entailment
187,267,15,15,0,1.0,16,14,2,0.875,0.9333333333333332,shc-gpt-4o,mimiciii,radiology_report,PROMPT2_ICL_entailment
188,268,21,20,1,0.9523809523809524,20,17,3,0.85,0.8982826948480845,shc-gpt-4o,mimiciii,radiology_report,PROMPT2_ICL_entailment
189,269,19,19,0,1.0,25,20,5,0.8,0.888888888888889,shc-gpt-4o,mimiciii,radiology_report,PROMPT2_ICL_entailment
190,27,15,15,0,1.0,14,13,1,0.9285714285714286,0.962962962962963,shc-gpt-4o,mimiciii,radiology_report,PROMPT2_ICL_entailment
191,270,22,20,2,0.9090909090909092,17,16,1,0.9411764705882352,0.92485549132948,shc-gpt-4o,mimiciii,radiology_report,PROMPT2_ICL_entailment
192,271,14,14,0,1.0,17,11,6,0.6470588235294118,0.7857142857142858,shc-gpt-4o,mimiciii,radiology_report,PROMPT2_ICL_entailment
193,272,23,22,1,0.9565217391304348,17,15,2,0.8823529411764706,0.917941585535466,shc-gpt-4o,mimiciii,radiology_report,PROMPT2_ICL_entailment
194,273,13,12,1,0.9230769230769232,12,10,2,0.8333333333333334,0.8759124087591241,shc-gpt-4o,mimiciii,radiology_report,PROMPT2_ICL_entailment
195,274,15,15,0,1.0,20,16,4,0.8,0.888888888888889,shc-gpt-4o,mimiciii,radiology_report,PROMPT2_ICL_entailment
196,275,13,12,1,0.9230769230769232,12,12,0,1.0,0.96,shc-gpt-4o,mimiciii,radiology_report,PROMPT2_ICL_entailment
197,276,27,26,1,0.9629629629629628,24,20,4,0.8333333333333334,0.8934707903780069,shc-gpt-4o,mimiciii,radiology_report,PROMPT2_ICL_entailment
198,277,23,21,2,0.9130434782608696,25,21,4,0.84,0.8749999999999999,shc-gpt-4o,mimiciii,radiology_report,PROMPT2_ICL_entailment
199,278,19,19,0,1.0,16,13,3,0.8125,0.896551724137931,shc-gpt-4o,mimiciii,radiology_report,PROMPT2_ICL_entailment
200,279,17,17,0,1.0,10,7,3,0.7,0.8235294117647058,shc-gpt-4o,mimiciii,radiology_report,PROMPT2_ICL_entailment
201,28,32,28,4,0.875,30,25,5,0.8333333333333334,0.8536585365853658,shc-gpt-4o,mimiciii,radiology_report,PROMPT2_ICL_entailment
202,280,14,14,0,1.0,12,9,3,0.75,0.8571428571428571,shc-gpt-4o,mimiciii,radiology_report,PROMPT2_ICL_entailment
203,281,19,17,2,0.8947368421052632,24,19,5,0.7916666666666666,0.8400520156046813,shc-gpt-4o,mimiciii,radiology_report,PROMPT2_ICL_entailment
204,282,20,20,0,1.0,12,11,1,0.9166666666666666,0.9565217391304348,shc-gpt-4o,mimiciii,radiology_report,PROMPT2_ICL_entailment
205,283,22,21,1,0.9545454545454546,25,22,3,0.88,0.9157581764122896,shc-gpt-4o,mimiciii,radiology_report,PROMPT2_ICL_entailment
206,284,15,15,0,1.0,14,11,3,0.7857142857142857,0.88,shc-gpt-4o,mimiciii,radiology_report,PROMPT2_ICL_entailment
207,285,19,19,0,1.0,18,18,0,1.0,1.0,shc-gpt-4o,mimiciii,radiology_report,PROMPT2_ICL_entailment
208,286,7,7,0,1.0,6,5,1,0.8333333333333334,0.9090909090909092,shc-gpt-4o,mimiciii,radiology_report,PROMPT2_ICL_entailment
209,287,20,19,1,0.95,18,15,3,0.8333333333333334,0.8878504672897196,shc-gpt-4o,mimiciii,radiology_report,PROMPT2_ICL_entailment
210,288,31,20,11,0.6451612903225806,32,25,7,0.78125,0.7067137809187279,shc-gpt-4o,mimiciii,radiology_report,PROMPT2_ICL_entailment
211,289,23,23,0,1.0,20,17,3,0.85,0.9189189189189187,shc-gpt-4o,mimiciii,radiology_report,PROMPT2_ICL_entailment
212,29,10,9,1,0.9,8,6,2,0.75,0.8181818181818182,shc-gpt-4o,mimiciii,radiology_report,PROMPT2_ICL_entailment
213,290,11,11,0,1.0,11,8,3,0.7272727272727273,0.8421052631578948,shc-gpt-4o,mimiciii,radiology_report,PROMPT2_ICL_entailment
214,291,24,22,2,0.9166666666666666,23,17,6,0.7391304347826086,0.8183807439824944,shc-gpt-4o,mimiciii,radiology_report,PROMPT2_ICL_entailment
215,292,24,17,7,0.7083333333333334,21,18,3,0.8571428571428571,0.7756653992395437,shc-gpt-4o,mimiciii,radiology_report,PROMPT2_ICL_entailment
216,293,13,13,0,1.0,18,14,4,0.7777777777777778,0.8750000000000001,shc-gpt-4o,mimiciii,radiology_report,PROMPT2_ICL_entailment
217,294,24,22,2,0.9166666666666666,22,17,5,0.7727272727272727,0.8385650224215245,shc-gpt-4o,mimiciii,radiology_report,PROMPT2_ICL_entailment
218,295,23,18,5,0.782608695652174,32,21,11,0.65625,0.7138810198300284,shc-gpt-4o,mimiciii,radiology_report,PROMPT2_ICL_entailment
219,296,23,23,0,1.0,17,15,2,0.8823529411764706,0.9375,shc-gpt-4o,mimiciii,radiology_report,PROMPT2_ICL_entailment
220,297,18,15,3,0.8333333333333334,24,15,9,0.625,0.7142857142857143,shc-gpt-4o,mimiciii,radiology_report,PROMPT2_ICL_entailment
221,298,23,20,3,0.8695652173913043,20,13,7,0.65,0.7439198855507868,shc-gpt-4o,mimiciii,radiology_report,PROMPT2_ICL_entailment
222,299,27,25,2,0.925925925925926,28,25,3,0.8928571428571429,0.9090909090909092,shc-gpt-4o,mimiciii,radiology_report,PROMPT2_ICL_entailment
223,3,14,14,0,1.0,20,14,6,0.7,0.8235294117647058,shc-gpt-4o,mimiciii,radiology_report,PROMPT2_ICL_entailment
224,30,22,20,2,0.9090909090909092,21,17,4,0.8095238095238095,0.8564231738035265,shc-gpt-4o,mimiciii,radiology_report,PROMPT2_ICL_entailment
225,300,14,14,0,1.0,13,6,7,0.4615384615384615,0.631578947368421,shc-gpt-4o,mimiciii,radiology_report,PROMPT2_ICL_entailment
226,301,12,12,0,1.0,16,12,4,0.75,0.8571428571428571,shc-gpt-4o,mimiciii,radiology_report,PROMPT2_ICL_entailment
227,302,17,17,0,1.0,15,14,1,0.9333333333333332,0.9655172413793104,shc-gpt-4o,mimiciii,radiology_report,PROMPT2_ICL_entailment
228,303,32,31,1,0.96875,24,20,4,0.8333333333333334,0.8959537572254336,shc-gpt-4o,mimiciii,radiology_report,PROMPT2_ICL_entailment
229,304,21,21,0,1.0,19,13,6,0.6842105263157895,0.8125000000000001,shc-gpt-4o,mimiciii,radiology_report,PROMPT2_ICL_entailment
230,305,22,20,2,0.9090909090909092,24,17,7,0.7083333333333334,0.7962529274004684,shc-gpt-4o,mimiciii,radiology_report,PROMPT2_ICL_entailment
231,306,14,13,1,0.9285714285714286,14,12,2,0.8571428571428571,0.8914285714285715,shc-gpt-4o,mimiciii,radiology_report,PROMPT2_ICL_entailment
232,307,21,21,0,1.0,17,14,3,0.8235294117647058,0.9032258064516128,shc-gpt-4o,mimiciii,radiology_report,PROMPT2_ICL_entailment
233,308,14,14,0,1.0,15,11,4,0.7333333333333333,0.846153846153846,shc-gpt-4o,mimiciii,radiology_report,PROMPT2_ICL_entailment
234,309,19,18,1,0.9473684210526316,26,17,9,0.6538461538461539,0.7737041719342604,shc-gpt-4o,mimiciii,radiology_report,PROMPT2_ICL_entailment
235,31,17,16,1,0.9411764705882352,19,14,5,0.7368421052631579,0.8265682656826568,shc-gpt-4o,mimiciii,radiology_report,PROMPT2_ICL_entailment
236,310,22,21,1,0.9545454545454546,24,19,5,0.7916666666666666,0.8655097613882864,shc-gpt-4o,mimiciii,radiology_report,PROMPT2_ICL_entailment
237,311,15,15,0,1.0,15,15,0,1.0,1.0,shc-gpt-4o,mimiciii,radiology_report,PROMPT2_ICL_entailment
238,312,19,17,2,0.8947368421052632,18,15,3,0.8333333333333334,0.8629441624365481,shc-gpt-4o,mimiciii,radiology_report,PROMPT2_ICL_entailment
239,313,15,14,1,0.9333333333333332,17,15,2,0.8823529411764706,0.9071274298056156,shc-gpt-4o,mimiciii,radiology_report,PROMPT2_ICL_entailment
240,314,20,19,1,0.95,15,12,3,0.8,0.8685714285714285,shc-gpt-4o,mimiciii,radiology_report,PROMPT2_ICL_entailment
241,315,35,28,7,0.8,25,18,7,0.72,0.7578947368421052,shc-gpt-4o,mimiciii,radiology_report,PROMPT2_ICL_entailment
242,316,11,10,1,0.9090909090909092,10,8,2,0.8,0.8510638297872342,shc-gpt-4o,mimiciii,radiology_report,PROMPT2_ICL_entailment
243,317,28,22,6,0.7857142857142857,26,20,6,0.7692307692307693,0.7773851590106008,shc-gpt-4o,mimiciii,radiology_report,PROMPT2_ICL_entailment
244,318,22,20,2,0.9090909090909092,21,14,7,0.6666666666666666,0.7692307692307692,shc-gpt-4o,mimiciii,radiology_report,PROMPT2_ICL_entailment
245,319,17,17,0,1.0,12,11,1,0.9166666666666666,0.9565217391304348,shc-gpt-4o,mimiciii,radiology_report,PROMPT2_ICL_entailment
246,32,13,11,2,0.8461538461538461,15,10,5,0.6666666666666666,0.7457627118644068,shc-gpt-4o,mimiciii,radiology_report,PROMPT2_ICL_entailment
247,320,10,10,0,1.0,11,9,2,0.8181818181818182,0.9,shc-gpt-4o,mimiciii,radiology_report,PROMPT2_ICL_entailment
248,321,20,16,4,0.8,21,17,4,0.8095238095238095,0.8047337278106509,shc-gpt-4o,mimiciii,radiology_report,PROMPT2_ICL_entailment
249,322,9,7,2,0.7777777777777778,8,6,2,0.75,0.7636363636363638,shc-gpt-4o,mimiciii,radiology_report,PROMPT2_ICL_entailment
250,323,16,14,2,0.875,25,15,10,0.6,0.711864406779661,shc-gpt-4o,mimiciii,radiology_report,PROMPT2_ICL_entailment
251,324,24,22,2,0.9166666666666666,18,17,1,0.9444444444444444,0.9303482587064676,shc-gpt-4o,mimiciii,radiology_report,PROMPT2_ICL_entailment
252,325,21,18,3,0.8571428571428571,22,18,4,0.8181818181818182,0.8372093023255814,shc-gpt-4o,mimiciii,radiology_report,PROMPT2_ICL_entailment
253,326,20,19,1,0.95,23,20,3,0.8695652173913043,0.9080047789725209,shc-gpt-4o,mimiciii,radiology_report,PROMPT2_ICL_entailment
254,327,10,10,0,1.0,9,8,1,0.8888888888888888,0.9411764705882352,shc-gpt-4o,mimiciii,radiology_report,PROMPT2_ICL_entailment
255,328,22,20,2,0.9090909090909092,17,14,3,0.8235294117647058,0.8641975308641976,shc-gpt-4o,mimiciii,radiology_report,PROMPT2_ICL_entailment
256,329,15,15,0,1.0,24,12,12,0.5,0.6666666666666666,shc-gpt-4o,mimiciii,radiology_report,PROMPT2_ICL_entailment
257,33,11,11,0,1.0,9,7,2,0.7777777777777778,0.8750000000000001,shc-gpt-4o,mimiciii,radiology_report,PROMPT2_ICL_entailment
258,330,15,15,0,1.0,11,9,2,0.8181818181818182,0.9,shc-gpt-4o,mimiciii,radiology_report,PROMPT2_ICL_entailment
259,331,13,13,0,1.0,15,12,3,0.8,0.888888888888889,shc-gpt-4o,mimiciii,radiology_report,PROMPT2_ICL_entailment
260,332,23,22,1,0.9565217391304348,20,17,3,0.85,0.9001203369434416,shc-gpt-4o,mimiciii,radiology_report,PROMPT2_ICL_entailment
261,333,11,11,0,1.0,13,12,1,0.9230769230769232,0.96,shc-gpt-4o,mimiciii,radiology_report,PROMPT2_ICL_entailment
262,334,22,20,2,0.9090909090909092,20,16,4,0.8,0.8510638297872342,shc-gpt-4o,mimiciii,radiology_report,PROMPT2_ICL_entailment
263,335,19,19,0,1.0,17,14,3,0.8235294117647058,0.9032258064516128,shc-gpt-4o,mimiciii,radiology_report,PROMPT2_ICL_entailment
264,336,21,21,0,1.0,16,15,1,0.9375,0.967741935483871,shc-gpt-4o,mimiciii,radiology_report,PROMPT2_ICL_entailment
265,337,22,22,0,1.0,16,15,1,0.9375,0.967741935483871,shc-gpt-4o,mimiciii,radiology_report,PROMPT2_ICL_entailment
266,338,16,16,0,1.0,13,7,6,0.5384615384615384,0.7000000000000001,shc-gpt-4o,mimiciii,radiology_report,PROMPT2_ICL_entailment
267,339,30,24,6,0.8,28,22,6,0.7857142857142857,0.7927927927927927,shc-gpt-4o,mimiciii,radiology_report,PROMPT2_ICL_entailment
268,34,13,13,0,1.0,14,12,2,0.8571428571428571,0.923076923076923,shc-gpt-4o,mimiciii,radiology_report,PROMPT2_ICL_entailment
269,340,24,23,1,0.9583333333333334,15,11,4,0.7333333333333333,0.8308702791461412,shc-gpt-4o,mimiciii,radiology_report,PROMPT2_ICL_entailment
270,341,9,9,0,1.0,6,5,1,0.8333333333333334,0.9090909090909092,shc-gpt-4o,mimiciii,radiology_report,PROMPT2_ICL_entailment
271,342,17,15,2,0.8823529411764706,15,14,1,0.9333333333333332,0.9071274298056156,shc-gpt-4o,mimiciii,radiology_report,PROMPT2_ICL_entailment
272,343,20,17,3,0.85,22,18,4,0.8181818181818182,0.8337874659400545,shc-gpt-4o,mimiciii,radiology_report,PROMPT2_ICL_entailment
273,344,18,17,1,0.9444444444444444,19,17,2,0.8947368421052632,0.918918918918919,shc-gpt-4o,mimiciii,radiology_report,PROMPT2_ICL_entailment
274,345,21,21,0,1.0,22,16,6,0.7272727272727273,0.8421052631578948,shc-gpt-4o,mimiciii,radiology_report,PROMPT2_ICL_entailment
275,346,17,17,0,1.0,15,11,4,0.7333333333333333,0.846153846153846,shc-gpt-4o,mimiciii,radiology_report,PROMPT2_ICL_entailment
276,347,18,17,1,0.9444444444444444,15,13,2,0.8666666666666667,0.9038854805725972,shc-gpt-4o,mimiciii,radiology_report,PROMPT2_ICL_entailment
277,348,21,19,2,0.9047619047619048,12,11,1,0.9166666666666666,0.9106753812636164,shc-gpt-4o,mimiciii,radiology_report,PROMPT2_ICL_entailment
278,349,19,18,1,0.9473684210526316,16,12,4,0.75,0.8372093023255814,shc-gpt-4o,mimiciii,radiology_report,PROMPT2_ICL_entailment
279,35,17,17,0,1.0,21,15,6,0.7142857142857143,0.8333333333333333,shc-gpt-4o,mimiciii,radiology_report,PROMPT2_ICL_entailment
280,350,24,23,1,0.9583333333333334,21,17,4,0.8095238095238095,0.877665544332211,shc-gpt-4o,mimiciii,radiology_report,PROMPT2_ICL_entailment
281,351,23,15,8,0.6521739130434783,21,18,3,0.8571428571428571,0.7407407407407407,shc-gpt-4o,mimiciii,radiology_report,PROMPT2_ICL_entailment
282,352,17,17,0,1.0,22,17,5,0.7727272727272727,0.8717948717948718,shc-gpt-4o,mimiciii,radiology_report,PROMPT2_ICL_entailment
283,353,21,15,6,0.7142857142857143,23,19,4,0.8260869565217391,0.7661290322580645,shc-gpt-4o,mimiciii,radiology_report,PROMPT2_ICL_entailment
284,354,27,24,3,0.8888888888888888,26,22,4,0.8461538461538461,0.8669950738916256,shc-gpt-4o,mimiciii,radiology_report,PROMPT2_ICL_entailment
285,355,20,20,0,1.0,18,17,1,0.9444444444444444,0.9714285714285714,shc-gpt-4o,mimiciii,radiology_report,PROMPT2_ICL_entailment
286,356,22,21,1,0.9545454545454546,22,19,3,0.8636363636363636,0.906818181818182,shc-gpt-4o,mimiciii,radiology_report,PROMPT2_ICL_entailment
287,357,11,11,0,1.0,15,10,5,0.6666666666666666,0.8,shc-gpt-4o,mimiciii,radiology_report,PROMPT2_ICL_entailment
288,358,17,17,0,1.0,12,7,5,0.5833333333333334,0.7368421052631579,shc-gpt-4o,mimiciii,radiology_report,PROMPT2_ICL_entailment
289,359,15,15,0,1.0,18,13,5,0.7222222222222222,0.8387096774193548,shc-gpt-4o,mimiciii,radiology_report,PROMPT2_ICL_entailment
290,36,20,19,1,0.95,22,17,5,0.7727272727272727,0.8522427440633245,shc-gpt-4o,mimiciii,radiology_report,PROMPT2_ICL_entailment
291,360,20,18,2,0.9,15,13,2,0.8666666666666667,0.8830188679245283,shc-gpt-4o,mimiciii,radiology_report,PROMPT2_ICL_entailment
292,361,17,16,1,0.9411764705882352,23,18,5,0.782608695652174,0.8545994065281899,shc-gpt-4o,mimiciii,radiology_report,PROMPT2_ICL_entailment
293,362,24,22,2,0.9166666666666666,24,18,6,0.75,0.8250000000000001,shc-gpt-4o,mimiciii,radiology_report,PROMPT2_ICL_entailment
294,363,22,19,3,0.8636363636363636,22,16,6,0.7272727272727273,0.7896103896103897,shc-gpt-4o,mimiciii,radiology_report,PROMPT2_ICL_entailment
295,364,12,12,0,1.0,11,8,3,0.7272727272727273,0.8421052631578948,shc-gpt-4o,mimiciii,radiology_report,PROMPT2_ICL_entailment
296,365,28,20,8,0.7142857142857143,29,19,10,0.6551724137931034,0.683453237410072,shc-gpt-4o,mimiciii,radiology_report,PROMPT2_ICL_entailment
297,366,11,11,0,1.0,13,8,5,0.6153846153846154,0.761904761904762,shc-gpt-4o,mimiciii,radiology_report,PROMPT2_ICL_entailment
298,367,17,15,2,0.8823529411764706,16,12,4,0.75,0.8108108108108107,shc-gpt-4o,mimiciii,radiology_report,PROMPT2_ICL_entailment
299,368,17,13,4,0.7647058823529411,20,14,6,0.7,0.7309236947791163,shc-gpt-4o,mimiciii,radiology_report,PROMPT2_ICL_entailment
300,369,17,17,0,1.0,20,16,4,0.8,0.888888888888889,shc-gpt-4o,mimiciii,radiology_report,PROMPT2_ICL_entailment
301,37,17,15,2,0.8823529411764706,21,16,5,0.7619047619047619,0.817717206132879,shc-gpt-4o,mimiciii,radiology_report,PROMPT2_ICL_entailment
302,370,21,19,2,0.9047619047619048,19,13,6,0.6842105263157895,0.7791798107255521,shc-gpt-4o,mimiciii,radiology_report,PROMPT2_ICL_entailment
303,371,15,15,0,1.0,17,15,2,0.8823529411764706,0.9375,shc-gpt-4o,mimiciii,radiology_report,PROMPT2_ICL_entailment
304,372,22,20,2,0.9090909090909092,27,21,6,0.7777777777777778,0.8383233532934132,shc-gpt-4o,mimiciii,radiology_report,PROMPT2_ICL_entailment
305,373,23,22,1,0.9565217391304348,23,20,3,0.8695652173913043,0.9109730848861284,shc-gpt-4o,mimiciii,radiology_report,PROMPT2_ICL_entailment
306,374,11,10,1,0.9090909090909092,11,7,4,0.6363636363636364,0.7486631016042781,shc-gpt-4o,mimiciii,radiology_report,PROMPT2_ICL_entailment
307,375,13,13,0,1.0,16,11,5,0.6875,0.8148148148148148,shc-gpt-4o,mimiciii,radiology_report,PROMPT2_ICL_entailment
308,376,21,18,3,0.8571428571428571,18,15,3,0.8333333333333334,0.8450704225352113,shc-gpt-4o,mimiciii,radiology_report,PROMPT2_ICL_entailment
309,377,12,12,0,1.0,10,8,2,0.8,0.888888888888889,shc-gpt-4o,mimiciii,radiology_report,PROMPT2_ICL_entailment
310,378,19,17,2,0.8947368421052632,24,13,11,0.5416666666666666,0.6748091603053434,shc-gpt-4o,mimiciii,radiology_report,PROMPT2_ICL_entailment
311,379,20,20,0,1.0,18,15,3,0.8333333333333334,0.9090909090909092,shc-gpt-4o,mimiciii,radiology_report,PROMPT2_ICL_entailment
312,38,20,19,1,0.95,19,17,2,0.8947368421052632,0.9215406562054208,shc-gpt-4o,mimiciii,radiology_report,PROMPT2_ICL_entailment
313,380,12,12,0,1.0,8,6,2,0.75,0.8571428571428571,shc-gpt-4o,mimiciii,radiology_report,PROMPT2_ICL_entailment
314,381,12,11,1,0.9166666666666666,14,9,5,0.6428571428571429,0.7557251908396947,shc-gpt-4o,mimiciii,radiology_report,PROMPT2_ICL_entailment
315,382,14,13,1,0.9285714285714286,13,9,4,0.6923076923076923,0.7932203389830509,shc-gpt-4o,mimiciii,radiology_report,PROMPT2_ICL_entailment
316,383,22,21,1,0.9545454545454546,17,15,2,0.8823529411764706,0.9170305676855895,shc-gpt-4o,mimiciii,radiology_report,PROMPT2_ICL_entailment
317,384,15,15,0,1.0,13,12,1,0.9230769230769232,0.96,shc-gpt-4o,mimiciii,radiology_report,PROMPT2_ICL_entailment
318,385,27,26,1,0.9629629629629628,27,22,5,0.8148148148148148,0.882716049382716,shc-gpt-4o,mimiciii,radiology_report,PROMPT2_ICL_entailment
319,386,17,17,0,1.0,18,14,4,0.7777777777777778,0.8750000000000001,shc-gpt-4o,mimiciii,radiology_report,PROMPT2_ICL_entailment
320,387,23,23,0,1.0,19,17,2,0.8947368421052632,0.9444444444444444,shc-gpt-4o,mimiciii,radiology_report,PROMPT2_ICL_entailment
321,388,24,22,2,0.9166666666666666,33,25,8,0.7575757575757576,0.8295625942684766,shc-gpt-4o,mimiciii,radiology_report,PROMPT2_ICL_entailment
322,389,19,16,3,0.8421052631578947,12,10,2,0.8333333333333334,0.8376963350785339,shc-gpt-4o,mimiciii,radiology_report,PROMPT2_ICL_entailment
323,39,13,13,0,1.0,10,9,1,0.9,0.9473684210526316,shc-gpt-4o,mimiciii,radiology_report,PROMPT2_ICL_entailment
324,390,14,12,2,0.8571428571428571,14,12,2,0.8571428571428571,0.8571428571428571,shc-gpt-4o,mimiciii,radiology_report,PROMPT2_ICL_entailment
325,391,13,13,0,1.0,13,10,3,0.7692307692307693,0.8695652173913044,shc-gpt-4o,mimiciii,radiology_report,PROMPT2_ICL_entailment
326,392,15,15,0,1.0,15,13,2,0.8666666666666667,0.9285714285714286,shc-gpt-4o,mimiciii,radiology_report,PROMPT2_ICL_entailment
327,393,22,20,2,0.9090909090909092,19,15,4,0.7894736842105263,0.8450704225352113,shc-gpt-4o,mimiciii,radiology_report,PROMPT2_ICL_entailment
328,394,20,19,1,0.95,18,18,0,1.0,0.9743589743589745,shc-gpt-4o,mimiciii,radiology_report,PROMPT2_ICL_entailment
329,395,16,16,0,1.0,16,14,2,0.875,0.9333333333333332,shc-gpt-4o,mimiciii,radiology_report,PROMPT2_ICL_entailment
330,396,17,15,2,0.8823529411764706,19,11,8,0.5789473684210527,0.6991525423728814,shc-gpt-4o,mimiciii,radiology_report,PROMPT2_ICL_entailment
331,397,19,19,0,1.0,18,13,5,0.7222222222222222,0.8387096774193548,shc-gpt-4o,mimiciii,radiology_report,PROMPT2_ICL_entailment
332,398,30,29,1,0.9666666666666668,21,18,3,0.8571428571428571,0.908616187989556,shc-gpt-4o,mimiciii,radiology_report,PROMPT2_ICL_entailment
333,399,19,18,1,0.9473684210526316,19,12,7,0.631578947368421,0.7578947368421052,shc-gpt-4o,mimiciii,radiology_report,PROMPT2_ICL_entailment
334,4,15,15,0,1.0,16,13,3,0.8125,0.896551724137931,shc-gpt-4o,mimiciii,radiology_report,PROMPT2_ICL_entailment
335,40,20,19,1,0.95,17,15,2,0.8823529411764706,0.9149277688603532,shc-gpt-4o,mimiciii,radiology_report,PROMPT2_ICL_entailment
336,400,13,13,0,1.0,13,7,6,0.5384615384615384,0.7000000000000001,shc-gpt-4o,mimiciii,radiology_report,PROMPT2_ICL_entailment
337,401,10,10,0,1.0,9,9,0,1.0,1.0,shc-gpt-4o,mimiciii,radiology_report,PROMPT2_ICL_entailment
338,402,21,17,4,0.8095238095238095,20,14,6,0.7,0.750788643533123,shc-gpt-4o,mimiciii,radiology_report,PROMPT2_ICL_entailment
339,403,16,16,0,1.0,18,13,5,0.7222222222222222,0.8387096774193548,shc-gpt-4o,mimiciii,radiology_report,PROMPT2_ICL_entailment
340,404,19,19,0,1.0,19,16,3,0.8421052631578947,0.9142857142857144,shc-gpt-4o,mimiciii,radiology_report,PROMPT2_ICL_entailment
341,405,20,20,0,1.0,14,11,3,0.7857142857142857,0.88,shc-gpt-4o,mimiciii,radiology_report,PROMPT2_ICL_entailment
342,406,28,26,2,0.9285714285714286,25,20,5,0.8,0.859504132231405,shc-gpt-4o,mimiciii,radiology_report,PROMPT2_ICL_entailment
343,407,25,20,5,0.8,20,14,6,0.7,0.7466666666666666,shc-gpt-4o,mimiciii,radiology_report,PROMPT2_ICL_entailment
344,408,19,19,0,1.0,20,15,5,0.75,0.8571428571428571,shc-gpt-4o,mimiciii,radiology_report,PROMPT2_ICL_entailment
345,409,21,20,1,0.9523809523809524,18,14,4,0.7777777777777778,0.856269113149847,shc-gpt-4o,mimiciii,radiology_report,PROMPT2_ICL_entailment
346,41,31,26,5,0.8387096774193549,26,20,6,0.7692307692307693,0.8024691358024693,shc-gpt-4o,mimiciii,radiology_report,PROMPT2_ICL_entailment
347,410,21,20,1,0.9523809523809524,20,17,3,0.85,0.8982826948480845,shc-gpt-4o,mimiciii,radiology_report,PROMPT2_ICL_entailment
348,411,6,6,0,1.0,6,5,1,0.8333333333333334,0.9090909090909092,shc-gpt-4o,mimiciii,radiology_report,PROMPT2_ICL_entailment
349,412,31,26,5,0.8387096774193549,26,21,5,0.8076923076923077,0.8229088168801809,shc-gpt-4o,mimiciii,radiology_report,PROMPT2_ICL_entailment
350,413,14,14,0,1.0,14,12,2,0.8571428571428571,0.923076923076923,shc-gpt-4o,mimiciii,radiology_report,PROMPT2_ICL_entailment
351,414,28,28,0,1.0,28,26,2,0.9285714285714286,0.962962962962963,shc-gpt-4o,mimiciii,radiology_report,PROMPT2_ICL_entailment
352,415,22,21,1,0.9545454545454546,20,18,2,0.9,0.9264705882352942,shc-gpt-4o,mimiciii,radiology_report,PROMPT2_ICL_entailment
353,416,18,18,0,1.0,17,13,4,0.7647058823529411,0.8666666666666666,shc-gpt-4o,mimiciii,radiology_report,PROMPT2_ICL_entailment
354,417,31,29,2,0.935483870967742,20,17,3,0.85,0.8906955736224028,shc-gpt-4o,mimiciii,radiology_report,PROMPT2_ICL_entailment
355,418,18,15,3,0.8333333333333334,14,11,3,0.7857142857142857,0.8088235294117647,shc-gpt-4o,mimiciii,radiology_report,PROMPT2_ICL_entailment
356,419,21,20,1,0.9523809523809524,16,13,3,0.8125,0.8768971332209106,shc-gpt-4o,mimiciii,radiology_report,PROMPT2_ICL_entailment
357,42,17,17,0,1.0,14,10,4,0.7142857142857143,0.8333333333333333,shc-gpt-4o,mimiciii,radiology_report,PROMPT2_ICL_entailment
358,420,16,15,1,0.9375,15,10,5,0.6666666666666666,0.7792207792207793,shc-gpt-4o,mimiciii,radiology_report,PROMPT2_ICL_entailment
359,421,22,19,3,0.8636363636363636,23,20,3,0.8695652173913043,0.8665906499429875,shc-gpt-4o,mimiciii,radiology_report,PROMPT2_ICL_entailment
360,422,22,21,1,0.9545454545454546,20,15,5,0.75,0.84,shc-gpt-4o,mimiciii,radiology_report,PROMPT2_ICL_entailment
361,423,15,15,0,1.0,12,11,1,0.9166666666666666,0.9565217391304348,shc-gpt-4o,mimiciii,radiology_report,PROMPT2_ICL_entailment
362,424,8,7,1,0.875,9,8,1,0.8888888888888888,0.8818897637795274,shc-gpt-4o,mimiciii,radiology_report,PROMPT2_ICL_entailment
363,425,21,19,2,0.9047619047619048,19,15,4,0.7894736842105263,0.8431952662721893,shc-gpt-4o,mimiciii,radiology_report,PROMPT2_ICL_entailment
364,426,17,17,0,1.0,16,14,2,0.875,0.9333333333333332,shc-gpt-4o,mimiciii,radiology_report,PROMPT2_ICL_entailment
365,427,11,11,0,1.0,15,12,3,0.8,0.888888888888889,shc-gpt-4o,mimiciii,radiology_report,PROMPT2_ICL_entailment
366,428,12,12,0,1.0,15,14,1,0.9333333333333332,0.9655172413793104,shc-gpt-4o,mimiciii,radiology_report,PROMPT2_ICL_entailment
367,429,16,15,1,0.9375,13,10,3,0.7692307692307693,0.8450704225352113,shc-gpt-4o,mimiciii,radiology_report,PROMPT2_ICL_entailment
368,43,10,9,1,0.9,7,5,2,0.7142857142857143,0.7964601769911505,shc-gpt-4o,mimiciii,radiology_report,PROMPT2_ICL_entailment
369,430,9,9,0,1.0,7,5,2,0.7142857142857143,0.8333333333333333,shc-gpt-4o,mimiciii,radiology_report,PROMPT2_ICL_entailment
370,431,14,10,4,0.7142857142857143,18,10,8,0.5555555555555556,0.6250000000000001,shc-gpt-4o,mimiciii,radiology_report,PROMPT2_ICL_entailment
371,432,22,22,0,1.0,13,11,2,0.8461538461538461,0.9166666666666666,shc-gpt-4o,mimiciii,radiology_report,PROMPT2_ICL_entailment
372,433,17,16,1,0.9411764705882352,18,15,3,0.8333333333333334,0.8839779005524863,shc-gpt-4o,mimiciii,radiology_report,PROMPT2_ICL_entailment
373,434,26,23,3,0.8846153846153846,27,22,5,0.8148148148148148,0.8482816429170159,shc-gpt-4o,mimiciii,radiology_report,PROMPT2_ICL_entailment
374,435,17,17,0,1.0,13,13,0,1.0,1.0,shc-gpt-4o,mimiciii,radiology_report,PROMPT2_ICL_entailment
375,436,26,26,0,1.0,25,22,3,0.88,0.9361702127659576,shc-gpt-4o,mimiciii,radiology_report,PROMPT2_ICL_entailment
376,437,11,11,0,1.0,7,7,0,1.0,1.0,shc-gpt-4o,mimiciii,radiology_report,PROMPT2_ICL_entailment
377,438,17,17,0,1.0,19,13,6,0.6842105263157895,0.8125000000000001,shc-gpt-4o,mimiciii,radiology_report,PROMPT2_ICL_entailment
378,439,22,19,3,0.8636363636363636,22,19,3,0.8636363636363636,0.8636363636363636,shc-gpt-4o,mimiciii,radiology_report,PROMPT2_ICL_entailment
379,44,12,12,0,1.0,16,11,5,0.6875,0.8148148148148148,shc-gpt-4o,mimiciii,radiology_report,PROMPT2_ICL_entailment
380,440,17,17,0,1.0,19,12,7,0.631578947368421,0.7741935483870968,shc-gpt-4o,mimiciii,radiology_report,PROMPT2_ICL_entailment
381,441,16,12,4,0.75,17,17,0,1.0,0.8571428571428571,shc-gpt-4o,mimiciii,radiology_report,PROMPT2_ICL_entailment
382,442,13,13,0,1.0,12,9,3,0.75,0.8571428571428571,shc-gpt-4o,mimiciii,radiology_report,PROMPT2_ICL_entailment
383,443,20,17,3,0.85,21,16,5,0.7619047619047619,0.8035450516986705,shc-gpt-4o,mimiciii,radiology_report,PROMPT2_ICL_entailment
384,444,11,10,1,0.9090909090909092,8,6,2,0.75,0.821917808219178,shc-gpt-4o,mimiciii,radiology_report,PROMPT2_ICL_entailment
385,445,21,19,2,0.9047619047619048,22,17,5,0.7727272727272727,0.8335483870967741,shc-gpt-4o,mimiciii,radiology_report,PROMPT2_ICL_entailment
386,446,26,24,2,0.9230769230769232,22,15,7,0.6818181818181818,0.7843137254901961,shc-gpt-4o,mimiciii,radiology_report,PROMPT2_ICL_entailment
387,447,17,17,0,1.0,14,13,1,0.9285714285714286,0.962962962962963,shc-gpt-4o,mimiciii,radiology_report,PROMPT2_ICL_entailment
388,448,28,24,4,0.8571428571428571,36,30,6,0.8333333333333334,0.8450704225352113,shc-gpt-4o,mimiciii,radiology_report,PROMPT2_ICL_entailment
389,449,10,10,0,1.0,9,7,2,0.7777777777777778,0.8750000000000001,shc-gpt-4o,mimiciii,radiology_report,PROMPT2_ICL_entailment
390,45,19,19,0,1.0,20,12,8,0.6,0.7499999999999999,shc-gpt-4o,mimiciii,radiology_report,PROMPT2_ICL_entailment
391,450,26,25,1,0.9615384615384616,21,18,3,0.8571428571428571,0.9063444108761328,shc-gpt-4o,mimiciii,radiology_report,PROMPT2_ICL_entailment
392,451,12,11,1,0.9166666666666666,10,8,2,0.8,0.854368932038835,shc-gpt-4o,mimiciii,radiology_report,PROMPT2_ICL_entailment
393,452,21,21,0,1.0,16,12,4,0.75,0.8571428571428571,shc-gpt-4o,mimiciii,radiology_report,PROMPT2_ICL_entailment
394,453,16,16,0,1.0,14,12,2,0.8571428571428571,0.923076923076923,shc-gpt-4o,mimiciii,radiology_report,PROMPT2_ICL_entailment
395,454,9,8,1,0.8888888888888888,10,6,4,0.6,0.7164179104477612,shc-gpt-4o,mimiciii,radiology_report,PROMPT2_ICL_entailment
396,455,19,18,1,0.9473684210526316,16,14,2,0.875,0.9097472924187724,shc-gpt-4o,mimiciii,radiology_report,PROMPT2_ICL_entailment
397,456,19,17,2,0.8947368421052632,21,20,1,0.9523809523809524,0.9226594301221168,shc-gpt-4o,mimiciii,radiology_report,PROMPT2_ICL_entailment
398,457,15,15,0,1.0,12,9,3,0.75,0.8571428571428571,shc-gpt-4o,mimiciii,radiology_report,PROMPT2_ICL_entailment
399,458,18,18,0,1.0,16,10,6,0.625,0.7692307692307693,shc-gpt-4o,mimiciii,radiology_report,PROMPT2_ICL_entailment
400,459,16,15,1,0.9375,13,10,3,0.7692307692307693,0.8450704225352113,shc-gpt-4o,mimiciii,radiology_report,PROMPT2_ICL_entailment
401,46,14,14,0,1.0,22,15,7,0.6818181818181818,0.8108108108108109,shc-gpt-4o,mimiciii,radiology_report,PROMPT2_ICL_entailment
402,460,21,20,1,0.9523809523809524,20,16,4,0.8,0.8695652173913043,shc-gpt-4o,mimiciii,radiology_report,PROMPT2_ICL_entailment
403,461,19,17,2,0.8947368421052632,22,14,8,0.6363636363636364,0.74375,shc-gpt-4o,mimiciii,radiology_report,PROMPT2_ICL_entailment
404,462,24,22,2,0.9166666666666666,20,16,4,0.8,0.854368932038835,shc-gpt-4o,mimiciii,radiology_report,PROMPT2_ICL_entailment
405,463,19,19,0,1.0,12,10,2,0.8333333333333334,0.9090909090909092,shc-gpt-4o,mimiciii,radiology_report,PROMPT2_ICL_entailment
406,464,26,25,1,0.9615384615384616,25,22,3,0.88,0.9189640768588136,shc-gpt-4o,mimiciii,radiology_report,PROMPT2_ICL_entailment
407,465,27,25,2,0.925925925925926,33,27,6,0.8181818181818182,0.8687258687258688,shc-gpt-4o,mimiciii,radiology_report,PROMPT2_ICL_entailment
408,466,19,17,2,0.8947368421052632,22,18,4,0.8181818181818182,0.8547486033519553,shc-gpt-4o,mimiciii,radiology_report,PROMPT2_ICL_entailment
409,467,12,12,0,1.0,14,13,1,0.9285714285714286,0.962962962962963,shc-gpt-4o,mimiciii,radiology_report,PROMPT2_ICL_entailment
410,468,20,20,0,1.0,18,13,5,0.7222222222222222,0.8387096774193548,shc-gpt-4o,mimiciii,radiology_report,PROMPT2_ICL_entailment
411,469,27,23,4,0.8518518518518519,25,22,3,0.88,0.8656971770744225,shc-gpt-4o,mimiciii,radiology_report,PROMPT2_ICL_entailment
412,47,19,19,0,1.0,15,14,1,0.9333333333333332,0.9655172413793104,shc-gpt-4o,mimiciii,radiology_report,PROMPT2_ICL_entailment
413,470,11,10,1,0.9090909090909092,15,13,2,0.8666666666666667,0.887372013651877,shc-gpt-4o,mimiciii,radiology_report,PROMPT2_ICL_entailment
414,471,23,22,1,0.9565217391304348,18,12,6,0.6666666666666666,0.7857142857142856,shc-gpt-4o,mimiciii,radiology_report,PROMPT2_ICL_entailment
415,472,20,20,0,1.0,16,12,4,0.75,0.8571428571428571,shc-gpt-4o,mimiciii,radiology_report,PROMPT2_ICL_entailment
416,473,12,12,0,1.0,11,9,2,0.8181818181818182,0.9,shc-gpt-4o,mimiciii,radiology_report,PROMPT2_ICL_entailment
417,474,22,21,1,0.9545454545454546,25,23,2,0.92,0.9369544131910768,shc-gpt-4o,mimiciii,radiology_report,PROMPT2_ICL_entailment
418,475,7,7,0,1.0,7,5,2,0.7142857142857143,0.8333333333333333,shc-gpt-4o,mimiciii,radiology_report,PROMPT2_ICL_entailment
419,476,23,23,0,1.0,12,9,3,0.75,0.8571428571428571,shc-gpt-4o,mimiciii,radiology_report,PROMPT2_ICL_entailment
420,477,14,12,2,0.8571428571428571,16,12,4,0.75,0.7999999999999999,shc-gpt-4o,mimiciii,radiology_report,PROMPT2_ICL_entailment
421,478,22,19,3,0.8636363636363636,21,16,5,0.7619047619047619,0.8095872170439413,shc-gpt-4o,mimiciii,radiology_report,PROMPT2_ICL_entailment
422,479,15,15,0,1.0,22,18,4,0.8181818181818182,0.9,shc-gpt-4o,mimiciii,radiology_report,PROMPT2_ICL_entailment
423,48,19,18,1,0.9473684210526316,21,17,4,0.8095238095238095,0.8730385164051354,shc-gpt-4o,mimiciii,radiology_report,PROMPT2_ICL_entailment
424,480,15,11,4,0.7333333333333333,10,5,5,0.5,0.5945945945945945,shc-gpt-4o,mimiciii,radiology_report,PROMPT2_ICL_entailment
425,481,22,22,0,1.0,17,12,5,0.7058823529411765,0.8275862068965517,shc-gpt-4o,mimiciii,radiology_report,PROMPT2_ICL_entailment
426,482,20,20,0,1.0,19,13,6,0.6842105263157895,0.8125000000000001,shc-gpt-4o,mimiciii,radiology_report,PROMPT2_ICL_entailment
427,483,25,24,1,0.96,23,17,6,0.7391304347826086,0.8352098259979529,shc-gpt-4o,mimiciii,radiology_report,PROMPT2_ICL_entailment
428,484,9,9,0,1.0,13,9,4,0.6923076923076923,0.8181818181818181,shc-gpt-4o,mimiciii,radiology_report,PROMPT2_ICL_entailment
429,485,23,23,0,1.0,24,20,4,0.8333333333333334,0.9090909090909092,shc-gpt-4o,mimiciii,radiology_report,PROMPT2_ICL_entailment
430,486,12,11,1,0.9166666666666666,11,9,2,0.8181818181818182,0.8646288209606987,shc-gpt-4o,mimiciii,radiology_report,PROMPT2_ICL_entailment
431,487,22,20,2,0.9090909090909092,20,13,7,0.65,0.7580174927113703,shc-gpt-4o,mimiciii,radiology_report,PROMPT2_ICL_entailment
432,488,19,17,2,0.8947368421052632,15,12,3,0.8,0.84472049689441,shc-gpt-4o,mimiciii,radiology_report,PROMPT2_ICL_entailment
433,489,22,19,3,0.8636363636363636,18,14,4,0.7777777777777778,0.8184615384615385,shc-gpt-4o,mimiciii,radiology_report,PROMPT2_ICL_entailment
434,49,19,18,1,0.9473684210526316,24,19,5,0.7916666666666666,0.8625472887767969,shc-gpt-4o,mimiciii,radiology_report,PROMPT2_ICL_entailment
435,490,7,7,0,1.0,8,3,5,0.375,0.5454545454545454,shc-gpt-4o,mimiciii,radiology_report,PROMPT2_ICL_entailment
436,491,18,18,0,1.0,17,9,8,0.5294117647058824,0.6923076923076924,shc-gpt-4o,mimiciii,radiology_report,PROMPT2_ICL_entailment
437,492,16,15,1,0.9375,13,9,4,0.6923076923076923,0.7964601769911505,shc-gpt-4o,mimiciii,radiology_report,PROMPT2_ICL_entailment
438,493,14,14,0,1.0,9,6,3,0.6666666666666666,0.8,shc-gpt-4o,mimiciii,radiology_report,PROMPT2_ICL_entailment
439,494,11,9,2,0.8181818181818182,8,6,2,0.75,0.7826086956521738,shc-gpt-4o,mimiciii,radiology_report,PROMPT2_ICL_entailment
440,495,10,10,0,1.0,12,10,2,0.8333333333333334,0.9090909090909092,shc-gpt-4o,mimiciii,radiology_report,PROMPT2_ICL_entailment
441,496,29,29,0,1.0,32,22,10,0.6875,0.8148148148148148,shc-gpt-4o,mimiciii,radiology_report,PROMPT2_ICL_entailment
442,497,18,16,2,0.8888888888888888,22,17,5,0.7727272727272727,0.8267477203647416,shc-gpt-4o,mimiciii,radiology_report,PROMPT2_ICL_entailment
443,498,28,26,2,0.9285714285714286,22,17,5,0.7727272727272727,0.8435114503816794,shc-gpt-4o,mimiciii,radiology_report,PROMPT2_ICL_entailment
444,499,20,20,0,1.0,17,13,4,0.7647058823529411,0.8666666666666666,shc-gpt-4o,mimiciii,radiology_report,PROMPT2_ICL_entailment
445,5,16,16,0,1.0,22,13,9,0.5909090909090909,0.7428571428571429,shc-gpt-4o,mimiciii,radiology_report,PROMPT2_ICL_entailment
446,50,17,17,0,1.0,15,11,4,0.7333333333333333,0.846153846153846,shc-gpt-4o,mimiciii,radiology_report,PROMPT2_ICL_entailment
447,51,16,15,1,0.9375,13,11,2,0.8461538461538461,0.8894878706199459,shc-gpt-4o,mimiciii,radiology_report,PROMPT2_ICL_entailment
448,52,21,20,1,0.9523809523809524,21,17,4,0.8095238095238095,0.8751608751608752,shc-gpt-4o,mimiciii,radiology_report,PROMPT2_ICL_entailment
449,53,17,16,1,0.9411764705882352,12,10,2,0.8333333333333334,0.8839779005524863,shc-gpt-4o,mimiciii,radiology_report,PROMPT2_ICL_entailment
450,54,12,12,0,1.0,10,6,4,0.6,0.7499999999999999,shc-gpt-4o,mimiciii,radiology_report,PROMPT2_ICL_entailment
451,55,17,16,1,0.9411764705882352,18,15,3,0.8333333333333334,0.8839779005524863,shc-gpt-4o,mimiciii,radiology_report,PROMPT2_ICL_entailment
452,56,16,13,3,0.8125,21,13,8,0.6190476190476191,0.7027027027027026,shc-gpt-4o,mimiciii,radiology_report,PROMPT2_ICL_entailment
453,57,11,8,3,0.7272727272727273,10,7,3,0.7,0.7133757961783439,shc-gpt-4o,mimiciii,radiology_report,PROMPT2_ICL_entailment
454,58,26,26,0,1.0,16,12,4,0.75,0.8571428571428571,shc-gpt-4o,mimiciii,radiology_report,PROMPT2_ICL_entailment
455,59,15,14,1,0.9333333333333332,16,13,3,0.8125,0.8687350835322195,shc-gpt-4o,mimiciii,radiology_report,PROMPT2_ICL_entailment
456,6,8,8,0,1.0,8,5,3,0.625,0.7692307692307693,shc-gpt-4o,mimiciii,radiology_report,PROMPT2_ICL_entailment
457,60,19,19,0,1.0,19,15,4,0.7894736842105263,0.8823529411764706,shc-gpt-4o,mimiciii,radiology_report,PROMPT2_ICL_entailment
458,61,22,22,0,1.0,22,20,2,0.9090909090909092,0.9523809523809524,shc-gpt-4o,mimiciii,radiology_report,PROMPT2_ICL_entailment
459,62,18,18,0,1.0,13,10,3,0.7692307692307693,0.8695652173913044,shc-gpt-4o,mimiciii,radiology_report,PROMPT2_ICL_entailment
460,63,16,16,0,1.0,15,11,4,0.7333333333333333,0.846153846153846,shc-gpt-4o,mimiciii,radiology_report,PROMPT2_ICL_entailment
461,64,24,22,2,0.9166666666666666,20,14,6,0.7,0.7938144329896907,shc-gpt-4o,mimiciii,radiology_report,PROMPT2_ICL_entailment
462,65,26,24,2,0.9230769230769232,18,15,3,0.8333333333333334,0.8759124087591241,shc-gpt-4o,mimiciii,radiology_report,PROMPT2_ICL_entailment
463,66,20,19,1,0.95,29,22,7,0.7586206896551724,0.8435923309788091,shc-gpt-4o,mimiciii,radiology_report,PROMPT2_ICL_entailment
464,67,20,19,1,0.95,28,24,4,0.8571428571428571,0.9011857707509882,shc-gpt-4o,mimiciii,radiology_report,PROMPT2_ICL_entailment
465,68,25,22,3,0.88,30,21,9,0.7,0.7797468354430379,shc-gpt-4o,mimiciii,radiology_report,PROMPT2_ICL_entailment
466,69,25,22,3,0.88,31,24,7,0.7741935483870968,0.8237129485179406,shc-gpt-4o,mimiciii,radiology_report,PROMPT2_ICL_entailment
467,7,19,18,1,0.9473684210526316,16,14,2,0.875,0.9097472924187724,shc-gpt-4o,mimiciii,radiology_report,PROMPT2_ICL_entailment
468,70,15,11,4,0.7333333333333333,17,14,3,0.8235294117647058,0.7758186397984888,shc-gpt-4o,mimiciii,radiology_report,PROMPT2_ICL_entailment
469,71,18,16,2,0.8888888888888888,18,12,6,0.6666666666666666,0.761904761904762,shc-gpt-4o,mimiciii,radiology_report,PROMPT2_ICL_entailment
470,72,14,14,0,1.0,13,12,1,0.9230769230769232,0.96,shc-gpt-4o,mimiciii,radiology_report,PROMPT2_ICL_entailment
471,73,23,22,1,0.9565217391304348,29,17,12,0.5862068965517241,0.7269193391642372,shc-gpt-4o,mimiciii,radiology_report,PROMPT2_ICL_entailment
472,74,15,15,0,1.0,18,14,4,0.7777777777777778,0.8750000000000001,shc-gpt-4o,mimiciii,radiology_report,PROMPT2_ICL_entailment
473,75,20,20,0,1.0,12,11,1,0.9166666666666666,0.9565217391304348,shc-gpt-4o,mimiciii,radiology_report,PROMPT2_ICL_entailment
474,76,13,12,1,0.9230769230769232,14,10,4,0.7142857142857143,0.8053691275167787,shc-gpt-4o,mimiciii,radiology_report,PROMPT2_ICL_entailment
475,77,29,23,6,0.7931034482758621,26,19,7,0.7307692307692307,0.7606614447345518,shc-gpt-4o,mimiciii,radiology_report,PROMPT2_ICL_entailment
476,78,27,20,7,0.7407407407407407,33,25,8,0.7575757575757576,0.7490636704119851,shc-gpt-4o,mimiciii,radiology_report,PROMPT2_ICL_entailment
477,79,17,17,0,1.0,17,15,2,0.8823529411764706,0.9375,shc-gpt-4o,mimiciii,radiology_report,PROMPT2_ICL_entailment
478,8,22,22,0,1.0,15,13,2,0.8666666666666667,0.9285714285714286,shc-gpt-4o,mimiciii,radiology_report,PROMPT2_ICL_entailment
479,80,22,21,1,0.9545454545454546,25,20,5,0.8,0.8704663212435233,shc-gpt-4o,mimiciii,radiology_report,PROMPT2_ICL_entailment
480,81,16,16,0,1.0,15,9,6,0.6,0.7499999999999999,shc-gpt-4o,mimiciii,radiology_report,PROMPT2_ICL_entailment
481,82,14,12,2,0.8571428571428571,14,13,1,0.9285714285714286,0.8914285714285715,shc-gpt-4o,mimiciii,radiology_report,PROMPT2_ICL_entailment
482,83,21,19,2,0.9047619047619048,17,14,3,0.8235294117647058,0.8622366288492707,shc-gpt-4o,mimiciii,radiology_report,PROMPT2_ICL_entailment
483,84,19,18,1,0.9473684210526316,20,17,3,0.85,0.8960468521229868,shc-gpt-4o,mimiciii,radiology_report,PROMPT2_ICL_entailment
484,85,18,16,2,0.8888888888888888,14,12,2,0.8571428571428571,0.8727272727272727,shc-gpt-4o,mimiciii,radiology_report,PROMPT2_ICL_entailment
485,86,14,14,0,1.0,10,10,0,1.0,1.0,shc-gpt-4o,mimiciii,radiology_report,PROMPT2_ICL_entailment
486,87,16,16,0,1.0,14,11,3,0.7857142857142857,0.88,shc-gpt-4o,mimiciii,radiology_report,PROMPT2_ICL_entailment
487,88,21,20,1,0.9523809523809524,19,15,4,0.7894736842105263,0.8633093525179856,shc-gpt-4o,mimiciii,radiology_report,PROMPT2_ICL_entailment
488,89,21,19,2,0.9047619047619048,18,15,3,0.8333333333333334,0.867579908675799,shc-gpt-4o,mimiciii,radiology_report,PROMPT2_ICL_entailment
489,9,12,12,0,1.0,13,13,0,1.0,1.0,shc-gpt-4o,mimiciii,radiology_report,PROMPT2_ICL_entailment
490,90,11,11,0,1.0,14,12,2,0.8571428571428571,0.923076923076923,shc-gpt-4o,mimiciii,radiology_report,PROMPT2_ICL_entailment
491,91,14,14,0,1.0,13,9,4,0.6923076923076923,0.8181818181818181,shc-gpt-4o,mimiciii,radiology_report,PROMPT2_ICL_entailment
492,92,21,20,1,0.9523809523809524,21,16,5,0.7619047619047619,0.8465608465608465,shc-gpt-4o,mimiciii,radiology_report,PROMPT2_ICL_entailment
493,93,22,22,0,1.0,15,14,1,0.9333333333333332,0.9655172413793104,shc-gpt-4o,mimiciii,radiology_report,PROMPT2_ICL_entailment
494,94,28,24,4,0.8571428571428571,28,23,5,0.8214285714285714,0.8389057750759878,shc-gpt-4o,mimiciii,radiology_report,PROMPT2_ICL_entailment
495,95,21,20,1,0.9523809523809524,18,8,10,0.4444444444444444,0.6060606060606061,shc-gpt-4o,mimiciii,radiology_report,PROMPT2_ICL_entailment
496,96,18,18,0,1.0,21,15,6,0.7142857142857143,0.8333333333333333,shc-gpt-4o,mimiciii,radiology_report,PROMPT2_ICL_entailment
497,97,19,16,3,0.8421052631578947,23,18,5,0.782608695652174,0.8112676056338028,shc-gpt-4o,mimiciii,radiology_report,PROMPT2_ICL_entailment
498,98,24,20,4,0.8333333333333334,19,14,5,0.7368421052631579,0.782122905027933,shc-gpt-4o,mimiciii,radiology_report,PROMPT2_ICL_entailment
499,99,17,17,0,1.0,13,12,1,0.9230769230769232,0.96,shc-gpt-4o,mimiciii,radiology_report,PROMPT2_ICL_entailment
0,0,23,22,1,0.9565217391304348,21,14,7,0.6666666666666666,0.7857142857142856,shc-gpt-4o,mimiciii,radiology_report,PROMPT2_entailment
1,1,14,14,0,1.0,15,11,4,0.7333333333333333,0.846153846153846,shc-gpt-4o,mimiciii,radiology_report,PROMPT2_entailment
2,10,14,12,2,0.8571428571428571,18,15,3,0.8333333333333334,0.8450704225352113,shc-gpt-4o,mimiciii,radiology_report,PROMPT2_entailment
3,100,11,11,0,1.0,9,9,0,1.0,1.0,shc-gpt-4o,mimiciii,radiology_report,PROMPT2_entailment
4,101,10,10,0,1.0,15,10,5,0.6666666666666666,0.8,shc-gpt-4o,mimiciii,radiology_report,PROMPT2_entailment
5,102,13,13,0,1.0,16,12,4,0.75,0.8571428571428571,shc-gpt-4o,mimiciii,radiology_report,PROMPT2_entailment
6,103,18,18,0,1.0,19,18,1,0.9473684210526316,0.972972972972973,shc-gpt-4o,mimiciii,radiology_report,PROMPT2_entailment
7,104,12,12,0,1.0,17,9,8,0.5294117647058824,0.6923076923076924,shc-gpt-4o,mimiciii,radiology_report,PROMPT2_entailment
8,105,6,6,0,1.0,8,6,2,0.75,0.8571428571428571,shc-gpt-4o,mimiciii,radiology_report,PROMPT2_entailment
9,106,10,10,0,1.0,12,9,3,0.75,0.8571428571428571,shc-gpt-4o,mimiciii,radiology_report,PROMPT2_entailment
10,107,16,14,2,0.875,19,13,6,0.6842105263157895,0.7679324894514769,shc-gpt-4o,mimiciii,radiology_report,PROMPT2_entailment
11,108,14,14,0,1.0,13,11,2,0.8461538461538461,0.9166666666666666,shc-gpt-4o,mimiciii,radiology_report,PROMPT2_entailment
12,109,16,14,2,0.875,20,14,6,0.7,0.7777777777777777,shc-gpt-4o,mimiciii,radiology_report,PROMPT2_entailment
13,11,15,15,0,1.0,20,18,2,0.9,0.9473684210526316,shc-gpt-4o,mimiciii,radiology_report,PROMPT2_entailment
14,110,17,15,2,0.8823529411764706,17,15,2,0.8823529411764706,0.8823529411764706,shc-gpt-4o,mimiciii,radiology_report,PROMPT2_entailment
15,111,14,14,0,1.0,20,18,2,0.9,0.9473684210526316,shc-gpt-4o,mimiciii,radiology_report,PROMPT2_entailment
16,112,9,9,0,1.0,14,13,1,0.9285714285714286,0.962962962962963,shc-gpt-4o,mimiciii,radiology_report,PROMPT2_entailment
17,113,19,12,7,0.631578947368421,20,16,4,0.8,0.7058823529411765,shc-gpt-4o,mimiciii,radiology_report,PROMPT2_entailment
18,114,20,14,6,0.7,23,19,4,0.8260869565217391,0.7578347578347578,shc-gpt-4o,mimiciii,radiology_report,PROMPT2_entailment
19,115,15,15,0,1.0,20,16,4,0.8,0.888888888888889,shc-gpt-4o,mimiciii,radiology_report,PROMPT2_entailment
20,116,9,9,0,1.0,13,9,4,0.6923076923076923,0.8181818181818181,shc-gpt-4o,mimiciii,radiology_report,PROMPT2_entailment
21,117,12,11,1,0.9166666666666666,16,12,4,0.75,0.8250000000000001,shc-gpt-4o,mimiciii,radiology_report,PROMPT2_entailment
22,118,19,18,1,0.9473684210526316,24,22,2,0.9166666666666666,0.9317647058823528,shc-gpt-4o,mimiciii,radiology_report,PROMPT2_entailment
23,119,15,15,0,1.0,17,14,3,0.8235294117647058,0.9032258064516128,shc-gpt-4o,mimiciii,radiology_report,PROMPT2_entailment
24,12,11,11,0,1.0,17,14,3,0.8235294117647058,0.9032258064516128,shc-gpt-4o,mimiciii,radiology_report,PROMPT2_entailment
25,120,18,16,2,0.8888888888888888,16,10,6,0.625,0.7339449541284404,shc-gpt-4o,mimiciii,radiology_report,PROMPT2_entailment
26,121,27,20,7,0.7407407407407407,26,19,7,0.7307692307692307,0.7357212003872217,shc-gpt-4o,mimiciii,radiology_report,PROMPT2_entailment
27,122,14,14,0,1.0,20,16,4,0.8,0.888888888888889,shc-gpt-4o,mimiciii,radiology_report,PROMPT2_entailment
28,123,10,10,0,1.0,13,10,3,0.7692307692307693,0.8695652173913044,shc-gpt-4o,mimiciii,radiology_report,PROMPT2_entailment
29,124,10,10,0,1.0,12,8,4,0.6666666666666666,0.8,shc-gpt-4o,mimiciii,radiology_report,PROMPT2_entailment
30,125,20,17,3,0.85,23,20,3,0.8695652173913043,0.8596713021491782,shc-gpt-4o,mimiciii,radiology_report,PROMPT2_entailment
31,126,9,8,1,0.8888888888888888,9,7,2,0.7777777777777778,0.8296296296296296,shc-gpt-4o,mimiciii,radiology_report,PROMPT2_entailment
32,127,34,33,1,0.9705882352941176,43,30,13,0.6976744186046512,0.8118081180811809,shc-gpt-4o,mimiciii,radiology_report,PROMPT2_entailment
33,128,12,12,0,1.0,14,11,3,0.7857142857142857,0.88,shc-gpt-4o,mimiciii,radiology_report,PROMPT2_entailment
34,129,10,10,0,1.0,16,12,4,0.75,0.8571428571428571,shc-gpt-4o,mimiciii,radiology_report,PROMPT2_entailment
35,13,12,11,1,0.9166666666666666,17,14,3,0.8235294117647058,0.8676056338028169,shc-gpt-4o,mimiciii,radiology_report,PROMPT2_entailment
36,130,16,16,0,1.0,25,15,10,0.6,0.7499999999999999,shc-gpt-4o,mimiciii,radiology_report,PROMPT2_entailment
37,131,11,11,0,1.0,32,22,10,0.6875,0.8148148148148148,shc-gpt-4o,mimiciii,radiology_report,PROMPT2_entailment
38,132,12,8,4,0.6666666666666666,23,12,11,0.5217391304347826,0.5853658536585366,shc-gpt-4o,mimiciii,radiology_report,PROMPT2_entailment
39,133,16,14,2,0.875,21,17,4,0.8095238095238095,0.8409893992932863,shc-gpt-4o,mimiciii,radiology_report,PROMPT2_entailment
40,134,16,14,2,0.875,23,19,4,0.8260869565217391,0.8498402555910542,shc-gpt-4o,mimiciii,radiology_report,PROMPT2_entailment
41,135,15,15,0,1.0,20,17,3,0.85,0.9189189189189187,shc-gpt-4o,mimiciii,radiology_report,PROMPT2_entailment
42,136,10,10,0,1.0,14,11,3,0.7857142857142857,0.88,shc-gpt-4o,mimiciii,radiology_report,PROMPT2_entailment
43,137,7,7,0,1.0,10,9,1,0.9,0.9473684210526316,shc-gpt-4o,mimiciii,radiology_report,PROMPT2_entailment
44,138,11,11,0,1.0,14,11,3,0.7857142857142857,0.88,shc-gpt-4o,mimiciii,radiology_report,PROMPT2_entailment
45,139,12,12,0,1.0,13,10,3,0.7692307692307693,0.8695652173913044,shc-gpt-4o,mimiciii,radiology_report,PROMPT2_entailment
46,14,8,8,0,1.0,12,8,4,0.6666666666666666,0.8,shc-gpt-4o,mimiciii,radiology_report,PROMPT2_entailment
47,140,14,13,1,0.9285714285714286,18,15,3,0.8333333333333334,0.8783783783783784,shc-gpt-4o,mimiciii,radiology_report,PROMPT2_entailment
48,141,13,13,0,1.0,16,10,6,0.625,0.7692307692307693,shc-gpt-4o,mimiciii,radiology_report,PROMPT2_entailment
49,142,11,11,0,1.0,14,13,1,0.9285714285714286,0.962962962962963,shc-gpt-4o,mimiciii,radiology_report,PROMPT2_entailment
50,143,21,21,0,1.0,28,19,9,0.6785714285714286,0.8085106382978724,shc-gpt-4o,mimiciii,radiology_report,PROMPT2_entailment
51,144,15,14,1,0.9333333333333332,23,17,6,0.7391304347826086,0.8249566724436742,shc-gpt-4o,mimiciii,radiology_report,PROMPT2_entailment
52,145,19,19,0,1.0,18,15,3,0.8333333333333334,0.9090909090909092,shc-gpt-4o,mimiciii,radiology_report,PROMPT2_entailment
53,146,8,8,0,1.0,11,6,5,0.5454545454545454,0.7058823529411764,shc-gpt-4o,mimiciii,radiology_report,PROMPT2_entailment
54,147,8,8,0,1.0,10,7,3,0.7,0.8235294117647058,shc-gpt-4o,mimiciii,radiology_report,PROMPT2_entailment
55,148,20,20,0,1.0,26,22,4,0.8461538461538461,0.9166666666666666,shc-gpt-4o,mimiciii,radiology_report,PROMPT2_entailment
56,149,17,14,3,0.8235294117647058,20,16,4,0.8,0.8115942028985507,shc-gpt-4o,mimiciii,radiology_report,PROMPT2_entailment
57,15,26,23,3,0.8846153846153846,29,22,7,0.7586206896551724,0.8167877320419693,shc-gpt-4o,mimiciii,radiology_report,PROMPT2_entailment
58,150,10,10,0,1.0,14,8,6,0.5714285714285714,0.7272727272727273,shc-gpt-4o,mimiciii,radiology_report,PROMPT2_entailment
59,151,16,13,3,0.8125,15,9,6,0.6,0.6902654867256637,shc-gpt-4o,mimiciii,radiology_report,PROMPT2_entailment
60,152,14,14,0,1.0,18,15,3,0.8333333333333334,0.9090909090909092,shc-gpt-4o,mimiciii,radiology_report,PROMPT2_entailment
61,153,14,12,2,0.8571428571428571,16,13,3,0.8125,0.8342245989304812,shc-gpt-4o,mimiciii,radiology_report,PROMPT2_entailment
62,154,20,18,2,0.9,23,18,5,0.782608695652174,0.8372093023255814,shc-gpt-4o,mimiciii,radiology_report,PROMPT2_entailment
63,155,25,25,0,1.0,47,38,9,0.8085106382978723,0.8941176470588235,shc-gpt-4o,mimiciii,radiology_report,PROMPT2_entailment
64,156,19,16,3,0.8421052631578947,20,15,5,0.75,0.7933884297520661,shc-gpt-4o,mimiciii,radiology_report,PROMPT2_entailment
65,157,9,9,0,1.0,12,10,2,0.8333333333333334,0.9090909090909092,shc-gpt-4o,mimiciii,radiology_report,PROMPT2_entailment
66,158,4,4,0,1.0,6,4,2,0.6666666666666666,0.8,shc-gpt-4o,mimiciii,radiology_report,PROMPT2_entailment
67,159,12,12,0,1.0,13,10,3,0.7692307692307693,0.8695652173913044,shc-gpt-4o,mimiciii,radiology_report,PROMPT2_entailment
68,16,14,14,0,1.0,17,13,4,0.7647058823529411,0.8666666666666666,shc-gpt-4o,mimiciii,radiology_report,PROMPT2_entailment
69,160,14,14,0,1.0,12,10,2,0.8333333333333334,0.9090909090909092,shc-gpt-4o,mimiciii,radiology_report,PROMPT2_entailment
70,161,12,12,0,1.0,13,11,2,0.8461538461538461,0.9166666666666666,shc-gpt-4o,mimiciii,radiology_report,PROMPT2_entailment
71,162,9,9,0,1.0,11,10,1,0.9090909090909092,0.9523809523809524,shc-gpt-4o,mimiciii,radiology_report,PROMPT2_entailment
72,163,10,10,0,1.0,8,5,3,0.625,0.7692307692307693,shc-gpt-4o,mimiciii,radiology_report,PROMPT2_entailment
73,164,13,13,0,1.0,10,10,0,1.0,1.0,shc-gpt-4o,mimiciii,radiology_report,PROMPT2_entailment
74,165,17,15,2,0.8823529411764706,28,22,6,0.7857142857142857,0.8312342569269522,shc-gpt-4o,mimiciii,radiology_report,PROMPT2_entailment
75,166,21,18,3,0.8571428571428571,26,22,4,0.8461538461538461,0.8516129032258064,shc-gpt-4o,mimiciii,radiology_report,PROMPT2_entailment
76,167,7,7,0,1.0,10,7,3,0.7,0.8235294117647058,shc-gpt-4o,mimiciii,radiology_report,PROMPT2_entailment
77,168,11,11,0,1.0,13,8,5,0.6153846153846154,0.761904761904762,shc-gpt-4o,mimiciii,radiology_report,PROMPT2_entailment
78,169,17,16,1,0.9411764705882352,22,16,6,0.7272727272727273,0.8205128205128205,shc-gpt-4o,mimiciii,radiology_report,PROMPT2_entailment
79,17,11,11,0,1.0,12,8,4,0.6666666666666666,0.8,shc-gpt-4o,mimiciii,radiology_report,PROMPT2_entailment
80,170,22,20,2,0.9090909090909092,24,18,6,0.75,0.821917808219178,shc-gpt-4o,mimiciii,radiology_report,PROMPT2_entailment
81,171,7,7,0,1.0,7,6,1,0.8571428571428571,0.923076923076923,shc-gpt-4o,mimiciii,radiology_report,PROMPT2_entailment
82,172,11,11,0,1.0,14,11,3,0.7857142857142857,0.88,shc-gpt-4o,mimiciii,radiology_report,PROMPT2_entailment
83,173,10,9,1,0.9,12,12,0,1.0,0.9473684210526316,shc-gpt-4o,mimiciii,radiology_report,PROMPT2_entailment
84,174,14,14,0,1.0,20,13,7,0.65,0.787878787878788,shc-gpt-4o,mimiciii,radiology_report,PROMPT2_entailment
85,175,7,7,0,1.0,8,7,1,0.875,0.9333333333333332,shc-gpt-4o,mimiciii,radiology_report,PROMPT2_entailment
86,176,17,14,3,0.8235294117647058,19,18,1,0.9473684210526316,0.881118881118881,shc-gpt-4o,mimiciii,radiology_report,PROMPT2_entailment
87,177,16,15,1,0.9375,16,13,3,0.8125,0.8705357142857143,shc-gpt-4o,mimiciii,radiology_report,PROMPT2_entailment
88,178,22,20,2,0.9090909090909092,25,24,1,0.96,0.9338521400778208,shc-gpt-4o,mimiciii,radiology_report,PROMPT2_entailment
89,179,10,9,1,0.9,17,8,9,0.4705882352941176,0.6180257510729613,shc-gpt-4o,mimiciii,radiology_report,PROMPT2_entailment
90,18,14,14,0,1.0,17,12,5,0.7058823529411765,0.8275862068965517,shc-gpt-4o,mimiciii,radiology_report,PROMPT2_entailment
91,180,10,10,0,1.0,11,10,1,0.9090909090909092,0.9523809523809524,shc-gpt-4o,mimiciii,radiology_report,PROMPT2_entailment
92,181,22,20,2,0.9090909090909092,26,18,8,0.6923076923076923,0.7860262008733625,shc-gpt-4o,mimiciii,radiology_report,PROMPT2_entailment
93,182,16,15,1,0.9375,23,14,9,0.6086956521739131,0.7381370826010545,shc-gpt-4o,mimiciii,radiology_report,PROMPT2_entailment
94,183,11,8,3,0.7272727272727273,17,11,6,0.6470588235294118,0.6848249027237354,shc-gpt-4o,mimiciii,radiology_report,PROMPT2_entailment
95,184,10,10,0,1.0,15,12,3,0.8,0.888888888888889,shc-gpt-4o,mimiciii,radiology_report,PROMPT2_entailment
96,185,7,7,0,1.0,6,5,1,0.8333333333333334,0.9090909090909092,shc-gpt-4o,mimiciii,radiology_report,PROMPT2_entailment
97,186,13,12,1,0.9230769230769232,26,24,2,0.9230769230769232,0.9230769230769232,shc-gpt-4o,mimiciii,radiology_report,PROMPT2_entailment
98,187,19,19,0,1.0,14,11,3,0.7857142857142857,0.88,shc-gpt-4o,mimiciii,radiology_report,PROMPT2_entailment
99,188,22,21,1,0.9545454545454546,22,17,5,0.7727272727272727,0.8540669856459331,shc-gpt-4o,mimiciii,radiology_report,PROMPT2_entailment
100,189,10,10,0,1.0,15,13,2,0.8666666666666667,0.9285714285714286,shc-gpt-4o,mimiciii,radiology_report,PROMPT2_entailment
101,19,9,9,0,1.0,14,10,4,0.7142857142857143,0.8333333333333333,shc-gpt-4o,mimiciii,radiology_report,PROMPT2_entailment
102,190,13,13,0,1.0,17,16,1,0.9411764705882352,0.9696969696969696,shc-gpt-4o,mimiciii,radiology_report,PROMPT2_entailment
103,191,21,17,4,0.8095238095238095,15,11,4,0.7333333333333333,0.7695473251028807,shc-gpt-4o,mimiciii,radiology_report,PROMPT2_entailment
104,192,22,18,4,0.8181818181818182,28,19,9,0.6785714285714286,0.7418655097613883,shc-gpt-4o,mimiciii,radiology_report,PROMPT2_entailment
105,193,13,13,0,1.0,14,12,2,0.8571428571428571,0.923076923076923,shc-gpt-4o,mimiciii,radiology_report,PROMPT2_entailment
106,194,22,21,1,0.9545454545454546,38,23,15,0.6052631578947368,0.74079754601227,shc-gpt-4o,mimiciii,radiology_report,PROMPT2_entailment
107,195,18,16,2,0.8888888888888888,21,18,3,0.8571428571428571,0.8727272727272727,shc-gpt-4o,mimiciii,radiology_report,PROMPT2_entailment
108,196,12,10,2,0.8333333333333334,18,13,5,0.7222222222222222,0.7738095238095238,shc-gpt-4o,mimiciii,radiology_report,PROMPT2_entailment
109,197,11,10,1,0.9090909090909092,15,10,5,0.6666666666666666,0.7692307692307692,shc-gpt-4o,mimiciii,radiology_report,PROMPT2_entailment
110,198,9,8,1,0.8888888888888888,9,7,2,0.7777777777777778,0.8296296296296296,shc-gpt-4o,mimiciii,radiology_report,PROMPT2_entailment
111,199,24,22,2,0.9166666666666666,23,20,3,0.8695652173913043,0.8924949290060852,shc-gpt-4o,mimiciii,radiology_report,PROMPT2_entailment
112,2,15,14,1,0.9333333333333332,15,11,4,0.7333333333333333,0.8213333333333334,shc-gpt-4o,mimiciii,radiology_report,PROMPT2_entailment
113,20,18,18,0,1.0,36,32,4,0.8888888888888888,0.9411764705882352,shc-gpt-4o,mimiciii,radiology_report,PROMPT2_entailment
114,200,11,10,1,0.9090909090909092,14,14,0,1.0,0.9523809523809524,shc-gpt-4o,mimiciii,radiology_report,PROMPT2_entailment
115,201,18,15,3,0.8333333333333334,18,15,3,0.8333333333333334,0.8333333333333334,shc-gpt-4o,mimiciii,radiology_report,PROMPT2_entailment
116,202,16,16,0,1.0,24,19,5,0.7916666666666666,0.8837209302325582,shc-gpt-4o,mimiciii,radiology_report,PROMPT2_entailment
117,203,21,18,3,0.8571428571428571,19,14,5,0.7368421052631579,0.7924528301886793,shc-gpt-4o,mimiciii,radiology_report,PROMPT2_entailment
118,204,17,17,0,1.0,23,21,2,0.9130434782608696,0.9545454545454544,shc-gpt-4o,mimiciii,radiology_report,PROMPT2_entailment
119,205,20,20,0,1.0,14,11,3,0.7857142857142857,0.88,shc-gpt-4o,mimiciii,radiology_report,PROMPT2_entailment
120,206,14,14,0,1.0,13,10,3,0.7692307692307693,0.8695652173913044,shc-gpt-4o,mimiciii,radiology_report,PROMPT2_entailment
121,207,8,8,0,1.0,9,7,2,0.7777777777777778,0.8750000000000001,shc-gpt-4o,mimiciii,radiology_report,PROMPT2_entailment
122,208,13,13,0,1.0,18,16,2,0.8888888888888888,0.9411764705882352,shc-gpt-4o,mimiciii,radiology_report,PROMPT2_entailment
123,209,15,14,1,0.9333333333333332,16,15,1,0.9375,0.935412026726058,shc-gpt-4o,mimiciii,radiology_report,PROMPT2_entailment
124,21,26,26,0,1.0,27,21,6,0.7777777777777778,0.8750000000000001,shc-gpt-4o,mimiciii,radiology_report,PROMPT2_entailment
125,210,12,10,2,0.8333333333333334,14,9,5,0.6428571428571429,0.7258064516129034,shc-gpt-4o,mimiciii,radiology_report,PROMPT2_entailment
126,211,11,10,1,0.9090909090909092,13,10,3,0.7692307692307693,0.8333333333333333,shc-gpt-4o,mimiciii,radiology_report,PROMPT2_entailment
127,212,18,16,2,0.8888888888888888,19,19,0,1.0,0.9411764705882352,shc-gpt-4o,mimiciii,radiology_report,PROMPT2_entailment
128,213,14,14,0,1.0,22,17,5,0.7727272727272727,0.8717948717948718,shc-gpt-4o,mimiciii,radiology_report,PROMPT2_entailment
129,214,23,14,9,0.6086956521739131,23,20,3,0.8695652173913043,0.7161125319693096,shc-gpt-4o,mimiciii,radiology_report,PROMPT2_entailment
130,215,8,8,0,1.0,10,7,3,0.7,0.8235294117647058,shc-gpt-4o,mimiciii,radiology_report,PROMPT2_entailment
131,216,16,15,1,0.9375,19,13,6,0.6842105263157895,0.7910750507099392,shc-gpt-4o,mimiciii,radiology_report,PROMPT2_entailment
132,217,14,13,1,0.9285714285714286,20,10,10,0.5,0.65,shc-gpt-4o,mimiciii,radiology_report,PROMPT2_entailment
133,218,17,16,1,0.9411764705882352,15,10,5,0.6666666666666666,0.7804878048780487,shc-gpt-4o,mimiciii,radiology_report,PROMPT2_entailment
134,219,15,15,0,1.0,13,8,5,0.6153846153846154,0.761904761904762,shc-gpt-4o,mimiciii,radiology_report,PROMPT2_entailment
135,22,17,15,2,0.8823529411764706,19,19,0,1.0,0.9375,shc-gpt-4o,mimiciii,radiology_report,PROMPT2_entailment
136,220,10,10,0,1.0,19,19,0,1.0,1.0,shc-gpt-4o,mimiciii,radiology_report,PROMPT2_entailment
137,221,21,20,1,0.9523809523809524,27,17,10,0.6296296296296297,0.758082497212932,shc-gpt-4o,mimiciii,radiology_report,PROMPT2_entailment
138,222,19,19,0,1.0,16,12,4,0.75,0.8571428571428571,shc-gpt-4o,mimiciii,radiology_report,PROMPT2_entailment
139,223,19,16,3,0.8421052631578947,21,17,4,0.8095238095238095,0.8254931714719271,shc-gpt-4o,mimiciii,radiology_report,PROMPT2_entailment
140,224,26,23,3,0.8846153846153846,17,13,4,0.7647058823529411,0.8203017832647462,shc-gpt-4o,mimiciii,radiology_report,PROMPT2_entailment
141,225,8,8,0,1.0,11,7,4,0.6363636363636364,0.7777777777777778,shc-gpt-4o,mimiciii,radiology_report,PROMPT2_entailment
142,226,13,12,1,0.9230769230769232,18,13,5,0.7222222222222222,0.8103896103896105,shc-gpt-4o,mimiciii,radiology_report,PROMPT2_entailment
143,227,14,13,1,0.9285714285714286,18,13,5,0.7222222222222222,0.8125000000000001,shc-gpt-4o,mimiciii,radiology_report,PROMPT2_entailment
144,228,16,15,1,0.9375,17,15,2,0.8823529411764706,0.9090909090909092,shc-gpt-4o,mimiciii,radiology_report,PROMPT2_entailment
145,229,34,32,2,0.9411764705882352,44,31,13,0.7045454545454546,0.8058489033306255,shc-gpt-4o,mimiciii,radiology_report,PROMPT2_entailment
146,23,15,15,0,1.0,15,12,3,0.8,0.888888888888889,shc-gpt-4o,mimiciii,radiology_report,PROMPT2_entailment
147,230,12,10,2,0.8333333333333334,17,15,2,0.8823529411764706,0.8571428571428571,shc-gpt-4o,mimiciii,radiology_report,PROMPT2_entailment
148,231,10,10,0,1.0,13,10,3,0.7692307692307693,0.8695652173913044,shc-gpt-4o,mimiciii,radiology_report,PROMPT2_entailment
149,232,15,15,0,1.0,18,15,3,0.8333333333333334,0.9090909090909092,shc-gpt-4o,mimiciii,radiology_report,PROMPT2_entailment
150,233,19,19,0,1.0,17,13,4,0.7647058823529411,0.8666666666666666,shc-gpt-4o,mimiciii,radiology_report,PROMPT2_entailment
151,234,6,6,0,1.0,11,10,1,0.9090909090909092,0.9523809523809524,shc-gpt-4o,mimiciii,radiology_report,PROMPT2_entailment
152,235,12,12,0,1.0,14,13,1,0.9285714285714286,0.962962962962963,shc-gpt-4o,mimiciii,radiology_report,PROMPT2_entailment
153,236,14,14,0,1.0,11,10,1,0.9090909090909092,0.9523809523809524,shc-gpt-4o,mimiciii,radiology_report,PROMPT2_entailment
154,237,18,14,4,0.7777777777777778,17,13,4,0.7647058823529411,0.7711864406779662,shc-gpt-4o,mimiciii,radiology_report,PROMPT2_entailment
155,238,13,12,1,0.9230769230769232,20,16,4,0.8,0.8571428571428571,shc-gpt-4o,mimiciii,radiology_report,PROMPT2_entailment
156,239,14,14,0,1.0,17,13,4,0.7647058823529411,0.8666666666666666,shc-gpt-4o,mimiciii,radiology_report,PROMPT2_entailment
157,24,15,15,0,1.0,18,15,3,0.8333333333333334,0.9090909090909092,shc-gpt-4o,mimiciii,radiology_report,PROMPT2_entailment
158,240,9,9,0,1.0,13,12,1,0.9230769230769232,0.96,shc-gpt-4o,mimiciii,radiology_report,PROMPT2_entailment
159,241,13,13,0,1.0,16,13,3,0.8125,0.896551724137931,shc-gpt-4o,mimiciii,radiology_report,PROMPT2_entailment
160,242,18,18,0,1.0,18,14,4,0.7777777777777778,0.8750000000000001,shc-gpt-4o,mimiciii,radiology_report,PROMPT2_entailment
161,243,10,9,1,0.9,13,9,4,0.6923076923076923,0.7826086956521738,shc-gpt-4o,mimiciii,radiology_report,PROMPT2_entailment
162,244,15,13,2,0.8666666666666667,17,17,0,1.0,0.9285714285714286,shc-gpt-4o,mimiciii,radiology_report,PROMPT2_entailment
163,245,23,17,6,0.7391304347826086,28,23,5,0.8214285714285714,0.7781094527363184,shc-gpt-4o,mimiciii,radiology_report,PROMPT2_entailment
164,246,7,7,0,1.0,12,7,5,0.5833333333333334,0.7368421052631579,shc-gpt-4o,mimiciii,radiology_report,PROMPT2_entailment
165,247,9,9,0,1.0,12,9,3,0.75,0.8571428571428571,shc-gpt-4o,mimiciii,radiology_report,PROMPT2_entailment
166,248,15,14,1,0.9333333333333332,17,13,4,0.7647058823529411,0.8406466512702079,shc-gpt-4o,mimiciii,radiology_report,PROMPT2_entailment
167,249,17,14,3,0.8235294117647058,23,16,7,0.6956521739130435,0.7542087542087542,shc-gpt-4o,mimiciii,radiology_report,PROMPT2_entailment
168,25,21,20,1,0.9523809523809524,27,17,10,0.6296296296296297,0.758082497212932,shc-gpt-4o,mimiciii,radiology_report,PROMPT2_entailment
169,250,8,8,0,1.0,8,6,2,0.75,0.8571428571428571,shc-gpt-4o,mimiciii,radiology_report,PROMPT2_entailment
170,251,26,24,2,0.9230769230769232,22,19,3,0.8636363636363636,0.8923679060665364,shc-gpt-4o,mimiciii,radiology_report,PROMPT2_entailment
171,252,8,8,0,1.0,10,7,3,0.7,0.8235294117647058,shc-gpt-4o,mimiciii,radiology_report,PROMPT2_entailment
172,253,23,20,3,0.8695652173913043,24,22,2,0.9166666666666666,0.8924949290060852,shc-gpt-4o,mimiciii,radiology_report,PROMPT2_entailment
173,254,10,10,0,1.0,13,7,6,0.5384615384615384,0.7000000000000001,shc-gpt-4o,mimiciii,radiology_report,PROMPT2_entailment
174,255,13,13,0,1.0,16,11,5,0.6875,0.8148148148148148,shc-gpt-4o,mimiciii,radiology_report,PROMPT2_entailment
175,256,14,14,0,1.0,19,16,3,0.8421052631578947,0.9142857142857144,shc-gpt-4o,mimiciii,radiology_report,PROMPT2_entailment
176,257,15,15,0,1.0,15,13,2,0.8666666666666667,0.9285714285714286,shc-gpt-4o,mimiciii,radiology_report,PROMPT2_entailment
177,258,15,15,0,1.0,20,13,7,0.65,0.787878787878788,shc-gpt-4o,mimiciii,radiology_report,PROMPT2_entailment
178,259,12,12,0,1.0,17,14,3,0.8235294117647058,0.9032258064516128,shc-gpt-4o,mimiciii,radiology_report,PROMPT2_entailment
179,26,17,15,2,0.8823529411764706,18,13,5,0.7222222222222222,0.7942973523421588,shc-gpt-4o,mimiciii,radiology_report,PROMPT2_entailment
180,260,16,15,1,0.9375,20,11,9,0.55,0.6932773109243697,shc-gpt-4o,mimiciii,radiology_report,PROMPT2_entailment
181,261,21,19,2,0.9047619047619048,30,28,2,0.9333333333333332,0.9188255613126078,shc-gpt-4o,mimiciii,radiology_report,PROMPT2_entailment
182,262,15,13,2,0.8666666666666667,23,19,4,0.8260869565217391,0.845890410958904,shc-gpt-4o,mimiciii,radiology_report,PROMPT2_entailment
183,263,23,20,3,0.8695652173913043,27,23,4,0.8518518518518519,0.8606173994387277,shc-gpt-4o,mimiciii,radiology_report,PROMPT2_entailment
184,264,15,13,2,0.8666666666666667,20,17,3,0.85,0.858252427184466,shc-gpt-4o,mimiciii,radiology_report,PROMPT2_entailment
185,265,6,6,0,1.0,9,7,2,0.7777777777777778,0.8750000000000001,shc-gpt-4o,mimiciii,radiology_report,PROMPT2_entailment
186,266,11,10,1,0.9090909090909092,18,15,3,0.8333333333333334,0.8695652173913043,shc-gpt-4o,mimiciii,radiology_report,PROMPT2_entailment
187,267,10,10,0,1.0,16,16,0,1.0,1.0,shc-gpt-4o,mimiciii,radiology_report,PROMPT2_entailment
188,268,19,16,3,0.8421052631578947,20,16,4,0.8,0.8205128205128205,shc-gpt-4o,mimiciii,radiology_report,PROMPT2_entailment
189,269,20,20,0,1.0,25,21,4,0.84,0.9130434782608696,shc-gpt-4o,mimiciii,radiology_report,PROMPT2_entailment
190,27,16,16,0,1.0,14,11,3,0.7857142857142857,0.88,shc-gpt-4o,mimiciii,radiology_report,PROMPT2_entailment
191,270,16,14,2,0.875,17,13,4,0.7647058823529411,0.8161434977578476,shc-gpt-4o,mimiciii,radiology_report,PROMPT2_entailment
192,271,14,13,1,0.9285714285714286,17,12,5,0.7058823529411765,0.802056555269923,shc-gpt-4o,mimiciii,radiology_report,PROMPT2_entailment
193,272,19,18,1,0.9473684210526316,17,15,2,0.8823529411764706,0.9137055837563453,shc-gpt-4o,mimiciii,radiology_report,PROMPT2_entailment
194,273,11,10,1,0.9090909090909092,12,8,4,0.6666666666666666,0.7692307692307692,shc-gpt-4o,mimiciii,radiology_report,PROMPT2_entailment
195,274,14,11,3,0.7857142857142857,20,15,5,0.75,0.7674418604651163,shc-gpt-4o,mimiciii,radiology_report,PROMPT2_entailment
196,275,9,9,0,1.0,12,8,4,0.6666666666666666,0.8,shc-gpt-4o,mimiciii,radiology_report,PROMPT2_entailment
197,276,16,15,1,0.9375,24,19,5,0.7916666666666666,0.8584337349397592,shc-gpt-4o,mimiciii,radiology_report,PROMPT2_entailment
198,277,23,20,3,0.8695652173913043,25,22,3,0.88,0.874751491053678,shc-gpt-4o,mimiciii,radiology_report,PROMPT2_entailment
199,278,12,12,0,1.0,16,11,5,0.6875,0.8148148148148148,shc-gpt-4o,mimiciii,radiology_report,PROMPT2_entailment
200,279,9,9,0,1.0,10,8,2,0.8,0.888888888888889,shc-gpt-4o,mimiciii,radiology_report,PROMPT2_entailment
201,28,29,25,4,0.8620689655172413,30,24,6,0.8,0.8298755186721992,shc-gpt-4o,mimiciii,radiology_report,PROMPT2_entailment
202,280,12,12,0,1.0,12,10,2,0.8333333333333334,0.9090909090909092,shc-gpt-4o,mimiciii,radiology_report,PROMPT2_entailment
203,281,18,17,1,0.9444444444444444,24,17,7,0.7083333333333334,0.8095238095238096,shc-gpt-4o,mimiciii,radiology_report,PROMPT2_entailment
204,282,15,15,0,1.0,12,11,1,0.9166666666666666,0.9565217391304348,shc-gpt-4o,mimiciii,radiology_report,PROMPT2_entailment
205,283,14,14,0,1.0,25,17,8,0.68,0.8095238095238095,shc-gpt-4o,mimiciii,radiology_report,PROMPT2_entailment
206,284,14,13,1,0.9285714285714286,14,10,4,0.7142857142857143,0.8074534161490684,shc-gpt-4o,mimiciii,radiology_report,PROMPT2_entailment
207,285,15,15,0,1.0,18,17,1,0.9444444444444444,0.9714285714285714,shc-gpt-4o,mimiciii,radiology_report,PROMPT2_entailment
208,286,6,6,0,1.0,6,5,1,0.8333333333333334,0.9090909090909092,shc-gpt-4o,mimiciii,radiology_report,PROMPT2_entailment
209,287,15,14,1,0.9333333333333332,18,13,5,0.7222222222222222,0.814317673378076,shc-gpt-4o,mimiciii,radiology_report,PROMPT2_entailment
210,288,28,24,4,0.8571428571428571,32,25,7,0.78125,0.8174386920980925,shc-gpt-4o,mimiciii,radiology_report,PROMPT2_entailment
211,289,22,22,0,1.0,20,17,3,0.85,0.9189189189189187,shc-gpt-4o,mimiciii,radiology_report,PROMPT2_entailment
212,29,8,8,0,1.0,8,6,2,0.75,0.8571428571428571,shc-gpt-4o,mimiciii,radiology_report,PROMPT2_entailment
213,290,11,11,0,1.0,11,9,2,0.8181818181818182,0.9,shc-gpt-4o,mimiciii,radiology_report,PROMPT2_entailment
214,291,19,17,2,0.8947368421052632,23,12,11,0.5217391304347826,0.6591276252019386,shc-gpt-4o,mimiciii,radiology_report,PROMPT2_entailment
215,292,17,15,2,0.8823529411764706,21,15,6,0.7142857142857143,0.7894736842105262,shc-gpt-4o,mimiciii,radiology_report,PROMPT2_entailment
216,293,13,13,0,1.0,18,14,4,0.7777777777777778,0.8750000000000001,shc-gpt-4o,mimiciii,radiology_report,PROMPT2_entailment
217,294,18,18,0,1.0,22,16,6,0.7272727272727273,0.8421052631578948,shc-gpt-4o,mimiciii,radiology_report,PROMPT2_entailment
218,295,19,14,5,0.7368421052631579,32,25,7,0.78125,0.7583965330444202,shc-gpt-4o,mimiciii,radiology_report,PROMPT2_entailment
219,296,19,18,1,0.9473684210526316,17,16,1,0.9411764705882352,0.9442622950819672,shc-gpt-4o,mimiciii,radiology_report,PROMPT2_entailment
220,297,17,14,3,0.8235294117647058,24,15,9,0.625,0.7106598984771573,shc-gpt-4o,mimiciii,radiology_report,PROMPT2_entailment
221,298,17,16,1,0.9411764705882352,20,15,5,0.75,0.8347826086956521,shc-gpt-4o,mimiciii,radiology_report,PROMPT2_entailment
222,299,23,23,0,1.0,28,19,9,0.6785714285714286,0.8085106382978724,shc-gpt-4o,mimiciii,radiology_report,PROMPT2_entailment
223,3,15,15,0,1.0,20,16,4,0.8,0.888888888888889,shc-gpt-4o,mimiciii,radiology_report,PROMPT2_entailment
224,30,16,15,1,0.9375,21,16,5,0.7619047619047619,0.8406304728546409,shc-gpt-4o,mimiciii,radiology_report,PROMPT2_entailment
225,300,13,12,1,0.9230769230769232,13,7,6,0.5384615384615384,0.6801619433198379,shc-gpt-4o,mimiciii,radiology_report,PROMPT2_entailment
226,301,11,11,0,1.0,16,14,2,0.875,0.9333333333333332,shc-gpt-4o,mimiciii,radiology_report,PROMPT2_entailment
227,302,13,13,0,1.0,15,13,2,0.8666666666666667,0.9285714285714286,shc-gpt-4o,mimiciii,radiology_report,PROMPT2_entailment
228,303,20,17,3,0.85,24,20,4,0.8333333333333334,0.8415841584158417,shc-gpt-4o,mimiciii,radiology_report,PROMPT2_entailment
229,304,16,16,0,1.0,19,18,1,0.9473684210526316,0.972972972972973,shc-gpt-4o,mimiciii,radiology_report,PROMPT2_entailment
230,305,16,15,1,0.9375,24,15,9,0.625,0.75,shc-gpt-4o,mimiciii,radiology_report,PROMPT2_entailment
231,306,12,11,1,0.9166666666666666,14,12,2,0.8571428571428571,0.8859060402684563,shc-gpt-4o,mimiciii,radiology_report,PROMPT2_entailment
232,307,16,16,0,1.0,17,13,4,0.7647058823529411,0.8666666666666666,shc-gpt-4o,mimiciii,radiology_report,PROMPT2_entailment
233,308,15,12,3,0.8,15,10,5,0.6666666666666666,0.7272727272727272,shc-gpt-4o,mimiciii,radiology_report,PROMPT2_entailment
234,309,18,17,1,0.9444444444444444,26,21,5,0.8076923076923077,0.8707317073170732,shc-gpt-4o,mimiciii,radiology_report,PROMPT2_entailment
235,31,15,12,3,0.8,19,11,8,0.5789473684210527,0.6717557251908397,shc-gpt-4o,mimiciii,radiology_report,PROMPT2_entailment
236,310,17,17,0,1.0,24,18,6,0.75,0.8571428571428571,shc-gpt-4o,mimiciii,radiology_report,PROMPT2_entailment
237,311,10,6,4,0.6,15,11,4,0.7333333333333333,0.6599999999999999,shc-gpt-4o,mimiciii,radiology_report,PROMPT2_entailment
238,312,14,14,0,1.0,18,12,6,0.6666666666666666,0.8,shc-gpt-4o,mimiciii,radiology_report,PROMPT2_entailment
239,313,14,14,0,1.0,17,14,3,0.8235294117647058,0.9032258064516128,shc-gpt-4o,mimiciii,radiology_report,PROMPT2_entailment
240,314,16,16,0,1.0,15,13,2,0.8666666666666667,0.9285714285714286,shc-gpt-4o,mimiciii,radiology_report,PROMPT2_entailment
241,315,35,31,4,0.8857142857142857,25,19,6,0.76,0.8180555555555555,shc-gpt-4o,mimiciii,radiology_report,PROMPT2_entailment
242,316,8,7,1,0.875,10,7,3,0.7,0.7777777777777777,shc-gpt-4o,mimiciii,radiology_report,PROMPT2_entailment
243,317,22,17,5,0.7727272727272727,26,22,4,0.8461538461538461,0.8077753779697625,shc-gpt-4o,mimiciii,radiology_report,PROMPT2_entailment
244,318,18,16,2,0.8888888888888888,21,15,6,0.7142857142857143,0.792079207920792,shc-gpt-4o,mimiciii,radiology_report,PROMPT2_entailment
245,319,16,16,0,1.0,12,11,1,0.9166666666666666,0.9565217391304348,shc-gpt-4o,mimiciii,radiology_report,PROMPT2_entailment
246,32,11,9,2,0.8181818181818182,15,11,4,0.7333333333333333,0.7734375,shc-gpt-4o,mimiciii,radiology_report,PROMPT2_entailment
247,320,6,6,0,1.0,11,8,3,0.7272727272727273,0.8421052631578948,shc-gpt-4o,mimiciii,radiology_report,PROMPT2_entailment
248,321,16,14,2,0.875,21,18,3,0.8571428571428571,0.8659793814432989,shc-gpt-4o,mimiciii,radiology_report,PROMPT2_entailment
249,322,9,7,2,0.7777777777777778,8,6,2,0.75,0.7636363636363638,shc-gpt-4o,mimiciii,radiology_report,PROMPT2_entailment
250,323,17,16,1,0.9411764705882352,25,18,7,0.72,0.8158640226628895,shc-gpt-4o,mimiciii,radiology_report,PROMPT2_entailment
251,324,23,21,2,0.9130434782608696,18,14,4,0.7777777777777778,0.84,shc-gpt-4o,mimiciii,radiology_report,PROMPT2_entailment
252,325,22,20,2,0.9090909090909092,22,17,5,0.7727272727272727,0.8353808353808354,shc-gpt-4o,mimiciii,radiology_report,PROMPT2_entailment
253,326,11,10,1,0.9090909090909092,23,19,4,0.8260869565217391,0.8656036446469249,shc-gpt-4o,mimiciii,radiology_report,PROMPT2_entailment
254,327,8,8,0,1.0,9,9,0,1.0,1.0,shc-gpt-4o,mimiciii,radiology_report,PROMPT2_entailment
255,328,15,14,1,0.9333333333333332,17,13,4,0.7647058823529411,0.8406466512702079,shc-gpt-4o,mimiciii,radiology_report,PROMPT2_entailment
256,329,12,12,0,1.0,24,17,7,0.7083333333333334,0.8292682926829268,shc-gpt-4o,mimiciii,radiology_report,PROMPT2_entailment
257,33,8,8,0,1.0,9,7,2,0.7777777777777778,0.8750000000000001,shc-gpt-4o,mimiciii,radiology_report,PROMPT2_entailment
258,330,12,11,1,0.9166666666666666,11,8,3,0.7272727272727273,0.8110599078341013,shc-gpt-4o,mimiciii,radiology_report,PROMPT2_entailment
259,331,11,11,0,1.0,15,12,3,0.8,0.888888888888889,shc-gpt-4o,mimiciii,radiology_report,PROMPT2_entailment
260,332,18,16,2,0.8888888888888888,20,16,4,0.8,0.8421052631578948,shc-gpt-4o,mimiciii,radiology_report,PROMPT2_entailment
261,333,10,10,0,1.0,13,12,1,0.9230769230769232,0.96,shc-gpt-4o,mimiciii,radiology_report,PROMPT2_entailment
262,334,22,22,0,1.0,20,20,0,1.0,1.0,shc-gpt-4o,mimiciii,radiology_report,PROMPT2_entailment
263,335,18,18,0,1.0,17,14,3,0.8235294117647058,0.9032258064516128,shc-gpt-4o,mimiciii,radiology_report,PROMPT2_entailment
264,336,19,19,0,1.0,16,15,1,0.9375,0.967741935483871,shc-gpt-4o,mimiciii,radiology_report,PROMPT2_entailment
265,337,19,19,0,1.0,16,16,0,1.0,1.0,shc-gpt-4o,mimiciii,radiology_report,PROMPT2_entailment
266,338,11,11,0,1.0,13,7,6,0.5384615384615384,0.7000000000000001,shc-gpt-4o,mimiciii,radiology_report,PROMPT2_entailment
267,339,25,22,3,0.88,28,22,6,0.7857142857142857,0.830188679245283,shc-gpt-4o,mimiciii,radiology_report,PROMPT2_entailment
268,34,13,13,0,1.0,14,13,1,0.9285714285714286,0.962962962962963,shc-gpt-4o,mimiciii,radiology_report,PROMPT2_entailment
269,340,20,12,8,0.6,15,14,1,0.9333333333333332,0.7304347826086957,shc-gpt-4o,mimiciii,radiology_report,PROMPT2_entailment
270,341,4,4,0,1.0,6,5,1,0.8333333333333334,0.9090909090909092,shc-gpt-4o,mimiciii,radiology_report,PROMPT2_entailment
271,342,13,12,1,0.9230769230769232,15,13,2,0.8666666666666667,0.8939828080229226,shc-gpt-4o,mimiciii,radiology_report,PROMPT2_entailment
272,343,16,15,1,0.9375,22,17,5,0.7727272727272727,0.8471760797342192,shc-gpt-4o,mimiciii,radiology_report,PROMPT2_entailment
273,344,14,14,0,1.0,19,15,4,0.7894736842105263,0.8823529411764706,shc-gpt-4o,mimiciii,radiology_report,PROMPT2_entailment
274,345,18,18,0,1.0,22,19,3,0.8636363636363636,0.9268292682926828,shc-gpt-4o,mimiciii,radiology_report,PROMPT2_entailment
275,346,15,14,1,0.9333333333333332,15,11,4,0.7333333333333333,0.8213333333333334,shc-gpt-4o,mimiciii,radiology_report,PROMPT2_entailment
276,347,14,14,0,1.0,15,13,2,0.8666666666666667,0.9285714285714286,shc-gpt-4o,mimiciii,radiology_report,PROMPT2_entailment
277,348,11,10,1,0.9090909090909092,12,9,3,0.75,0.821917808219178,shc-gpt-4o,mimiciii,radiology_report,PROMPT2_entailment
278,349,16,15,1,0.9375,16,12,4,0.75,0.8333333333333334,shc-gpt-4o,mimiciii,radiology_report,PROMPT2_entailment
279,35,17,16,1,0.9411764705882352,21,17,4,0.8095238095238095,0.8704,shc-gpt-4o,mimiciii,radiology_report,PROMPT2_entailment
280,350,17,16,1,0.9411764705882352,21,16,5,0.7619047619047619,0.8421052631578947,shc-gpt-4o,mimiciii,radiology_report,PROMPT2_entailment
281,351,22,14,8,0.6363636363636364,21,18,3,0.8571428571428571,0.7304347826086957,shc-gpt-4o,mimiciii,radiology_report,PROMPT2_entailment
282,352,14,14,0,1.0,22,18,4,0.8181818181818182,0.9,shc-gpt-4o,mimiciii,radiology_report,PROMPT2_entailment
283,353,18,16,2,0.8888888888888888,23,19,4,0.8260869565217391,0.8563380281690139,shc-gpt-4o,mimiciii,radiology_report,PROMPT2_entailment
284,354,25,20,5,0.8,26,22,4,0.8461538461538461,0.8224299065420562,shc-gpt-4o,mimiciii,radiology_report,PROMPT2_entailment
285,355,17,16,1,0.9411764705882352,18,16,2,0.8888888888888888,0.9142857142857144,shc-gpt-4o,mimiciii,radiology_report,PROMPT2_entailment
286,356,16,12,4,0.75,22,19,3,0.8636363636363636,0.8028169014084506,shc-gpt-4o,mimiciii,radiology_report,PROMPT2_entailment
287,357,9,9,0,1.0,15,8,7,0.5333333333333333,0.6956521739130436,shc-gpt-4o,mimiciii,radiology_report,PROMPT2_entailment
288,358,17,17,0,1.0,12,7,5,0.5833333333333334,0.7368421052631579,shc-gpt-4o,mimiciii,radiology_report,PROMPT2_entailment
289,359,9,8,1,0.8888888888888888,18,15,3,0.8333333333333334,0.8602150537634408,shc-gpt-4o,mimiciii,radiology_report,PROMPT2_entailment
290,36,18,18,0,1.0,22,18,4,0.8181818181818182,0.9,shc-gpt-4o,mimiciii,radiology_report,PROMPT2_entailment
291,360,17,17,0,1.0,15,11,4,0.7333333333333333,0.846153846153846,shc-gpt-4o,mimiciii,radiology_report,PROMPT2_entailment
292,361,19,16,3,0.8421052631578947,23,16,7,0.6956521739130435,0.761904761904762,shc-gpt-4o,mimiciii,radiology_report,PROMPT2_entailment
293,362,13,13,0,1.0,24,15,9,0.625,0.7692307692307693,shc-gpt-4o,mimiciii,radiology_report,PROMPT2_entailment
294,363,20,18,2,0.9,22,17,5,0.7727272727272727,0.8315217391304347,shc-gpt-4o,mimiciii,radiology_report,PROMPT2_entailment
295,364,8,8,0,1.0,11,9,2,0.8181818181818182,0.9,shc-gpt-4o,mimiciii,radiology_report,PROMPT2_entailment
296,365,21,17,4,0.8095238095238095,29,19,10,0.6551724137931034,0.7242152466367713,shc-gpt-4o,mimiciii,radiology_report,PROMPT2_entailment
297,366,10,10,0,1.0,13,8,5,0.6153846153846154,0.761904761904762,shc-gpt-4o,mimiciii,radiology_report,PROMPT2_entailment
298,367,15,15,0,1.0,16,13,3,0.8125,0.896551724137931,shc-gpt-4o,mimiciii,radiology_report,PROMPT2_entailment
299,368,17,15,2,0.8823529411764706,20,15,5,0.75,0.8108108108108107,shc-gpt-4o,mimiciii,radiology_report,PROMPT2_entailment
300,369,18,18,0,1.0,20,14,6,0.7,0.8235294117647058,shc-gpt-4o,mimiciii,radiology_report,PROMPT2_entailment
301,37,11,9,2,0.8181818181818182,21,16,5,0.7619047619047619,0.7890410958904108,shc-gpt-4o,mimiciii,radiology_report,PROMPT2_entailment
302,370,10,10,0,1.0,19,11,8,0.5789473684210527,0.7333333333333334,shc-gpt-4o,mimiciii,radiology_report,PROMPT2_entailment
303,371,13,13,0,1.0,17,15,2,0.8823529411764706,0.9375,shc-gpt-4o,mimiciii,radiology_report,PROMPT2_entailment
304,372,15,15,0,1.0,27,17,10,0.6296296296296297,0.7727272727272727,shc-gpt-4o,mimiciii,radiology_report,PROMPT2_entailment
305,373,16,16,0,1.0,23,18,5,0.782608695652174,0.878048780487805,shc-gpt-4o,mimiciii,radiology_report,PROMPT2_entailment
306,374,9,9,0,1.0,11,8,3,0.7272727272727273,0.8421052631578948,shc-gpt-4o,mimiciii,radiology_report,PROMPT2_entailment
307,375,10,10,0,1.0,16,10,6,0.625,0.7692307692307693,shc-gpt-4o,mimiciii,radiology_report,PROMPT2_entailment
308,376,20,19,1,0.95,18,14,4,0.7777777777777778,0.855305466237942,shc-gpt-4o,mimiciii,radiology_report,PROMPT2_entailment
309,377,8,8,0,1.0,10,9,1,0.9,0.9473684210526316,shc-gpt-4o,mimiciii,radiology_report,PROMPT2_entailment
310,378,20,14,6,0.7,24,16,8,0.6666666666666666,0.6829268292682926,shc-gpt-4o,mimiciii,radiology_report,PROMPT2_entailment
311,379,16,15,1,0.9375,18,15,3,0.8333333333333334,0.8823529411764706,shc-gpt-4o,mimiciii,radiology_report,PROMPT2_entailment
312,38,15,14,1,0.9333333333333332,19,16,3,0.8421052631578947,0.8853754940711462,shc-gpt-4o,mimiciii,radiology_report,PROMPT2_entailment
313,380,8,8,0,1.0,8,6,2,0.75,0.8571428571428571,shc-gpt-4o,mimiciii,radiology_report,PROMPT2_entailment
314,381,10,10,0,1.0,14,11,3,0.7857142857142857,0.88,shc-gpt-4o,mimiciii,radiology_report,PROMPT2_entailment
315,382,13,12,1,0.9230769230769232,13,9,4,0.6923076923076923,0.7912087912087913,shc-gpt-4o,mimiciii,radiology_report,PROMPT2_entailment
316,383,13,12,1,0.9230769230769232,17,13,4,0.7647058823529411,0.8364611260053619,shc-gpt-4o,mimiciii,radiology_report,PROMPT2_entailment
317,384,11,11,0,1.0,13,13,0,1.0,1.0,shc-gpt-4o,mimiciii,radiology_report,PROMPT2_entailment
318,385,21,18,3,0.8571428571428571,27,25,2,0.925925925925926,0.8902077151335311,shc-gpt-4o,mimiciii,radiology_report,PROMPT2_entailment
319,386,16,16,0,1.0,18,14,4,0.7777777777777778,0.8750000000000001,shc-gpt-4o,mimiciii,radiology_report,PROMPT2_entailment
320,387,13,13,0,1.0,19,9,10,0.4736842105263157,0.6428571428571429,shc-gpt-4o,mimiciii,radiology_report,PROMPT2_entailment
321,388,20,16,4,0.8,33,28,5,0.8484848484848485,0.823529411764706,shc-gpt-4o,mimiciii,radiology_report,PROMPT2_entailment
322,389,16,16,0,1.0,12,10,2,0.8333333333333334,0.9090909090909092,shc-gpt-4o,mimiciii,radiology_report,PROMPT2_entailment
323,39,13,12,1,0.9230769230769232,10,8,2,0.8,0.8571428571428571,shc-gpt-4o,mimiciii,radiology_report,PROMPT2_entailment
324,390,11,10,1,0.9090909090909092,14,13,1,0.9285714285714286,0.9187279151943464,shc-gpt-4o,mimiciii,radiology_report,PROMPT2_entailment
325,391,11,11,0,1.0,13,8,5,0.6153846153846154,0.761904761904762,shc-gpt-4o,mimiciii,radiology_report,PROMPT2_entailment
326,392,11,11,0,1.0,15,10,5,0.6666666666666666,0.8,shc-gpt-4o,mimiciii,radiology_report,PROMPT2_entailment
327,393,21,20,1,0.9523809523809524,19,15,4,0.7894736842105263,0.8633093525179856,shc-gpt-4o,mimiciii,radiology_report,PROMPT2_entailment
328,394,14,14,0,1.0,18,17,1,0.9444444444444444,0.9714285714285714,shc-gpt-4o,mimiciii,radiology_report,PROMPT2_entailment
329,395,14,14,0,1.0,16,10,6,0.625,0.7692307692307693,shc-gpt-4o,mimiciii,radiology_report,PROMPT2_entailment
330,396,16,15,1,0.9375,19,16,3,0.8421052631578947,0.8872458410351202,shc-gpt-4o,mimiciii,radiology_report,PROMPT2_entailment
331,397,11,11,0,1.0,18,12,6,0.6666666666666666,0.8,shc-gpt-4o,mimiciii,radiology_report,PROMPT2_entailment
332,398,27,25,2,0.925925925925926,21,18,3,0.8571428571428571,0.8902077151335311,shc-gpt-4o,mimiciii,radiology_report,PROMPT2_entailment
333,399,15,13,2,0.8666666666666667,19,10,9,0.5263157894736842,0.654911838790932,shc-gpt-4o,mimiciii,radiology_report,PROMPT2_entailment
334,4,14,13,1,0.9285714285714286,16,14,2,0.875,0.900990099009901,shc-gpt-4o,mimiciii,radiology_report,PROMPT2_entailment
335,40,12,12,0,1.0,17,12,5,0.7058823529411765,0.8275862068965517,shc-gpt-4o,mimiciii,radiology_report,PROMPT2_entailment
336,400,10,10,0,1.0,13,7,6,0.5384615384615384,0.7000000000000001,shc-gpt-4o,mimiciii,radiology_report,PROMPT2_entailment
337,401,10,10,0,1.0,9,8,1,0.8888888888888888,0.9411764705882352,shc-gpt-4o,mimiciii,radiology_report,PROMPT2_entailment
338,402,15,12,3,0.8,20,14,6,0.7,0.7466666666666666,shc-gpt-4o,mimiciii,radiology_report,PROMPT2_entailment
339,403,12,11,1,0.9166666666666666,18,9,9,0.5,0.6470588235294118,shc-gpt-4o,mimiciii,radiology_report,PROMPT2_entailment
340,404,17,17,0,1.0,19,17,2,0.8947368421052632,0.9444444444444444,shc-gpt-4o,mimiciii,radiology_report,PROMPT2_entailment
341,405,15,15,0,1.0,14,11,3,0.7857142857142857,0.88,shc-gpt-4o,mimiciii,radiology_report,PROMPT2_entailment
342,406,27,26,1,0.9629629629629628,25,21,4,0.84,0.8972884141331141,shc-gpt-4o,mimiciii,radiology_report,PROMPT2_entailment
343,407,26,22,4,0.8461538461538461,20,16,4,0.8,0.8224299065420562,shc-gpt-4o,mimiciii,radiology_report,PROMPT2_entailment
344,408,18,18,0,1.0,20,14,6,0.7,0.8235294117647058,shc-gpt-4o,mimiciii,radiology_report,PROMPT2_entailment
345,409,24,23,1,0.9583333333333334,18,17,1,0.9444444444444444,0.951338199513382,shc-gpt-4o,mimiciii,radiology_report,PROMPT2_entailment
346,41,17,15,2,0.8823529411764706,26,17,9,0.6538461538461539,0.7511045655375552,shc-gpt-4o,mimiciii,radiology_report,PROMPT2_entailment
347,410,18,18,0,1.0,20,14,6,0.7,0.8235294117647058,shc-gpt-4o,mimiciii,radiology_report,PROMPT2_entailment
348,411,5,5,0,1.0,6,5,1,0.8333333333333334,0.9090909090909092,shc-gpt-4o,mimiciii,radiology_report,PROMPT2_entailment
349,412,17,13,4,0.7647058823529411,26,19,7,0.7307692307692307,0.7473524962178516,shc-gpt-4o,mimiciii,radiology_report,PROMPT2_entailment
350,413,11,11,0,1.0,14,11,3,0.7857142857142857,0.88,shc-gpt-4o,mimiciii,radiology_report,PROMPT2_entailment
351,414,23,21,2,0.9130434782608696,28,19,9,0.6785714285714286,0.7785365853658537,shc-gpt-4o,mimiciii,radiology_report,PROMPT2_entailment
352,415,14,13,1,0.9285714285714286,20,16,4,0.8,0.859504132231405,shc-gpt-4o,mimiciii,radiology_report,PROMPT2_entailment
353,416,16,16,0,1.0,17,15,2,0.8823529411764706,0.9375,shc-gpt-4o,mimiciii,radiology_report,PROMPT2_entailment
354,417,23,22,1,0.9565217391304348,20,18,2,0.9,0.9274004683840747,shc-gpt-4o,mimiciii,radiology_report,PROMPT2_entailment
355,418,11,11,0,1.0,14,11,3,0.7857142857142857,0.88,shc-gpt-4o,mimiciii,radiology_report,PROMPT2_entailment
356,419,18,18,0,1.0,16,12,4,0.75,0.8571428571428571,shc-gpt-4o,mimiciii,radiology_report,PROMPT2_entailment
357,42,12,12,0,1.0,14,9,5,0.6428571428571429,0.782608695652174,shc-gpt-4o,mimiciii,radiology_report,PROMPT2_entailment
358,420,13,13,0,1.0,15,11,4,0.7333333333333333,0.846153846153846,shc-gpt-4o,mimiciii,radiology_report,PROMPT2_entailment
359,421,20,18,2,0.9,23,20,3,0.8695652173913043,0.8845208845208845,shc-gpt-4o,mimiciii,radiology_report,PROMPT2_entailment
360,422,17,17,0,1.0,20,16,4,0.8,0.888888888888889,shc-gpt-4o,mimiciii,radiology_report,PROMPT2_entailment
361,423,10,10,0,1.0,12,10,2,0.8333333333333334,0.9090909090909092,shc-gpt-4o,mimiciii,radiology_report,PROMPT2_entailment
362,424,6,6,0,1.0,9,8,1,0.8888888888888888,0.9411764705882352,shc-gpt-4o,mimiciii,radiology_report,PROMPT2_entailment
363,425,19,18,1,0.9473684210526316,19,16,3,0.8421052631578947,0.8916408668730651,shc-gpt-4o,mimiciii,radiology_report,PROMPT2_entailment
364,426,17,16,1,0.9411764705882352,16,15,1,0.9375,0.9393346379647748,shc-gpt-4o,mimiciii,radiology_report,PROMPT2_entailment
365,427,12,12,0,1.0,15,11,4,0.7333333333333333,0.846153846153846,shc-gpt-4o,mimiciii,radiology_report,PROMPT2_entailment
366,428,10,9,1,0.9,15,13,2,0.8666666666666667,0.8830188679245283,shc-gpt-4o,mimiciii,radiology_report,PROMPT2_entailment
367,429,13,12,1,0.9230769230769232,13,10,3,0.7692307692307693,0.8391608391608392,shc-gpt-4o,mimiciii,radiology_report,PROMPT2_entailment
368,43,11,10,1,0.9090909090909092,7,6,1,0.8571428571428571,0.8823529411764706,shc-gpt-4o,mimiciii,radiology_report,PROMPT2_entailment
369,430,6,6,0,1.0,7,5,2,0.7142857142857143,0.8333333333333333,shc-gpt-4o,mimiciii,radiology_report,PROMPT2_entailment
370,431,13,8,5,0.6153846153846154,18,14,4,0.7777777777777778,0.6871165644171779,shc-gpt-4o,mimiciii,radiology_report,PROMPT2_entailment
371,432,18,18,0,1.0,13,10,3,0.7692307692307693,0.8695652173913044,shc-gpt-4o,mimiciii,radiology_report,PROMPT2_entailment
372,433,15,14,1,0.9333333333333332,18,15,3,0.8333333333333334,0.8805031446540881,shc-gpt-4o,mimiciii,radiology_report,PROMPT2_entailment
373,434,20,19,1,0.95,27,20,7,0.7407407407407407,0.832420591456736,shc-gpt-4o,mimiciii,radiology_report,PROMPT2_entailment
374,435,9,9,0,1.0,13,10,3,0.7692307692307693,0.8695652173913044,shc-gpt-4o,mimiciii,radiology_report,PROMPT2_entailment
375,436,21,19,2,0.9047619047619048,25,24,1,0.96,0.9315628192032688,shc-gpt-4o,mimiciii,radiology_report,PROMPT2_entailment
376,437,6,6,0,1.0,7,6,1,0.8571428571428571,0.923076923076923,shc-gpt-4o,mimiciii,radiology_report,PROMPT2_entailment
377,438,15,14,1,0.9333333333333332,19,14,5,0.7368421052631579,0.8235294117647058,shc-gpt-4o,mimiciii,radiology_report,PROMPT2_entailment
378,439,19,17,2,0.8947368421052632,22,19,3,0.8636363636363636,0.8789115646258503,shc-gpt-4o,mimiciii,radiology_report,PROMPT2_entailment
379,44,11,11,0,1.0,16,11,5,0.6875,0.8148148148148148,shc-gpt-4o,mimiciii,radiology_report,PROMPT2_entailment
380,440,18,18,0,1.0,19,13,6,0.6842105263157895,0.8125000000000001,shc-gpt-4o,mimiciii,radiology_report,PROMPT2_entailment
381,441,16,15,1,0.9375,17,17,0,1.0,0.967741935483871,shc-gpt-4o,mimiciii,radiology_report,PROMPT2_entailment
382,442,11,11,0,1.0,12,9,3,0.75,0.8571428571428571,shc-gpt-4o,mimiciii,radiology_report,PROMPT2_entailment
383,443,18,18,0,1.0,21,15,6,0.7142857142857143,0.8333333333333333,shc-gpt-4o,mimiciii,radiology_report,PROMPT2_entailment
384,444,8,8,0,1.0,8,6,2,0.75,0.8571428571428571,shc-gpt-4o,mimiciii,radiology_report,PROMPT2_entailment
385,445,17,16,1,0.9411764705882352,22,17,5,0.7727272727272727,0.8486739469578783,shc-gpt-4o,mimiciii,radiology_report,PROMPT2_entailment
386,446,22,19,3,0.8636363636363636,22,16,6,0.7272727272727273,0.7896103896103897,shc-gpt-4o,mimiciii,radiology_report,PROMPT2_entailment
387,447,13,13,0,1.0,14,13,1,0.9285714285714286,0.962962962962963,shc-gpt-4o,mimiciii,radiology_report,PROMPT2_entailment
388,448,30,28,2,0.9333333333333332,36,27,9,0.75,0.8316831683168316,shc-gpt-4o,mimiciii,radiology_report,PROMPT2_entailment
389,449,10,10,0,1.0,9,9,0,1.0,1.0,shc-gpt-4o,mimiciii,radiology_report,PROMPT2_entailment
390,45,16,13,3,0.8125,20,13,7,0.65,0.7222222222222223,shc-gpt-4o,mimiciii,radiology_report,PROMPT2_entailment
391,450,23,23,0,1.0,21,19,2,0.9047619047619048,0.95,shc-gpt-4o,mimiciii,radiology_report,PROMPT2_entailment
392,451,8,8,0,1.0,10,7,3,0.7,0.8235294117647058,shc-gpt-4o,mimiciii,radiology_report,PROMPT2_entailment
393,452,16,16,0,1.0,16,13,3,0.8125,0.896551724137931,shc-gpt-4o,mimiciii,radiology_report,PROMPT2_entailment
394,453,11,11,0,1.0,14,12,2,0.8571428571428571,0.923076923076923,shc-gpt-4o,mimiciii,radiology_report,PROMPT2_entailment
395,454,8,8,0,1.0,10,6,4,0.6,0.7499999999999999,shc-gpt-4o,mimiciii,radiology_report,PROMPT2_entailment
396,455,17,16,1,0.9411764705882352,16,14,2,0.875,0.9068825910931174,shc-gpt-4o,mimiciii,radiology_report,PROMPT2_entailment
397,456,16,14,2,0.875,21,19,2,0.9047619047619048,0.8896321070234113,shc-gpt-4o,mimiciii,radiology_report,PROMPT2_entailment
398,457,12,12,0,1.0,12,7,5,0.5833333333333334,0.7368421052631579,shc-gpt-4o,mimiciii,radiology_report,PROMPT2_entailment
399,458,10,10,0,1.0,16,11,5,0.6875,0.8148148148148148,shc-gpt-4o,mimiciii,radiology_report,PROMPT2_entailment
400,459,10,10,0,1.0,13,9,4,0.6923076923076923,0.8181818181818181,shc-gpt-4o,mimiciii,radiology_report,PROMPT2_entailment
401,46,13,13,0,1.0,22,15,7,0.6818181818181818,0.8108108108108109,shc-gpt-4o,mimiciii,radiology_report,PROMPT2_entailment
402,460,20,20,0,1.0,20,15,5,0.75,0.8571428571428571,shc-gpt-4o,mimiciii,radiology_report,PROMPT2_entailment
403,461,21,18,3,0.8571428571428571,22,12,10,0.5454545454545454,0.6666666666666665,shc-gpt-4o,mimiciii,radiology_report,PROMPT2_entailment
404,462,21,20,1,0.9523809523809524,20,17,3,0.85,0.8982826948480845,shc-gpt-4o,mimiciii,radiology_report,PROMPT2_entailment
405,463,10,9,1,0.9,12,10,2,0.8333333333333334,0.8653846153846153,shc-gpt-4o,mimiciii,radiology_report,PROMPT2_entailment
406,464,21,19,2,0.9047619047619048,25,22,3,0.88,0.8922091782283885,shc-gpt-4o,mimiciii,radiology_report,PROMPT2_entailment
407,465,23,23,0,1.0,33,28,5,0.8484848484848485,0.9180327868852458,shc-gpt-4o,mimiciii,radiology_report,PROMPT2_entailment
408,466,17,17,0,1.0,22,17,5,0.7727272727272727,0.8717948717948718,shc-gpt-4o,mimiciii,radiology_report,PROMPT2_entailment
409,467,10,10,0,1.0,14,13,1,0.9285714285714286,0.962962962962963,shc-gpt-4o,mimiciii,radiology_report,PROMPT2_entailment
410,468,16,16,0,1.0,18,15,3,0.8333333333333334,0.9090909090909092,shc-gpt-4o,mimiciii,radiology_report,PROMPT2_entailment
411,469,20,20,0,1.0,25,19,6,0.76,0.8636363636363636,shc-gpt-4o,mimiciii,radiology_report,PROMPT2_entailment
412,47,14,10,4,0.7142857142857143,15,11,4,0.7333333333333333,0.7236842105263158,shc-gpt-4o,mimiciii,radiology_report,PROMPT2_entailment
413,470,10,10,0,1.0,15,10,5,0.6666666666666666,0.8,shc-gpt-4o,mimiciii,radiology_report,PROMPT2_entailment
414,471,19,17,2,0.8947368421052632,18,11,7,0.6111111111111112,0.7262135922330096,shc-gpt-4o,mimiciii,radiology_report,PROMPT2_entailment
415,472,12,12,0,1.0,16,11,5,0.6875,0.8148148148148148,shc-gpt-4o,mimiciii,radiology_report,PROMPT2_entailment
416,473,11,11,0,1.0,11,10,1,0.9090909090909092,0.9523809523809524,shc-gpt-4o,mimiciii,radiology_report,PROMPT2_entailment
417,474,21,19,2,0.9047619047619048,25,22,3,0.88,0.8922091782283885,shc-gpt-4o,mimiciii,radiology_report,PROMPT2_entailment
418,475,6,6,0,1.0,7,5,2,0.7142857142857143,0.8333333333333333,shc-gpt-4o,mimiciii,radiology_report,PROMPT2_entailment
419,476,12,12,0,1.0,12,11,1,0.9166666666666666,0.9565217391304348,shc-gpt-4o,mimiciii,radiology_report,PROMPT2_entailment
420,477,15,15,0,1.0,16,12,4,0.75,0.8571428571428571,shc-gpt-4o,mimiciii,radiology_report,PROMPT2_entailment
421,478,20,19,1,0.95,21,15,6,0.7142857142857143,0.8154506437768242,shc-gpt-4o,mimiciii,radiology_report,PROMPT2_entailment
422,479,13,13,0,1.0,22,19,3,0.8636363636363636,0.9268292682926828,shc-gpt-4o,mimiciii,radiology_report,PROMPT2_entailment
423,48,14,13,1,0.9285714285714286,21,18,3,0.8571428571428571,0.8914285714285715,shc-gpt-4o,mimiciii,radiology_report,PROMPT2_entailment
424,480,8,6,2,0.75,10,6,4,0.6,0.6666666666666665,shc-gpt-4o,mimiciii,radiology_report,PROMPT2_entailment
425,481,17,17,0,1.0,17,14,3,0.8235294117647058,0.9032258064516128,shc-gpt-4o,mimiciii,radiology_report,PROMPT2_entailment
426,482,17,17,0,1.0,19,18,1,0.9473684210526316,0.972972972972973,shc-gpt-4o,mimiciii,radiology_report,PROMPT2_entailment
427,483,16,16,0,1.0,23,18,5,0.782608695652174,0.878048780487805,shc-gpt-4o,mimiciii,radiology_report,PROMPT2_entailment
428,484,9,8,1,0.8888888888888888,13,10,3,0.7692307692307693,0.8247422680412372,shc-gpt-4o,mimiciii,radiology_report,PROMPT2_entailment
429,485,17,17,0,1.0,24,21,3,0.875,0.9333333333333332,shc-gpt-4o,mimiciii,radiology_report,PROMPT2_entailment
430,486,13,12,1,0.9230769230769232,11,8,3,0.7272727272727273,0.8135593220338984,shc-gpt-4o,mimiciii,radiology_report,PROMPT2_entailment
431,487,20,16,4,0.8,20,13,7,0.65,0.7172413793103448,shc-gpt-4o,mimiciii,radiology_report,PROMPT2_entailment
432,488,13,12,1,0.9230769230769232,15,13,2,0.8666666666666667,0.8939828080229226,shc-gpt-4o,mimiciii,radiology_report,PROMPT2_entailment
433,489,20,19,1,0.95,18,15,3,0.8333333333333334,0.8878504672897196,shc-gpt-4o,mimiciii,radiology_report,PROMPT2_entailment
434,49,19,18,1,0.9473684210526316,24,20,4,0.8333333333333334,0.8866995073891626,shc-gpt-4o,mimiciii,radiology_report,PROMPT2_entailment
435,490,6,5,1,0.8333333333333334,8,3,5,0.375,0.5172413793103448,shc-gpt-4o,mimiciii,radiology_report,PROMPT2_entailment
436,491,15,14,1,0.9333333333333332,17,10,7,0.5882352941176471,0.7216494845360826,shc-gpt-4o,mimiciii,radiology_report,PROMPT2_entailment
437,492,16,15,1,0.9375,13,9,4,0.6923076923076923,0.7964601769911505,shc-gpt-4o,mimiciii,radiology_report,PROMPT2_entailment
438,493,12,12,0,1.0,9,7,2,0.7777777777777778,0.8750000000000001,shc-gpt-4o,mimiciii,radiology_report,PROMPT2_entailment
439,494,7,7,0,1.0,8,6,2,0.75,0.8571428571428571,shc-gpt-4o,mimiciii,radiology_report,PROMPT2_entailment
440,495,8,8,0,1.0,12,11,1,0.9166666666666666,0.9565217391304348,shc-gpt-4o,mimiciii,radiology_report,PROMPT2_entailment
441,496,19,19,0,1.0,32,24,8,0.75,0.8571428571428571,shc-gpt-4o,mimiciii,radiology_report,PROMPT2_entailment
442,497,18,16,2,0.8888888888888888,22,17,5,0.7727272727272727,0.8267477203647416,shc-gpt-4o,mimiciii,radiology_report,PROMPT2_entailment
443,498,18,15,3,0.8333333333333334,22,18,4,0.8181818181818182,0.8256880733944955,shc-gpt-4o,mimiciii,radiology_report,PROMPT2_entailment
444,499,16,16,0,1.0,17,13,4,0.7647058823529411,0.8666666666666666,shc-gpt-4o,mimiciii,radiology_report,PROMPT2_entailment
445,5,16,15,1,0.9375,22,14,8,0.6363636363636364,0.7581227436823105,shc-gpt-4o,mimiciii,radiology_report,PROMPT2_entailment
446,50,10,10,0,1.0,15,11,4,0.7333333333333333,0.846153846153846,shc-gpt-4o,mimiciii,radiology_report,PROMPT2_entailment
447,51,11,10,1,0.9090909090909092,13,11,2,0.8461538461538461,0.8764940239043824,shc-gpt-4o,mimiciii,radiology_report,PROMPT2_entailment
448,52,18,18,0,1.0,21,16,5,0.7619047619047619,0.8648648648648648,shc-gpt-4o,mimiciii,radiology_report,PROMPT2_entailment
449,53,10,10,0,1.0,12,11,1,0.9166666666666666,0.9565217391304348,shc-gpt-4o,mimiciii,radiology_report,PROMPT2_entailment
450,54,11,10,1,0.9090909090909092,10,6,4,0.6,0.7228915662650602,shc-gpt-4o,mimiciii,radiology_report,PROMPT2_entailment
451,55,16,13,3,0.8125,18,15,3,0.8333333333333334,0.8227848101265822,shc-gpt-4o,mimiciii,radiology_report,PROMPT2_entailment
452,56,14,12,2,0.8571428571428571,21,14,7,0.6666666666666666,0.75,shc-gpt-4o,mimiciii,radiology_report,PROMPT2_entailment
453,57,9,8,1,0.8888888888888888,10,8,2,0.8,0.8421052631578948,shc-gpt-4o,mimiciii,radiology_report,PROMPT2_entailment
454,58,13,13,0,1.0,16,12,4,0.75,0.8571428571428571,shc-gpt-4o,mimiciii,radiology_report,PROMPT2_entailment
455,59,13,13,0,1.0,16,13,3,0.8125,0.896551724137931,shc-gpt-4o,mimiciii,radiology_report,PROMPT2_entailment
456,6,7,7,0,1.0,8,5,3,0.625,0.7692307692307693,shc-gpt-4o,mimiciii,radiology_report,PROMPT2_entailment
457,60,17,17,0,1.0,19,16,3,0.8421052631578947,0.9142857142857144,shc-gpt-4o,mimiciii,radiology_report,PROMPT2_entailment
458,61,17,17,0,1.0,22,20,2,0.9090909090909092,0.9523809523809524,shc-gpt-4o,mimiciii,radiology_report,PROMPT2_entailment
459,62,16,15,1,0.9375,13,13,0,1.0,0.967741935483871,shc-gpt-4o,mimiciii,radiology_report,PROMPT2_entailment
460,63,11,10,1,0.9090909090909092,15,11,4,0.7333333333333333,0.8118081180811808,shc-gpt-4o,mimiciii,radiology_report,PROMPT2_entailment
461,64,26,23,3,0.8846153846153846,20,16,4,0.8,0.8401826484018265,shc-gpt-4o,mimiciii,radiology_report,PROMPT2_entailment
462,65,19,17,2,0.8947368421052632,18,15,3,0.8333333333333334,0.8629441624365481,shc-gpt-4o,mimiciii,radiology_report,PROMPT2_entailment
463,66,14,13,1,0.9285714285714286,29,20,9,0.6896551724137931,0.7914764079147641,shc-gpt-4o,mimiciii,radiology_report,PROMPT2_entailment
464,67,18,18,0,1.0,28,23,5,0.8214285714285714,0.9019607843137256,shc-gpt-4o,mimiciii,radiology_report,PROMPT2_entailment
465,68,18,16,2,0.8888888888888888,30,19,11,0.6333333333333333,0.7396593673965937,shc-gpt-4o,mimiciii,radiology_report,PROMPT2_entailment
466,69,22,20,2,0.9090909090909092,31,19,12,0.6129032258064516,0.7321772639691714,shc-gpt-4o,mimiciii,radiology_report,PROMPT2_entailment
467,7,13,13,0,1.0,16,14,2,0.875,0.9333333333333332,shc-gpt-4o,mimiciii,radiology_report,PROMPT2_entailment
468,70,13,12,1,0.9230769230769232,17,17,0,1.0,0.96,shc-gpt-4o,mimiciii,radiology_report,PROMPT2_entailment
469,71,14,13,1,0.9285714285714286,18,16,2,0.8888888888888888,0.9082969432314412,shc-gpt-4o,mimiciii,radiology_report,PROMPT2_entailment
470,72,14,13,1,0.9285714285714286,13,12,1,0.9230769230769232,0.9258160237388724,shc-gpt-4o,mimiciii,radiology_report,PROMPT2_entailment
471,73,20,20,0,1.0,29,19,10,0.6551724137931034,0.7916666666666666,shc-gpt-4o,mimiciii,radiology_report,PROMPT2_entailment
472,74,17,17,0,1.0,18,14,4,0.7777777777777778,0.8750000000000001,shc-gpt-4o,mimiciii,radiology_report,PROMPT2_entailment
473,75,16,16,0,1.0,12,11,1,0.9166666666666666,0.9565217391304348,shc-gpt-4o,mimiciii,radiology_report,PROMPT2_entailment
474,76,11,10,1,0.9090909090909092,14,10,4,0.7142857142857143,0.8,shc-gpt-4o,mimiciii,radiology_report,PROMPT2_entailment
475,77,22,19,3,0.8636363636363636,26,20,6,0.7692307692307693,0.8137044967880086,shc-gpt-4o,mimiciii,radiology_report,PROMPT2_entailment
476,78,24,19,5,0.7916666666666666,33,25,8,0.7575757575757576,0.7742461287693561,shc-gpt-4o,mimiciii,radiology_report,PROMPT2_entailment
477,79,13,13,0,1.0,17,13,4,0.7647058823529411,0.8666666666666666,shc-gpt-4o,mimiciii,radiology_report,PROMPT2_entailment
478,8,16,16,0,1.0,15,12,3,0.8,0.888888888888889,shc-gpt-4o,mimiciii,radiology_report,PROMPT2_entailment
479,80,16,14,2,0.875,25,18,7,0.72,0.7899686520376176,shc-gpt-4o,mimiciii,radiology_report,PROMPT2_entailment
480,81,14,14,0,1.0,15,10,5,0.6666666666666666,0.8,shc-gpt-4o,mimiciii,radiology_report,PROMPT2_entailment
481,82,13,13,0,1.0,14,12,2,0.8571428571428571,0.923076923076923,shc-gpt-4o,mimiciii,radiology_report,PROMPT2_entailment
482,83,21,19,2,0.9047619047619048,17,14,3,0.8235294117647058,0.8622366288492707,shc-gpt-4o,mimiciii,radiology_report,PROMPT2_entailment
483,84,15,15,0,1.0,20,15,5,0.75,0.8571428571428571,shc-gpt-4o,mimiciii,radiology_report,PROMPT2_entailment
484,85,12,11,1,0.9166666666666666,14,11,3,0.7857142857142857,0.8461538461538461,shc-gpt-4o,mimiciii,radiology_report,PROMPT2_entailment
485,86,17,17,0,1.0,10,10,0,1.0,1.0,shc-gpt-4o,mimiciii,radiology_report,PROMPT2_entailment
486,87,12,12,0,1.0,14,11,3,0.7857142857142857,0.88,shc-gpt-4o,mimiciii,radiology_report,PROMPT2_entailment
487,88,17,14,3,0.8235294117647058,19,18,1,0.9473684210526316,0.881118881118881,shc-gpt-4o,mimiciii,radiology_report,PROMPT2_entailment
488,89,16,15,1,0.9375,18,17,1,0.9444444444444444,0.940959409594096,shc-gpt-4o,mimiciii,radiology_report,PROMPT2_entailment
489,9,11,11,0,1.0,13,10,3,0.7692307692307693,0.8695652173913044,shc-gpt-4o,mimiciii,radiology_report,PROMPT2_entailment
490,90,10,10,0,1.0,14,11,3,0.7857142857142857,0.88,shc-gpt-4o,mimiciii,radiology_report,PROMPT2_entailment
491,91,14,13,1,0.9285714285714286,13,9,4,0.6923076923076923,0.7932203389830509,shc-gpt-4o,mimiciii,radiology_report,PROMPT2_entailment
492,92,17,17,0,1.0,21,14,7,0.6666666666666666,0.8,shc-gpt-4o,mimiciii,radiology_report,PROMPT2_entailment
493,93,14,14,0,1.0,15,11,4,0.7333333333333333,0.846153846153846,shc-gpt-4o,mimiciii,radiology_report,PROMPT2_entailment
494,94,21,20,1,0.9523809523809524,28,19,9,0.6785714285714286,0.7924921793534931,shc-gpt-4o,mimiciii,radiology_report,PROMPT2_entailment
495,95,14,14,0,1.0,18,9,9,0.5,0.6666666666666666,shc-gpt-4o,mimiciii,radiology_report,PROMPT2_entailment
496,96,15,15,0,1.0,21,15,6,0.7142857142857143,0.8333333333333333,shc-gpt-4o,mimiciii,radiology_report,PROMPT2_entailment
497,97,12,10,2,0.8333333333333334,23,15,8,0.6521739130434783,0.7317073170731708,shc-gpt-4o,mimiciii,radiology_report,PROMPT2_entailment
498,98,14,14,0,1.0,19,12,7,0.631578947368421,0.7741935483870968,shc-gpt-4o,mimiciii,radiology_report,PROMPT2_entailment
499,99,16,16,0,1.0,13,13,0,1.0,1.0,shc-gpt-4o,mimiciii,radiology_report,PROMPT2_entailment
0,0,13,12,1,0.9230769230769232,78,56,22,0.717948717948718,0.8076923076923078,shc-gpt-4o,mimiciii,progress_note,PROMPT1_entailment
1,1,36,34,2,0.9444444444444444,189,65,124,0.3439153439153439,0.5042208532968286,shc-gpt-4o,mimiciii,progress_note,PROMPT1_entailment
2,10,15,13,2,0.8666666666666667,140,50,90,0.3571428571428571,0.5058365758754864,shc-gpt-4o,mimiciii,progress_note,PROMPT1_entailment
3,100,41,39,2,0.951219512195122,77,60,17,0.7792207792207793,0.85667215815486,shc-gpt-4o,mimiciii,progress_note,PROMPT1_entailment
4,101,23,21,2,0.9130434782608696,36,20,16,0.5555555555555556,0.6907894736842106,shc-gpt-4o,mimiciii,progress_note,PROMPT1_entailment
5,102,29,29,0,1.0,42,36,6,0.8571428571428571,0.923076923076923,shc-gpt-4o,mimiciii,progress_note,PROMPT1_entailment
6,103,20,18,2,0.9,204,70,134,0.3431372549019608,0.4968454258675079,shc-gpt-4o,mimiciii,progress_note,PROMPT1_entailment
7,104,3,2,1,0.6666666666666666,39,20,19,0.5128205128205128,0.5797101449275363,shc-gpt-4o,mimiciii,progress_note,PROMPT1_entailment
8,105,15,14,1,0.9333333333333332,17,13,4,0.7647058823529411,0.8406466512702079,shc-gpt-4o,mimiciii,progress_note,PROMPT1_entailment
9,106,18,17,1,0.9444444444444444,40,27,13,0.675,0.7873070325900515,shc-gpt-4o,mimiciii,progress_note,PROMPT1_entailment
10,107,24,24,0,1.0,31,23,8,0.7419354838709677,0.8518518518518519,shc-gpt-4o,mimiciii,progress_note,PROMPT1_entailment
11,108,38,34,4,0.8947368421052632,68,50,18,0.7352941176470589,0.8072174738841406,shc-gpt-4o,mimiciii,progress_note,PROMPT1_entailment
12,109,16,13,3,0.8125,176,74,102,0.4204545454545454,0.554147465437788,shc-gpt-4o,mimiciii,progress_note,PROMPT1_entailment
13,11,15,9,6,0.6,141,64,77,0.4539007092198581,0.5168236877523554,shc-gpt-4o,mimiciii,progress_note,PROMPT1_entailment
14,110,19,16,3,0.8421052631578947,215,81,134,0.3767441860465116,0.52058646314521,shc-gpt-4o,mimiciii,progress_note,PROMPT1_entailment
15,111,70,51,19,0.7285714285714285,219,69,150,0.3150684931506849,0.439902493905869,shc-gpt-4o,mimiciii,progress_note,PROMPT1_entailment
16,112,17,13,4,0.7647058823529411,234,120,114,0.5128205128205128,0.613931523022432,shc-gpt-4o,mimiciii,progress_note,PROMPT1_entailment
17,113,11,11,0,1.0,196,101,95,0.5153061224489796,0.68013468013468,shc-gpt-4o,mimiciii,progress_note,PROMPT1_entailment
18,114,14,8,6,0.5714285714285714,225,69,156,0.3066666666666666,0.3991323210412147,shc-gpt-4o,mimiciii,progress_note,PROMPT1_entailment
19,115,120,89,31,0.7416666666666667,280,130,150,0.4642857142857143,0.5710760118460019,shc-gpt-4o,mimiciii,progress_note,PROMPT1_entailment
20,116,15,13,2,0.8666666666666667,35,27,8,0.7714285714285715,0.8162790697674419,shc-gpt-4o,mimiciii,progress_note,PROMPT1_entailment
21,117,12,12,0,1.0,20,18,2,0.9,0.9473684210526316,shc-gpt-4o,mimiciii,progress_note,PROMPT1_entailment
22,118,22,22,0,1.0,23,17,6,0.7391304347826086,0.85,shc-gpt-4o,mimiciii,progress_note,PROMPT1_entailment
23,119,14,14,0,1.0,14,11,3,0.7857142857142857,0.88,shc-gpt-4o,mimiciii,progress_note,PROMPT1_entailment
24,12,76,41,35,0.5394736842105263,225,71,154,0.3155555555555555,0.3981943779495246,shc-gpt-4o,mimiciii,progress_note,PROMPT1_entailment
25,120,15,13,2,0.8666666666666667,64,50,14,0.78125,0.8217446270543616,shc-gpt-4o,mimiciii,progress_note,PROMPT1_entailment
26,121,13,13,0,1.0,14,9,5,0.6428571428571429,0.782608695652174,shc-gpt-4o,mimiciii,progress_note,PROMPT1_entailment
27,122,34,28,6,0.8235294117647058,47,34,13,0.723404255319149,0.7702265372168284,shc-gpt-4o,mimiciii,progress_note,PROMPT1_entailment
28,123,35,29,6,0.8285714285714286,50,19,31,0.38,0.5210401891252956,shc-gpt-4o,mimiciii,progress_note,PROMPT1_entailment
29,124,6,6,0,1.0,65,53,12,0.8153846153846154,0.8983050847457628,shc-gpt-4o,mimiciii,progress_note,PROMPT1_entailment
30,125,10,9,1,0.9,50,32,18,0.64,0.7480519480519481,shc-gpt-4o,mimiciii,progress_note,PROMPT1_entailment
31,126,3,3,0,1.0,27,14,13,0.5185185185185185,0.6829268292682926,shc-gpt-4o,mimiciii,progress_note,PROMPT1_entailment
32,127,3,3,0,1.0,27,17,10,0.6296296296296297,0.7727272727272727,shc-gpt-4o,mimiciii,progress_note,PROMPT1_entailment
33,128,28,27,1,0.9642857142857144,37,30,7,0.8108108108108109,0.8809135399673736,shc-gpt-4o,mimiciii,progress_note,PROMPT1_entailment
34,129,40,28,12,0.7,66,44,22,0.6666666666666666,0.6829268292682926,shc-gpt-4o,mimiciii,progress_note,PROMPT1_entailment
35,13,41,39,2,0.951219512195122,73,38,35,0.5205479452054794,0.6728717366628831,shc-gpt-4o,mimiciii,progress_note,PROMPT1_entailment
36,130,32,28,4,0.875,44,38,6,0.8636363636363636,0.869281045751634,shc-gpt-4o,mimiciii,progress_note,PROMPT1_entailment
37,131,123,98,25,0.7967479674796748,202,90,112,0.4455445544554455,0.5715026242467439,shc-gpt-4o,mimiciii,progress_note,PROMPT1_entailment
38,132,16,12,4,0.75,193,88,105,0.4559585492227979,0.5671321160042964,shc-gpt-4o,mimiciii,progress_note,PROMPT1_entailment
39,133,76,56,20,0.7368421052631579,157,52,105,0.3312101910828025,0.4569993722536095,shc-gpt-4o,mimiciii,progress_note,PROMPT1_entailment
40,134,13,11,2,0.8461538461538461,18,11,7,0.6111111111111112,0.7096774193548387,shc-gpt-4o,mimiciii,progress_note,PROMPT1_entailment
41,135,10,10,0,1.0,35,21,14,0.6,0.7499999999999999,shc-gpt-4o,mimiciii,progress_note,PROMPT1_entailment
42,136,25,21,4,0.84,43,23,20,0.5348837209302325,0.6535859269282814,shc-gpt-4o,mimiciii,progress_note,PROMPT1_entailment
43,137,23,22,1,0.9565217391304348,26,19,7,0.7307692307692307,0.8285431119920714,shc-gpt-4o,mimiciii,progress_note,PROMPT1_entailment
44,138,9,9,0,1.0,45,30,15,0.6666666666666666,0.8,shc-gpt-4o,mimiciii,progress_note,PROMPT1_entailment
45,139,4,4,0,1.0,45,24,21,0.5333333333333333,0.6956521739130436,shc-gpt-4o,mimiciii,progress_note,PROMPT1_entailment
46,14,41,30,11,0.7317073170731707,43,33,10,0.7674418604651163,0.7491486946651533,shc-gpt-4o,mimiciii,progress_note,PROMPT1_entailment
47,140,19,16,3,0.8421052631578947,25,19,6,0.76,0.7989487516425756,shc-gpt-4o,mimiciii,progress_note,PROMPT1_entailment
48,141,20,20,0,1.0,45,24,21,0.5333333333333333,0.6956521739130436,shc-gpt-4o,mimiciii,progress_note,PROMPT1_entailment
49,142,39,37,2,0.9487179487179488,50,31,19,0.62,0.749918273945734,shc-gpt-4o,mimiciii,progress_note,PROMPT1_entailment
50,143,9,9,0,1.0,11,7,4,0.6363636363636364,0.7777777777777778,shc-gpt-4o,mimiciii,progress_note,PROMPT1_entailment
51,144,3,2,1,0.6666666666666666,50,34,16,0.68,0.6732673267326733,shc-gpt-4o,mimiciii,progress_note,PROMPT1_entailment
52,145,4,4,0,1.0,43,29,14,0.6744186046511628,0.8055555555555556,shc-gpt-4o,mimiciii,progress_note,PROMPT1_entailment
53,146,36,31,5,0.8611111111111112,32,24,8,0.75,0.8017241379310345,shc-gpt-4o,mimiciii,progress_note,PROMPT1_entailment
54,147,34,30,4,0.8823529411764706,56,44,12,0.7857142857142857,0.8312342569269522,shc-gpt-4o,mimiciii,progress_note,PROMPT1_entailment
55,148,7,7,0,1.0,4,3,1,0.75,0.8571428571428571,shc-gpt-4o,mimiciii,progress_note,PROMPT1_entailment
56,149,24,24,0,1.0,29,24,5,0.8275862068965517,0.9056603773584906,shc-gpt-4o,mimiciii,progress_note,PROMPT1_entailment
57,15,131,73,58,0.5572519083969466,163,66,97,0.4049079754601227,0.4690192260890728,shc-gpt-4o,mimiciii,progress_note,PROMPT1_entailment
58,150,27,26,1,0.9629629629629628,83,70,13,0.8433734939759037,0.8992094861660079,shc-gpt-4o,mimiciii,progress_note,PROMPT1_entailment
59,151,20,19,1,0.95,201,104,97,0.5174129353233831,0.6699440583149685,shc-gpt-4o,mimiciii,progress_note,PROMPT1_entailment
60,152,29,16,13,0.5517241379310345,45,21,24,0.4666666666666667,0.5056433408577878,shc-gpt-4o,mimiciii,progress_note,PROMPT1_entailment
61,153,74,64,10,0.8648648648648649,219,112,107,0.5114155251141552,0.6427546628407461,shc-gpt-4o,mimiciii,progress_note,PROMPT1_entailment
62,154,15,15,0,1.0,15,14,1,0.9333333333333332,0.9655172413793104,shc-gpt-4o,mimiciii,progress_note,PROMPT1_entailment
63,155,21,20,1,0.9523809523809524,32,27,5,0.84375,0.8947804473902237,shc-gpt-4o,mimiciii,progress_note,PROMPT1_entailment
64,156,22,21,1,0.9545454545454546,32,23,9,0.71875,0.8200339558573855,shc-gpt-4o,mimiciii,progress_note,PROMPT1_entailment
65,157,18,18,0,1.0,29,23,6,0.7931034482758621,0.8846153846153846,shc-gpt-4o,mimiciii,progress_note,PROMPT1_entailment
66,158,24,19,5,0.7916666666666666,242,126,116,0.5206611570247934,0.6281815796378902,shc-gpt-4o,mimiciii,progress_note,PROMPT1_entailment
67,159,17,17,0,1.0,22,12,10,0.5454545454545454,0.7058823529411764,shc-gpt-4o,mimiciii,progress_note,PROMPT1_entailment
68,16,17,17,0,1.0,28,18,10,0.6428571428571429,0.782608695652174,shc-gpt-4o,mimiciii,progress_note,PROMPT1_entailment
69,160,55,53,2,0.9636363636363636,65,44,21,0.676923076923077,0.795225916453538,shc-gpt-4o,mimiciii,progress_note,PROMPT1_entailment
70,161,17,16,1,0.9411764705882352,201,108,93,0.5373134328358209,0.6840855106888362,shc-gpt-4o,mimiciii,progress_note,PROMPT1_entailment
71,162,23,18,5,0.782608695652174,177,84,93,0.4745762711864407,0.5908558030480656,shc-gpt-4o,mimiciii,progress_note,PROMPT1_entailment
72,163,16,16,0,1.0,28,18,10,0.6428571428571429,0.782608695652174,shc-gpt-4o,mimiciii,progress_note,PROMPT1_entailment
73,164,20,18,2,0.9,57,36,21,0.631578947368421,0.7422680412371133,shc-gpt-4o,mimiciii,progress_note,PROMPT1_entailment
74,165,9,8,1,0.8888888888888888,25,25,0,1.0,0.9411764705882352,shc-gpt-4o,mimiciii,progress_note,PROMPT1_entailment
75,166,12,12,0,1.0,42,39,3,0.9285714285714286,0.962962962962963,shc-gpt-4o,mimiciii,progress_note,PROMPT1_entailment
76,167,28,28,0,1.0,52,30,22,0.5769230769230769,0.7317073170731707,shc-gpt-4o,mimiciii,progress_note,PROMPT1_entailment
77,168,15,12,3,0.8,182,85,97,0.467032967032967,0.5897658282740676,shc-gpt-4o,mimiciii,progress_note,PROMPT1_entailment
78,169,58,51,7,0.8793103448275862,219,96,123,0.4383561643835616,0.5850510844237318,shc-gpt-4o,mimiciii,progress_note,PROMPT1_entailment
79,17,10,6,4,0.6,15,6,9,0.4,0.48,shc-gpt-4o,mimiciii,progress_note,PROMPT1_entailment
80,170,22,16,6,0.7272727272727273,184,76,108,0.4130434782608695,0.5268630849220104,shc-gpt-4o,mimiciii,progress_note,PROMPT1_entailment
81,171,101,81,20,0.801980198019802,222,128,94,0.5765765765765766,0.6708508573277256,shc-gpt-4o,mimiciii,progress_note,PROMPT1_entailment
82,172,24,17,7,0.7083333333333334,198,90,108,0.4545454545454545,0.5537459283387622,shc-gpt-4o,mimiciii,progress_note,PROMPT1_entailment
83,173,14,11,3,0.7857142857142857,172,74,98,0.4302325581395348,0.5560109289617486,shc-gpt-4o,mimiciii,progress_note,PROMPT1_entailment
84,174,25,22,3,0.88,200,86,114,0.43,0.5777099236641221,shc-gpt-4o,mimiciii,progress_note,PROMPT1_entailment
85,175,17,15,2,0.8823529411764706,207,55,152,0.2657004830917874,0.4084158415841584,shc-gpt-4o,mimiciii,progress_note,PROMPT1_entailment
86,176,99,66,33,0.6666666666666666,192,95,97,0.4947916666666667,0.5680119581464873,shc-gpt-4o,mimiciii,progress_note,PROMPT1_entailment
87,177,16,12,4,0.75,192,65,127,0.3385416666666667,0.4665071770334928,shc-gpt-4o,mimiciii,progress_note,PROMPT1_entailment
88,178,17,17,0,1.0,17,15,2,0.8823529411764706,0.9375,shc-gpt-4o,mimiciii,progress_note,PROMPT1_entailment
89,179,34,30,4,0.8823529411764706,197,92,105,0.467005076142132,0.6107545917238327,shc-gpt-4o,mimiciii,progress_note,PROMPT1_entailment
90,18,14,10,4,0.7142857142857143,18,17,1,0.9444444444444444,0.813397129186603,shc-gpt-4o,mimiciii,progress_note,PROMPT1_entailment
91,180,121,108,13,0.8925619834710744,201,94,107,0.4676616915422885,0.6137476573363159,shc-gpt-4o,mimiciii,progress_note,PROMPT1_entailment
92,181,118,78,40,0.6610169491525424,208,96,112,0.4615384615384615,0.5435540069686411,shc-gpt-4o,mimiciii,progress_note,PROMPT1_entailment
93,182,33,32,1,0.9696969696969696,214,84,130,0.3925233644859813,0.5588357588357589,shc-gpt-4o,mimiciii,progress_note,PROMPT1_entailment
94,183,101,75,26,0.7425742574257426,226,95,131,0.4203539823008849,0.5368242606893954,shc-gpt-4o,mimiciii,progress_note,PROMPT1_entailment
95,184,23,20,3,0.8695652173913043,194,84,110,0.4329896907216495,0.5781142463867859,shc-gpt-4o,mimiciii,progress_note,PROMPT1_entailment
96,185,4,3,1,0.75,48,24,24,0.5,0.6,shc-gpt-4o,mimiciii,progress_note,PROMPT1_entailment
97,186,29,28,1,0.9655172413793104,205,109,96,0.5317073170731708,0.685765644309628,shc-gpt-4o,mimiciii,progress_note,PROMPT1_entailment
98,187,69,48,21,0.6956521739130435,170,66,104,0.388235294117647,0.4983482774893819,shc-gpt-4o,mimiciii,progress_note,PROMPT1_entailment
99,188,17,16,1,0.9411764705882352,202,75,127,0.3712871287128713,0.5325049922343021,shc-gpt-4o,mimiciii,progress_note,PROMPT1_entailment
100,189,13,11,2,0.8461538461538461,225,103,122,0.4577777777777778,0.5941269008914526,shc-gpt-4o,mimiciii,progress_note,PROMPT1_entailment
101,19,17,17,0,1.0,38,25,13,0.6578947368421053,0.7936507936507937,shc-gpt-4o,mimiciii,progress_note,PROMPT1_entailment
102,190,107,87,20,0.8130841121495327,223,88,135,0.3946188340807174,0.5313530207863414,shc-gpt-4o,mimiciii,progress_note,PROMPT1_entailment
103,191,21,17,4,0.8095238095238095,206,93,113,0.4514563106796116,0.5796516956920257,shc-gpt-4o,mimiciii,progress_note,PROMPT1_entailment
104,192,17,10,7,0.5882352941176471,208,85,123,0.4086538461538461,0.4822695035460993,shc-gpt-4o,mimiciii,progress_note,PROMPT1_entailment
105,193,19,15,4,0.7894736842105263,243,93,150,0.382716049382716,0.5155210643015521,shc-gpt-4o,mimiciii,progress_note,PROMPT1_entailment
106,194,39,35,4,0.8974358974358975,211,111,100,0.5260663507109005,0.6633088611917365,shc-gpt-4o,mimiciii,progress_note,PROMPT1_entailment
107,195,25,24,1,0.96,44,28,16,0.6363636363636364,0.765375854214123,shc-gpt-4o,mimiciii,progress_note,PROMPT1_entailment
108,196,23,22,1,0.9565217391304348,42,32,10,0.7619047619047619,0.8481927710843373,shc-gpt-4o,mimiciii,progress_note,PROMPT1_entailment
109,197,61,59,2,0.9672131147540984,90,73,17,0.8111111111111111,0.8823107651336679,shc-gpt-4o,mimiciii,progress_note,PROMPT1_entailment
110,198,33,32,1,0.9696969696969696,34,31,3,0.9117647058823528,0.9398389388915208,shc-gpt-4o,mimiciii,progress_note,PROMPT1_entailment
111,199,3,3,0,1.0,52,32,20,0.6153846153846154,0.761904761904762,shc-gpt-4o,mimiciii,progress_note,PROMPT1_entailment
112,2,18,15,3,0.8333333333333334,140,71,69,0.5071428571428571,0.6305506216696269,shc-gpt-4o,mimiciii,progress_note,PROMPT1_entailment
113,20,8,6,2,0.75,33,12,21,0.3636363636363636,0.4897959183673468,shc-gpt-4o,mimiciii,progress_note,PROMPT1_entailment
114,200,21,15,6,0.7142857142857143,164,64,100,0.3902439024390244,0.5047318611987383,shc-gpt-4o,mimiciii,progress_note,PROMPT1_entailment
115,201,17,16,1,0.9411764705882352,200,97,103,0.485,0.6401319859764899,shc-gpt-4o,mimiciii,progress_note,PROMPT1_entailment
116,202,19,12,7,0.631578947368421,176,97,79,0.5511363636363636,0.5886219974715551,shc-gpt-4o,mimiciii,progress_note,PROMPT1_entailment
117,203,15,12,3,0.8,211,125,86,0.5924170616113744,0.6807351940095303,shc-gpt-4o,mimiciii,progress_note,PROMPT1_entailment
118,204,17,14,3,0.8235294117647058,201,83,118,0.4129353233830846,0.5500591715976332,shc-gpt-4o,mimiciii,progress_note,PROMPT1_entailment
119,205,16,16,0,1.0,195,83,112,0.4256410256410256,0.5971223021582733,shc-gpt-4o,mimiciii,progress_note,PROMPT1_entailment
120,206,105,82,23,0.780952380952381,239,100,139,0.4184100418410041,0.5448867034354442,shc-gpt-4o,mimiciii,progress_note,PROMPT1_entailment
121,207,13,10,3,0.7692307692307693,233,106,127,0.4549356223175965,0.5717367853290183,shc-gpt-4o,mimiciii,progress_note,PROMPT1_entailment
122,208,17,13,4,0.7647058823529411,229,86,143,0.3755458515283842,0.5037170533904032,shc-gpt-4o,mimiciii,progress_note,PROMPT1_entailment
123,209,34,30,4,0.8823529411764706,205,100,105,0.4878048780487805,0.6282722513089005,shc-gpt-4o,mimiciii,progress_note,PROMPT1_entailment
124,21,14,13,1,0.9285714285714286,217,113,104,0.5207373271889401,0.6672723143311378,shc-gpt-4o,mimiciii,progress_note,PROMPT1_entailment
125,210,23,22,1,0.9565217391304348,28,25,3,0.8928571428571429,0.9235936188077246,shc-gpt-4o,mimiciii,progress_note,PROMPT1_entailment
126,211,12,12,0,1.0,54,37,17,0.6851851851851852,0.8131868131868133,shc-gpt-4o,mimiciii,progress_note,PROMPT1_entailment
127,212,15,15,0,1.0,14,13,1,0.9285714285714286,0.962962962962963,shc-gpt-4o,mimiciii,progress_note,PROMPT1_entailment
128,213,33,30,3,0.9090909090909092,41,25,16,0.6097560975609756,0.7299270072992701,shc-gpt-4o,mimiciii,progress_note,PROMPT1_entailment
129,214,13,12,1,0.9230769230769232,27,20,7,0.7407407407407407,0.8219178082191781,shc-gpt-4o,mimiciii,progress_note,PROMPT1_entailment
130,215,38,28,10,0.7368421052631579,66,38,28,0.5757575757575758,0.6464155528554071,shc-gpt-4o,mimiciii,progress_note,PROMPT1_entailment
131,216,47,43,4,0.9148936170212766,67,53,14,0.7910447761194029,0.8484735666418466,shc-gpt-4o,mimiciii,progress_note,PROMPT1_entailment
132,217,45,37,8,0.8222222222222222,73,40,33,0.547945205479452,0.6576316374139081,shc-gpt-4o,mimiciii,progress_note,PROMPT1_entailment
133,218,24,22,2,0.9166666666666666,27,17,10,0.6296296296296297,0.7465069860279442,shc-gpt-4o,mimiciii,progress_note,PROMPT1_entailment
134,219,19,19,0,1.0,17,11,6,0.6470588235294118,0.7857142857142858,shc-gpt-4o,mimiciii,progress_note,PROMPT1_entailment
135,22,9,9,0,1.0,38,34,4,0.8947368421052632,0.9444444444444444,shc-gpt-4o,mimiciii,progress_note,PROMPT1_entailment
136,220,40,38,2,0.95,34,29,5,0.8529411764705882,0.898858075040783,shc-gpt-4o,mimiciii,progress_note,PROMPT1_entailment
137,221,17,16,1,0.9411764705882352,188,73,115,0.3882978723404255,0.5497764179807013,shc-gpt-4o,mimiciii,progress_note,PROMPT1_entailment
138,222,27,25,2,0.925925925925926,263,165,98,0.6273764258555133,0.7479601087941976,shc-gpt-4o,mimiciii,progress_note,PROMPT1_entailment
139,223,11,11,0,1.0,30,22,8,0.7333333333333333,0.846153846153846,shc-gpt-4o,mimiciii,progress_note,PROMPT1_entailment
140,224,16,16,0,1.0,33,30,3,0.9090909090909092,0.9523809523809524,shc-gpt-4o,mimiciii,progress_note,PROMPT1_entailment
141,225,23,23,0,1.0,37,19,18,0.5135135135135135,0.6785714285714285,shc-gpt-4o,mimiciii,progress_note,PROMPT1_entailment
142,226,20,20,0,1.0,33,23,10,0.696969696969697,0.8214285714285715,shc-gpt-4o,mimiciii,progress_note,PROMPT1_entailment
143,227,7,7,0,1.0,15,6,9,0.4,0.5714285714285715,shc-gpt-4o,mimiciii,progress_note,PROMPT1_entailment
144,228,3,3,0,1.0,15,3,12,0.2,0.3333333333333333,shc-gpt-4o,mimiciii,progress_note,PROMPT1_entailment
145,229,3,3,0,1.0,15,3,12,0.2,0.3333333333333333,shc-gpt-4o,mimiciii,progress_note,PROMPT1_entailment
146,23,18,18,0,1.0,37,24,13,0.6486486486486487,0.7868852459016393,shc-gpt-4o,mimiciii,progress_note,PROMPT1_entailment
147,230,22,19,3,0.8636363636363636,26,25,1,0.9615384615384616,0.9099616858237548,shc-gpt-4o,mimiciii,progress_note,PROMPT1_entailment
148,231,45,44,1,0.9777777777777776,102,77,25,0.7549019607843137,0.8520055325034578,shc-gpt-4o,mimiciii,progress_note,PROMPT1_entailment
149,232,37,33,4,0.8918918918918919,72,53,19,0.7361111111111112,0.8065483052801475,shc-gpt-4o,mimiciii,progress_note,PROMPT1_entailment
150,233,40,35,5,0.875,82,50,32,0.6097560975609756,0.7186858316221766,shc-gpt-4o,mimiciii,progress_note,PROMPT1_entailment
151,234,12,12,0,1.0,42,37,5,0.8809523809523809,0.9367088607594936,shc-gpt-4o,mimiciii,progress_note,PROMPT1_entailment
152,24,21,17,4,0.8095238095238095,22,14,8,0.6363636363636364,0.7125748502994012,shc-gpt-4o,mimiciii,progress_note,PROMPT1_entailment
153,25,22,22,0,1.0,22,15,7,0.6818181818181818,0.8108108108108109,shc-gpt-4o,mimiciii,progress_note,PROMPT1_entailment
154,26,10,9,1,0.9,22,12,10,0.5454545454545454,0.679245283018868,shc-gpt-4o,mimiciii,progress_note,PROMPT1_entailment
155,27,19,16,3,0.8421052631578947,19,15,4,0.7894736842105263,0.8149405772495756,shc-gpt-4o,mimiciii,progress_note,PROMPT1_entailment
156,28,37,34,3,0.918918918918919,50,37,13,0.74,0.8198110133594004,shc-gpt-4o,mimiciii,progress_note,PROMPT1_entailment
157,29,40,32,8,0.8,52,37,15,0.7115384615384616,0.7531806615776083,shc-gpt-4o,mimiciii,progress_note,PROMPT1_entailment
158,3,11,9,2,0.8181818181818182,157,67,90,0.4267515923566879,0.5609302325581396,shc-gpt-4o,mimiciii,progress_note,PROMPT1_entailment
159,30,20,20,0,1.0,18,9,9,0.5,0.6666666666666666,shc-gpt-4o,mimiciii,progress_note,PROMPT1_entailment
160,31,5,5,0,1.0,17,17,0,1.0,1.0,shc-gpt-4o,mimiciii,progress_note,PROMPT1_entailment
161,32,35,34,1,0.9714285714285714,99,61,38,0.6161616161616161,0.7540447191419742,shc-gpt-4o,mimiciii,progress_note,PROMPT1_entailment
162,33,36,28,8,0.7777777777777778,65,51,14,0.7846153846153846,0.7811816192560176,shc-gpt-4o,mimiciii,progress_note,PROMPT1_entailment
163,34,46,46,0,1.0,71,49,22,0.6901408450704225,0.8166666666666667,shc-gpt-4o,mimiciii,progress_note,PROMPT1_entailment
164,35,3,3,0,1.0,20,4,16,0.2,0.3333333333333333,shc-gpt-4o,mimiciii,progress_note,PROMPT1_entailment
165,36,4,4,0,1.0,40,17,23,0.425,0.5964912280701754,shc-gpt-4o,mimiciii,progress_note,PROMPT1_entailment
166,37,25,19,6,0.76,199,111,88,0.5577889447236181,0.6433801098230627,shc-gpt-4o,mimiciii,progress_note,PROMPT1_entailment
167,38,122,69,53,0.5655737704918032,158,78,80,0.4936708860759494,0.5271818983250073,shc-gpt-4o,mimiciii,progress_note,PROMPT1_entailment
168,39,35,34,1,0.9714285714285714,76,56,20,0.7368421052631579,0.8380281690140845,shc-gpt-4o,mimiciii,progress_note,PROMPT1_entailment
169,4,20,11,9,0.55,162,89,73,0.5493827160493827,0.5496911847276811,shc-gpt-4o,mimiciii,progress_note,PROMPT1_entailment
170,40,37,35,2,0.945945945945946,76,56,20,0.7368421052631579,0.8284023668639052,shc-gpt-4o,mimiciii,progress_note,PROMPT1_entailment
171,41,33,31,2,0.9393939393939394,78,53,25,0.6794871794871795,0.7885769138468923,shc-gpt-4o,mimiciii,progress_note,PROMPT1_entailment
172,42,35,35,0,1.0,78,51,27,0.6538461538461539,0.7906976744186047,shc-gpt-4o,mimiciii,progress_note,PROMPT1_entailment
173,43,72,63,9,0.875,79,51,28,0.6455696202531646,0.7429760665972945,shc-gpt-4o,mimiciii,progress_note,PROMPT1_entailment
174,44,13,12,1,0.9230769230769232,96,66,30,0.6875,0.7880597014925373,shc-gpt-4o,mimiciii,progress_note,PROMPT1_entailment
175,45,32,28,4,0.875,82,65,17,0.7926829268292683,0.8318098720292505,shc-gpt-4o,mimiciii,progress_note,PROMPT1_entailment
176,46,19,19,0,1.0,36,27,9,0.75,0.8571428571428571,shc-gpt-4o,mimiciii,progress_note,PROMPT1_entailment
177,47,10,10,0,1.0,10,9,1,0.9,0.9473684210526316,shc-gpt-4o,mimiciii,progress_note,PROMPT1_entailment
178,48,48,47,1,0.9791666666666666,30,26,4,0.8666666666666667,0.9194883370955608,shc-gpt-4o,mimiciii,progress_note,PROMPT1_entailment
179,49,62,57,5,0.9193548387096774,57,45,12,0.7894736842105263,0.8494783904619971,shc-gpt-4o,mimiciii,progress_note,PROMPT1_entailment
180,5,137,57,80,0.4160583941605839,175,48,127,0.2742857142857143,0.3306144643828168,shc-gpt-4o,mimiciii,progress_note,PROMPT1_entailment
181,50,80,74,6,0.925,116,92,24,0.7931034482758621,0.8539889613647768,shc-gpt-4o,mimiciii,progress_note,PROMPT1_entailment
182,51,71,36,35,0.5070422535211268,180,72,108,0.4,0.4472049689440994,shc-gpt-4o,mimiciii,progress_note,PROMPT1_entailment
183,52,14,11,3,0.7857142857142857,180,60,120,0.3333333333333333,0.4680851063829786,shc-gpt-4o,mimiciii,progress_note,PROMPT1_entailment
184,53,53,30,23,0.5660377358490566,221,76,145,0.3438914027149321,0.4278476261962844,shc-gpt-4o,mimiciii,progress_note,PROMPT1_entailment
185,54,12,7,5,0.5833333333333334,131,64,67,0.4885496183206106,0.5317507418397626,shc-gpt-4o,mimiciii,progress_note,PROMPT1_entailment
186,55,13,11,2,0.8461538461538461,169,30,139,0.1775147928994082,0.2934637616718542,shc-gpt-4o,mimiciii,progress_note,PROMPT1_entailment
187,56,8,8,0,1.0,40,8,32,0.2,0.3333333333333333,shc-gpt-4o,mimiciii,progress_note,PROMPT1_entailment
188,57,11,10,1,0.9090909090909092,28,23,5,0.8214285714285714,0.8630393996247655,shc-gpt-4o,mimiciii,progress_note,PROMPT1_entailment
189,58,18,16,2,0.8888888888888888,25,17,8,0.68,0.7705382436260623,shc-gpt-4o,mimiciii,progress_note,PROMPT1_entailment
190,59,2,2,0,1.0,25,16,9,0.64,0.7804878048780487,shc-gpt-4o,mimiciii,progress_note,PROMPT1_entailment
191,6,135,82,53,0.6074074074074074,188,67,121,0.3563829787234042,0.4492048567106823,shc-gpt-4o,mimiciii,progress_note,PROMPT1_entailment
192,60,119,71,48,0.5966386554621849,161,93,68,0.577639751552795,0.5869855098230954,shc-gpt-4o,mimiciii,progress_note,PROMPT1_entailment
193,61,18,15,3,0.8333333333333334,37,16,21,0.4324324324324324,0.5693950177935942,shc-gpt-4o,mimiciii,progress_note,PROMPT1_entailment
194,62,18,14,4,0.7777777777777778,37,28,9,0.7567567567567568,0.7671232876712328,shc-gpt-4o,mimiciii,progress_note,PROMPT1_entailment
195,63,44,41,3,0.9318181818181818,96,43,53,0.4479166666666667,0.6050102951269732,shc-gpt-4o,mimiciii,progress_note,PROMPT1_entailment
196,64,1,1,0,1.0,1,1,0,1.0,1.0,shc-gpt-4o,mimiciii,progress_note,PROMPT1_entailment
197,65,17,17,0,1.0,8,8,0,1.0,1.0,shc-gpt-4o,mimiciii,progress_note,PROMPT1_entailment
198,66,27,25,2,0.925925925925926,48,35,13,0.7291666666666666,0.8158508158508158,shc-gpt-4o,mimiciii,progress_note,PROMPT1_entailment
199,67,14,11,3,0.7857142857142857,285,117,168,0.4105263157894737,0.5392834695160276,shc-gpt-4o,mimiciii,progress_note,PROMPT1_entailment
200,68,23,17,6,0.7391304347826086,206,107,99,0.5194174757281553,0.6100955894683884,shc-gpt-4o,mimiciii,progress_note,PROMPT1_entailment
201,69,97,89,8,0.9175257731958762,219,91,128,0.4155251141552511,0.5720036725757468,shc-gpt-4o,mimiciii,progress_note,PROMPT1_entailment
202,7,18,14,4,0.7777777777777778,187,64,123,0.3422459893048128,0.4753315649867374,shc-gpt-4o,mimiciii,progress_note,PROMPT1_entailment
203,70,22,19,3,0.8636363636363636,217,82,135,0.3778801843317972,0.5257297114897924,shc-gpt-4o,mimiciii,progress_note,PROMPT1_entailment
204,71,15,9,6,0.6,213,110,103,0.5164319248826291,0.5550883095037846,shc-gpt-4o,mimiciii,progress_note,PROMPT1_entailment
205,72,7,7,0,1.0,15,8,7,0.5333333333333333,0.6956521739130436,shc-gpt-4o,mimiciii,progress_note,PROMPT1_entailment
206,73,53,45,8,0.8490566037735849,264,83,181,0.3143939393939394,0.4588733951716935,shc-gpt-4o,mimiciii,progress_note,PROMPT1_entailment
207,74,15,15,0,1.0,184,100,84,0.5434782608695652,0.704225352112676,shc-gpt-4o,mimiciii,progress_note,PROMPT1_entailment
208,75,3,3,0,1.0,40,25,15,0.625,0.7692307692307693,shc-gpt-4o,mimiciii,progress_note,PROMPT1_entailment
209,76,5,5,0,1.0,58,30,28,0.5172413793103449,0.6818181818181819,shc-gpt-4o,mimiciii,progress_note,PROMPT1_entailment
210,77,2,2,0,1.0,27,24,3,0.8888888888888888,0.9411764705882352,shc-gpt-4o,mimiciii,progress_note,PROMPT1_entailment
211,78,18,18,0,1.0,20,18,2,0.9,0.9473684210526316,shc-gpt-4o,mimiciii,progress_note,PROMPT1_entailment
212,79,22,18,4,0.8181818181818182,43,22,21,0.5116279069767442,0.629570747217806,shc-gpt-4o,mimiciii,progress_note,PROMPT1_entailment
213,8,48,43,5,0.8958333333333334,78,66,12,0.8461538461538461,0.8702851885924563,shc-gpt-4o,mimiciii,progress_note,PROMPT1_entailment
214,80,5,5,0,1.0,21,19,2,0.9047619047619048,0.95,shc-gpt-4o,mimiciii,progress_note,PROMPT1_entailment
215,81,34,32,2,0.9411764705882352,32,24,8,0.75,0.8347826086956521,shc-gpt-4o,mimiciii,progress_note,PROMPT1_entailment
216,82,3,3,0,1.0,15,2,13,0.1333333333333333,0.2352941176470588,shc-gpt-4o,mimiciii,progress_note,PROMPT1_entailment
217,83,32,30,2,0.9375,43,26,17,0.6046511627906976,0.7351555136663526,shc-gpt-4o,mimiciii,progress_note,PROMPT1_entailment
218,84,22,22,0,1.0,35,23,12,0.6571428571428571,0.7931034482758621,shc-gpt-4o,mimiciii,progress_note,PROMPT1_entailment
219,85,5,4,1,0.8,50,28,22,0.56,0.6588235294117648,shc-gpt-4o,mimiciii,progress_note,PROMPT1_entailment
220,86,42,42,0,1.0,32,22,10,0.6875,0.8148148148148148,shc-gpt-4o,mimiciii,progress_note,PROMPT1_entailment
221,87,8,3,5,0.375,12,6,6,0.5,0.4285714285714285,shc-gpt-4o,mimiciii,progress_note,PROMPT1_entailment
222,88,12,12,0,1.0,67,41,26,0.6119402985074627,0.7592592592592593,shc-gpt-4o,mimiciii,progress_note,PROMPT1_entailment
223,89,15,11,4,0.7333333333333333,199,62,137,0.3115577889447236,0.4373196537351715,shc-gpt-4o,mimiciii,progress_note,PROMPT1_entailment
224,9,28,27,1,0.9642857142857144,42,29,13,0.6904761904761905,0.8047276464542653,shc-gpt-4o,mimiciii,progress_note,PROMPT1_entailment
225,90,5,5,0,1.0,3,3,0,1.0,1.0,shc-gpt-4o,mimiciii,progress_note,PROMPT1_entailment
226,91,46,43,3,0.9347826086956522,79,55,24,0.6962025316455697,0.7980428547325799,shc-gpt-4o,mimiciii,progress_note,PROMPT1_entailment
227,92,9,7,2,0.7777777777777778,143,92,51,0.6433566433566433,0.7042099507927829,shc-gpt-4o,mimiciii,progress_note,PROMPT1_entailment
228,93,5,3,2,0.6,27,15,12,0.5555555555555556,0.576923076923077,shc-gpt-4o,mimiciii,progress_note,PROMPT1_entailment
229,94,50,45,5,0.9,80,60,20,0.75,0.8181818181818182,shc-gpt-4o,mimiciii,progress_note,PROMPT1_entailment
230,95,4,4,0,1.0,32,16,16,0.5,0.6666666666666666,shc-gpt-4o,mimiciii,progress_note,PROMPT1_entailment
231,96,11,2,9,0.1818181818181818,11,5,6,0.4545454545454545,0.2597402597402597,shc-gpt-4o,mimiciii,progress_note,PROMPT1_entailment
232,97,5,5,0,1.0,14,13,1,0.9285714285714286,0.962962962962963,shc-gpt-4o,mimiciii,progress_note,PROMPT1_entailment
233,98,15,15,0,1.0,24,24,0,1.0,1.0,shc-gpt-4o,mimiciii,progress_note,PROMPT1_entailment
234,99,3,3,0,1.0,70,33,37,0.4714285714285714,0.6407766990291262,shc-gpt-4o,mimiciii,progress_note,PROMPT1_entailment
0,0,69,59,10,0.855072463768116,78,73,5,0.935897435897436,0.8936611681709721,shc-gpt-4o,mimiciii,progress_note,PROMPT1_ICL_entailment
1,1,55,50,5,0.9090909090909092,189,85,104,0.4497354497354497,0.6017699115044247,shc-gpt-4o,mimiciii,progress_note,PROMPT1_ICL_entailment
2,10,73,53,20,0.726027397260274,140,66,74,0.4714285714285714,0.571662036280438,shc-gpt-4o,mimiciii,progress_note,PROMPT1_ICL_entailment
3,100,69,64,5,0.927536231884058,77,64,13,0.8311688311688312,0.8767123287671235,shc-gpt-4o,mimiciii,progress_note,PROMPT1_ICL_entailment
4,101,28,27,1,0.9642857142857144,36,24,12,0.6666666666666666,0.7883211678832116,shc-gpt-4o,mimiciii,progress_note,PROMPT1_ICL_entailment
5,102,42,37,5,0.8809523809523809,42,35,7,0.8333333333333334,0.8564814814814815,shc-gpt-4o,mimiciii,progress_note,PROMPT1_ICL_entailment
6,103,106,82,24,0.7735849056603774,204,115,89,0.5637254901960784,0.6521889480600318,shc-gpt-4o,mimiciii,progress_note,PROMPT1_ICL_entailment
7,104,29,29,0,1.0,39,28,11,0.717948717948718,0.835820895522388,shc-gpt-4o,mimiciii,progress_note,PROMPT1_ICL_entailment
8,105,30,28,2,0.9333333333333332,17,16,1,0.9411764705882352,0.9372384937238494,shc-gpt-4o,mimiciii,progress_note,PROMPT1_ICL_entailment
9,106,21,21,0,1.0,40,29,11,0.725,0.8405797101449275,shc-gpt-4o,mimiciii,progress_note,PROMPT1_ICL_entailment
10,107,28,27,1,0.9642857142857144,31,27,4,0.8709677419354839,0.9152542372881356,shc-gpt-4o,mimiciii,progress_note,PROMPT1_ICL_entailment
11,108,48,44,4,0.9166666666666666,68,46,22,0.6764705882352942,0.7784615384615384,shc-gpt-4o,mimiciii,progress_note,PROMPT1_ICL_entailment
12,109,89,77,12,0.8651685393258427,176,91,85,0.5170454545454546,0.6472680245716134,shc-gpt-4o,mimiciii,progress_note,PROMPT1_ICL_entailment
13,11,76,58,18,0.7631578947368421,141,85,56,0.6028368794326241,0.6735892881541194,shc-gpt-4o,mimiciii,progress_note,PROMPT1_ICL_entailment
14,110,88,76,12,0.8636363636363636,215,100,115,0.4651162790697674,0.6046141607000796,shc-gpt-4o,mimiciii,progress_note,PROMPT1_ICL_entailment
15,111,146,110,36,0.7534246575342466,219,97,122,0.4429223744292237,0.5578793265711596,shc-gpt-4o,mimiciii,progress_note,PROMPT1_ICL_entailment
16,112,70,65,5,0.9285714285714286,234,105,129,0.4487179487179487,0.6050531914893618,shc-gpt-4o,mimiciii,progress_note,PROMPT1_ICL_entailment
17,113,113,98,15,0.8672566371681416,196,99,97,0.5051020408163265,0.6383944727751274,shc-gpt-4o,mimiciii,progress_note,PROMPT1_ICL_entailment
18,114,169,114,55,0.6745562130177515,225,95,130,0.4222222222222222,0.5193621867881549,shc-gpt-4o,mimiciii,progress_note,PROMPT1_ICL_entailment
19,115,101,86,15,0.8514851485148515,280,138,142,0.4928571428571429,0.6243358409174602,shc-gpt-4o,mimiciii,progress_note,PROMPT1_ICL_entailment
20,116,33,30,3,0.9090909090909092,35,29,6,0.8285714285714286,0.866965620328849,shc-gpt-4o,mimiciii,progress_note,PROMPT1_ICL_entailment
21,117,25,22,3,0.88,20,18,2,0.9,0.8898876404494382,shc-gpt-4o,mimiciii,progress_note,PROMPT1_ICL_entailment
22,118,38,37,1,0.9736842105263158,23,20,3,0.8695652173913043,0.9186840471756672,shc-gpt-4o,mimiciii,progress_note,PROMPT1_ICL_entailment
23,119,17,16,1,0.9411764705882352,14,13,1,0.9285714285714286,0.9348314606741572,shc-gpt-4o,mimiciii,progress_note,PROMPT1_ICL_entailment
24,12,85,67,18,0.788235294117647,225,79,146,0.3511111111111111,0.4858191831115191,shc-gpt-4o,mimiciii,progress_note,PROMPT1_ICL_entailment
25,120,53,50,3,0.9433962264150944,64,46,18,0.71875,0.8158921603405462,shc-gpt-4o,mimiciii,progress_note,PROMPT1_ICL_entailment
26,121,21,19,2,0.9047619047619048,14,9,5,0.6428571428571429,0.7516483516483518,shc-gpt-4o,mimiciii,progress_note,PROMPT1_ICL_entailment
27,122,51,35,16,0.6862745098039216,47,27,20,0.574468085106383,0.6254136333553938,shc-gpt-4o,mimiciii,progress_note,PROMPT1_ICL_entailment
28,123,45,39,6,0.8666666666666667,50,41,9,0.82,0.8426877470355731,shc-gpt-4o,mimiciii,progress_note,PROMPT1_ICL_entailment
29,124,53,50,3,0.9433962264150944,65,53,12,0.8153846153846154,0.874731803928041,shc-gpt-4o,mimiciii,progress_note,PROMPT1_ICL_entailment
30,125,36,32,4,0.8888888888888888,50,39,11,0.78,0.8308921438082557,shc-gpt-4o,mimiciii,progress_note,PROMPT1_ICL_entailment
31,126,28,26,2,0.9285714285714286,27,17,10,0.6296296296296297,0.7504244482173175,shc-gpt-4o,mimiciii,progress_note,PROMPT1_ICL_entailment
32,127,26,24,2,0.9230769230769232,27,23,4,0.8518518518518519,0.8860353130016052,shc-gpt-4o,mimiciii,progress_note,PROMPT1_ICL_entailment
33,128,40,40,0,1.0,37,29,8,0.7837837837837838,0.8787878787878788,shc-gpt-4o,mimiciii,progress_note,PROMPT1_ICL_entailment
34,129,63,52,11,0.8253968253968254,66,47,19,0.7121212121212122,0.7645862662286875,shc-gpt-4o,mimiciii,progress_note,PROMPT1_ICL_entailment
35,13,47,44,3,0.9361702127659576,73,64,9,0.8767123287671232,0.9054662379421222,shc-gpt-4o,mimiciii,progress_note,PROMPT1_ICL_entailment
36,130,48,41,7,0.8541666666666666,44,29,15,0.6590909090909091,0.744055068836045,shc-gpt-4o,mimiciii,progress_note,PROMPT1_ICL_entailment
37,131,133,117,16,0.8796992481203008,202,118,84,0.5841584158415841,0.7020951993490643,shc-gpt-4o,mimiciii,progress_note,PROMPT1_ICL_entailment
38,132,120,95,25,0.7916666666666666,193,106,87,0.5492227979274611,0.6485268072774109,shc-gpt-4o,mimiciii,progress_note,PROMPT1_ICL_entailment
39,133,66,58,8,0.8787878787878788,157,68,89,0.4331210191082802,0.5802559952920406,shc-gpt-4o,mimiciii,progress_note,PROMPT1_ICL_entailment
40,134,14,11,3,0.7857142857142857,18,11,7,0.6111111111111112,0.6875000000000001,shc-gpt-4o,mimiciii,progress_note,PROMPT1_ICL_entailment
41,135,32,32,0,1.0,35,28,7,0.8,0.888888888888889,shc-gpt-4o,mimiciii,progress_note,PROMPT1_ICL_entailment
42,136,31,30,1,0.967741935483871,43,32,11,0.7441860465116279,0.84136722173532,shc-gpt-4o,mimiciii,progress_note,PROMPT1_ICL_entailment
43,137,20,17,3,0.85,26,24,2,0.9230769230769232,0.8850325379609545,shc-gpt-4o,mimiciii,progress_note,PROMPT1_ICL_entailment
44,138,43,42,1,0.9767441860465116,45,24,21,0.5333333333333333,0.6899383983572895,shc-gpt-4o,mimiciii,progress_note,PROMPT1_ICL_entailment
45,139,45,39,6,0.8666666666666667,45,36,9,0.8,0.832,shc-gpt-4o,mimiciii,progress_note,PROMPT1_ICL_entailment
46,14,41,36,5,0.8780487804878049,43,32,11,0.7441860465116279,0.8055944055944056,shc-gpt-4o,mimiciii,progress_note,PROMPT1_ICL_entailment
47,140,24,21,3,0.875,25,20,5,0.8,0.8358208955223881,shc-gpt-4o,mimiciii,progress_note,PROMPT1_ICL_entailment
48,141,47,43,4,0.9148936170212766,45,22,23,0.4888888888888889,0.6372515998652745,shc-gpt-4o,mimiciii,progress_note,PROMPT1_ICL_entailment
49,142,1,1,0,1.0,50,46,4,0.92,0.9583333333333334,shc-gpt-4o,mimiciii,progress_note,PROMPT1_ICL_entailment
50,143,12,11,1,0.9166666666666666,11,9,2,0.8181818181818182,0.8646288209606987,shc-gpt-4o,mimiciii,progress_note,PROMPT1_ICL_entailment
51,144,57,53,4,0.9298245614035088,50,42,8,0.84,0.8826328310864392,shc-gpt-4o,mimiciii,progress_note,PROMPT1_ICL_entailment
52,145,32,30,2,0.9375,43,30,13,0.6976744186046512,0.8000000000000002,shc-gpt-4o,mimiciii,progress_note,PROMPT1_ICL_entailment
53,146,45,43,2,0.9555555555555556,32,24,8,0.75,0.8403908794788273,shc-gpt-4o,mimiciii,progress_note,PROMPT1_ICL_entailment
54,147,48,48,0,1.0,56,47,9,0.8392857142857143,0.9126213592233008,shc-gpt-4o,mimiciii,progress_note,PROMPT1_ICL_entailment
55,148,9,8,1,0.8888888888888888,4,3,1,0.75,0.8135593220338982,shc-gpt-4o,mimiciii,progress_note,PROMPT1_ICL_entailment
56,149,32,32,0,1.0,29,26,3,0.896551724137931,0.9454545454545454,shc-gpt-4o,mimiciii,progress_note,PROMPT1_ICL_entailment
57,15,108,86,22,0.7962962962962963,163,77,86,0.4723926380368098,0.5929972239634638,shc-gpt-4o,mimiciii,progress_note,PROMPT1_ICL_entailment
58,150,73,68,5,0.9315068493150684,83,71,12,0.8554216867469879,0.8918444629167821,shc-gpt-4o,mimiciii,progress_note,PROMPT1_ICL_entailment
59,151,77,71,6,0.922077922077922,201,93,108,0.4626865671641791,0.6161814109742442,shc-gpt-4o,mimiciii,progress_note,PROMPT1_ICL_entailment
60,152,45,29,16,0.6444444444444445,45,41,4,0.9111111111111112,0.7549206349206349,shc-gpt-4o,mimiciii,progress_note,PROMPT1_ICL_entailment
61,153,52,48,4,0.9230769230769232,219,75,144,0.3424657534246575,0.4995836802664446,shc-gpt-4o,mimiciii,progress_note,PROMPT1_ICL_entailment
62,154,15,15,0,1.0,15,15,0,1.0,1.0,shc-gpt-4o,mimiciii,progress_note,PROMPT1_ICL_entailment
63,155,28,28,0,1.0,32,26,6,0.8125,0.896551724137931,shc-gpt-4o,mimiciii,progress_note,PROMPT1_ICL_entailment
64,156,26,25,1,0.9615384615384616,32,30,2,0.9375,0.9493670886075948,shc-gpt-4o,mimiciii,progress_note,PROMPT1_ICL_entailment
65,157,26,26,0,1.0,29,22,7,0.7586206896551724,0.8627450980392156,shc-gpt-4o,mimiciii,progress_note,PROMPT1_ICL_entailment
66,158,145,126,19,0.8689655172413793,242,137,105,0.5661157024793388,0.6855849236451734,shc-gpt-4o,mimiciii,progress_note,PROMPT1_ICL_entailment
67,159,22,19,3,0.8636363636363636,22,18,4,0.8181818181818182,0.8402948402948404,shc-gpt-4o,mimiciii,progress_note,PROMPT1_ICL_entailment
68,16,25,22,3,0.88,28,26,2,0.9285714285714286,0.9036334913112164,shc-gpt-4o,mimiciii,progress_note,PROMPT1_ICL_entailment
69,160,54,50,4,0.925925925925926,65,39,26,0.6,0.7281553398058253,shc-gpt-4o,mimiciii,progress_note,PROMPT1_ICL_entailment
70,161,74,69,5,0.9324324324324323,201,100,101,0.4975124378109453,0.6488316328929428,shc-gpt-4o,mimiciii,progress_note,PROMPT1_ICL_entailment
71,162,88,74,14,0.8409090909090909,177,93,84,0.5254237288135594,0.6467437270933184,shc-gpt-4o,mimiciii,progress_note,PROMPT1_ICL_entailment
72,163,21,21,0,1.0,28,16,12,0.5714285714285714,0.7272727272727273,shc-gpt-4o,mimiciii,progress_note,PROMPT1_ICL_entailment
73,164,40,36,4,0.9,57,42,15,0.7368421052631579,0.810289389067524,shc-gpt-4o,mimiciii,progress_note,PROMPT1_ICL_entailment
74,165,17,17,0,1.0,25,25,0,1.0,1.0,shc-gpt-4o,mimiciii,progress_note,PROMPT1_ICL_entailment
75,166,32,30,2,0.9375,42,34,8,0.8095238095238095,0.868824531516184,shc-gpt-4o,mimiciii,progress_note,PROMPT1_ICL_entailment
76,167,39,36,3,0.9230769230769232,52,48,4,0.9230769230769232,0.9230769230769232,shc-gpt-4o,mimiciii,progress_note,PROMPT1_ICL_entailment
77,168,114,79,35,0.6929824561403509,182,93,89,0.510989010989011,0.588230584467574,shc-gpt-4o,mimiciii,progress_note,PROMPT1_ICL_entailment
78,169,121,99,22,0.8181818181818182,219,100,119,0.45662100456621,0.5861282969716705,shc-gpt-4o,mimiciii,progress_note,PROMPT1_ICL_entailment
79,17,15,12,3,0.8,15,6,9,0.4,0.5333333333333333,shc-gpt-4o,mimiciii,progress_note,PROMPT1_ICL_entailment
80,170,98,90,8,0.9183673469387756,184,89,95,0.483695652173913,0.633652400917649,shc-gpt-4o,mimiciii,progress_note,PROMPT1_ICL_entailment
81,171,118,103,15,0.8728813559322034,222,106,116,0.4774774774774775,0.617289534686493,shc-gpt-4o,mimiciii,progress_note,PROMPT1_ICL_entailment
82,172,106,89,17,0.839622641509434,198,96,102,0.4848484848484848,0.6147204834880208,shc-gpt-4o,mimiciii,progress_note,PROMPT1_ICL_entailment
83,173,63,54,9,0.8571428571428571,172,80,92,0.4651162790697674,0.6030150753768844,shc-gpt-4o,mimiciii,progress_note,PROMPT1_ICL_entailment
84,174,52,46,6,0.8846153846153846,200,77,123,0.385,0.536504089669797,shc-gpt-4o,mimiciii,progress_note,PROMPT1_ICL_entailment
85,175,102,89,13,0.8725490196078431,207,85,122,0.4106280193236715,0.5584468312848336,shc-gpt-4o,mimiciii,progress_note,PROMPT1_ICL_entailment
86,176,95,68,27,0.7157894736842105,192,96,96,0.5,0.5887445887445888,shc-gpt-4o,mimiciii,progress_note,PROMPT1_ICL_entailment
87,177,79,68,11,0.8607594936708861,192,63,129,0.328125,0.4751289302944601,shc-gpt-4o,mimiciii,progress_note,PROMPT1_ICL_entailment
88,178,18,18,0,1.0,17,16,1,0.9411764705882352,0.9696969696969696,shc-gpt-4o,mimiciii,progress_note,PROMPT1_ICL_entailment
89,179,86,74,12,0.8604651162790697,197,104,93,0.5279187817258884,0.6543661253294788,shc-gpt-4o,mimiciii,progress_note,PROMPT1_ICL_entailment
90,18,27,27,0,1.0,18,18,0,1.0,1.0,shc-gpt-4o,mimiciii,progress_note,PROMPT1_ICL_entailment
91,180,96,86,10,0.8958333333333334,201,95,106,0.472636815920398,0.6187987578580625,shc-gpt-4o,mimiciii,progress_note,PROMPT1_ICL_entailment
92,181,103,72,31,0.6990291262135923,208,95,113,0.4567307692307692,0.5524817252938088,shc-gpt-4o,mimiciii,progress_note,PROMPT1_ICL_entailment
93,182,68,63,5,0.9264705882352942,214,99,115,0.4626168224299065,0.6170970614425646,shc-gpt-4o,mimiciii,progress_note,PROMPT1_ICL_entailment
94,183,118,92,26,0.7796610169491526,226,93,133,0.411504424778761,0.5386891645155197,shc-gpt-4o,mimiciii,progress_note,PROMPT1_ICL_entailment
95,184,103,99,4,0.9611650485436892,194,102,92,0.5257731958762887,0.6797253634894992,shc-gpt-4o,mimiciii,progress_note,PROMPT1_ICL_entailment
96,185,42,37,5,0.8809523809523809,48,25,23,0.5208333333333334,0.6546355272469923,shc-gpt-4o,mimiciii,progress_note,PROMPT1_ICL_entailment
97,186,128,108,20,0.84375,205,131,74,0.6390243902439025,0.7272540351598642,shc-gpt-4o,mimiciii,progress_note,PROMPT1_ICL_entailment
98,187,76,64,12,0.8421052631578947,170,92,78,0.5411764705882353,0.6589077887197852,shc-gpt-4o,mimiciii,progress_note,PROMPT1_ICL_entailment
99,188,79,66,13,0.8354430379746836,202,91,111,0.4504950495049505,0.5853515910530677,shc-gpt-4o,mimiciii,progress_note,PROMPT1_ICL_entailment
100,189,114,100,14,0.8771929824561403,225,116,109,0.5155555555555555,0.6494233568469376,shc-gpt-4o,mimiciii,progress_note,PROMPT1_ICL_entailment
101,19,29,28,1,0.9655172413793104,38,26,12,0.6842105263157895,0.8008800880088008,shc-gpt-4o,mimiciii,progress_note,PROMPT1_ICL_entailment
102,190,68,60,8,0.8823529411764706,223,105,118,0.4708520179372197,0.6140350877192983,shc-gpt-4o,mimiciii,progress_note,PROMPT1_ICL_entailment
103,191,131,121,10,0.9236641221374046,206,118,88,0.5728155339805825,0.7071117274167988,shc-gpt-4o,mimiciii,progress_note,PROMPT1_ICL_entailment
104,192,77,68,9,0.8831168831168831,208,101,107,0.4855769230769231,0.6266137493727476,shc-gpt-4o,mimiciii,progress_note,PROMPT1_ICL_entailment
105,193,91,77,14,0.8461538461538461,243,83,160,0.3415637860082304,0.4866737739872068,shc-gpt-4o,mimiciii,progress_note,PROMPT1_ICL_entailment
106,194,121,106,15,0.8760330578512396,211,123,88,0.5829383886255924,0.7000456388090955,shc-gpt-4o,mimiciii,progress_note,PROMPT1_ICL_entailment
107,195,36,33,3,0.9166666666666666,44,33,11,0.75,0.8250000000000001,shc-gpt-4o,mimiciii,progress_note,PROMPT1_ICL_entailment
108,196,40,39,1,0.975,42,24,18,0.5714285714285714,0.720554272517321,shc-gpt-4o,mimiciii,progress_note,PROMPT1_ICL_entailment
109,197,106,100,6,0.9433962264150944,90,80,10,0.8888888888888888,0.9153318077803204,shc-gpt-4o,mimiciii,progress_note,PROMPT1_ICL_entailment
110,198,37,35,2,0.945945945945946,34,31,3,0.9117647058823528,0.928540864356012,shc-gpt-4o,mimiciii,progress_note,PROMPT1_ICL_entailment
111,199,49,44,5,0.8979591836734694,52,38,14,0.7307692307692307,0.8057831325301205,shc-gpt-4o,mimiciii,progress_note,PROMPT1_ICL_entailment
112,2,85,72,13,0.8470588235294118,140,66,74,0.4714285714285714,0.605736137667304,shc-gpt-4o,mimiciii,progress_note,PROMPT1_ICL_entailment
113,20,24,23,1,0.9583333333333334,33,20,13,0.6060606060606061,0.7425343018563358,shc-gpt-4o,mimiciii,progress_note,PROMPT1_ICL_entailment
114,200,80,60,20,0.75,164,56,108,0.3414634146341463,0.4692737430167597,shc-gpt-4o,mimiciii,progress_note,PROMPT1_ICL_entailment
115,201,100,88,12,0.88,200,100,100,0.5,0.6376811594202899,shc-gpt-4o,mimiciii,progress_note,PROMPT1_ICL_entailment
116,202,80,70,10,0.875,176,75,101,0.4261363636363636,0.5731441048034934,shc-gpt-4o,mimiciii,progress_note,PROMPT1_ICL_entailment
117,203,34,30,4,0.8823529411764706,211,110,101,0.5213270142180095,0.6554121151936445,shc-gpt-4o,mimiciii,progress_note,PROMPT1_ICL_entailment
118,204,128,110,18,0.859375,201,92,109,0.4577114427860697,0.5972968187452046,shc-gpt-4o,mimiciii,progress_note,PROMPT1_ICL_entailment
119,205,105,97,8,0.923809523809524,195,81,114,0.4153846153846154,0.5730853391684901,shc-gpt-4o,mimiciii,progress_note,PROMPT1_ICL_entailment
120,206,141,118,23,0.8368794326241135,239,105,134,0.4393305439330544,0.5761852721649964,shc-gpt-4o,mimiciii,progress_note,PROMPT1_ICL_entailment
121,207,99,79,20,0.797979797979798,233,104,129,0.4463519313304721,0.5724837125039194,shc-gpt-4o,mimiciii,progress_note,PROMPT1_ICL_entailment
122,208,89,72,17,0.8089887640449438,229,115,114,0.5021834061135371,0.6196909029674812,shc-gpt-4o,mimiciii,progress_note,PROMPT1_ICL_entailment
123,209,81,71,10,0.8765432098765432,205,111,94,0.5414634146341464,0.6694130637900281,shc-gpt-4o,mimiciii,progress_note,PROMPT1_ICL_entailment
124,21,89,73,16,0.8202247191011236,217,116,101,0.5345622119815668,0.647276896617619,shc-gpt-4o,mimiciii,progress_note,PROMPT1_ICL_entailment
125,210,29,29,0,1.0,28,25,3,0.8928571428571429,0.9433962264150944,shc-gpt-4o,mimiciii,progress_note,PROMPT1_ICL_entailment
126,211,48,46,2,0.9583333333333334,54,51,3,0.9444444444444444,0.951338199513382,shc-gpt-4o,mimiciii,progress_note,PROMPT1_ICL_entailment
127,212,22,22,0,1.0,14,13,1,0.9285714285714286,0.962962962962963,shc-gpt-4o,mimiciii,progress_note,PROMPT1_ICL_entailment
128,213,43,42,1,0.9767441860465116,41,26,15,0.6341463414634146,0.7690140845070421,shc-gpt-4o,mimiciii,progress_note,PROMPT1_ICL_entailment
129,214,26,26,0,1.0,27,26,1,0.9629629629629628,0.981132075471698,shc-gpt-4o,mimiciii,progress_note,PROMPT1_ICL_entailment
130,215,58,42,16,0.7241379310344828,66,46,20,0.696969696969697,0.7102941176470589,shc-gpt-4o,mimiciii,progress_note,PROMPT1_ICL_entailment
131,216,58,52,6,0.896551724137931,67,54,13,0.8059701492537313,0.8488512696493349,shc-gpt-4o,mimiciii,progress_note,PROMPT1_ICL_entailment
132,217,78,77,1,0.9871794871794872,73,55,18,0.7534246575342466,0.8546059933407326,shc-gpt-4o,mimiciii,progress_note,PROMPT1_ICL_entailment
133,218,42,39,3,0.9285714285714286,27,20,7,0.7407407407407407,0.8240887480190174,shc-gpt-4o,mimiciii,progress_note,PROMPT1_ICL_entailment
134,219,19,19,0,1.0,17,11,6,0.6470588235294118,0.7857142857142858,shc-gpt-4o,mimiciii,progress_note,PROMPT1_ICL_entailment
135,22,31,27,4,0.8709677419354839,38,30,8,0.7894736842105263,0.8282208588957056,shc-gpt-4o,mimiciii,progress_note,PROMPT1_ICL_entailment
136,220,46,44,2,0.9565217391304348,34,29,5,0.8529411764705882,0.9017667844522969,shc-gpt-4o,mimiciii,progress_note,PROMPT1_ICL_entailment
137,221,81,73,8,0.9012345679012346,188,63,125,0.3351063829787234,0.488553672916556,shc-gpt-4o,mimiciii,progress_note,PROMPT1_ICL_entailment
138,222,132,109,23,0.8257575757575758,263,167,96,0.6349809885931559,0.7179113012955769,shc-gpt-4o,mimiciii,progress_note,PROMPT1_ICL_entailment
139,223,29,28,1,0.9655172413793104,30,28,2,0.9333333333333332,0.9491525423728816,shc-gpt-4o,mimiciii,progress_note,PROMPT1_ICL_entailment
140,224,34,33,1,0.9705882352941176,33,31,2,0.9393939393939394,0.9547363509099394,shc-gpt-4o,mimiciii,progress_note,PROMPT1_ICL_entailment
141,225,24,24,0,1.0,37,33,4,0.8918918918918919,0.9428571428571428,shc-gpt-4o,mimiciii,progress_note,PROMPT1_ICL_entailment
142,226,30,27,3,0.9,33,21,12,0.6363636363636364,0.7455621301775148,shc-gpt-4o,mimiciii,progress_note,PROMPT1_ICL_entailment
143,227,8,7,1,0.875,15,2,13,0.1333333333333333,0.2314049586776859,shc-gpt-4o,mimiciii,progress_note,PROMPT1_ICL_entailment
144,228,7,7,0,1.0,15,3,12,0.2,0.3333333333333333,shc-gpt-4o,mimiciii,progress_note,PROMPT1_ICL_entailment
145,229,6,6,0,1.0,15,3,12,0.2,0.3333333333333333,shc-gpt-4o,mimiciii,progress_note,PROMPT1_ICL_entailment
146,23,27,24,3,0.8888888888888888,37,26,11,0.7027027027027027,0.7849056603773585,shc-gpt-4o,mimiciii,progress_note,PROMPT1_ICL_entailment
147,230,22,20,2,0.9090909090909092,26,13,13,0.5,0.6451612903225806,shc-gpt-4o,mimiciii,progress_note,PROMPT1_ICL_entailment
148,231,65,64,1,0.9846153846153848,102,59,43,0.5784313725490197,0.7287465019781917,shc-gpt-4o,mimiciii,progress_note,PROMPT1_ICL_entailment
149,232,65,55,10,0.8461538461538461,72,47,25,0.6527777777777778,0.736992159657876,shc-gpt-4o,mimiciii,progress_note,PROMPT1_ICL_entailment
150,233,63,50,13,0.7936507936507936,82,74,8,0.902439024390244,0.8445560374343757,shc-gpt-4o,mimiciii,progress_note,PROMPT1_ICL_entailment
151,234,32,28,4,0.875,42,32,10,0.7619047619047619,0.8145454545454546,shc-gpt-4o,mimiciii,progress_note,PROMPT1_ICL_entailment
152,24,28,22,6,0.7857142857142857,22,14,8,0.6363636363636364,0.7031963470319634,shc-gpt-4o,mimiciii,progress_note,PROMPT1_ICL_entailment
153,25,19,17,2,0.8947368421052632,22,12,10,0.5454545454545454,0.6777408637873754,shc-gpt-4o,mimiciii,progress_note,PROMPT1_ICL_entailment
154,26,22,20,2,0.9090909090909092,22,18,4,0.8181818181818182,0.861244019138756,shc-gpt-4o,mimiciii,progress_note,PROMPT1_ICL_entailment
155,27,28,14,14,0.5,19,15,4,0.7894736842105263,0.6122448979591837,shc-gpt-4o,mimiciii,progress_note,PROMPT1_ICL_entailment
156,28,49,42,7,0.8571428571428571,50,49,1,0.98,0.9144634525660964,shc-gpt-4o,mimiciii,progress_note,PROMPT1_ICL_entailment
157,29,35,32,3,0.9142857142857144,52,41,11,0.7884615384615384,0.8467247499193288,shc-gpt-4o,mimiciii,progress_note,PROMPT1_ICL_entailment
158,3,81,60,21,0.7407407407407407,157,58,99,0.3694267515923566,0.4929876753081172,shc-gpt-4o,mimiciii,progress_note,PROMPT1_ICL_entailment
159,30,23,22,1,0.9565217391304348,18,12,6,0.6666666666666666,0.7857142857142856,shc-gpt-4o,mimiciii,progress_note,PROMPT1_ICL_entailment
160,31,24,24,0,1.0,17,16,1,0.9411764705882352,0.9696969696969696,shc-gpt-4o,mimiciii,progress_note,PROMPT1_ICL_entailment
161,32,90,85,5,0.9444444444444444,99,74,25,0.7474747474747475,0.8344941956882255,shc-gpt-4o,mimiciii,progress_note,PROMPT1_ICL_entailment
162,33,64,61,3,0.953125,65,49,16,0.7538461538461538,0.8418532601042106,shc-gpt-4o,mimiciii,progress_note,PROMPT1_ICL_entailment
163,34,50,46,4,0.92,71,49,22,0.6901408450704225,0.7886634009797061,shc-gpt-4o,mimiciii,progress_note,PROMPT1_ICL_entailment
164,35,17,13,4,0.7647058823529411,20,6,14,0.3,0.4309392265193369,shc-gpt-4o,mimiciii,progress_note,PROMPT1_ICL_entailment
165,36,24,23,1,0.9583333333333334,40,31,9,0.775,0.856971153846154,shc-gpt-4o,mimiciii,progress_note,PROMPT1_ICL_entailment
166,37,117,107,10,0.9145299145299144,199,123,76,0.6180904522613065,0.7376415200089677,shc-gpt-4o,mimiciii,progress_note,PROMPT1_ICL_entailment
167,38,60,54,6,0.9,158,78,80,0.4936708860759494,0.6376021798365122,shc-gpt-4o,mimiciii,progress_note,PROMPT1_ICL_entailment
168,39,67,64,3,0.9552238805970148,76,57,19,0.75,0.8402625820568926,shc-gpt-4o,mimiciii,progress_note,PROMPT1_ICL_entailment
169,4,87,60,27,0.6896551724137931,162,66,96,0.4074074074074074,0.5122235157159488,shc-gpt-4o,mimiciii,progress_note,PROMPT1_ICL_entailment
170,40,44,44,0,1.0,76,68,8,0.8947368421052632,0.9444444444444444,shc-gpt-4o,mimiciii,progress_note,PROMPT1_ICL_entailment
171,41,70,63,7,0.9,78,59,19,0.7564102564102564,0.8219814241486069,shc-gpt-4o,mimiciii,progress_note,PROMPT1_ICL_entailment
172,42,72,65,7,0.9027777777777778,78,51,27,0.6538461538461539,0.75840768702814,shc-gpt-4o,mimiciii,progress_note,PROMPT1_ICL_entailment
173,43,73,51,22,0.6986301369863014,79,53,26,0.6708860759493671,0.6844770828057736,shc-gpt-4o,mimiciii,progress_note,PROMPT1_ICL_entailment
174,44,57,52,5,0.912280701754386,96,73,23,0.7604166666666666,0.8294548235551185,shc-gpt-4o,mimiciii,progress_note,PROMPT1_ICL_entailment
175,45,66,62,4,0.9393939393939394,82,61,21,0.7439024390243902,0.8302963776070252,shc-gpt-4o,mimiciii,progress_note,PROMPT1_ICL_entailment
176,46,31,31,0,1.0,36,25,11,0.6944444444444444,0.819672131147541,shc-gpt-4o,mimiciii,progress_note,PROMPT1_ICL_entailment
177,47,6,4,2,0.6666666666666666,10,2,8,0.2,0.3076923076923076,shc-gpt-4o,mimiciii,progress_note,PROMPT1_ICL_entailment
178,48,56,54,2,0.9642857142857144,30,26,4,0.8666666666666667,0.9128738621586476,shc-gpt-4o,mimiciii,progress_note,PROMPT1_ICL_entailment
179,49,74,69,5,0.9324324324324323,57,44,13,0.7719298245614035,0.8446237306996801,shc-gpt-4o,mimiciii,progress_note,PROMPT1_ICL_entailment
180,5,84,63,21,0.75,175,70,105,0.4,0.5217391304347827,shc-gpt-4o,mimiciii,progress_note,PROMPT1_ICL_entailment
181,50,115,105,10,0.9130434782608696,116,93,23,0.8017241379310345,0.8537704918032788,shc-gpt-4o,mimiciii,progress_note,PROMPT1_ICL_entailment
182,51,79,59,20,0.7468354430379747,180,90,90,0.5,0.5989847715736041,shc-gpt-4o,mimiciii,progress_note,PROMPT1_ICL_entailment
183,52,60,52,8,0.8666666666666667,180,82,98,0.4555555555555555,0.5971988795518208,shc-gpt-4o,mimiciii,progress_note,PROMPT1_ICL_entailment
184,53,81,70,11,0.8641975308641975,221,96,125,0.4343891402714932,0.578163985201755,shc-gpt-4o,mimiciii,progress_note,PROMPT1_ICL_entailment
185,54,76,46,30,0.6052631578947368,131,74,57,0.5648854961832062,0.5843776824034335,shc-gpt-4o,mimiciii,progress_note,PROMPT1_ICL_entailment
186,55,89,78,11,0.8764044943820225,169,83,86,0.4911242603550296,0.6294909815742137,shc-gpt-4o,mimiciii,progress_note,PROMPT1_ICL_entailment
187,56,18,16,2,0.8888888888888888,40,16,24,0.4,0.5517241379310346,shc-gpt-4o,mimiciii,progress_note,PROMPT1_ICL_entailment
188,57,29,27,2,0.9310344827586208,28,22,6,0.7857142857142857,0.8522238163558106,shc-gpt-4o,mimiciii,progress_note,PROMPT1_ICL_entailment
189,58,21,21,0,1.0,25,19,6,0.76,0.8636363636363636,shc-gpt-4o,mimiciii,progress_note,PROMPT1_ICL_entailment
190,59,25,21,4,0.84,25,19,6,0.76,0.7979999999999999,shc-gpt-4o,mimiciii,progress_note,PROMPT1_ICL_entailment
191,6,39,36,3,0.9230769230769232,188,64,124,0.3404255319148936,0.4974093264248704,shc-gpt-4o,mimiciii,progress_note,PROMPT1_ICL_entailment
192,60,77,60,17,0.7792207792207793,161,69,92,0.4285714285714285,0.5529953917050691,shc-gpt-4o,mimiciii,progress_note,PROMPT1_ICL_entailment
193,61,28,26,2,0.9285714285714286,37,34,3,0.918918918918919,0.9237199582027168,shc-gpt-4o,mimiciii,progress_note,PROMPT1_ICL_entailment
194,62,27,25,2,0.925925925925926,37,29,8,0.7837837837837838,0.8489461358313817,shc-gpt-4o,mimiciii,progress_note,PROMPT1_ICL_entailment
195,63,73,69,4,0.9452054794520548,96,82,14,0.8541666666666666,0.8973830293417921,shc-gpt-4o,mimiciii,progress_note,PROMPT1_ICL_entailment
196,64,2,1,1,0.5,1,1,0,1.0,0.6666666666666666,shc-gpt-4o,mimiciii,progress_note,PROMPT1_ICL_entailment
197,65,19,19,0,1.0,8,8,0,1.0,1.0,shc-gpt-4o,mimiciii,progress_note,PROMPT1_ICL_entailment
198,66,43,41,2,0.9534883720930232,48,37,11,0.7708333333333334,0.8524866535543693,shc-gpt-4o,mimiciii,progress_note,PROMPT1_ICL_entailment
199,67,172,125,47,0.7267441860465116,285,135,150,0.4736842105263157,0.5735406576599541,shc-gpt-4o,mimiciii,progress_note,PROMPT1_ICL_entailment
200,68,34,29,5,0.8529411764705882,206,97,109,0.470873786407767,0.6067730802415876,shc-gpt-4o,mimiciii,progress_note,PROMPT1_ICL_entailment
201,69,99,91,8,0.9191919191919192,219,102,117,0.4657534246575342,0.6182435807773005,shc-gpt-4o,mimiciii,progress_note,PROMPT1_ICL_entailment
202,7,91,75,16,0.8241758241758241,187,60,127,0.320855614973262,0.4618937644341802,shc-gpt-4o,mimiciii,progress_note,PROMPT1_ICL_entailment
203,70,107,94,13,0.8785046728971962,217,99,118,0.456221198156682,0.6005614533251589,shc-gpt-4o,mimiciii,progress_note,PROMPT1_ICL_entailment
204,71,103,99,4,0.9611650485436892,213,100,113,0.4694835680751174,0.6308344218944149,shc-gpt-4o,mimiciii,progress_note,PROMPT1_ICL_entailment
205,72,11,10,1,0.9090909090909092,15,9,6,0.6,0.7228915662650602,shc-gpt-4o,mimiciii,progress_note,PROMPT1_ICL_entailment
206,73,147,106,41,0.7210884353741497,264,109,155,0.4128787878787879,0.5250982798191196,shc-gpt-4o,mimiciii,progress_note,PROMPT1_ICL_entailment
207,74,128,107,21,0.8359375,184,115,69,0.625,0.7152406417112299,shc-gpt-4o,mimiciii,progress_note,PROMPT1_ICL_entailment
208,75,54,54,0,1.0,40,25,15,0.625,0.7692307692307693,shc-gpt-4o,mimiciii,progress_note,PROMPT1_ICL_entailment
209,76,44,41,3,0.9318181818181818,58,37,21,0.6379310344827587,0.7573639540688967,shc-gpt-4o,mimiciii,progress_note,PROMPT1_ICL_entailment
210,77,27,27,0,1.0,27,19,8,0.7037037037037037,0.8260869565217391,shc-gpt-4o,mimiciii,progress_note,PROMPT1_ICL_entailment
211,78,25,24,1,0.96,20,15,5,0.75,0.8421052631578947,shc-gpt-4o,mimiciii,progress_note,PROMPT1_ICL_entailment
212,79,39,35,4,0.8974358974358975,43,27,16,0.627906976744186,0.7388584831899921,shc-gpt-4o,mimiciii,progress_note,PROMPT1_ICL_entailment
213,8,60,56,4,0.9333333333333332,78,74,4,0.9487179487179488,0.9409627611262488,shc-gpt-4o,mimiciii,progress_note,PROMPT1_ICL_entailment
214,80,24,23,1,0.9583333333333334,21,20,1,0.9523809523809524,0.9553478712357216,shc-gpt-4o,mimiciii,progress_note,PROMPT1_ICL_entailment
215,81,38,34,4,0.8947368421052632,32,24,8,0.75,0.816,shc-gpt-4o,mimiciii,progress_note,PROMPT1_ICL_entailment
216,82,19,18,1,0.9473684210526316,15,15,0,1.0,0.972972972972973,shc-gpt-4o,mimiciii,progress_note,PROMPT1_ICL_entailment
217,83,37,34,3,0.918918918918919,43,25,18,0.5813953488372093,0.71219103477168,shc-gpt-4o,mimiciii,progress_note,PROMPT1_ICL_entailment
218,84,28,24,4,0.8571428571428571,35,25,10,0.7142857142857143,0.7792207792207793,shc-gpt-4o,mimiciii,progress_note,PROMPT1_ICL_entailment
219,85,51,43,8,0.8431372549019608,50,45,5,0.9,0.8706411698537683,shc-gpt-4o,mimiciii,progress_note,PROMPT1_ICL_entailment
220,86,63,61,2,0.9682539682539684,32,29,3,0.90625,0.9362265149510453,shc-gpt-4o,mimiciii,progress_note,PROMPT1_ICL_entailment
221,87,12,7,5,0.5833333333333334,12,2,10,0.1666666666666666,0.2592592592592592,shc-gpt-4o,mimiciii,progress_note,PROMPT1_ICL_entailment
222,88,81,71,10,0.8765432098765432,67,56,11,0.835820895522388,0.8556978370816744,shc-gpt-4o,mimiciii,progress_note,PROMPT1_ICL_entailment
223,89,75,69,6,0.92,199,69,130,0.3467336683417085,0.5036496350364964,shc-gpt-4o,mimiciii,progress_note,PROMPT1_ICL_entailment
224,9,33,33,0,1.0,42,29,13,0.6904761904761905,0.8169014084507042,shc-gpt-4o,mimiciii,progress_note,PROMPT1_ICL_entailment
225,90,8,7,1,0.875,3,3,0,1.0,0.9333333333333332,shc-gpt-4o,mimiciii,progress_note,PROMPT1_ICL_entailment
226,91,61,56,5,0.918032786885246,79,64,15,0.810126582278481,0.8607108549471661,shc-gpt-4o,mimiciii,progress_note,PROMPT1_ICL_entailment
227,92,78,67,11,0.8589743589743589,143,96,47,0.6713286713286714,0.753646962329369,shc-gpt-4o,mimiciii,progress_note,PROMPT1_ICL_entailment
228,93,22,19,3,0.8636363636363636,27,21,6,0.7777777777777778,0.8184615384615385,shc-gpt-4o,mimiciii,progress_note,PROMPT1_ICL_entailment
229,94,59,53,6,0.8983050847457628,80,56,24,0.7,0.7868504772004241,shc-gpt-4o,mimiciii,progress_note,PROMPT1_ICL_entailment
230,95,32,29,3,0.90625,32,17,15,0.53125,0.6698369565217391,shc-gpt-4o,mimiciii,progress_note,PROMPT1_ICL_entailment
231,96,9,9,0,1.0,11,2,9,0.1818181818181818,0.3076923076923077,shc-gpt-4o,mimiciii,progress_note,PROMPT1_ICL_entailment
232,97,16,14,2,0.875,14,9,5,0.6428571428571429,0.7411764705882353,shc-gpt-4o,mimiciii,progress_note,PROMPT1_ICL_entailment
233,98,29,28,1,0.9655172413793104,24,21,3,0.875,0.9180327868852458,shc-gpt-4o,mimiciii,progress_note,PROMPT1_ICL_entailment
234,99,47,45,2,0.9574468085106383,70,34,36,0.4857142857142857,0.6444818871103624,shc-gpt-4o,mimiciii,progress_note,PROMPT1_ICL_entailment
0,0,75,65,10,0.8666666666666667,78,67,11,0.8589743589743589,0.8628033680039623,shc-gpt-4o,mimiciii,progress_note,PROMPT2_ICL_entailment
1,1,102,89,13,0.8725490196078431,189,91,98,0.4814814814814814,0.6205417001877179,shc-gpt-4o,mimiciii,progress_note,PROMPT2_ICL_entailment
2,10,90,68,22,0.7555555555555555,140,81,59,0.5785714285714286,0.6553242117787031,shc-gpt-4o,mimiciii,progress_note,PROMPT2_ICL_entailment
3,100,74,67,7,0.9054054054054054,77,60,17,0.7792207792207793,0.8375872486717365,shc-gpt-4o,mimiciii,progress_note,PROMPT2_ICL_entailment
4,101,30,28,2,0.9333333333333332,36,26,10,0.7222222222222222,0.814317673378076,shc-gpt-4o,mimiciii,progress_note,PROMPT2_ICL_entailment
5,102,69,65,4,0.9420289855072465,42,33,9,0.7857142857142857,0.8568004793289394,shc-gpt-4o,mimiciii,progress_note,PROMPT2_ICL_entailment
6,103,118,85,33,0.7203389830508474,204,91,113,0.446078431372549,0.5509651684592919,shc-gpt-4o,mimiciii,progress_note,PROMPT2_ICL_entailment
7,104,29,26,3,0.896551724137931,39,25,14,0.6410256410256411,0.747556066705003,shc-gpt-4o,mimiciii,progress_note,PROMPT2_ICL_entailment
8,105,32,30,2,0.9375,17,16,1,0.9411764705882352,0.9393346379647748,shc-gpt-4o,mimiciii,progress_note,PROMPT2_ICL_entailment
9,106,26,25,1,0.9615384615384616,40,23,17,0.575,0.7196495619524406,shc-gpt-4o,mimiciii,progress_note,PROMPT2_ICL_entailment
10,107,31,29,2,0.935483870967742,31,28,3,0.9032258064516128,0.9190718732314658,shc-gpt-4o,mimiciii,progress_note,PROMPT2_ICL_entailment
11,108,55,47,8,0.8545454545454545,68,46,22,0.6764705882352942,0.7551519385260217,shc-gpt-4o,mimiciii,progress_note,PROMPT2_ICL_entailment
12,109,132,102,30,0.7727272727272727,176,77,99,0.4375,0.5586854460093897,shc-gpt-4o,mimiciii,progress_note,PROMPT2_ICL_entailment
13,11,112,85,27,0.7589285714285714,141,76,65,0.5390070921985816,0.6303361467531833,shc-gpt-4o,mimiciii,progress_note,PROMPT2_ICL_entailment
14,110,167,135,32,0.8083832335329342,215,81,134,0.3767441860465116,0.5139593908629441,shc-gpt-4o,mimiciii,progress_note,PROMPT2_ICL_entailment
15,111,100,68,32,0.68,219,68,151,0.3105022831050228,0.4263322884012539,shc-gpt-4o,mimiciii,progress_note,PROMPT2_ICL_entailment
16,112,172,142,30,0.8255813953488372,234,109,125,0.4658119658119658,0.5955825765738033,shc-gpt-4o,mimiciii,progress_note,PROMPT2_ICL_entailment
17,113,134,110,24,0.8208955223880597,196,111,85,0.5663265306122449,0.6702530603282649,shc-gpt-4o,mimiciii,progress_note,PROMPT2_ICL_entailment
18,114,123,92,31,0.7479674796747967,225,66,159,0.2933333333333333,0.42140328961066,shc-gpt-4o,mimiciii,progress_note,PROMPT2_ICL_entailment
19,115,213,172,41,0.8075117370892019,280,118,162,0.4214285714285714,0.5538243239555762,shc-gpt-4o,mimiciii,progress_note,PROMPT2_ICL_entailment
20,116,42,40,2,0.9523809523809524,35,29,6,0.8285714285714286,0.8861726508785333,shc-gpt-4o,mimiciii,progress_note,PROMPT2_ICL_entailment
21,117,31,27,4,0.8709677419354839,20,18,2,0.9,0.8852459016393444,shc-gpt-4o,mimiciii,progress_note,PROMPT2_ICL_entailment
22,118,40,40,0,1.0,23,18,5,0.782608695652174,0.878048780487805,shc-gpt-4o,mimiciii,progress_note,PROMPT2_ICL_entailment
23,119,16,16,0,1.0,14,12,2,0.8571428571428571,0.923076923076923,shc-gpt-4o,mimiciii,progress_note,PROMPT2_ICL_entailment
24,12,95,70,25,0.7368421052631579,225,81,144,0.36,0.4836852207293666,shc-gpt-4o,mimiciii,progress_note,PROMPT2_ICL_entailment
25,120,59,53,6,0.8983050847457628,64,36,28,0.5625,0.6918056562726613,shc-gpt-4o,mimiciii,progress_note,PROMPT2_ICL_entailment
26,121,20,19,1,0.95,14,9,5,0.6428571428571429,0.7668161434977578,shc-gpt-4o,mimiciii,progress_note,PROMPT2_ICL_entailment
27,122,48,34,14,0.7083333333333334,47,40,7,0.851063829787234,0.7731665719158612,shc-gpt-4o,mimiciii,progress_note,PROMPT2_ICL_entailment
28,123,42,38,4,0.9047619047619048,50,34,16,0.68,0.7764423076923077,shc-gpt-4o,mimiciii,progress_note,PROMPT2_ICL_entailment
29,124,65,59,6,0.9076923076923076,65,61,4,0.9384615384615383,0.9228205128205128,shc-gpt-4o,mimiciii,progress_note,PROMPT2_ICL_entailment
30,125,41,38,3,0.926829268292683,50,35,15,0.7,0.7976011994002998,shc-gpt-4o,mimiciii,progress_note,PROMPT2_ICL_entailment
31,126,28,28,0,1.0,27,14,13,0.5185185185185185,0.6829268292682926,shc-gpt-4o,mimiciii,progress_note,PROMPT2_ICL_entailment
32,127,29,25,4,0.8620689655172413,27,14,13,0.5185185185185185,0.6475485661424607,shc-gpt-4o,mimiciii,progress_note,PROMPT2_ICL_entailment
33,128,53,47,6,0.8867924528301887,37,32,5,0.8648648648648649,0.8756914119359535,shc-gpt-4o,mimiciii,progress_note,PROMPT2_ICL_entailment
34,129,67,59,8,0.8805970149253731,66,54,12,0.8181818181818182,0.8482428115015975,shc-gpt-4o,mimiciii,progress_note,PROMPT2_ICL_entailment
35,13,64,55,9,0.859375,73,45,28,0.6164383561643836,0.7179115300942712,shc-gpt-4o,mimiciii,progress_note,PROMPT2_ICL_entailment
36,130,46,42,4,0.9130434782608696,44,31,13,0.7045454545454546,0.7953573610262674,shc-gpt-4o,mimiciii,progress_note,PROMPT2_ICL_entailment
37,131,109,93,16,0.8532110091743119,202,97,105,0.4801980198019802,0.6145304676589801,shc-gpt-4o,mimiciii,progress_note,PROMPT2_ICL_entailment
38,132,104,90,14,0.8653846153846154,193,121,72,0.6269430051813472,0.7271149095279429,shc-gpt-4o,mimiciii,progress_note,PROMPT2_ICL_entailment
39,133,70,62,8,0.8857142857142857,157,68,89,0.4331210191082802,0.581757968814682,shc-gpt-4o,mimiciii,progress_note,PROMPT2_ICL_entailment
40,134,19,18,1,0.9473684210526316,18,9,9,0.5,0.6545454545454545,shc-gpt-4o,mimiciii,progress_note,PROMPT2_ICL_entailment
41,135,38,36,2,0.9473684210526316,35,15,20,0.4285714285714285,0.5901639344262295,shc-gpt-4o,mimiciii,progress_note,PROMPT2_ICL_entailment
42,136,39,37,2,0.9487179487179488,43,32,11,0.7441860465116279,0.8340965128566397,shc-gpt-4o,mimiciii,progress_note,PROMPT2_ICL_entailment
43,137,23,23,0,1.0,26,20,6,0.7692307692307693,0.8695652173913044,shc-gpt-4o,mimiciii,progress_note,PROMPT2_ICL_entailment
44,138,41,40,1,0.975609756097561,45,27,18,0.6,0.7430340557275541,shc-gpt-4o,mimiciii,progress_note,PROMPT2_ICL_entailment
45,139,45,44,1,0.9777777777777776,45,39,6,0.8666666666666667,0.918875502008032,shc-gpt-4o,mimiciii,progress_note,PROMPT2_ICL_entailment
46,14,40,16,24,0.4,43,2,41,0.0465116279069767,0.0833333333333333,shc-gpt-4o,mimiciii,progress_note,PROMPT2_ICL_entailment
47,140,24,21,3,0.875,25,17,8,0.68,0.7652733118971061,shc-gpt-4o,mimiciii,progress_note,PROMPT2_ICL_entailment
48,141,51,45,6,0.8823529411764706,45,31,14,0.6888888888888889,0.7737104825291181,shc-gpt-4o,mimiciii,progress_note,PROMPT2_ICL_entailment
49,142,53,49,4,0.9245283018867924,50,42,8,0.84,0.8802395209580839,shc-gpt-4o,mimiciii,progress_note,PROMPT2_ICL_entailment
50,143,14,13,1,0.9285714285714286,11,10,1,0.9090909090909092,0.9187279151943464,shc-gpt-4o,mimiciii,progress_note,PROMPT2_ICL_entailment
51,144,56,51,5,0.9107142857142856,50,38,12,0.76,0.8285592133390337,shc-gpt-4o,mimiciii,progress_note,PROMPT2_ICL_entailment
52,145,35,28,7,0.8,43,34,9,0.7906976744186046,0.7953216374269007,shc-gpt-4o,mimiciii,progress_note,PROMPT2_ICL_entailment
53,146,51,45,6,0.8823529411764706,32,24,8,0.75,0.8108108108108107,shc-gpt-4o,mimiciii,progress_note,PROMPT2_ICL_entailment
54,147,48,47,1,0.9791666666666666,56,44,12,0.7857142857142857,0.8718381112984822,shc-gpt-4o,mimiciii,progress_note,PROMPT2_ICL_entailment
55,148,10,9,1,0.9,4,3,1,0.75,0.8181818181818182,shc-gpt-4o,mimiciii,progress_note,PROMPT2_ICL_entailment
56,149,38,38,0,1.0,29,24,5,0.8275862068965517,0.9056603773584906,shc-gpt-4o,mimiciii,progress_note,PROMPT2_ICL_entailment
57,15,124,102,22,0.8225806451612904,163,78,85,0.4785276073619632,0.6050650239561944,shc-gpt-4o,mimiciii,progress_note,PROMPT2_ICL_entailment
58,150,82,71,11,0.8658536585365854,83,59,24,0.7108433734939759,0.7807287298481037,shc-gpt-4o,mimiciii,progress_note,PROMPT2_ICL_entailment
59,151,121,108,13,0.8925619834710744,201,110,91,0.5472636815920398,0.6785081957850247,shc-gpt-4o,mimiciii,progress_note,PROMPT2_ICL_entailment
60,152,24,6,18,0.25,45,11,34,0.2444444444444444,0.247191011235955,shc-gpt-4o,mimiciii,progress_note,PROMPT2_ICL_entailment
61,153,103,92,11,0.8932038834951457,219,62,157,0.2831050228310502,0.4299389462576316,shc-gpt-4o,mimiciii,progress_note,PROMPT2_ICL_entailment
62,154,20,19,1,0.95,15,15,0,1.0,0.9743589743589745,shc-gpt-4o,mimiciii,progress_note,PROMPT2_ICL_entailment
63,155,26,25,1,0.9615384615384616,32,28,4,0.875,0.9162303664921464,shc-gpt-4o,mimiciii,progress_note,PROMPT2_ICL_entailment
64,156,27,25,2,0.925925925925926,32,27,5,0.84375,0.8829300196206671,shc-gpt-4o,mimiciii,progress_note,PROMPT2_ICL_entailment
65,157,28,27,1,0.9642857142857144,29,29,0,1.0,0.9818181818181818,shc-gpt-4o,mimiciii,progress_note,PROMPT2_ICL_entailment
66,158,185,156,29,0.8432432432432433,242,107,135,0.4421487603305785,0.5801171216570804,shc-gpt-4o,mimiciii,progress_note,PROMPT2_ICL_entailment
67,159,22,21,1,0.9545454545454546,22,12,10,0.5454545454545454,0.6942148760330578,shc-gpt-4o,mimiciii,progress_note,PROMPT2_ICL_entailment
68,16,29,28,1,0.9655172413793104,28,24,4,0.8571428571428571,0.908108108108108,shc-gpt-4o,mimiciii,progress_note,PROMPT2_ICL_entailment
69,160,60,55,5,0.9166666666666666,65,52,13,0.8,0.854368932038835,shc-gpt-4o,mimiciii,progress_note,PROMPT2_ICL_entailment
70,161,112,86,26,0.7678571428571429,201,107,94,0.5323383084577115,0.6287666552784421,shc-gpt-4o,mimiciii,progress_note,PROMPT2_ICL_entailment
71,162,78,70,8,0.8974358974358975,177,70,107,0.3954802259887006,0.5490196078431373,shc-gpt-4o,mimiciii,progress_note,PROMPT2_ICL_entailment
72,163,21,20,1,0.9523809523809524,28,17,11,0.6071428571428571,0.7415485278080699,shc-gpt-4o,mimiciii,progress_note,PROMPT2_ICL_entailment
73,164,54,51,3,0.9444444444444444,57,50,7,0.8771929824561403,0.909577314071696,shc-gpt-4o,mimiciii,progress_note,PROMPT2_ICL_entailment
74,165,16,16,0,1.0,25,7,18,0.28,0.4375,shc-gpt-4o,mimiciii,progress_note,PROMPT2_ICL_entailment
75,166,31,28,3,0.9032258064516128,42,28,14,0.6666666666666666,0.7671232876712328,shc-gpt-4o,mimiciii,progress_note,PROMPT2_ICL_entailment
76,167,45,43,2,0.9555555555555556,52,29,23,0.5576923076923077,0.704320813329568,shc-gpt-4o,mimiciii,progress_note,PROMPT2_ICL_entailment
77,168,101,78,23,0.7722772277227723,182,82,100,0.4505494505494505,0.5690897766705223,shc-gpt-4o,mimiciii,progress_note,PROMPT2_ICL_entailment
78,169,145,138,7,0.9517241379310344,219,110,109,0.502283105022831,0.6575413670622888,shc-gpt-4o,mimiciii,progress_note,PROMPT2_ICL_entailment
79,17,9,8,1,0.8888888888888888,15,12,3,0.8,0.8421052631578948,shc-gpt-4o,mimiciii,progress_note,PROMPT2_ICL_entailment
80,170,138,120,18,0.8695652173913043,184,84,100,0.4565217391304347,0.5987170349251604,shc-gpt-4o,mimiciii,progress_note,PROMPT2_ICL_entailment
81,171,150,140,10,0.9333333333333332,222,119,103,0.536036036036036,0.6809728183118741,shc-gpt-4o,mimiciii,progress_note,PROMPT2_ICL_entailment
82,172,151,130,21,0.8609271523178808,198,108,90,0.5454545454545454,0.6678082191780822,shc-gpt-4o,mimiciii,progress_note,PROMPT2_ICL_entailment
83,173,81,65,16,0.8024691358024691,172,87,85,0.5058139534883721,0.620508037526746,shc-gpt-4o,mimiciii,progress_note,PROMPT2_ICL_entailment
84,174,128,111,17,0.8671875,200,91,109,0.455,0.5968447175608603,shc-gpt-4o,mimiciii,progress_note,PROMPT2_ICL_entailment
85,175,119,101,18,0.8487394957983193,207,92,115,0.4444444444444444,0.5833935018050542,shc-gpt-4o,mimiciii,progress_note,PROMPT2_ICL_entailment
86,176,127,103,24,0.8110236220472441,192,68,124,0.3541666666666667,0.493031113613966,shc-gpt-4o,mimiciii,progress_note,PROMPT2_ICL_entailment
87,177,109,85,24,0.7798165137614679,192,81,111,0.421875,0.5475366813789813,shc-gpt-4o,mimiciii,progress_note,PROMPT2_ICL_entailment
88,178,18,18,0,1.0,17,16,1,0.9411764705882352,0.9696969696969696,shc-gpt-4o,mimiciii,progress_note,PROMPT2_ICL_entailment
89,179,99,83,16,0.8383838383838383,197,101,96,0.5126903553299492,0.636280834914611,shc-gpt-4o,mimiciii,progress_note,PROMPT2_ICL_entailment
90,18,30,29,1,0.9666666666666668,18,16,2,0.8888888888888888,0.9261477045908182,shc-gpt-4o,mimiciii,progress_note,PROMPT2_ICL_entailment
91,180,101,89,12,0.8811881188118812,201,88,113,0.4378109452736318,0.5849796467117302,shc-gpt-4o,mimiciii,progress_note,PROMPT2_ICL_entailment
92,181,183,134,49,0.73224043715847,208,83,125,0.3990384615384615,0.5165695176609926,shc-gpt-4o,mimiciii,progress_note,PROMPT2_ICL_entailment
93,182,125,111,14,0.888,214,92,122,0.4299065420560747,0.5793385147784649,shc-gpt-4o,mimiciii,progress_note,PROMPT2_ICL_entailment
94,183,124,95,29,0.7661290322580645,226,95,131,0.4203539823008849,0.5428571428571428,shc-gpt-4o,mimiciii,progress_note,PROMPT2_ICL_entailment
95,184,95,94,1,0.9894736842105264,194,101,93,0.520618556701031,0.6822607883295607,shc-gpt-4o,mimiciii,progress_note,PROMPT2_ICL_entailment
96,185,41,38,3,0.926829268292683,48,28,20,0.5833333333333334,0.7160161507402424,shc-gpt-4o,mimiciii,progress_note,PROMPT2_ICL_entailment
97,186,148,125,23,0.8445945945945946,205,121,84,0.5902439024390244,0.694875152183401,shc-gpt-4o,mimiciii,progress_note,PROMPT2_ICL_entailment
98,187,135,100,35,0.7407407407407407,170,76,94,0.4470588235294118,0.5575935436537051,shc-gpt-4o,mimiciii,progress_note,PROMPT2_ICL_entailment
99,188,106,94,12,0.8867924528301887,202,66,136,0.3267326732673267,0.4775246305418719,shc-gpt-4o,mimiciii,progress_note,PROMPT2_ICL_entailment
100,189,139,114,25,0.8201438848920863,225,100,125,0.4444444444444444,0.5764854614412137,shc-gpt-4o,mimiciii,progress_note,PROMPT2_ICL_entailment
101,19,33,33,0,1.0,38,28,10,0.7368421052631579,0.8484848484848484,shc-gpt-4o,mimiciii,progress_note,PROMPT2_ICL_entailment
102,190,172,144,28,0.8372093023255814,223,98,125,0.4394618834080717,0.5763764090834831,shc-gpt-4o,mimiciii,progress_note,PROMPT2_ICL_entailment
103,191,137,123,14,0.8978102189781022,206,101,105,0.4902912621359223,0.6342310146777282,shc-gpt-4o,mimiciii,progress_note,PROMPT2_ICL_entailment
104,192,147,132,15,0.8979591836734694,208,109,99,0.5240384615384616,0.6618367487752708,shc-gpt-4o,mimiciii,progress_note,PROMPT2_ICL_entailment
105,193,141,109,32,0.7730496453900709,243,101,142,0.4156378600823045,0.5406108819485367,shc-gpt-4o,mimiciii,progress_note,PROMPT2_ICL_entailment
106,194,113,93,20,0.8230088495575221,211,123,88,0.5829383886255924,0.682477179165921,shc-gpt-4o,mimiciii,progress_note,PROMPT2_ICL_entailment
107,195,32,31,1,0.96875,44,37,7,0.8409090909090909,0.9003139717425432,shc-gpt-4o,mimiciii,progress_note,PROMPT2_ICL_entailment
108,196,44,42,2,0.9545454545454546,42,33,9,0.7857142857142857,0.8619402985074627,shc-gpt-4o,mimiciii,progress_note,PROMPT2_ICL_entailment
109,197,107,104,3,0.97196261682243,90,57,33,0.6333333333333333,0.7669318843392198,shc-gpt-4o,mimiciii,progress_note,PROMPT2_ICL_entailment
110,198,46,44,2,0.9565217391304348,34,32,2,0.9411764705882352,0.9487870619946092,shc-gpt-4o,mimiciii,progress_note,PROMPT2_ICL_entailment
111,199,55,47,8,0.8545454545454545,52,28,24,0.5384615384615384,0.6606425702811245,shc-gpt-4o,mimiciii,progress_note,PROMPT2_ICL_entailment
112,2,69,58,11,0.8405797101449275,140,87,53,0.6214285714285714,0.7145790554414785,shc-gpt-4o,mimiciii,progress_note,PROMPT2_ICL_entailment
113,20,28,26,2,0.9285714285714286,33,20,13,0.6060606060606061,0.7334273624823695,shc-gpt-4o,mimiciii,progress_note,PROMPT2_ICL_entailment
114,200,90,71,19,0.7888888888888889,164,63,101,0.3841463414634146,0.5166916945824188,shc-gpt-4o,mimiciii,progress_note,PROMPT2_ICL_entailment
115,201,114,97,17,0.8508771929824561,200,98,102,0.49,0.6218762266125867,shc-gpt-4o,mimiciii,progress_note,PROMPT2_ICL_entailment
116,202,108,93,15,0.8611111111111112,176,68,108,0.3863636363636363,0.5334008097165992,shc-gpt-4o,mimiciii,progress_note,PROMPT2_ICL_entailment
117,203,138,122,16,0.8840579710144928,211,98,113,0.4644549763033175,0.6089746854785311,shc-gpt-4o,mimiciii,progress_note,PROMPT2_ICL_entailment
118,204,110,99,11,0.9,201,95,106,0.472636815920398,0.6197897789054004,shc-gpt-4o,mimiciii,progress_note,PROMPT2_ICL_entailment
119,205,132,120,12,0.9090909090909092,195,121,74,0.6205128205128205,0.7375800060957025,shc-gpt-4o,mimiciii,progress_note,PROMPT2_ICL_entailment
120,206,149,119,30,0.7986577181208053,239,119,120,0.497907949790795,0.61340206185567,shc-gpt-4o,mimiciii,progress_note,PROMPT2_ICL_entailment
121,207,167,128,39,0.7664670658682635,233,75,158,0.3218884120171674,0.4533755224444497,shc-gpt-4o,mimiciii,progress_note,PROMPT2_ICL_entailment
122,208,117,95,22,0.811965811965812,229,90,139,0.3930131004366812,0.5296577357906148,shc-gpt-4o,mimiciii,progress_note,PROMPT2_ICL_entailment
123,209,161,133,28,0.8260869565217391,205,85,120,0.4146341463414634,0.5521367521367521,shc-gpt-4o,mimiciii,progress_note,PROMPT2_ICL_entailment
124,21,178,145,33,0.8146067415730337,217,65,152,0.2995391705069124,0.4380155687231323,shc-gpt-4o,mimiciii,progress_note,PROMPT2_ICL_entailment
125,210,42,42,0,1.0,28,24,4,0.8571428571428571,0.923076923076923,shc-gpt-4o,mimiciii,progress_note,PROMPT2_ICL_entailment
126,211,55,55,0,1.0,54,47,7,0.8703703703703703,0.9306930693069309,shc-gpt-4o,mimiciii,progress_note,PROMPT2_ICL_entailment
127,212,22,22,0,1.0,14,13,1,0.9285714285714286,0.962962962962963,shc-gpt-4o,mimiciii,progress_note,PROMPT2_ICL_entailment
128,213,48,48,0,1.0,41,25,16,0.6097560975609756,0.7575757575757575,shc-gpt-4o,mimiciii,progress_note,PROMPT2_ICL_entailment
129,214,29,29,0,1.0,27,26,1,0.9629629629629628,0.981132075471698,shc-gpt-4o,mimiciii,progress_note,PROMPT2_ICL_entailment
130,215,74,54,20,0.7297297297297297,66,41,25,0.6212121212121212,0.6711124583207032,shc-gpt-4o,mimiciii,progress_note,PROMPT2_ICL_entailment
131,216,70,58,12,0.8285714285714286,67,40,27,0.5970149253731343,0.6939874364343404,shc-gpt-4o,mimiciii,progress_note,PROMPT2_ICL_entailment
132,217,86,82,4,0.9534883720930232,73,61,12,0.8356164383561644,0.8906695156695156,shc-gpt-4o,mimiciii,progress_note,PROMPT2_ICL_entailment
133,218,41,39,2,0.951219512195122,27,23,4,0.8518518518518519,0.8987975951903807,shc-gpt-4o,mimiciii,progress_note,PROMPT2_ICL_entailment
134,219,23,23,0,1.0,17,14,3,0.8235294117647058,0.9032258064516128,shc-gpt-4o,mimiciii,progress_note,PROMPT2_ICL_entailment
135,22,37,34,3,0.918918918918919,38,28,10,0.7368421052631579,0.8178694158075602,shc-gpt-4o,mimiciii,progress_note,PROMPT2_ICL_entailment
136,220,54,52,2,0.9629629629629628,34,29,5,0.8529411764705882,0.904619076184763,shc-gpt-4o,mimiciii,progress_note,PROMPT2_ICL_entailment
137,221,125,105,20,0.84,188,72,116,0.3829787234042553,0.5260960334029228,shc-gpt-4o,mimiciii,progress_note,PROMPT2_ICL_entailment
138,222,187,153,34,0.8181818181818182,263,146,117,0.5551330798479087,0.6614648879939592,shc-gpt-4o,mimiciii,progress_note,PROMPT2_ICL_entailment
139,223,34,34,0,1.0,30,27,3,0.9,0.9473684210526316,shc-gpt-4o,mimiciii,progress_note,PROMPT2_ICL_entailment
140,224,36,35,1,0.9722222222222222,33,31,2,0.9393939393939394,0.9555261999119332,shc-gpt-4o,mimiciii,progress_note,PROMPT2_ICL_entailment
141,225,31,28,3,0.9032258064516128,37,28,9,0.7567567567567568,0.823529411764706,shc-gpt-4o,mimiciii,progress_note,PROMPT2_ICL_entailment
142,226,39,32,7,0.8205128205128205,33,20,13,0.6060606060606061,0.6971677559912853,shc-gpt-4o,mimiciii,progress_note,PROMPT2_ICL_entailment
143,227,7,7,0,1.0,15,3,12,0.2,0.3333333333333333,shc-gpt-4o,mimiciii,progress_note,PROMPT2_ICL_entailment
144,228,19,19,0,1.0,15,2,13,0.1333333333333333,0.2352941176470588,shc-gpt-4o,mimiciii,progress_note,PROMPT2_ICL_entailment
145,229,9,9,0,1.0,15,5,10,0.3333333333333333,0.5,shc-gpt-4o,mimiciii,progress_note,PROMPT2_ICL_entailment
146,23,27,25,2,0.925925925925926,37,28,9,0.7567567567567568,0.8328375966686498,shc-gpt-4o,mimiciii,progress_note,PROMPT2_ICL_entailment
147,230,27,24,3,0.8888888888888888,26,18,8,0.6923076923076923,0.7783783783783783,shc-gpt-4o,mimiciii,progress_note,PROMPT2_ICL_entailment
148,231,76,74,2,0.9736842105263158,102,78,24,0.7647058823529411,0.856634016028495,shc-gpt-4o,mimiciii,progress_note,PROMPT2_ICL_entailment
149,232,73,64,9,0.8767123287671232,72,50,22,0.6944444444444444,0.7750060547348027,shc-gpt-4o,mimiciii,progress_note,PROMPT2_ICL_entailment
150,233,70,59,11,0.8428571428571429,82,61,21,0.7439024390243902,0.790294246815986,shc-gpt-4o,mimiciii,progress_note,PROMPT2_ICL_entailment
151,234,31,31,0,1.0,42,37,5,0.8809523809523809,0.9367088607594936,shc-gpt-4o,mimiciii,progress_note,PROMPT2_ICL_entailment
152,24,24,19,5,0.7916666666666666,22,10,12,0.4545454545454545,0.5775075987841946,shc-gpt-4o,mimiciii,progress_note,PROMPT2_ICL_entailment
153,25,22,19,3,0.8636363636363636,22,12,10,0.5454545454545454,0.6686217008797654,shc-gpt-4o,mimiciii,progress_note,PROMPT2_ICL_entailment
154,26,28,23,5,0.8214285714285714,22,11,11,0.5,0.6216216216216216,shc-gpt-4o,mimiciii,progress_note,PROMPT2_ICL_entailment
155,27,28,20,8,0.7142857142857143,19,13,6,0.6842105263157895,0.6989247311827957,shc-gpt-4o,mimiciii,progress_note,PROMPT2_ICL_entailment
156,28,47,46,1,0.9787234042553192,50,41,9,0.82,0.8923586467944168,shc-gpt-4o,mimiciii,progress_note,PROMPT2_ICL_entailment
157,29,36,34,2,0.9444444444444444,52,40,12,0.7692307692307693,0.8478802992518703,shc-gpt-4o,mimiciii,progress_note,PROMPT2_ICL_entailment
158,3,89,71,18,0.797752808988764,157,59,98,0.375796178343949,0.5109159653616294,shc-gpt-4o,mimiciii,progress_note,PROMPT2_ICL_entailment
159,30,28,26,2,0.9285714285714286,18,11,7,0.6111111111111112,0.7371134020618557,shc-gpt-4o,mimiciii,progress_note,PROMPT2_ICL_entailment
160,31,27,27,0,1.0,17,16,1,0.9411764705882352,0.9696969696969696,shc-gpt-4o,mimiciii,progress_note,PROMPT2_ICL_entailment
161,32,94,89,5,0.946808510638298,99,62,37,0.6262626262626263,0.7538766309174124,shc-gpt-4o,mimiciii,progress_note,PROMPT2_ICL_entailment
162,33,81,68,13,0.8395061728395061,65,46,19,0.7076923076923077,0.7679842867665113,shc-gpt-4o,mimiciii,progress_note,PROMPT2_ICL_entailment
163,34,59,53,6,0.8983050847457628,71,37,34,0.5211267605633803,0.6596030945173226,shc-gpt-4o,mimiciii,progress_note,PROMPT2_ICL_entailment
164,35,20,19,1,0.95,20,6,14,0.3,0.4559999999999999,shc-gpt-4o,mimiciii,progress_note,PROMPT2_ICL_entailment
165,36,41,37,4,0.902439024390244,40,26,14,0.65,0.7556952081696781,shc-gpt-4o,mimiciii,progress_note,PROMPT2_ICL_entailment
166,37,142,121,21,0.852112676056338,199,124,75,0.6231155778894473,0.7198407177297479,shc-gpt-4o,mimiciii,progress_note,PROMPT2_ICL_entailment
167,38,60,53,7,0.8833333333333333,158,70,88,0.4430379746835443,0.5901065691108637,shc-gpt-4o,mimiciii,progress_note,PROMPT2_ICL_entailment
168,39,62,59,3,0.9516129032258064,76,56,20,0.7368421052631579,0.8305681246857717,shc-gpt-4o,mimiciii,progress_note,PROMPT2_ICL_entailment
169,4,96,74,22,0.7708333333333334,162,76,86,0.4691358024691358,0.5832814768720183,shc-gpt-4o,mimiciii,progress_note,PROMPT2_ICL_entailment
170,40,54,51,3,0.9444444444444444,76,62,14,0.8157894736842105,0.8754152823920266,shc-gpt-4o,mimiciii,progress_note,PROMPT2_ICL_entailment
171,41,74,64,10,0.8648648648648649,78,52,26,0.6666666666666666,0.7529411764705882,shc-gpt-4o,mimiciii,progress_note,PROMPT2_ICL_entailment
172,42,75,71,4,0.9466666666666668,78,58,20,0.7435897435897436,0.8329288025889967,shc-gpt-4o,mimiciii,progress_note,PROMPT2_ICL_entailment
173,43,80,67,13,0.8375,79,48,31,0.6075949367088608,0.7042592795357495,shc-gpt-4o,mimiciii,progress_note,PROMPT2_ICL_entailment
174,44,62,60,2,0.967741935483871,96,66,30,0.6875,0.8038976857490864,shc-gpt-4o,mimiciii,progress_note,PROMPT2_ICL_entailment
175,45,75,68,7,0.9066666666666666,82,59,23,0.7195121951219512,0.8023197680231977,shc-gpt-4o,mimiciii,progress_note,PROMPT2_ICL_entailment
176,46,30,29,1,0.9666666666666668,36,26,10,0.7222222222222222,0.8267543859649124,shc-gpt-4o,mimiciii,progress_note,PROMPT2_ICL_entailment
177,47,4,4,0,1.0,10,6,4,0.6,0.7499999999999999,shc-gpt-4o,mimiciii,progress_note,PROMPT2_ICL_entailment
178,48,63,61,2,0.9682539682539684,30,30,0,1.0,0.9838709677419354,shc-gpt-4o,mimiciii,progress_note,PROMPT2_ICL_entailment
179,49,88,82,6,0.9318181818181818,57,44,13,0.7719298245614035,0.8443716358530305,shc-gpt-4o,mimiciii,progress_note,PROMPT2_ICL_entailment
180,5,75,67,8,0.8933333333333333,175,83,92,0.4742857142857143,0.6196100278551532,shc-gpt-4o,mimiciii,progress_note,PROMPT2_ICL_entailment
181,50,130,110,20,0.8461538461538461,116,94,22,0.8103448275862069,0.8278622898318654,shc-gpt-4o,mimiciii,progress_note,PROMPT2_ICL_entailment
182,51,83,63,20,0.7590361445783133,180,70,110,0.3888888888888889,0.5142857142857142,shc-gpt-4o,mimiciii,progress_note,PROMPT2_ICL_entailment
183,52,100,76,24,0.76,180,69,111,0.3833333333333333,0.5096209912536444,shc-gpt-4o,mimiciii,progress_note,PROMPT2_ICL_entailment
184,53,110,91,19,0.8272727272727273,221,75,146,0.3393665158371041,0.4812947357286414,shc-gpt-4o,mimiciii,progress_note,PROMPT2_ICL_entailment
185,54,86,45,41,0.5232558139534884,131,40,91,0.3053435114503817,0.385645420460632,shc-gpt-4o,mimiciii,progress_note,PROMPT2_ICL_entailment
186,55,88,75,13,0.8522727272727273,169,60,109,0.3550295857988165,0.5012531328320802,shc-gpt-4o,mimiciii,progress_note,PROMPT2_ICL_entailment
187,56,16,16,0,1.0,40,8,32,0.2,0.3333333333333333,shc-gpt-4o,mimiciii,progress_note,PROMPT2_ICL_entailment
188,57,38,36,2,0.9473684210526316,28,21,7,0.75,0.8372093023255814,shc-gpt-4o,mimiciii,progress_note,PROMPT2_ICL_entailment
189,58,26,23,3,0.8846153846153846,25,14,11,0.56,0.6858359957401491,shc-gpt-4o,mimiciii,progress_note,PROMPT2_ICL_entailment
190,59,26,24,2,0.9230769230769232,25,18,7,0.72,0.8089887640449438,shc-gpt-4o,mimiciii,progress_note,PROMPT2_ICL_entailment
191,6,164,114,50,0.6951219512195121,188,66,122,0.351063829787234,0.4665178571428571,shc-gpt-4o,mimiciii,progress_note,PROMPT2_ICL_entailment
192,60,72,58,14,0.8055555555555556,161,110,51,0.6832298136645962,0.739367249971028,shc-gpt-4o,mimiciii,progress_note,PROMPT2_ICL_entailment
193,61,28,27,1,0.9642857142857144,37,29,8,0.7837837837837838,0.8647156267255659,shc-gpt-4o,mimiciii,progress_note,PROMPT2_ICL_entailment
194,62,29,28,1,0.9655172413793104,37,28,9,0.7567567567567568,0.8484848484848485,shc-gpt-4o,mimiciii,progress_note,PROMPT2_ICL_entailment
195,63,86,81,5,0.9418604651162792,96,71,25,0.7395833333333334,0.8285549632617779,shc-gpt-4o,mimiciii,progress_note,PROMPT2_ICL_entailment
196,64,3,3,0,1.0,1,1,0,1.0,1.0,shc-gpt-4o,mimiciii,progress_note,PROMPT2_ICL_entailment
197,65,19,19,0,1.0,8,8,0,1.0,1.0,shc-gpt-4o,mimiciii,progress_note,PROMPT2_ICL_entailment
198,66,43,41,2,0.9534883720930232,48,40,8,0.8333333333333334,0.8893709327548808,shc-gpt-4o,mimiciii,progress_note,PROMPT2_ICL_entailment
199,67,220,148,72,0.6727272727272727,285,108,177,0.3789473684210526,0.4848043676069154,shc-gpt-4o,mimiciii,progress_note,PROMPT2_ICL_entailment
200,68,132,97,35,0.7348484848484849,206,87,119,0.4223300970873786,0.536388482806839,shc-gpt-4o,mimiciii,progress_note,PROMPT2_ICL_entailment
201,69,135,121,14,0.8962962962962963,219,129,90,0.589041095890411,0.7108894657740128,shc-gpt-4o,mimiciii,progress_note,PROMPT2_ICL_entailment
202,7,111,97,14,0.8738738738738738,187,77,110,0.4117647058823529,0.5597691673536687,shc-gpt-4o,mimiciii,progress_note,PROMPT2_ICL_entailment
203,70,97,81,16,0.8350515463917526,217,81,136,0.3732718894009216,0.5159235668789809,shc-gpt-4o,mimiciii,progress_note,PROMPT2_ICL_entailment
204,71,122,109,13,0.8934426229508197,213,77,136,0.3615023474178404,0.5147342921100242,shc-gpt-4o,mimiciii,progress_note,PROMPT2_ICL_entailment
205,72,7,7,0,1.0,15,9,6,0.6,0.7499999999999999,shc-gpt-4o,mimiciii,progress_note,PROMPT2_ICL_entailment
206,73,204,136,68,0.6666666666666666,264,91,173,0.3446969696969697,0.4544319600499376,shc-gpt-4o,mimiciii,progress_note,PROMPT2_ICL_entailment
207,74,153,129,24,0.8431372549019608,184,110,74,0.5978260869565217,0.6996006507913032,shc-gpt-4o,mimiciii,progress_note,PROMPT2_ICL_entailment
208,75,60,56,4,0.9333333333333332,40,24,16,0.6,0.7304347826086957,shc-gpt-4o,mimiciii,progress_note,PROMPT2_ICL_entailment
209,76,46,42,4,0.9130434782608696,58,38,20,0.6551724137931034,0.762906309751434,shc-gpt-4o,mimiciii,progress_note,PROMPT2_ICL_entailment
210,77,26,26,0,1.0,27,25,2,0.925925925925926,0.9615384615384616,shc-gpt-4o,mimiciii,progress_note,PROMPT2_ICL_entailment
211,78,29,26,3,0.896551724137931,20,16,4,0.8,0.8455284552845529,shc-gpt-4o,mimiciii,progress_note,PROMPT2_ICL_entailment
212,79,41,36,5,0.8780487804878049,43,23,20,0.5348837209302325,0.6647932557205941,shc-gpt-4o,mimiciii,progress_note,PROMPT2_ICL_entailment
213,8,75,69,6,0.92,78,70,8,0.8974358974358975,0.9085778781038376,shc-gpt-4o,mimiciii,progress_note,PROMPT2_ICL_entailment
214,80,29,29,0,1.0,21,19,2,0.9047619047619048,0.95,shc-gpt-4o,mimiciii,progress_note,PROMPT2_ICL_entailment
215,81,37,33,4,0.8918918918918919,32,23,9,0.71875,0.7960146827477713,shc-gpt-4o,mimiciii,progress_note,PROMPT2_ICL_entailment
216,82,18,17,1,0.9444444444444444,15,15,0,1.0,0.9714285714285714,shc-gpt-4o,mimiciii,progress_note,PROMPT2_ICL_entailment
217,83,40,35,5,0.875,43,37,6,0.8604651162790697,0.8676716917922949,shc-gpt-4o,mimiciii,progress_note,PROMPT2_ICL_entailment
218,84,27,25,2,0.925925925925926,35,21,14,0.6,0.7281553398058253,shc-gpt-4o,mimiciii,progress_note,PROMPT2_ICL_entailment
219,85,46,42,4,0.9130434782608696,50,40,10,0.8,0.852791878172589,shc-gpt-4o,mimiciii,progress_note,PROMPT2_ICL_entailment
220,86,60,59,1,0.9833333333333332,32,26,6,0.8125,0.8897911832946636,shc-gpt-4o,mimiciii,progress_note,PROMPT2_ICL_entailment
221,87,7,7,0,1.0,12,3,9,0.25,0.4,shc-gpt-4o,mimiciii,progress_note,PROMPT2_ICL_entailment
222,88,90,77,13,0.8555555555555555,67,42,25,0.6268656716417911,0.7235708692247454,shc-gpt-4o,mimiciii,progress_note,PROMPT2_ICL_entailment
223,89,81,73,8,0.9012345679012346,199,87,112,0.4371859296482412,0.5887642532678224,shc-gpt-4o,mimiciii,progress_note,PROMPT2_ICL_entailment
224,9,38,38,0,1.0,42,33,9,0.7857142857142857,0.88,shc-gpt-4o,mimiciii,progress_note,PROMPT2_ICL_entailment
225,90,7,7,0,1.0,3,3,0,1.0,1.0,shc-gpt-4o,mimiciii,progress_note,PROMPT2_ICL_entailment
226,91,57,53,4,0.9298245614035088,79,67,12,0.8481012658227848,0.8870846864851362,shc-gpt-4o,mimiciii,progress_note,PROMPT2_ICL_entailment
227,92,80,72,8,0.9,143,85,58,0.5944055944055944,0.7159569489939167,shc-gpt-4o,mimiciii,progress_note,PROMPT2_ICL_entailment
228,93,23,20,3,0.8695652173913043,27,18,9,0.6666666666666666,0.7547169811320754,shc-gpt-4o,mimiciii,progress_note,PROMPT2_ICL_entailment
229,94,59,52,7,0.8813559322033898,80,48,32,0.6,0.7139588100686499,shc-gpt-4o,mimiciii,progress_note,PROMPT2_ICL_entailment
230,95,32,28,4,0.875,32,18,14,0.5625,0.6847826086956522,shc-gpt-4o,mimiciii,progress_note,PROMPT2_ICL_entailment
231,96,9,8,1,0.8888888888888888,11,3,8,0.2727272727272727,0.417391304347826,shc-gpt-4o,mimiciii,progress_note,PROMPT2_ICL_entailment
232,97,19,18,1,0.9473684210526316,14,11,3,0.7857142857142857,0.8590021691973969,shc-gpt-4o,mimiciii,progress_note,PROMPT2_ICL_entailment
233,98,24,24,0,1.0,24,22,2,0.9166666666666666,0.9565217391304348,shc-gpt-4o,mimiciii,progress_note,PROMPT2_ICL_entailment
234,99,57,54,3,0.9473684210526316,70,34,36,0.4857142857142857,0.6421825813221406,shc-gpt-4o,mimiciii,progress_note,PROMPT2_ICL_entailment
0,0,65,58,7,0.8923076923076924,78,69,9,0.8846153846153846,0.8884448884448886,shc-gpt-4o,mimiciii,progress_note,PROMPT2_entailment
1,1,64,57,7,0.890625,189,80,109,0.4232804232804232,0.5738375385389795,shc-gpt-4o,mimiciii,progress_note,PROMPT2_entailment
2,10,107,80,27,0.7476635514018691,140,68,72,0.4857142857142857,0.5888720502273219,shc-gpt-4o,mimiciii,progress_note,PROMPT2_entailment
3,100,68,61,7,0.8970588235294118,77,59,18,0.7662337662337663,0.8265013204730739,shc-gpt-4o,mimiciii,progress_note,PROMPT2_entailment
4,101,28,23,5,0.8214285714285714,36,24,12,0.6666666666666666,0.7359999999999999,shc-gpt-4o,mimiciii,progress_note,PROMPT2_entailment
5,102,42,36,6,0.8571428571428571,42,33,9,0.7857142857142857,0.8198757763975155,shc-gpt-4o,mimiciii,progress_note,PROMPT2_entailment
6,103,117,84,33,0.717948717948718,204,108,96,0.5294117647058824,0.6094316807738814,shc-gpt-4o,mimiciii,progress_note,PROMPT2_entailment
7,104,26,26,0,1.0,39,27,12,0.6923076923076923,0.8181818181818181,shc-gpt-4o,mimiciii,progress_note,PROMPT2_entailment
8,105,34,33,1,0.9705882352941176,17,15,2,0.8823529411764706,0.9243697478991596,shc-gpt-4o,mimiciii,progress_note,PROMPT2_entailment
9,106,22,20,2,0.9090909090909092,40,33,7,0.825,0.8650065530799476,shc-gpt-4o,mimiciii,progress_note,PROMPT2_entailment
10,107,28,27,1,0.9642857142857144,31,24,7,0.7741935483870968,0.8588469184890657,shc-gpt-4o,mimiciii,progress_note,PROMPT2_entailment
11,108,49,45,4,0.9183673469387756,68,44,24,0.6470588235294118,0.7592024539877301,shc-gpt-4o,mimiciii,progress_note,PROMPT2_entailment
12,109,96,84,12,0.875,176,48,128,0.2727272727272727,0.4158415841584158,shc-gpt-4o,mimiciii,progress_note,PROMPT2_entailment
13,11,99,68,31,0.6868686868686869,141,61,80,0.4326241134751773,0.5308760478658732,shc-gpt-4o,mimiciii,progress_note,PROMPT2_entailment
14,110,152,112,40,0.7368421052631579,215,81,134,0.3767441860465116,0.498571114530666,shc-gpt-4o,mimiciii,progress_note,PROMPT2_entailment
15,111,146,117,29,0.8013698630136986,219,93,126,0.4246575342465753,0.5551388995178694,shc-gpt-4o,mimiciii,progress_note,PROMPT2_entailment
16,112,158,120,38,0.759493670886076,234,95,139,0.405982905982906,0.5291250870271526,shc-gpt-4o,mimiciii,progress_note,PROMPT2_entailment
17,113,91,79,12,0.8681318681318682,196,79,117,0.4030612244897959,0.5505226480836237,shc-gpt-4o,mimiciii,progress_note,PROMPT2_entailment
18,114,185,135,50,0.7297297297297297,225,69,156,0.3066666666666666,0.4318497913769123,shc-gpt-4o,mimiciii,progress_note,PROMPT2_entailment
19,115,80,67,13,0.8375,280,143,137,0.5107142857142857,0.6345033112582782,shc-gpt-4o,mimiciii,progress_note,PROMPT2_entailment
20,116,28,26,2,0.9285714285714286,35,25,10,0.7142857142857143,0.8074534161490684,shc-gpt-4o,mimiciii,progress_note,PROMPT2_entailment
21,117,22,22,0,1.0,20,16,4,0.8,0.888888888888889,shc-gpt-4o,mimiciii,progress_note,PROMPT2_entailment
22,118,37,36,1,0.972972972972973,23,21,2,0.9130434782608696,0.9420560747663552,shc-gpt-4o,mimiciii,progress_note,PROMPT2_entailment
23,119,15,15,0,1.0,14,13,1,0.9285714285714286,0.962962962962963,shc-gpt-4o,mimiciii,progress_note,PROMPT2_entailment
24,12,116,82,34,0.7068965517241379,2,0,2,0.0,0.0,shc-gpt-4o,mimiciii,progress_note,PROMPT2_entailment
25,120,49,43,6,0.8775510204081632,64,34,30,0.53125,0.6618379357175193,shc-gpt-4o,mimiciii,progress_note,PROMPT2_entailment
26,121,15,15,0,1.0,14,10,4,0.7142857142857143,0.8333333333333333,shc-gpt-4o,mimiciii,progress_note,PROMPT2_entailment
27,122,50,36,14,0.72,47,30,17,0.6382978723404256,0.6766917293233082,shc-gpt-4o,mimiciii,progress_note,PROMPT2_entailment
28,123,38,33,5,0.868421052631579,50,22,28,0.44,0.5840707964601771,shc-gpt-4o,mimiciii,progress_note,PROMPT2_entailment
29,124,54,49,5,0.9074074074074074,65,44,21,0.676923076923077,0.7754001078942637,shc-gpt-4o,mimiciii,progress_note,PROMPT2_entailment
30,125,34,30,4,0.8823529411764706,50,34,16,0.68,0.7680722891566264,shc-gpt-4o,mimiciii,progress_note,PROMPT2_entailment
31,126,26,24,2,0.9230769230769232,27,23,4,0.8518518518518519,0.8860353130016052,shc-gpt-4o,mimiciii,progress_note,PROMPT2_entailment
32,127,23,20,3,0.8695652173913043,27,14,13,0.5185185185185185,0.6496519721577726,shc-gpt-4o,mimiciii,progress_note,PROMPT2_entailment
33,128,41,40,1,0.975609756097561,37,23,14,0.6216216216216216,0.7593891869583161,shc-gpt-4o,mimiciii,progress_note,PROMPT2_entailment
34,129,56,45,11,0.8035714285714286,66,54,12,0.8181818181818182,0.8108108108108109,shc-gpt-4o,mimiciii,progress_note,PROMPT2_entailment
35,13,40,37,3,0.925,73,50,23,0.684931506849315,0.7870665815783876,shc-gpt-4o,mimiciii,progress_note,PROMPT2_entailment
36,130,36,28,8,0.7777777777777778,44,29,15,0.6590909090909091,0.7135325131810194,shc-gpt-4o,mimiciii,progress_note,PROMPT2_entailment
37,131,109,93,16,0.8532110091743119,202,91,111,0.4504950495049505,0.5896533704929454,shc-gpt-4o,mimiciii,progress_note,PROMPT2_entailment
38,132,111,80,31,0.7207207207207207,193,91,102,0.4715025906735751,0.5700638189577542,shc-gpt-4o,mimiciii,progress_note,PROMPT2_entailment
39,133,70,58,12,0.8285714285714286,157,66,91,0.4203821656050955,0.5577735684103162,shc-gpt-4o,mimiciii,progress_note,PROMPT2_entailment
40,134,12,11,1,0.9166666666666666,18,6,12,0.3333333333333333,0.4888888888888888,shc-gpt-4o,mimiciii,progress_note,PROMPT2_entailment
41,135,31,30,1,0.967741935483871,35,25,10,0.7142857142857143,0.821917808219178,shc-gpt-4o,mimiciii,progress_note,PROMPT2_entailment
42,136,36,35,1,0.9722222222222222,43,30,13,0.6976744186046512,0.8123791102514507,shc-gpt-4o,mimiciii,progress_note,PROMPT2_entailment
43,137,20,20,0,1.0,26,24,2,0.9230769230769232,0.96,shc-gpt-4o,mimiciii,progress_note,PROMPT2_entailment
44,138,29,27,2,0.9310344827586208,45,21,24,0.4666666666666667,0.6217105263157895,shc-gpt-4o,mimiciii,progress_note,PROMPT2_entailment
45,139,41,38,3,0.926829268292683,45,34,11,0.7555555555555555,0.8324742268041238,shc-gpt-4o,mimiciii,progress_note,PROMPT2_entailment
46,14,38,1,37,0.0263157894736842,43,1,42,0.0232558139534883,0.0246913580246913,shc-gpt-4o,mimiciii,progress_note,PROMPT2_entailment
47,140,21,17,4,0.8095238095238095,25,17,8,0.68,0.7391304347826089,shc-gpt-4o,mimiciii,progress_note,PROMPT2_entailment
48,141,44,38,6,0.8636363636363636,45,26,19,0.5777777777777777,0.6923615977575333,shc-gpt-4o,mimiciii,progress_note,PROMPT2_entailment
49,142,42,39,3,0.9285714285714286,50,29,21,0.58,0.7140151515151516,shc-gpt-4o,mimiciii,progress_note,PROMPT2_entailment
50,143,10,10,0,1.0,11,8,3,0.7272727272727273,0.8421052631578948,shc-gpt-4o,mimiciii,progress_note,PROMPT2_entailment
51,144,52,50,2,0.9615384615384616,50,39,11,0.78,0.8613074204946997,shc-gpt-4o,mimiciii,progress_note,PROMPT2_entailment
52,145,30,26,4,0.8666666666666667,43,29,14,0.6744186046511628,0.7585513078470825,shc-gpt-4o,mimiciii,progress_note,PROMPT2_entailment
53,146,44,39,5,0.8863636363636364,32,24,8,0.75,0.8125000000000001,shc-gpt-4o,mimiciii,progress_note,PROMPT2_entailment
54,147,38,37,1,0.9736842105263158,56,36,20,0.6428571428571429,0.7744186046511629,shc-gpt-4o,mimiciii,progress_note,PROMPT2_entailment
55,148,7,7,0,1.0,4,3,1,0.75,0.8571428571428571,shc-gpt-4o,mimiciii,progress_note,PROMPT2_entailment
56,149,33,32,1,0.9696969696969696,29,25,4,0.8620689655172413,0.9127210496292072,shc-gpt-4o,mimiciii,progress_note,PROMPT2_entailment
57,15,122,81,41,0.6639344262295082,163,59,104,0.3619631901840491,0.4685064457624627,shc-gpt-4o,mimiciii,progress_note,PROMPT2_entailment
58,150,52,48,4,0.9230769230769232,83,60,23,0.7228915662650602,0.810810810810811,shc-gpt-4o,mimiciii,progress_note,PROMPT2_entailment
59,151,93,87,6,0.935483870967742,201,83,118,0.4129353233830846,0.5729588193287314,shc-gpt-4o,mimiciii,progress_note,PROMPT2_entailment
60,152,39,2,37,0.0512820512820512,45,2,43,0.0444444444444444,0.0476190476190476,shc-gpt-4o,mimiciii,progress_note,PROMPT2_entailment
61,153,88,80,8,0.9090909090909092,219,53,166,0.2420091324200913,0.3822574828705373,shc-gpt-4o,mimiciii,progress_note,PROMPT2_entailment
62,154,15,15,0,1.0,15,15,0,1.0,1.0,shc-gpt-4o,mimiciii,progress_note,PROMPT2_entailment
63,155,27,27,0,1.0,32,28,4,0.875,0.9333333333333332,shc-gpt-4o,mimiciii,progress_note,PROMPT2_entailment
64,156,27,25,2,0.925925925925926,32,28,4,0.875,0.8997429305912596,shc-gpt-4o,mimiciii,progress_note,PROMPT2_entailment
65,157,27,27,0,1.0,29,14,15,0.4827586206896552,0.6511627906976745,shc-gpt-4o,mimiciii,progress_note,PROMPT2_entailment
66,158,110,98,12,0.8909090909090909,242,121,121,0.5,0.6405228758169934,shc-gpt-4o,mimiciii,progress_note,PROMPT2_entailment
67,159,19,16,3,0.8421052631578947,22,12,10,0.5454545454545454,0.6620689655172414,shc-gpt-4o,mimiciii,progress_note,PROMPT2_entailment
68,16,23,23,0,1.0,28,17,11,0.6071428571428571,0.7555555555555554,shc-gpt-4o,mimiciii,progress_note,PROMPT2_entailment
69,160,54,48,6,0.8888888888888888,65,42,23,0.6461538461538462,0.7483296213808464,shc-gpt-4o,mimiciii,progress_note,PROMPT2_entailment
70,161,90,76,14,0.8444444444444444,201,89,112,0.4427860696517413,0.5809499269947608,shc-gpt-4o,mimiciii,progress_note,PROMPT2_entailment
71,162,100,80,20,0.8,177,65,112,0.3672316384180791,0.5033881897386253,shc-gpt-4o,mimiciii,progress_note,PROMPT2_entailment
72,163,20,19,1,0.95,28,16,12,0.5714285714285714,0.7136150234741784,shc-gpt-4o,mimiciii,progress_note,PROMPT2_entailment
73,164,44,40,4,0.9090909090909092,57,47,10,0.8245614035087719,0.8647654093836247,shc-gpt-4o,mimiciii,progress_note,PROMPT2_entailment
74,165,9,9,0,1.0,25,24,1,0.96,0.979591836734694,shc-gpt-4o,mimiciii,progress_note,PROMPT2_entailment
75,166,26,22,4,0.8461538461538461,42,29,13,0.6904761904761905,0.7604290822407629,shc-gpt-4o,mimiciii,progress_note,PROMPT2_entailment
76,167,40,38,2,0.95,52,36,16,0.6923076923076923,0.8009367681498829,shc-gpt-4o,mimiciii,progress_note,PROMPT2_entailment
77,168,90,73,17,0.8111111111111111,182,69,113,0.3791208791208791,0.5167213787443579,shc-gpt-4o,mimiciii,progress_note,PROMPT2_entailment
78,169,94,77,17,0.8191489361702128,219,86,133,0.3926940639269406,0.5308854772116888,shc-gpt-4o,mimiciii,progress_note,PROMPT2_entailment
79,17,7,7,0,1.0,15,14,1,0.9333333333333332,0.9655172413793104,shc-gpt-4o,mimiciii,progress_note,PROMPT2_entailment
80,170,110,101,9,0.9181818181818182,184,115,69,0.625,0.7437407952871871,shc-gpt-4o,mimiciii,progress_note,PROMPT2_entailment
81,171,101,88,13,0.8712871287128713,222,85,137,0.3828828828828828,0.5319867714519397,shc-gpt-4o,mimiciii,progress_note,PROMPT2_entailment
82,172,91,82,9,0.9010989010989012,198,98,100,0.494949494949495,0.6389441043174048,shc-gpt-4o,mimiciii,progress_note,PROMPT2_entailment
83,173,68,55,13,0.8088235294117647,172,80,92,0.4651162790697674,0.5906040268456376,shc-gpt-4o,mimiciii,progress_note,PROMPT2_entailment
84,174,88,82,6,0.9318181818181818,200,80,120,0.4,0.5597269624573379,shc-gpt-4o,mimiciii,progress_note,PROMPT2_entailment
85,175,72,61,11,0.8472222222222222,207,79,128,0.3816425120772946,0.5262353262353262,shc-gpt-4o,mimiciii,progress_note,PROMPT2_entailment
86,176,101,77,24,0.7623762376237624,192,76,116,0.3958333333333333,0.5211041852181657,shc-gpt-4o,mimiciii,progress_note,PROMPT2_entailment
87,177,108,81,27,0.75,192,85,107,0.4427083333333333,0.5567685589519651,shc-gpt-4o,mimiciii,progress_note,PROMPT2_entailment
88,178,16,15,1,0.9375,17,17,0,1.0,0.967741935483871,shc-gpt-4o,mimiciii,progress_note,PROMPT2_entailment
89,179,112,69,43,0.6160714285714286,197,71,126,0.3604060913705584,0.4547690879554421,shc-gpt-4o,mimiciii,progress_note,PROMPT2_entailment
90,18,21,18,3,0.8571428571428571,18,17,1,0.9444444444444444,0.8986784140969163,shc-gpt-4o,mimiciii,progress_note,PROMPT2_entailment
91,180,81,65,16,0.8024691358024691,201,83,118,0.4129353233830846,0.5452799676571659,shc-gpt-4o,mimiciii,progress_note,PROMPT2_entailment
92,181,95,78,17,0.8210526315789474,208,105,103,0.5048076923076923,0.6252147028512538,shc-gpt-4o,mimiciii,progress_note,PROMPT2_entailment
93,182,85,74,11,0.8705882352941177,214,68,146,0.3177570093457944,0.465581051073279,shc-gpt-4o,mimiciii,progress_note,PROMPT2_entailment
94,183,100,82,18,0.82,226,80,146,0.3539823008849557,0.4944972109151214,shc-gpt-4o,mimiciii,progress_note,PROMPT2_entailment
95,184,96,88,8,0.9166666666666666,194,83,111,0.4278350515463917,0.5833865814696485,shc-gpt-4o,mimiciii,progress_note,PROMPT2_entailment
96,185,30,29,1,0.9666666666666668,48,27,21,0.5625,0.7111716621253404,shc-gpt-4o,mimiciii,progress_note,PROMPT2_entailment
97,186,113,92,21,0.8141592920353983,205,78,127,0.3804878048780488,0.5186095251860953,shc-gpt-4o,mimiciii,progress_note,PROMPT2_entailment
98,187,76,60,16,0.7894736842105263,170,90,80,0.5294117647058824,0.6338028169014084,shc-gpt-4o,mimiciii,progress_note,PROMPT2_entailment
99,188,77,73,4,0.948051948051948,202,100,102,0.495049504950495,0.6504499688140426,shc-gpt-4o,mimiciii,progress_note,PROMPT2_entailment
100,189,92,84,8,0.9130434782608696,225,98,127,0.4355555555555555,0.5897693079237712,shc-gpt-4o,mimiciii,progress_note,PROMPT2_entailment
101,19,31,30,1,0.967741935483871,38,25,13,0.6578947368421053,0.783289817232376,shc-gpt-4o,mimiciii,progress_note,PROMPT2_entailment
102,190,145,124,21,0.8551724137931035,223,114,109,0.5112107623318386,0.6398986012403242,shc-gpt-4o,mimiciii,progress_note,PROMPT2_entailment
103,191,128,110,18,0.859375,206,103,103,0.5,0.632183908045977,shc-gpt-4o,mimiciii,progress_note,PROMPT2_entailment
104,192,119,108,11,0.907563025210084,208,90,118,0.4326923076923077,0.5860010851871947,shc-gpt-4o,mimiciii,progress_note,PROMPT2_entailment
105,193,77,70,7,0.9090909090909092,243,75,168,0.3086419753086419,0.4608294930875576,shc-gpt-4o,mimiciii,progress_note,PROMPT2_entailment
106,194,81,66,15,0.8148148148148148,211,124,87,0.5876777251184834,0.6828535669586984,shc-gpt-4o,mimiciii,progress_note,PROMPT2_entailment
107,195,30,29,1,0.9666666666666668,44,33,11,0.75,0.8446601941747572,shc-gpt-4o,mimiciii,progress_note,PROMPT2_entailment
108,196,39,32,7,0.8205128205128205,42,26,16,0.6190476190476191,0.7056827820186599,shc-gpt-4o,mimiciii,progress_note,PROMPT2_entailment
109,197,95,93,2,0.9789473684210528,90,70,20,0.7777777777777778,0.8668442077230359,shc-gpt-4o,mimiciii,progress_note,PROMPT2_entailment
110,198,33,31,2,0.9393939393939394,34,29,5,0.8529411764705882,0.8940825459970164,shc-gpt-4o,mimiciii,progress_note,PROMPT2_entailment
111,199,49,42,7,0.8571428571428571,52,28,24,0.5384615384615384,0.6614173228346457,shc-gpt-4o,mimiciii,progress_note,PROMPT2_entailment
112,2,73,56,17,0.7671232876712328,140,62,78,0.4428571428571428,0.5615397056445092,shc-gpt-4o,mimiciii,progress_note,PROMPT2_entailment
113,20,22,20,2,0.9090909090909092,33,25,8,0.7575757575757576,0.8264462809917356,shc-gpt-4o,mimiciii,progress_note,PROMPT2_entailment
114,200,75,57,18,0.76,164,60,104,0.3658536585365853,0.4939341421143846,shc-gpt-4o,mimiciii,progress_note,PROMPT2_entailment
115,201,93,89,4,0.956989247311828,200,68,132,0.34,0.5017410048084895,shc-gpt-4o,mimiciii,progress_note,PROMPT2_entailment
116,202,92,70,22,0.7608695652173914,176,52,124,0.2954545454545454,0.4256314312441535,shc-gpt-4o,mimiciii,progress_note,PROMPT2_entailment
117,203,114,99,15,0.868421052631579,211,89,122,0.4218009478672986,0.5678105364910585,shc-gpt-4o,mimiciii,progress_note,PROMPT2_entailment
118,204,90,72,18,0.8,201,80,121,0.3980099502487562,0.53156146179402,shc-gpt-4o,mimiciii,progress_note,PROMPT2_entailment
119,205,117,102,15,0.8717948717948718,195,95,100,0.4871794871794871,0.6250604741170779,shc-gpt-4o,mimiciii,progress_note,PROMPT2_entailment
120,206,108,96,12,0.8888888888888888,239,122,117,0.5104602510460251,0.6485049833887043,shc-gpt-4o,mimiciii,progress_note,PROMPT2_entailment
121,207,32,30,2,0.9375,233,119,114,0.5107296137339056,0.6612335617706983,shc-gpt-4o,mimiciii,progress_note,PROMPT2_entailment
122,208,115,103,12,0.8956521739130435,229,97,132,0.4235807860262008,0.5751539922859938,shc-gpt-4o,mimiciii,progress_note,PROMPT2_entailment
123,209,91,78,13,0.8571428571428571,205,98,107,0.4780487804878048,0.6137787056367432,shc-gpt-4o,mimiciii,progress_note,PROMPT2_entailment
124,21,134,112,22,0.835820895522388,217,93,124,0.4285714285714285,0.566610455311973,shc-gpt-4o,mimiciii,progress_note,PROMPT2_entailment
125,210,33,31,2,0.9393939393939394,28,24,4,0.8571428571428571,0.8963855421686747,shc-gpt-4o,mimiciii,progress_note,PROMPT2_entailment
126,211,52,49,3,0.9423076923076924,54,37,17,0.6851851851851852,0.7934354485776806,shc-gpt-4o,mimiciii,progress_note,PROMPT2_entailment
127,212,21,21,0,1.0,14,13,1,0.9285714285714286,0.962962962962963,shc-gpt-4o,mimiciii,progress_note,PROMPT2_entailment
128,213,41,40,1,0.975609756097561,41,34,7,0.8292682926829268,0.8965062623599209,shc-gpt-4o,mimiciii,progress_note,PROMPT2_entailment
129,214,23,23,0,1.0,27,20,7,0.7407407407407407,0.851063829787234,shc-gpt-4o,mimiciii,progress_note,PROMPT2_entailment
130,215,60,43,17,0.7166666666666667,66,38,28,0.5757575757575758,0.6385306760453302,shc-gpt-4o,mimiciii,progress_note,PROMPT2_entailment
131,216,70,60,10,0.8571428571428571,67,50,17,0.746268656716418,0.7978723404255319,shc-gpt-4o,mimiciii,progress_note,PROMPT2_entailment
132,217,69,60,9,0.8695652173913043,73,42,31,0.5753424657534246,0.6924979389942292,shc-gpt-4o,mimiciii,progress_note,PROMPT2_entailment
133,218,38,34,4,0.8947368421052632,27,24,3,0.8888888888888888,0.8918032786885245,shc-gpt-4o,mimiciii,progress_note,PROMPT2_entailment
134,219,20,20,0,1.0,17,10,7,0.5882352941176471,0.7407407407407407,shc-gpt-4o,mimiciii,progress_note,PROMPT2_entailment
135,22,19,18,1,0.9473684210526316,38,30,8,0.7894736842105263,0.8612440191387559,shc-gpt-4o,mimiciii,progress_note,PROMPT2_entailment
136,220,47,42,5,0.8936170212765957,34,32,2,0.9411764705882352,0.9167803547066848,shc-gpt-4o,mimiciii,progress_note,PROMPT2_entailment
137,221,75,69,6,0.92,188,66,122,0.351063829787234,0.5082022095748242,shc-gpt-4o,mimiciii,progress_note,PROMPT2_entailment
138,222,98,78,20,0.7959183673469388,263,107,156,0.4068441064638783,0.5384516129032257,shc-gpt-4o,mimiciii,progress_note,PROMPT2_entailment
139,223,24,23,1,0.9583333333333334,30,22,8,0.7333333333333333,0.8308702791461412,shc-gpt-4o,mimiciii,progress_note,PROMPT2_entailment
140,224,32,32,0,1.0,33,28,5,0.8484848484848485,0.9180327868852458,shc-gpt-4o,mimiciii,progress_note,PROMPT2_entailment
141,225,23,22,1,0.9565217391304348,37,30,7,0.8108108108108109,0.8776595744680852,shc-gpt-4o,mimiciii,progress_note,PROMPT2_entailment
142,226,25,24,1,0.96,33,21,12,0.6363636363636364,0.765375854214123,shc-gpt-4o,mimiciii,progress_note,PROMPT2_entailment
143,227,3,3,0,1.0,15,9,6,0.6,0.7499999999999999,shc-gpt-4o,mimiciii,progress_note,PROMPT2_entailment
144,228,5,5,0,1.0,15,3,12,0.2,0.3333333333333333,shc-gpt-4o,mimiciii,progress_note,PROMPT2_entailment
145,229,17,9,8,0.5294117647058824,15,3,12,0.2,0.2903225806451613,shc-gpt-4o,mimiciii,progress_note,PROMPT2_entailment
146,23,25,23,2,0.92,37,20,17,0.5405405405405406,0.6809770540340488,shc-gpt-4o,mimiciii,progress_note,PROMPT2_entailment
147,230,23,22,1,0.9565217391304348,26,15,11,0.5769230769230769,0.7197382769901853,shc-gpt-4o,mimiciii,progress_note,PROMPT2_entailment
148,231,58,57,1,0.9827586206896552,102,71,31,0.696078431372549,0.8149416028997182,shc-gpt-4o,mimiciii,progress_note,PROMPT2_entailment
149,232,65,56,9,0.8615384615384616,72,48,24,0.6666666666666666,0.7516778523489933,shc-gpt-4o,mimiciii,progress_note,PROMPT2_entailment
150,233,56,43,13,0.7678571428571429,82,64,18,0.7804878048780488,0.7741209563994375,shc-gpt-4o,mimiciii,progress_note,PROMPT2_entailment
151,234,28,27,1,0.9642857142857144,42,33,9,0.7857142857142857,0.8658892128279884,shc-gpt-4o,mimiciii,progress_note,PROMPT2_entailment
152,24,21,18,3,0.8571428571428571,22,15,7,0.6818181818181818,0.759493670886076,shc-gpt-4o,mimiciii,progress_note,PROMPT2_entailment
153,25,15,14,1,0.9333333333333332,22,12,10,0.5454545454545454,0.6885245901639344,shc-gpt-4o,mimiciii,progress_note,PROMPT2_entailment
154,26,15,15,0,1.0,22,12,10,0.5454545454545454,0.7058823529411764,shc-gpt-4o,mimiciii,progress_note,PROMPT2_entailment
155,27,23,18,5,0.782608695652174,19,11,8,0.5789473684210527,0.665546218487395,shc-gpt-4o,mimiciii,progress_note,PROMPT2_entailment
156,28,49,47,2,0.9591836734693876,50,40,10,0.8,0.8723897911832946,shc-gpt-4o,mimiciii,progress_note,PROMPT2_entailment
157,29,34,34,0,1.0,52,34,18,0.6538461538461539,0.7906976744186047,shc-gpt-4o,mimiciii,progress_note,PROMPT2_entailment
158,3,98,76,22,0.7755102040816326,157,73,84,0.464968152866242,0.58136854238709,shc-gpt-4o,mimiciii,progress_note,PROMPT2_entailment
159,30,22,20,2,0.9090909090909092,18,12,6,0.6666666666666666,0.7692307692307692,shc-gpt-4o,mimiciii,progress_note,PROMPT2_entailment
160,31,23,23,0,1.0,17,12,5,0.7058823529411765,0.8275862068965517,shc-gpt-4o,mimiciii,progress_note,PROMPT2_entailment
161,32,69,67,2,0.9710144927536232,99,55,44,0.5555555555555556,0.7067510548523207,shc-gpt-4o,mimiciii,progress_note,PROMPT2_entailment
162,33,55,51,4,0.9272727272727272,65,52,13,0.8,0.8589473684210526,shc-gpt-4o,mimiciii,progress_note,PROMPT2_entailment
163,34,50,49,1,0.98,71,53,18,0.7464788732394366,0.8474465655082396,shc-gpt-4o,mimiciii,progress_note,PROMPT2_entailment
164,35,11,10,1,0.9090909090909092,20,5,15,0.25,0.392156862745098,shc-gpt-4o,mimiciii,progress_note,PROMPT2_entailment
165,36,43,36,7,0.8372093023255814,40,21,19,0.525,0.645326504481434,shc-gpt-4o,mimiciii,progress_note,PROMPT2_entailment
166,37,118,101,17,0.8559322033898306,199,122,77,0.6130653266331658,0.7144223800550804,shc-gpt-4o,mimiciii,progress_note,PROMPT2_entailment
167,38,59,51,8,0.864406779661017,158,74,84,0.4683544303797468,0.607533805537669,shc-gpt-4o,mimiciii,progress_note,PROMPT2_entailment
168,39,45,44,1,0.9777777777777776,76,57,19,0.75,0.8488745980707395,shc-gpt-4o,mimiciii,progress_note,PROMPT2_entailment
169,4,122,80,42,0.6557377049180327,162,77,85,0.4753086419753086,0.5511317884942292,shc-gpt-4o,mimiciii,progress_note,PROMPT2_entailment
170,40,42,41,1,0.9761904761904762,76,52,24,0.6842105263157895,0.8045283018867925,shc-gpt-4o,mimiciii,progress_note,PROMPT2_entailment
171,41,64,59,5,0.921875,78,71,7,0.9102564102564102,0.9160288650776296,shc-gpt-4o,mimiciii,progress_note,PROMPT2_entailment
172,42,69,62,7,0.8985507246376812,78,55,23,0.7051282051282052,0.7901749507588923,shc-gpt-4o,mimiciii,progress_note,PROMPT2_entailment
173,43,61,52,9,0.8524590163934426,79,57,22,0.7215189873417721,0.7815425181278839,shc-gpt-4o,mimiciii,progress_note,PROMPT2_entailment
174,44,54,50,4,0.925925925925926,96,62,34,0.6458333333333334,0.7609229258713796,shc-gpt-4o,mimiciii,progress_note,PROMPT2_entailment
175,45,67,60,7,0.8955223880597015,82,68,14,0.8292682926829268,0.8611228366399325,shc-gpt-4o,mimiciii,progress_note,PROMPT2_entailment
176,46,29,28,1,0.9655172413793104,36,29,7,0.8055555555555556,0.8783126014061655,shc-gpt-4o,mimiciii,progress_note,PROMPT2_entailment
177,47,2,1,1,0.5,10,2,8,0.2,0.2857142857142857,shc-gpt-4o,mimiciii,progress_note,PROMPT2_entailment
178,48,57,55,2,0.9649122807017544,30,26,4,0.8666666666666667,0.9131545338441892,shc-gpt-4o,mimiciii,progress_note,PROMPT2_entailment
179,49,65,62,3,0.953846153846154,57,39,18,0.6842105263157895,0.7968363816114681,shc-gpt-4o,mimiciii,progress_note,PROMPT2_entailment
180,5,80,73,7,0.9125,175,63,112,0.36,0.5163064833005894,shc-gpt-4o,mimiciii,progress_note,PROMPT2_entailment
181,50,107,98,9,0.9158878504672896,116,94,22,0.8103448275862069,0.8598898534490805,shc-gpt-4o,mimiciii,progress_note,PROMPT2_entailment
182,51,114,71,43,0.6228070175438597,180,85,95,0.4722222222222222,0.5371606586559858,shc-gpt-4o,mimiciii,progress_note,PROMPT2_entailment
183,52,100,64,36,0.64,180,62,118,0.3444444444444444,0.4478555304740406,shc-gpt-4o,mimiciii,progress_note,PROMPT2_entailment
184,53,87,72,15,0.8275862068965517,221,77,144,0.3484162895927601,0.4903807881119808,shc-gpt-4o,mimiciii,progress_note,PROMPT2_entailment
185,54,66,46,20,0.696969696969697,131,55,76,0.4198473282442748,0.524026512013256,shc-gpt-4o,mimiciii,progress_note,PROMPT2_entailment
186,55,111,68,43,0.6126126126126126,169,56,113,0.3313609467455621,0.4300880957759205,shc-gpt-4o,mimiciii,progress_note,PROMPT2_entailment
187,56,12,12,0,1.0,40,16,24,0.4,0.5714285714285715,shc-gpt-4o,mimiciii,progress_note,PROMPT2_entailment
188,57,19,18,1,0.9473684210526316,28,15,13,0.5357142857142857,0.6844106463878327,shc-gpt-4o,mimiciii,progress_note,PROMPT2_entailment
189,58,22,21,1,0.9545454545454546,25,21,4,0.84,0.8936170212765958,shc-gpt-4o,mimiciii,progress_note,PROMPT2_entailment
190,59,22,20,2,0.9090909090909092,25,16,9,0.64,0.7511737089201878,shc-gpt-4o,mimiciii,progress_note,PROMPT2_entailment
191,6,77,69,8,0.8961038961038961,188,71,117,0.3776595744680851,0.5313737187483053,shc-gpt-4o,mimiciii,progress_note,PROMPT2_entailment
192,60,73,62,11,0.8493150684931506,161,102,59,0.6335403726708074,0.7257287124168005,shc-gpt-4o,mimiciii,progress_note,PROMPT2_entailment
193,61,27,25,2,0.925925925925926,37,27,10,0.7297297297297297,0.8162031438935913,shc-gpt-4o,mimiciii,progress_note,PROMPT2_entailment
194,62,27,24,3,0.8888888888888888,37,21,16,0.5675675675675675,0.6927835051546392,shc-gpt-4o,mimiciii,progress_note,PROMPT2_entailment
195,63,62,59,3,0.9516129032258064,96,75,21,0.78125,0.8580570098894706,shc-gpt-4o,mimiciii,progress_note,PROMPT2_entailment
196,64,1,0,1,0.0,1,0,1,0.0,,shc-gpt-4o,mimiciii,progress_note,PROMPT2_entailment
197,65,17,17,0,1.0,8,8,0,1.0,1.0,shc-gpt-4o,mimiciii,progress_note,PROMPT2_entailment
198,66,33,33,0,1.0,48,38,10,0.7916666666666666,0.8837209302325582,shc-gpt-4o,mimiciii,progress_note,PROMPT2_entailment
199,67,229,149,80,0.6506550218340611,285,118,167,0.4140350877192982,0.5060514916459193,shc-gpt-4o,mimiciii,progress_note,PROMPT2_entailment
200,68,150,110,40,0.7333333333333333,206,93,113,0.4514563106796116,0.5588636984430483,shc-gpt-4o,mimiciii,progress_note,PROMPT2_entailment
201,69,85,80,5,0.9411764705882352,219,91,128,0.4155251141552511,0.5765195010888933,shc-gpt-4o,mimiciii,progress_note,PROMPT2_entailment
202,7,79,71,8,0.8987341772151899,187,68,119,0.3636363636363636,0.5177757520510483,shc-gpt-4o,mimiciii,progress_note,PROMPT2_entailment
203,70,80,71,9,0.8875,217,73,144,0.336405529953917,0.4878806419729844,shc-gpt-4o,mimiciii,progress_note,PROMPT2_entailment
204,71,94,88,6,0.9361702127659576,213,91,122,0.4272300469483568,0.5867096490585391,shc-gpt-4o,mimiciii,progress_note,PROMPT2_entailment
205,72,8,8,0,1.0,15,9,6,0.6,0.7499999999999999,shc-gpt-4o,mimiciii,progress_note,PROMPT2_entailment
206,73,145,100,45,0.6896551724137931,264,98,166,0.3712121212121212,0.4826397439054421,shc-gpt-4o,mimiciii,progress_note,PROMPT2_entailment
207,74,20,20,0,1.0,184,115,69,0.625,0.7692307692307693,shc-gpt-4o,mimiciii,progress_note,PROMPT2_entailment
208,75,46,46,0,1.0,40,26,14,0.65,0.787878787878788,shc-gpt-4o,mimiciii,progress_note,PROMPT2_entailment
209,76,44,39,5,0.8863636363636364,58,44,14,0.7586206896551724,0.8175321581705574,shc-gpt-4o,mimiciii,progress_note,PROMPT2_entailment
210,77,20,20,0,1.0,27,18,9,0.6666666666666666,0.8,shc-gpt-4o,mimiciii,progress_note,PROMPT2_entailment
211,78,26,25,1,0.9615384615384616,20,17,3,0.85,0.902335456475584,shc-gpt-4o,mimiciii,progress_note,PROMPT2_entailment
212,79,30,26,4,0.8666666666666667,43,23,20,0.5348837209302325,0.661504424778761,shc-gpt-4o,mimiciii,progress_note,PROMPT2_entailment
213,8,61,57,4,0.9344262295081968,78,60,18,0.7692307692307693,0.843819393042191,shc-gpt-4o,mimiciii,progress_note,PROMPT2_entailment
214,80,27,25,2,0.925925925925926,21,19,2,0.9047619047619048,0.9152215799614644,shc-gpt-4o,mimiciii,progress_note,PROMPT2_entailment
215,81,35,32,3,0.9142857142857144,32,26,6,0.8125,0.8603929679420891,shc-gpt-4o,mimiciii,progress_note,PROMPT2_entailment
216,82,5,4,1,0.8,15,9,6,0.6,0.6857142857142857,shc-gpt-4o,mimiciii,progress_note,PROMPT2_entailment
217,83,32,30,2,0.9375,43,30,13,0.6976744186046512,0.8000000000000002,shc-gpt-4o,mimiciii,progress_note,PROMPT2_entailment
218,84,25,25,0,1.0,35,26,9,0.7428571428571429,0.8524590163934427,shc-gpt-4o,mimiciii,progress_note,PROMPT2_entailment
219,85,43,42,1,0.9767441860465116,50,42,8,0.84,0.9032258064516128,shc-gpt-4o,mimiciii,progress_note,PROMPT2_entailment
220,86,55,54,1,0.9818181818181818,32,28,4,0.875,0.9253365973072216,shc-gpt-4o,mimiciii,progress_note,PROMPT2_entailment
221,87,5,4,1,0.8,12,3,9,0.25,0.3809523809523809,shc-gpt-4o,mimiciii,progress_note,PROMPT2_entailment
222,88,68,62,6,0.9117647058823528,67,48,19,0.7164179104477612,0.8023726071717443,shc-gpt-4o,mimiciii,progress_note,PROMPT2_entailment
223,89,81,76,5,0.9382716049382716,199,74,125,0.371859296482412,0.532626195662468,shc-gpt-4o,mimiciii,progress_note,PROMPT2_entailment
224,9,36,35,1,0.9722222222222222,42,28,14,0.6666666666666666,0.7909604519774012,shc-gpt-4o,mimiciii,progress_note,PROMPT2_entailment
225,90,6,6,0,1.0,3,3,0,1.0,1.0,shc-gpt-4o,mimiciii,progress_note,PROMPT2_entailment
226,91,61,59,2,0.9672131147540984,79,69,10,0.8734177215189873,0.9179255918827508,shc-gpt-4o,mimiciii,progress_note,PROMPT2_entailment
227,92,73,62,11,0.8493150684931506,143,56,87,0.3916083916083916,0.5360506407287325,shc-gpt-4o,mimiciii,progress_note,PROMPT2_entailment
228,93,17,15,2,0.8823529411764706,27,17,10,0.6296296296296297,0.7348703170028819,shc-gpt-4o,mimiciii,progress_note,PROMPT2_entailment
229,94,55,49,6,0.8909090909090909,80,41,39,0.5125,0.6506882591093117,shc-gpt-4o,mimiciii,progress_note,PROMPT2_entailment
230,95,27,25,2,0.925925925925926,32,15,17,0.46875,0.6224066390041494,shc-gpt-4o,mimiciii,progress_note,PROMPT2_entailment
231,96,12,11,1,0.9166666666666666,11,7,4,0.6363636363636364,0.7512195121951218,shc-gpt-4o,mimiciii,progress_note,PROMPT2_entailment
232,97,14,14,0,1.0,14,13,1,0.9285714285714286,0.962962962962963,shc-gpt-4o,mimiciii,progress_note,PROMPT2_entailment
233,98,24,23,1,0.9583333333333334,24,22,2,0.9166666666666666,0.937037037037037,shc-gpt-4o,mimiciii,progress_note,PROMPT2_entailment
234,99,41,39,2,0.951219512195122,70,36,34,0.5142857142857142,0.6676176890156917,shc-gpt-4o,mimiciii,progress_note,PROMPT2_entailment
0,0,8,8,0,1.0,6,5,1,0.8333333333333334,0.9090909090909092,shc-gpt-4o,medalign,nursing_note,PROMPT1_entailment
1,1,3,3,0,1.0,1,1,0,1.0,1.0,shc-gpt-4o,medalign,nursing_note,PROMPT1_entailment
2,10,5,5,0,1.0,5,4,1,0.8,0.888888888888889,shc-gpt-4o,medalign,nursing_note,PROMPT1_entailment
3,100,10,10,0,1.0,10,8,2,0.8,0.888888888888889,shc-gpt-4o,medalign,nursing_note,PROMPT1_entailment
4,101,6,6,0,1.0,1,1,0,1.0,1.0,shc-gpt-4o,medalign,nursing_note,PROMPT1_entailment
5,102,7,7,0,1.0,4,3,1,0.75,0.8571428571428571,shc-gpt-4o,medalign,nursing_note,PROMPT1_entailment
6,103,4,4,0,1.0,2,2,0,1.0,1.0,shc-gpt-4o,medalign,nursing_note,PROMPT1_entailment
7,104,15,14,1,0.9333333333333332,15,15,0,1.0,0.9655172413793104,shc-gpt-4o,medalign,nursing_note,PROMPT1_entailment
8,105,3,3,0,1.0,1,1,0,1.0,1.0,shc-gpt-4o,medalign,nursing_note,PROMPT1_entailment
9,106,4,4,0,1.0,1,1,0,1.0,1.0,shc-gpt-4o,medalign,nursing_note,PROMPT1_entailment
10,107,7,7,0,1.0,4,4,0,1.0,1.0,shc-gpt-4o,medalign,nursing_note,PROMPT1_entailment
11,108,3,3,0,1.0,2,2,0,1.0,1.0,shc-gpt-4o,medalign,nursing_note,PROMPT1_entailment
12,109,7,7,0,1.0,5,5,0,1.0,1.0,shc-gpt-4o,medalign,nursing_note,PROMPT1_entailment
13,11,2,2,0,1.0,1,1,0,1.0,1.0,shc-gpt-4o,medalign,nursing_note,PROMPT1_entailment
14,110,10,8,2,0.8,6,6,0,1.0,0.888888888888889,shc-gpt-4o,medalign,nursing_note,PROMPT1_entailment
15,111,3,3,0,1.0,1,1,0,1.0,1.0,shc-gpt-4o,medalign,nursing_note,PROMPT1_entailment
16,112,6,6,0,1.0,2,2,0,1.0,1.0,shc-gpt-4o,medalign,nursing_note,PROMPT1_entailment
17,113,2,2,0,1.0,1,1,0,1.0,1.0,shc-gpt-4o,medalign,nursing_note,PROMPT1_entailment
18,114,3,3,0,1.0,1,1,0,1.0,1.0,shc-gpt-4o,medalign,nursing_note,PROMPT1_entailment
19,115,15,15,0,1.0,7,5,2,0.7142857142857143,0.8333333333333333,shc-gpt-4o,medalign,nursing_note,PROMPT1_entailment
20,116,9,7,2,0.7777777777777778,5,5,0,1.0,0.8750000000000001,shc-gpt-4o,medalign,nursing_note,PROMPT1_entailment
21,117,13,12,1,0.9230769230769232,13,12,1,0.9230769230769232,0.9230769230769232,shc-gpt-4o,medalign,nursing_note,PROMPT1_entailment
22,118,3,3,0,1.0,2,2,0,1.0,1.0,shc-gpt-4o,medalign,nursing_note,PROMPT1_entailment
23,119,2,2,0,1.0,2,2,0,1.0,1.0,shc-gpt-4o,medalign,nursing_note,PROMPT1_entailment
24,12,3,3,0,1.0,1,1,0,1.0,1.0,shc-gpt-4o,medalign,nursing_note,PROMPT1_entailment
25,120,7,7,0,1.0,7,5,2,0.7142857142857143,0.8333333333333333,shc-gpt-4o,medalign,nursing_note,PROMPT1_entailment
26,121,3,3,0,1.0,1,1,0,1.0,1.0,shc-gpt-4o,medalign,nursing_note,PROMPT1_entailment
27,122,2,2,0,1.0,1,1,0,1.0,1.0,shc-gpt-4o,medalign,nursing_note,PROMPT1_entailment
28,123,4,4,0,1.0,4,3,1,0.75,0.8571428571428571,shc-gpt-4o,medalign,nursing_note,PROMPT1_entailment
29,124,19,18,1,0.9473684210526316,14,14,0,1.0,0.972972972972973,shc-gpt-4o,medalign,nursing_note,PROMPT1_entailment
30,125,15,15,0,1.0,9,8,1,0.8888888888888888,0.9411764705882352,shc-gpt-4o,medalign,nursing_note,PROMPT1_entailment
31,126,3,3,0,1.0,2,2,0,1.0,1.0,shc-gpt-4o,medalign,nursing_note,PROMPT1_entailment
32,127,2,2,0,1.0,1,1,0,1.0,1.0,shc-gpt-4o,medalign,nursing_note,PROMPT1_entailment
33,128,4,4,0,1.0,2,2,0,1.0,1.0,shc-gpt-4o,medalign,nursing_note,PROMPT1_entailment
34,129,19,17,2,0.8947368421052632,20,20,0,1.0,0.9444444444444444,shc-gpt-4o,medalign,nursing_note,PROMPT1_entailment
35,13,6,5,1,0.8333333333333334,5,5,0,1.0,0.9090909090909092,shc-gpt-4o,medalign,nursing_note,PROMPT1_entailment
36,130,5,5,0,1.0,2,2,0,1.0,1.0,shc-gpt-4o,medalign,nursing_note,PROMPT1_entailment
37,131,3,3,0,1.0,1,1,0,1.0,1.0,shc-gpt-4o,medalign,nursing_note,PROMPT1_entailment
38,132,5,5,0,1.0,2,2,0,1.0,1.0,shc-gpt-4o,medalign,nursing_note,PROMPT1_entailment
39,133,15,14,1,0.9333333333333332,14,8,6,0.5714285714285714,0.7088607594936709,shc-gpt-4o,medalign,nursing_note,PROMPT1_entailment
40,134,6,6,0,1.0,3,3,0,1.0,1.0,shc-gpt-4o,medalign,nursing_note,PROMPT1_entailment
41,135,8,8,0,1.0,2,2,0,1.0,1.0,shc-gpt-4o,medalign,nursing_note,PROMPT1_entailment
42,136,21,19,2,0.9047619047619048,51,33,18,0.6470588235294118,0.7545126353790614,shc-gpt-4o,medalign,nursing_note,PROMPT1_entailment
43,137,6,6,0,1.0,6,6,0,1.0,1.0,shc-gpt-4o,medalign,nursing_note,PROMPT1_entailment
44,138,2,2,0,1.0,1,1,0,1.0,1.0,shc-gpt-4o,medalign,nursing_note,PROMPT1_entailment
45,139,6,5,1,0.8333333333333334,1,1,0,1.0,0.9090909090909092,shc-gpt-4o,medalign,nursing_note,PROMPT1_entailment
46,14,3,3,0,1.0,1,1,0,1.0,1.0,shc-gpt-4o,medalign,nursing_note,PROMPT1_entailment
47,140,5,5,0,1.0,3,3,0,1.0,1.0,shc-gpt-4o,medalign,nursing_note,PROMPT1_entailment
48,141,2,2,0,1.0,1,1,0,1.0,1.0,shc-gpt-4o,medalign,nursing_note,PROMPT1_entailment
49,142,2,2,0,1.0,1,1,0,1.0,1.0,shc-gpt-4o,medalign,nursing_note,PROMPT1_entailment
50,143,2,1,1,0.5,1,1,0,1.0,0.6666666666666666,shc-gpt-4o,medalign,nursing_note,PROMPT1_entailment
51,144,4,4,0,1.0,1,1,0,1.0,1.0,shc-gpt-4o,medalign,nursing_note,PROMPT1_entailment
52,145,5,5,0,1.0,4,4,0,1.0,1.0,shc-gpt-4o,medalign,nursing_note,PROMPT1_entailment
53,146,9,9,0,1.0,3,3,0,1.0,1.0,shc-gpt-4o,medalign,nursing_note,PROMPT1_entailment
54,147,5,5,0,1.0,6,3,3,0.5,0.6666666666666666,shc-gpt-4o,medalign,nursing_note,PROMPT1_entailment
55,148,10,10,0,1.0,7,7,0,1.0,1.0,shc-gpt-4o,medalign,nursing_note,PROMPT1_entailment
56,149,3,3,0,1.0,1,1,0,1.0,1.0,shc-gpt-4o,medalign,nursing_note,PROMPT1_entailment
57,15,4,3,1,0.75,1,1,0,1.0,0.8571428571428571,shc-gpt-4o,medalign,nursing_note,PROMPT1_entailment
58,150,4,4,0,1.0,1,1,0,1.0,1.0,shc-gpt-4o,medalign,nursing_note,PROMPT1_entailment
59,151,12,12,0,1.0,8,7,1,0.875,0.9333333333333332,shc-gpt-4o,medalign,nursing_note,PROMPT1_entailment
60,152,6,6,0,1.0,4,4,0,1.0,1.0,shc-gpt-4o,medalign,nursing_note,PROMPT1_entailment
61,153,14,14,0,1.0,14,12,2,0.8571428571428571,0.923076923076923,shc-gpt-4o,medalign,nursing_note,PROMPT1_entailment
62,154,2,2,0,1.0,1,1,0,1.0,1.0,shc-gpt-4o,medalign,nursing_note,PROMPT1_entailment
63,155,17,17,0,1.0,14,11,3,0.7857142857142857,0.88,shc-gpt-4o,medalign,nursing_note,PROMPT1_entailment
64,156,10,9,1,0.9,1,1,0,1.0,0.9473684210526316,shc-gpt-4o,medalign,nursing_note,PROMPT1_entailment
65,157,5,5,0,1.0,3,2,1,0.6666666666666666,0.8,shc-gpt-4o,medalign,nursing_note,PROMPT1_entailment
66,158,10,9,1,0.9,1,1,0,1.0,0.9473684210526316,shc-gpt-4o,medalign,nursing_note,PROMPT1_entailment
67,159,6,6,0,1.0,3,3,0,1.0,1.0,shc-gpt-4o,medalign,nursing_note,PROMPT1_entailment
68,16,5,5,0,1.0,3,2,1,0.6666666666666666,0.8,shc-gpt-4o,medalign,nursing_note,PROMPT1_entailment
69,160,4,4,0,1.0,1,1,0,1.0,1.0,shc-gpt-4o,medalign,nursing_note,PROMPT1_entailment
70,161,6,6,0,1.0,1,1,0,1.0,1.0,shc-gpt-4o,medalign,nursing_note,PROMPT1_entailment
71,162,9,9,0,1.0,8,8,0,1.0,1.0,shc-gpt-4o,medalign,nursing_note,PROMPT1_entailment
72,163,6,6,0,1.0,3,3,0,1.0,1.0,shc-gpt-4o,medalign,nursing_note,PROMPT1_entailment
73,164,5,5,0,1.0,2,2,0,1.0,1.0,shc-gpt-4o,medalign,nursing_note,PROMPT1_entailment
74,165,7,7,0,1.0,4,4,0,1.0,1.0,shc-gpt-4o,medalign,nursing_note,PROMPT1_entailment
75,166,10,9,1,0.9,5,5,0,1.0,0.9473684210526316,shc-gpt-4o,medalign,nursing_note,PROMPT1_entailment
76,167,10,10,0,1.0,2,1,1,0.5,0.6666666666666666,shc-gpt-4o,medalign,nursing_note,PROMPT1_entailment
77,168,5,5,0,1.0,3,3,0,1.0,1.0,shc-gpt-4o,medalign,nursing_note,PROMPT1_entailment
78,169,12,12,0,1.0,9,7,2,0.7777777777777778,0.8750000000000001,shc-gpt-4o,medalign,nursing_note,PROMPT1_entailment
79,17,4,3,1,0.75,1,0,1,0.0,0.0,shc-gpt-4o,medalign,nursing_note,PROMPT1_entailment
80,170,4,4,0,1.0,1,1,0,1.0,1.0,shc-gpt-4o,medalign,nursing_note,PROMPT1_entailment
81,171,12,8,4,0.6666666666666666,7,4,3,0.5714285714285714,0.6153846153846153,shc-gpt-4o,medalign,nursing_note,PROMPT1_entailment
82,172,15,12,3,0.8,12,9,3,0.75,0.7741935483870969,shc-gpt-4o,medalign,nursing_note,PROMPT1_entailment
83,173,8,8,0,1.0,1,1,0,1.0,1.0,shc-gpt-4o,medalign,nursing_note,PROMPT1_entailment
84,174,4,4,0,1.0,1,1,0,1.0,1.0,shc-gpt-4o,medalign,nursing_note,PROMPT1_entailment
85,175,2,2,0,1.0,2,2,0,1.0,1.0,shc-gpt-4o,medalign,nursing_note,PROMPT1_entailment
86,176,8,7,1,0.875,3,2,1,0.6666666666666666,0.7567567567567567,shc-gpt-4o,medalign,nursing_note,PROMPT1_entailment
87,177,7,6,1,0.8571428571428571,8,7,1,0.875,0.8659793814432989,shc-gpt-4o,medalign,nursing_note,PROMPT1_entailment
88,178,8,8,0,1.0,10,9,1,0.9,0.9473684210526316,shc-gpt-4o,medalign,nursing_note,PROMPT1_entailment
89,179,11,7,4,0.6363636363636364,2,2,0,1.0,0.7777777777777778,shc-gpt-4o,medalign,nursing_note,PROMPT1_entailment
90,18,10,10,0,1.0,3,3,0,1.0,1.0,shc-gpt-4o,medalign,nursing_note,PROMPT1_entailment
91,180,9,9,0,1.0,4,3,1,0.75,0.8571428571428571,shc-gpt-4o,medalign,nursing_note,PROMPT1_entailment
92,181,8,8,0,1.0,7,7,0,1.0,1.0,shc-gpt-4o,medalign,nursing_note,PROMPT1_entailment
93,182,3,3,0,1.0,2,1,1,0.5,0.6666666666666666,shc-gpt-4o,medalign,nursing_note,PROMPT1_entailment
94,183,6,6,0,1.0,6,6,0,1.0,1.0,shc-gpt-4o,medalign,nursing_note,PROMPT1_entailment
95,184,11,11,0,1.0,11,9,2,0.8181818181818182,0.9,shc-gpt-4o,medalign,nursing_note,PROMPT1_entailment
96,185,7,7,0,1.0,3,3,0,1.0,1.0,shc-gpt-4o,medalign,nursing_note,PROMPT1_entailment
97,186,5,5,0,1.0,3,3,0,1.0,1.0,shc-gpt-4o,medalign,nursing_note,PROMPT1_entailment
98,187,2,1,1,0.5,1,1,0,1.0,0.6666666666666666,shc-gpt-4o,medalign,nursing_note,PROMPT1_entailment
99,188,3,2,1,0.6666666666666666,3,3,0,1.0,0.8,shc-gpt-4o,medalign,nursing_note,PROMPT1_entailment
100,189,19,19,0,1.0,10,9,1,0.9,0.9473684210526316,shc-gpt-4o,medalign,nursing_note,PROMPT1_entailment
101,19,15,15,0,1.0,7,7,0,1.0,1.0,shc-gpt-4o,medalign,nursing_note,PROMPT1_entailment
102,190,4,4,0,1.0,2,2,0,1.0,1.0,shc-gpt-4o,medalign,nursing_note,PROMPT1_entailment
103,191,10,9,1,0.9,5,5,0,1.0,0.9473684210526316,shc-gpt-4o,medalign,nursing_note,PROMPT1_entailment
104,192,4,4,0,1.0,1,1,0,1.0,1.0,shc-gpt-4o,medalign,nursing_note,PROMPT1_entailment
105,193,3,3,0,1.0,3,3,0,1.0,1.0,shc-gpt-4o,medalign,nursing_note,PROMPT1_entailment
106,194,3,3,0,1.0,2,1,1,0.5,0.6666666666666666,shc-gpt-4o,medalign,nursing_note,PROMPT1_entailment
107,195,14,12,2,0.8571428571428571,10,8,2,0.8,0.8275862068965518,shc-gpt-4o,medalign,nursing_note,PROMPT1_entailment
108,196,7,7,0,1.0,1,1,0,1.0,1.0,shc-gpt-4o,medalign,nursing_note,PROMPT1_entailment
109,197,3,3,0,1.0,1,1,0,1.0,1.0,shc-gpt-4o,medalign,nursing_note,PROMPT1_entailment
110,198,18,16,2,0.8888888888888888,8,6,2,0.75,0.8135593220338982,shc-gpt-4o,medalign,nursing_note,PROMPT1_entailment
111,199,13,10,3,0.7692307692307693,7,7,0,1.0,0.8695652173913044,shc-gpt-4o,medalign,nursing_note,PROMPT1_entailment
112,2,19,9,10,0.4736842105263157,5,4,1,0.8,0.5950413223140496,shc-gpt-4o,medalign,nursing_note,PROMPT1_entailment
113,20,6,5,1,0.8333333333333334,2,1,1,0.5,0.625,shc-gpt-4o,medalign,nursing_note,PROMPT1_entailment
114,200,5,5,0,1.0,3,3,0,1.0,1.0,shc-gpt-4o,medalign,nursing_note,PROMPT1_entailment
115,201,4,4,0,1.0,1,1,0,1.0,1.0,shc-gpt-4o,medalign,nursing_note,PROMPT1_entailment
116,202,7,6,1,0.8571428571428571,1,1,0,1.0,0.923076923076923,shc-gpt-4o,medalign,nursing_note,PROMPT1_entailment
117,203,2,2,0,1.0,1,1,0,1.0,1.0,shc-gpt-4o,medalign,nursing_note,PROMPT1_entailment
118,204,15,14,1,0.9333333333333332,9,6,3,0.6666666666666666,0.7777777777777778,shc-gpt-4o,medalign,nursing_note,PROMPT1_entailment
119,205,22,11,11,0.5,8,4,4,0.5,0.5,shc-gpt-4o,medalign,nursing_note,PROMPT1_entailment
120,206,6,6,0,1.0,4,4,0,1.0,1.0,shc-gpt-4o,medalign,nursing_note,PROMPT1_entailment
121,207,11,11,0,1.0,6,6,0,1.0,1.0,shc-gpt-4o,medalign,nursing_note,PROMPT1_entailment
122,208,12,12,0,1.0,10,9,1,0.9,0.9473684210526316,shc-gpt-4o,medalign,nursing_note,PROMPT1_entailment
123,209,7,7,0,1.0,1,1,0,1.0,1.0,shc-gpt-4o,medalign,nursing_note,PROMPT1_entailment
124,21,4,4,0,1.0,1,1,0,1.0,1.0,shc-gpt-4o,medalign,nursing_note,PROMPT1_entailment
125,210,4,4,0,1.0,2,1,1,0.5,0.6666666666666666,shc-gpt-4o,medalign,nursing_note,PROMPT1_entailment
126,211,4,4,0,1.0,2,2,0,1.0,1.0,shc-gpt-4o,medalign,nursing_note,PROMPT1_entailment
127,212,6,6,0,1.0,3,3,0,1.0,1.0,shc-gpt-4o,medalign,nursing_note,PROMPT1_entailment
128,213,10,9,1,0.9,8,8,0,1.0,0.9473684210526316,shc-gpt-4o,medalign,nursing_note,PROMPT1_entailment
129,214,3,3,0,1.0,2,2,0,1.0,1.0,shc-gpt-4o,medalign,nursing_note,PROMPT1_entailment
130,215,2,2,0,1.0,1,1,0,1.0,1.0,shc-gpt-4o,medalign,nursing_note,PROMPT1_entailment
131,216,6,6,0,1.0,3,3,0,1.0,1.0,shc-gpt-4o,medalign,nursing_note,PROMPT1_entailment
132,217,16,13,3,0.8125,11,6,5,0.5454545454545454,0.6527196652719665,shc-gpt-4o,medalign,nursing_note,PROMPT1_entailment
133,218,15,15,0,1.0,3,2,1,0.6666666666666666,0.8,shc-gpt-4o,medalign,nursing_note,PROMPT1_entailment
134,219,5,4,1,0.8,2,2,0,1.0,0.888888888888889,shc-gpt-4o,medalign,nursing_note,PROMPT1_entailment
135,22,1,1,0,1.0,1,1,0,1.0,1.0,shc-gpt-4o,medalign,nursing_note,PROMPT1_entailment
136,220,9,9,0,1.0,7,7,0,1.0,1.0,shc-gpt-4o,medalign,nursing_note,PROMPT1_entailment
137,221,11,11,0,1.0,23,13,10,0.5652173913043478,0.7222222222222222,shc-gpt-4o,medalign,nursing_note,PROMPT1_entailment
138,222,4,4,0,1.0,4,4,0,1.0,1.0,shc-gpt-4o,medalign,nursing_note,PROMPT1_entailment
139,223,5,5,0,1.0,2,1,1,0.5,0.6666666666666666,shc-gpt-4o,medalign,nursing_note,PROMPT1_entailment
140,224,19,17,2,0.8947368421052632,4,2,2,0.5,0.6415094339622641,shc-gpt-4o,medalign,nursing_note,PROMPT1_entailment
141,225,5,5,0,1.0,2,2,0,1.0,1.0,shc-gpt-4o,medalign,nursing_note,PROMPT1_entailment
142,226,7,6,1,0.8571428571428571,5,4,1,0.8,0.8275862068965518,shc-gpt-4o,medalign,nursing_note,PROMPT1_entailment
143,227,3,2,1,0.6666666666666666,1,1,0,1.0,0.8,shc-gpt-4o,medalign,nursing_note,PROMPT1_entailment
144,228,28,26,2,0.9285714285714286,18,17,1,0.9444444444444444,0.9364406779661016,shc-gpt-4o,medalign,nursing_note,PROMPT1_entailment
145,229,7,6,1,0.8571428571428571,7,7,0,1.0,0.923076923076923,shc-gpt-4o,medalign,nursing_note,PROMPT1_entailment
146,23,13,11,2,0.8461538461538461,21,10,11,0.4761904761904761,0.6094182825484764,shc-gpt-4o,medalign,nursing_note,PROMPT1_entailment
147,230,1,1,0,1.0,1,1,0,1.0,1.0,shc-gpt-4o,medalign,nursing_note,PROMPT1_entailment
148,231,15,14,1,0.9333333333333332,13,10,3,0.7692307692307693,0.8433734939759036,shc-gpt-4o,medalign,nursing_note,PROMPT1_entailment
149,232,6,6,0,1.0,6,3,3,0.5,0.6666666666666666,shc-gpt-4o,medalign,nursing_note,PROMPT1_entailment
150,233,5,3,2,0.6,4,2,2,0.5,0.5454545454545454,shc-gpt-4o,medalign,nursing_note,PROMPT1_entailment
151,234,4,4,0,1.0,2,2,0,1.0,1.0,shc-gpt-4o,medalign,nursing_note,PROMPT1_entailment
152,235,3,3,0,1.0,1,1,0,1.0,1.0,shc-gpt-4o,medalign,nursing_note,PROMPT1_entailment
153,236,14,13,1,0.9285714285714286,14,9,5,0.6428571428571429,0.7597402597402597,shc-gpt-4o,medalign,nursing_note,PROMPT1_entailment
154,237,10,9,1,0.9,5,5,0,1.0,0.9473684210526316,shc-gpt-4o,medalign,nursing_note,PROMPT1_entailment
155,238,5,5,0,1.0,4,3,1,0.75,0.8571428571428571,shc-gpt-4o,medalign,nursing_note,PROMPT1_entailment
156,239,7,6,1,0.8571428571428571,4,4,0,1.0,0.923076923076923,shc-gpt-4o,medalign,nursing_note,PROMPT1_entailment
157,24,3,3,0,1.0,1,1,0,1.0,1.0,shc-gpt-4o,medalign,nursing_note,PROMPT1_entailment
158,240,3,3,0,1.0,2,2,0,1.0,1.0,shc-gpt-4o,medalign,nursing_note,PROMPT1_entailment
159,241,6,5,1,0.8333333333333334,2,2,0,1.0,0.9090909090909092,shc-gpt-4o,medalign,nursing_note,PROMPT1_entailment
160,242,17,11,6,0.6470588235294118,2,2,0,1.0,0.7857142857142858,shc-gpt-4o,medalign,nursing_note,PROMPT1_entailment
161,243,23,23,0,1.0,10,10,0,1.0,1.0,shc-gpt-4o,medalign,nursing_note,PROMPT1_entailment
162,244,3,3,0,1.0,1,1,0,1.0,1.0,shc-gpt-4o,medalign,nursing_note,PROMPT1_entailment
163,245,4,3,1,0.75,1,0,1,0.0,0.0,shc-gpt-4o,medalign,nursing_note,PROMPT1_entailment
164,246,3,3,0,1.0,1,1,0,1.0,1.0,shc-gpt-4o,medalign,nursing_note,PROMPT1_entailment
165,247,6,6,0,1.0,5,5,0,1.0,1.0,shc-gpt-4o,medalign,nursing_note,PROMPT1_entailment
166,248,2,2,0,1.0,1,1,0,1.0,1.0,shc-gpt-4o,medalign,nursing_note,PROMPT1_entailment
167,249,6,6,0,1.0,2,2,0,1.0,1.0,shc-gpt-4o,medalign,nursing_note,PROMPT1_entailment
168,25,56,49,7,0.875,33,24,9,0.7272727272727273,0.7943262411347517,shc-gpt-4o,medalign,nursing_note,PROMPT1_entailment
169,26,5,5,0,1.0,1,1,0,1.0,1.0,shc-gpt-4o,medalign,nursing_note,PROMPT1_entailment
170,27,8,8,0,1.0,2,2,0,1.0,1.0,shc-gpt-4o,medalign,nursing_note,PROMPT1_entailment
171,28,12,7,5,0.5833333333333334,4,4,0,1.0,0.7368421052631579,shc-gpt-4o,medalign,nursing_note,PROMPT1_entailment
172,29,5,5,0,1.0,3,3,0,1.0,1.0,shc-gpt-4o,medalign,nursing_note,PROMPT1_entailment
173,3,3,3,0,1.0,2,2,0,1.0,1.0,shc-gpt-4o,medalign,nursing_note,PROMPT1_entailment
174,30,2,2,0,1.0,1,1,0,1.0,1.0,shc-gpt-4o,medalign,nursing_note,PROMPT1_entailment
175,31,2,2,0,1.0,1,1,0,1.0,1.0,shc-gpt-4o,medalign,nursing_note,PROMPT1_entailment
176,32,6,6,0,1.0,2,2,0,1.0,1.0,shc-gpt-4o,medalign,nursing_note,PROMPT1_entailment
177,33,13,13,0,1.0,5,5,0,1.0,1.0,shc-gpt-4o,medalign,nursing_note,PROMPT1_entailment
178,34,9,9,0,1.0,4,1,3,0.25,0.4,shc-gpt-4o,medalign,nursing_note,PROMPT1_entailment
179,35,7,7,0,1.0,4,3,1,0.75,0.8571428571428571,shc-gpt-4o,medalign,nursing_note,PROMPT1_entailment
180,36,14,10,4,0.7142857142857143,5,5,0,1.0,0.8333333333333333,shc-gpt-4o,medalign,nursing_note,PROMPT1_entailment
181,37,3,3,0,1.0,3,3,0,1.0,1.0,shc-gpt-4o,medalign,nursing_note,PROMPT1_entailment
182,38,8,5,3,0.625,5,3,2,0.6,0.6122448979591836,shc-gpt-4o,medalign,nursing_note,PROMPT1_entailment
183,39,4,4,0,1.0,1,1,0,1.0,1.0,shc-gpt-4o,medalign,nursing_note,PROMPT1_entailment
184,4,4,3,1,0.75,3,3,0,1.0,0.8571428571428571,shc-gpt-4o,medalign,nursing_note,PROMPT1_entailment
185,40,10,8,2,0.8,8,6,2,0.75,0.7741935483870969,shc-gpt-4o,medalign,nursing_note,PROMPT1_entailment
186,41,2,2,0,1.0,1,1,0,1.0,1.0,shc-gpt-4o,medalign,nursing_note,PROMPT1_entailment
187,42,9,8,1,0.8888888888888888,8,6,2,0.75,0.8135593220338982,shc-gpt-4o,medalign,nursing_note,PROMPT1_entailment
188,43,5,5,0,1.0,2,2,0,1.0,1.0,shc-gpt-4o,medalign,nursing_note,PROMPT1_entailment
189,44,4,4,0,1.0,1,1,0,1.0,1.0,shc-gpt-4o,medalign,nursing_note,PROMPT1_entailment
190,45,3,2,1,0.6666666666666666,1,1,0,1.0,0.8,shc-gpt-4o,medalign,nursing_note,PROMPT1_entailment
191,46,7,7,0,1.0,5,5,0,1.0,1.0,shc-gpt-4o,medalign,nursing_note,PROMPT1_entailment
192,47,20,19,1,0.95,20,20,0,1.0,0.9743589743589745,shc-gpt-4o,medalign,nursing_note,PROMPT1_entailment
193,48,5,4,1,0.8,2,2,0,1.0,0.888888888888889,shc-gpt-4o,medalign,nursing_note,PROMPT1_entailment
194,49,6,6,0,1.0,2,1,1,0.5,0.6666666666666666,shc-gpt-4o,medalign,nursing_note,PROMPT1_entailment
195,5,9,9,0,1.0,5,5,0,1.0,1.0,shc-gpt-4o,medalign,nursing_note,PROMPT1_entailment
196,50,2,2,0,1.0,1,0,1,0.0,0.0,shc-gpt-4o,medalign,nursing_note,PROMPT1_entailment
197,51,3,3,0,1.0,2,2,0,1.0,1.0,shc-gpt-4o,medalign,nursing_note,PROMPT1_entailment
198,52,5,5,0,1.0,4,3,1,0.75,0.8571428571428571,shc-gpt-4o,medalign,nursing_note,PROMPT1_entailment
199,53,2,2,0,1.0,1,1,0,1.0,1.0,shc-gpt-4o,medalign,nursing_note,PROMPT1_entailment
200,54,12,11,1,0.9166666666666666,7,5,2,0.7142857142857143,0.8029197080291971,shc-gpt-4o,medalign,nursing_note,PROMPT1_entailment
201,55,4,4,0,1.0,2,2,0,1.0,1.0,shc-gpt-4o,medalign,nursing_note,PROMPT1_entailment
202,56,7,7,0,1.0,3,2,1,0.6666666666666666,0.8,shc-gpt-4o,medalign,nursing_note,PROMPT1_entailment
203,57,11,7,4,0.6363636363636364,4,4,0,1.0,0.7777777777777778,shc-gpt-4o,medalign,nursing_note,PROMPT1_entailment
204,58,3,3,0,1.0,1,1,0,1.0,1.0,shc-gpt-4o,medalign,nursing_note,PROMPT1_entailment
205,59,3,3,0,1.0,1,1,0,1.0,1.0,shc-gpt-4o,medalign,nursing_note,PROMPT1_entailment
206,6,6,6,0,1.0,3,3,0,1.0,1.0,shc-gpt-4o,medalign,nursing_note,PROMPT1_entailment
207,60,10,10,0,1.0,9,8,1,0.8888888888888888,0.9411764705882352,shc-gpt-4o,medalign,nursing_note,PROMPT1_entailment
208,61,5,5,0,1.0,1,1,0,1.0,1.0,shc-gpt-4o,medalign,nursing_note,PROMPT1_entailment
209,62,13,12,1,0.9230769230769232,5,5,0,1.0,0.96,shc-gpt-4o,medalign,nursing_note,PROMPT1_entailment
210,63,8,7,1,0.875,7,3,4,0.4285714285714285,0.5753424657534246,shc-gpt-4o,medalign,nursing_note,PROMPT1_entailment
211,64,3,3,0,1.0,1,1,0,1.0,1.0,shc-gpt-4o,medalign,nursing_note,PROMPT1_entailment
212,65,4,4,0,1.0,2,2,0,1.0,1.0,shc-gpt-4o,medalign,nursing_note,PROMPT1_entailment
213,66,5,5,0,1.0,4,4,0,1.0,1.0,shc-gpt-4o,medalign,nursing_note,PROMPT1_entailment
214,67,6,6,0,1.0,4,3,1,0.75,0.8571428571428571,shc-gpt-4o,medalign,nursing_note,PROMPT1_entailment
215,68,4,4,0,1.0,1,1,0,1.0,1.0,shc-gpt-4o,medalign,nursing_note,PROMPT1_entailment
216,69,6,6,0,1.0,2,2,0,1.0,1.0,shc-gpt-4o,medalign,nursing_note,PROMPT1_entailment
217,7,7,7,0,1.0,1,1,0,1.0,1.0,shc-gpt-4o,medalign,nursing_note,PROMPT1_entailment
218,70,6,5,1,0.8333333333333334,1,0,1,0.0,0.0,shc-gpt-4o,medalign,nursing_note,PROMPT1_entailment
219,71,6,6,0,1.0,1,0,1,0.0,0.0,shc-gpt-4o,medalign,nursing_note,PROMPT1_entailment
220,72,2,2,0,1.0,1,1,0,1.0,1.0,shc-gpt-4o,medalign,nursing_note,PROMPT1_entailment
221,73,4,4,0,1.0,2,2,0,1.0,1.0,shc-gpt-4o,medalign,nursing_note,PROMPT1_entailment
222,74,11,10,1,0.9090909090909092,5,5,0,1.0,0.9523809523809524,shc-gpt-4o,medalign,nursing_note,PROMPT1_entailment
223,75,2,2,0,1.0,1,1,0,1.0,1.0,shc-gpt-4o,medalign,nursing_note,PROMPT1_entailment
224,76,10,10,0,1.0,5,5,0,1.0,1.0,shc-gpt-4o,medalign,nursing_note,PROMPT1_entailment
225,77,6,6,0,1.0,3,3,0,1.0,1.0,shc-gpt-4o,medalign,nursing_note,PROMPT1_entailment
226,78,5,4,1,0.8,3,3,0,1.0,0.888888888888889,shc-gpt-4o,medalign,nursing_note,PROMPT1_entailment
227,79,7,7,0,1.0,8,7,1,0.875,0.9333333333333332,shc-gpt-4o,medalign,nursing_note,PROMPT1_entailment
228,8,8,8,0,1.0,8,4,4,0.5,0.6666666666666666,shc-gpt-4o,medalign,nursing_note,PROMPT1_entailment
229,80,12,12,0,1.0,10,10,0,1.0,1.0,shc-gpt-4o,medalign,nursing_note,PROMPT1_entailment
230,81,2,2,0,1.0,1,1,0,1.0,1.0,shc-gpt-4o,medalign,nursing_note,PROMPT1_entailment
231,82,3,3,0,1.0,3,3,0,1.0,1.0,shc-gpt-4o,medalign,nursing_note,PROMPT1_entailment
232,83,5,5,0,1.0,3,1,2,0.3333333333333333,0.5,shc-gpt-4o,medalign,nursing_note,PROMPT1_entailment
233,84,9,9,0,1.0,2,2,0,1.0,1.0,shc-gpt-4o,medalign,nursing_note,PROMPT1_entailment
234,85,9,9,0,1.0,8,8,0,1.0,1.0,shc-gpt-4o,medalign,nursing_note,PROMPT1_entailment
235,86,3,3,0,1.0,3,3,0,1.0,1.0,shc-gpt-4o,medalign,nursing_note,PROMPT1_entailment
236,87,5,4,1,0.8,2,2,0,1.0,0.888888888888889,shc-gpt-4o,medalign,nursing_note,PROMPT1_entailment
237,88,9,9,0,1.0,7,6,1,0.8571428571428571,0.923076923076923,shc-gpt-4o,medalign,nursing_note,PROMPT1_entailment
238,89,8,8,0,1.0,6,6,0,1.0,1.0,shc-gpt-4o,medalign,nursing_note,PROMPT1_entailment
239,9,5,5,0,1.0,2,2,0,1.0,1.0,shc-gpt-4o,medalign,nursing_note,PROMPT1_entailment
240,90,7,7,0,1.0,1,1,0,1.0,1.0,shc-gpt-4o,medalign,nursing_note,PROMPT1_entailment
241,91,5,5,0,1.0,1,1,0,1.0,1.0,shc-gpt-4o,medalign,nursing_note,PROMPT1_entailment
242,92,6,6,0,1.0,4,2,2,0.5,0.6666666666666666,shc-gpt-4o,medalign,nursing_note,PROMPT1_entailment
243,93,3,3,0,1.0,1,1,0,1.0,1.0,shc-gpt-4o,medalign,nursing_note,PROMPT1_entailment
244,94,3,3,0,1.0,2,1,1,0.5,0.6666666666666666,shc-gpt-4o,medalign,nursing_note,PROMPT1_entailment
245,95,3,3,0,1.0,1,1,0,1.0,1.0,shc-gpt-4o,medalign,nursing_note,PROMPT1_entailment
246,96,2,2,0,1.0,1,1,0,1.0,1.0,shc-gpt-4o,medalign,nursing_note,PROMPT1_entailment
247,97,5,5,0,1.0,2,2,0,1.0,1.0,shc-gpt-4o,medalign,nursing_note,PROMPT1_entailment
248,98,9,9,0,1.0,5,4,1,0.8,0.888888888888889,shc-gpt-4o,medalign,nursing_note,PROMPT1_entailment
249,99,15,14,1,0.9333333333333332,7,5,2,0.7142857142857143,0.809248554913295,shc-gpt-4o,medalign,nursing_note,PROMPT1_entailment
0,0,14,14,0,1.0,6,6,0,1.0,1.0,shc-gpt-4o,medalign,nursing_note,PROMPT1_ICL_entailment
1,1,11,11,0,1.0,1,1,0,1.0,1.0,shc-gpt-4o,medalign,nursing_note,PROMPT1_ICL_entailment
2,10,8,8,0,1.0,5,4,1,0.8,0.888888888888889,shc-gpt-4o,medalign,nursing_note,PROMPT1_ICL_entailment
3,100,14,13,1,0.9285714285714286,10,8,2,0.8,0.859504132231405,shc-gpt-4o,medalign,nursing_note,PROMPT1_ICL_entailment
4,101,8,7,1,0.875,1,1,0,1.0,0.9333333333333332,shc-gpt-4o,medalign,nursing_note,PROMPT1_ICL_entailment
5,102,10,10,0,1.0,4,3,1,0.75,0.8571428571428571,shc-gpt-4o,medalign,nursing_note,PROMPT1_ICL_entailment
6,103,4,4,0,1.0,2,2,0,1.0,1.0,shc-gpt-4o,medalign,nursing_note,PROMPT1_ICL_entailment
7,104,19,18,1,0.9473684210526316,15,14,1,0.9333333333333332,0.9402985074626864,shc-gpt-4o,medalign,nursing_note,PROMPT1_ICL_entailment
8,105,4,3,1,0.75,1,1,0,1.0,0.8571428571428571,shc-gpt-4o,medalign,nursing_note,PROMPT1_ICL_entailment
9,106,5,5,0,1.0,1,1,0,1.0,1.0,shc-gpt-4o,medalign,nursing_note,PROMPT1_ICL_entailment
10,107,10,9,1,0.9,4,4,0,1.0,0.9473684210526316,shc-gpt-4o,medalign,nursing_note,PROMPT1_ICL_entailment
11,108,3,2,1,0.6666666666666666,2,2,0,1.0,0.8,shc-gpt-4o,medalign,nursing_note,PROMPT1_ICL_entailment
12,109,11,11,0,1.0,5,5,0,1.0,1.0,shc-gpt-4o,medalign,nursing_note,PROMPT1_ICL_entailment
13,11,4,3,1,0.75,1,1,0,1.0,0.8571428571428571,shc-gpt-4o,medalign,nursing_note,PROMPT1_ICL_entailment
14,110,20,13,7,0.65,6,5,1,0.8333333333333334,0.7303370786516855,shc-gpt-4o,medalign,nursing_note,PROMPT1_ICL_entailment
15,111,4,4,0,1.0,1,1,0,1.0,1.0,shc-gpt-4o,medalign,nursing_note,PROMPT1_ICL_entailment
16,112,7,7,0,1.0,2,2,0,1.0,1.0,shc-gpt-4o,medalign,nursing_note,PROMPT1_ICL_entailment
17,113,4,4,0,1.0,1,1,0,1.0,1.0,shc-gpt-4o,medalign,nursing_note,PROMPT1_ICL_entailment
18,114,5,5,0,1.0,1,1,0,1.0,1.0,shc-gpt-4o,medalign,nursing_note,PROMPT1_ICL_entailment
19,115,16,15,1,0.9375,7,4,3,0.5714285714285714,0.7100591715976331,shc-gpt-4o,medalign,nursing_note,PROMPT1_ICL_entailment
20,116,11,10,1,0.9090909090909092,5,4,1,0.8,0.8510638297872342,shc-gpt-4o,medalign,nursing_note,PROMPT1_ICL_entailment
21,117,20,17,3,0.85,13,10,3,0.7692307692307693,0.8076009501187649,shc-gpt-4o,medalign,nursing_note,PROMPT1_ICL_entailment
22,118,4,4,0,1.0,2,2,0,1.0,1.0,shc-gpt-4o,medalign,nursing_note,PROMPT1_ICL_entailment
23,119,5,4,1,0.8,2,2,0,1.0,0.888888888888889,shc-gpt-4o,medalign,nursing_note,PROMPT1_ICL_entailment
24,12,4,4,0,1.0,1,1,0,1.0,1.0,shc-gpt-4o,medalign,nursing_note,PROMPT1_ICL_entailment
25,120,10,10,0,1.0,7,5,2,0.7142857142857143,0.8333333333333333,shc-gpt-4o,medalign,nursing_note,PROMPT1_ICL_entailment
26,121,3,2,1,0.6666666666666666,1,1,0,1.0,0.8,shc-gpt-4o,medalign,nursing_note,PROMPT1_ICL_entailment
27,122,4,3,1,0.75,1,1,0,1.0,0.8571428571428571,shc-gpt-4o,medalign,nursing_note,PROMPT1_ICL_entailment
28,123,5,4,1,0.8,4,4,0,1.0,0.888888888888889,shc-gpt-4o,medalign,nursing_note,PROMPT1_ICL_entailment
29,124,22,21,1,0.9545454545454546,14,12,2,0.8571428571428571,0.9032258064516128,shc-gpt-4o,medalign,nursing_note,PROMPT1_ICL_entailment
30,125,15,15,0,1.0,9,9,0,1.0,1.0,shc-gpt-4o,medalign,nursing_note,PROMPT1_ICL_entailment
31,126,4,4,0,1.0,2,2,0,1.0,1.0,shc-gpt-4o,medalign,nursing_note,PROMPT1_ICL_entailment
32,127,4,4,0,1.0,1,1,0,1.0,1.0,shc-gpt-4o,medalign,nursing_note,PROMPT1_ICL_entailment
33,128,5,5,0,1.0,2,2,0,1.0,1.0,shc-gpt-4o,medalign,nursing_note,PROMPT1_ICL_entailment
34,129,33,32,1,0.9696969696969696,20,19,1,0.95,0.9597474348855564,shc-gpt-4o,medalign,nursing_note,PROMPT1_ICL_entailment
35,13,9,9,0,1.0,5,4,1,0.8,0.888888888888889,shc-gpt-4o,medalign,nursing_note,PROMPT1_ICL_entailment
36,130,6,6,0,1.0,2,2,0,1.0,1.0,shc-gpt-4o,medalign,nursing_note,PROMPT1_ICL_entailment
37,131,4,4,0,1.0,1,1,0,1.0,1.0,shc-gpt-4o,medalign,nursing_note,PROMPT1_ICL_entailment
38,132,8,8,0,1.0,2,2,0,1.0,1.0,shc-gpt-4o,medalign,nursing_note,PROMPT1_ICL_entailment
39,133,16,15,1,0.9375,14,8,6,0.5714285714285714,0.7100591715976331,shc-gpt-4o,medalign,nursing_note,PROMPT1_ICL_entailment
40,134,6,6,0,1.0,3,3,0,1.0,1.0,shc-gpt-4o,medalign,nursing_note,PROMPT1_ICL_entailment
41,135,6,6,0,1.0,2,2,0,1.0,1.0,shc-gpt-4o,medalign,nursing_note,PROMPT1_ICL_entailment
42,136,53,38,15,0.7169811320754716,51,27,24,0.5294117647058824,0.6090828138913624,shc-gpt-4o,medalign,nursing_note,PROMPT1_ICL_entailment
43,137,14,14,0,1.0,6,6,0,1.0,1.0,shc-gpt-4o,medalign,nursing_note,PROMPT1_ICL_entailment
44,138,4,2,2,0.5,1,1,0,1.0,0.6666666666666666,shc-gpt-4o,medalign,nursing_note,PROMPT1_ICL_entailment
45,139,5,4,1,0.8,1,1,0,1.0,0.888888888888889,shc-gpt-4o,medalign,nursing_note,PROMPT1_ICL_entailment
46,14,3,3,0,1.0,1,1,0,1.0,1.0,shc-gpt-4o,medalign,nursing_note,PROMPT1_ICL_entailment
47,140,5,4,1,0.8,3,3,0,1.0,0.888888888888889,shc-gpt-4o,medalign,nursing_note,PROMPT1_ICL_entailment
48,141,3,3,0,1.0,1,1,0,1.0,1.0,shc-gpt-4o,medalign,nursing_note,PROMPT1_ICL_entailment
49,142,3,3,0,1.0,1,1,0,1.0,1.0,shc-gpt-4o,medalign,nursing_note,PROMPT1_ICL_entailment
50,143,3,3,0,1.0,1,1,0,1.0,1.0,shc-gpt-4o,medalign,nursing_note,PROMPT1_ICL_entailment
51,144,4,2,2,0.5,1,1,0,1.0,0.6666666666666666,shc-gpt-4o,medalign,nursing_note,PROMPT1_ICL_entailment
52,145,5,5,0,1.0,4,4,0,1.0,1.0,shc-gpt-4o,medalign,nursing_note,PROMPT1_ICL_entailment
53,146,20,20,0,1.0,3,3,0,1.0,1.0,shc-gpt-4o,medalign,nursing_note,PROMPT1_ICL_entailment
54,147,12,11,1,0.9166666666666666,6,4,2,0.6666666666666666,0.7719298245614035,shc-gpt-4o,medalign,nursing_note,PROMPT1_ICL_entailment
55,148,28,28,0,1.0,7,7,0,1.0,1.0,shc-gpt-4o,medalign,nursing_note,PROMPT1_ICL_entailment
56,149,12,10,2,0.8333333333333334,1,1,0,1.0,0.9090909090909092,shc-gpt-4o,medalign,nursing_note,PROMPT1_ICL_entailment
57,15,9,8,1,0.8888888888888888,1,1,0,1.0,0.9411764705882352,shc-gpt-4o,medalign,nursing_note,PROMPT1_ICL_entailment
58,150,5,4,1,0.8,1,1,0,1.0,0.888888888888889,shc-gpt-4o,medalign,nursing_note,PROMPT1_ICL_entailment
59,151,16,16,0,1.0,8,7,1,0.875,0.9333333333333332,shc-gpt-4o,medalign,nursing_note,PROMPT1_ICL_entailment
60,152,7,7,0,1.0,4,4,0,1.0,1.0,shc-gpt-4o,medalign,nursing_note,PROMPT1_ICL_entailment
61,153,16,15,1,0.9375,14,12,2,0.8571428571428571,0.8955223880597014,shc-gpt-4o,medalign,nursing_note,PROMPT1_ICL_entailment
62,154,3,3,0,1.0,1,1,0,1.0,1.0,shc-gpt-4o,medalign,nursing_note,PROMPT1_ICL_entailment
63,155,30,26,4,0.8666666666666667,14,9,5,0.6428571428571429,0.7381703470031546,shc-gpt-4o,medalign,nursing_note,PROMPT1_ICL_entailment
64,156,12,11,1,0.9166666666666666,1,1,0,1.0,0.9565217391304348,shc-gpt-4o,medalign,nursing_note,PROMPT1_ICL_entailment
65,157,7,6,1,0.8571428571428571,3,3,0,1.0,0.923076923076923,shc-gpt-4o,medalign,nursing_note,PROMPT1_ICL_entailment
66,158,12,12,0,1.0,1,1,0,1.0,1.0,shc-gpt-4o,medalign,nursing_note,PROMPT1_ICL_entailment
67,159,7,7,0,1.0,3,3,0,1.0,1.0,shc-gpt-4o,medalign,nursing_note,PROMPT1_ICL_entailment
68,16,15,15,0,1.0,3,2,1,0.6666666666666666,0.8,shc-gpt-4o,medalign,nursing_note,PROMPT1_ICL_entailment
69,160,5,5,0,1.0,1,1,0,1.0,1.0,shc-gpt-4o,medalign,nursing_note,PROMPT1_ICL_entailment
70,161,6,6,0,1.0,1,1,0,1.0,1.0,shc-gpt-4o,medalign,nursing_note,PROMPT1_ICL_entailment
71,162,11,10,1,0.9090909090909092,8,8,0,1.0,0.9523809523809524,shc-gpt-4o,medalign,nursing_note,PROMPT1_ICL_entailment
72,163,6,6,0,1.0,3,3,0,1.0,1.0,shc-gpt-4o,medalign,nursing_note,PROMPT1_ICL_entailment
73,164,9,9,0,1.0,2,2,0,1.0,1.0,shc-gpt-4o,medalign,nursing_note,PROMPT1_ICL_entailment
74,165,11,10,1,0.9090909090909092,4,4,0,1.0,0.9523809523809524,shc-gpt-4o,medalign,nursing_note,PROMPT1_ICL_entailment
75,166,14,11,3,0.7857142857142857,5,5,0,1.0,0.88,shc-gpt-4o,medalign,nursing_note,PROMPT1_ICL_entailment
76,167,15,13,2,0.8666666666666667,2,1,1,0.5,0.6341463414634146,shc-gpt-4o,medalign,nursing_note,PROMPT1_ICL_entailment
77,168,8,7,1,0.875,3,3,0,1.0,0.9333333333333332,shc-gpt-4o,medalign,nursing_note,PROMPT1_ICL_entailment
78,169,12,12,0,1.0,9,9,0,1.0,1.0,shc-gpt-4o,medalign,nursing_note,PROMPT1_ICL_entailment
79,17,4,3,1,0.75,1,0,1,0.0,0.0,shc-gpt-4o,medalign,nursing_note,PROMPT1_ICL_entailment
80,170,6,5,1,0.8333333333333334,1,1,0,1.0,0.9090909090909092,shc-gpt-4o,medalign,nursing_note,PROMPT1_ICL_entailment
81,171,13,11,2,0.8461538461538461,7,4,3,0.5714285714285714,0.6821705426356589,shc-gpt-4o,medalign,nursing_note,PROMPT1_ICL_entailment
82,172,17,15,2,0.8823529411764706,12,8,4,0.6666666666666666,0.7594936708860759,shc-gpt-4o,medalign,nursing_note,PROMPT1_ICL_entailment
83,173,11,11,0,1.0,1,1,0,1.0,1.0,shc-gpt-4o,medalign,nursing_note,PROMPT1_ICL_entailment
84,174,4,4,0,1.0,1,1,0,1.0,1.0,shc-gpt-4o,medalign,nursing_note,PROMPT1_ICL_entailment
85,175,3,2,1,0.6666666666666666,2,2,0,1.0,0.8,shc-gpt-4o,medalign,nursing_note,PROMPT1_ICL_entailment
86,176,13,10,3,0.7692307692307693,3,2,1,0.6666666666666666,0.7142857142857142,shc-gpt-4o,medalign,nursing_note,PROMPT1_ICL_entailment
87,177,9,9,0,1.0,8,7,1,0.875,0.9333333333333332,shc-gpt-4o,medalign,nursing_note,PROMPT1_ICL_entailment
88,178,11,10,1,0.9090909090909092,10,10,0,1.0,0.9523809523809524,shc-gpt-4o,medalign,nursing_note,PROMPT1_ICL_entailment
89,179,10,8,2,0.8,2,2,0,1.0,0.888888888888889,shc-gpt-4o,medalign,nursing_note,PROMPT1_ICL_entailment
90,18,20,17,3,0.85,3,3,0,1.0,0.9189189189189187,shc-gpt-4o,medalign,nursing_note,PROMPT1_ICL_entailment
91,180,16,13,3,0.8125,4,3,1,0.75,0.78,shc-gpt-4o,medalign,nursing_note,PROMPT1_ICL_entailment
92,181,10,10,0,1.0,7,7,0,1.0,1.0,shc-gpt-4o,medalign,nursing_note,PROMPT1_ICL_entailment
93,182,4,3,1,0.75,2,2,0,1.0,0.8571428571428571,shc-gpt-4o,medalign,nursing_note,PROMPT1_ICL_entailment
94,183,8,8,0,1.0,6,6,0,1.0,1.0,shc-gpt-4o,medalign,nursing_note,PROMPT1_ICL_entailment
95,184,12,10,2,0.8333333333333334,11,10,1,0.9090909090909092,0.8695652173913043,shc-gpt-4o,medalign,nursing_note,PROMPT1_ICL_entailment
96,185,7,6,1,0.8571428571428571,3,3,0,1.0,0.923076923076923,shc-gpt-4o,medalign,nursing_note,PROMPT1_ICL_entailment
97,186,6,5,1,0.8333333333333334,3,3,0,1.0,0.9090909090909092,shc-gpt-4o,medalign,nursing_note,PROMPT1_ICL_entailment
98,187,3,2,1,0.6666666666666666,1,1,0,1.0,0.8,shc-gpt-4o,medalign,nursing_note,PROMPT1_ICL_entailment
99,188,5,5,0,1.0,3,3,0,1.0,1.0,shc-gpt-4o,medalign,nursing_note,PROMPT1_ICL_entailment
100,189,22,19,3,0.8636363636363636,10,9,1,0.9,0.8814432989690723,shc-gpt-4o,medalign,nursing_note,PROMPT1_ICL_entailment
101,19,15,14,1,0.9333333333333332,7,7,0,1.0,0.9655172413793104,shc-gpt-4o,medalign,nursing_note,PROMPT1_ICL_entailment
102,190,6,6,0,1.0,2,2,0,1.0,1.0,shc-gpt-4o,medalign,nursing_note,PROMPT1_ICL_entailment
103,191,19,19,0,1.0,5,4,1,0.8,0.888888888888889,shc-gpt-4o,medalign,nursing_note,PROMPT1_ICL_entailment
104,192,4,4,0,1.0,1,1,0,1.0,1.0,shc-gpt-4o,medalign,nursing_note,PROMPT1_ICL_entailment
105,193,7,6,1,0.8571428571428571,3,3,0,1.0,0.923076923076923,shc-gpt-4o,medalign,nursing_note,PROMPT1_ICL_entailment
106,194,4,3,1,0.75,2,1,1,0.5,0.6,shc-gpt-4o,medalign,nursing_note,PROMPT1_ICL_entailment
107,195,16,15,1,0.9375,10,9,1,0.9,0.9183673469387756,shc-gpt-4o,medalign,nursing_note,PROMPT1_ICL_entailment
108,196,6,6,0,1.0,1,1,0,1.0,1.0,shc-gpt-4o,medalign,nursing_note,PROMPT1_ICL_entailment
109,197,5,4,1,0.8,1,1,0,1.0,0.888888888888889,shc-gpt-4o,medalign,nursing_note,PROMPT1_ICL_entailment
110,198,24,22,2,0.9166666666666666,8,7,1,0.875,0.8953488372093024,shc-gpt-4o,medalign,nursing_note,PROMPT1_ICL_entailment
111,199,20,15,5,0.75,7,7,0,1.0,0.8571428571428571,shc-gpt-4o,medalign,nursing_note,PROMPT1_ICL_entailment
112,2,14,11,3,0.7857142857142857,5,4,1,0.8,0.7927927927927927,shc-gpt-4o,medalign,nursing_note,PROMPT1_ICL_entailment
113,20,8,6,2,0.75,2,2,0,1.0,0.8571428571428571,shc-gpt-4o,medalign,nursing_note,PROMPT1_ICL_entailment
114,200,5,5,0,1.0,3,3,0,1.0,1.0,shc-gpt-4o,medalign,nursing_note,PROMPT1_ICL_entailment
115,201,5,4,1,0.8,1,1,0,1.0,0.888888888888889,shc-gpt-4o,medalign,nursing_note,PROMPT1_ICL_entailment
116,202,8,7,1,0.875,1,1,0,1.0,0.9333333333333332,shc-gpt-4o,medalign,nursing_note,PROMPT1_ICL_entailment
117,203,5,5,0,1.0,1,1,0,1.0,1.0,shc-gpt-4o,medalign,nursing_note,PROMPT1_ICL_entailment
118,204,17,16,1,0.9411764705882352,9,9,0,1.0,0.9696969696969696,shc-gpt-4o,medalign,nursing_note,PROMPT1_ICL_entailment
119,205,34,18,16,0.5294117647058824,8,4,4,0.5,0.5142857142857143,shc-gpt-4o,medalign,nursing_note,PROMPT1_ICL_entailment
120,206,6,6,0,1.0,4,4,0,1.0,1.0,shc-gpt-4o,medalign,nursing_note,PROMPT1_ICL_entailment
121,207,14,14,0,1.0,6,5,1,0.8333333333333334,0.9090909090909092,shc-gpt-4o,medalign,nursing_note,PROMPT1_ICL_entailment
122,208,16,15,1,0.9375,10,8,2,0.8,0.8633093525179856,shc-gpt-4o,medalign,nursing_note,PROMPT1_ICL_entailment
123,209,8,8,0,1.0,1,1,0,1.0,1.0,shc-gpt-4o,medalign,nursing_note,PROMPT1_ICL_entailment
124,21,6,6,0,1.0,1,1,0,1.0,1.0,shc-gpt-4o,medalign,nursing_note,PROMPT1_ICL_entailment
125,210,4,3,1,0.75,2,1,1,0.5,0.6,shc-gpt-4o,medalign,nursing_note,PROMPT1_ICL_entailment
126,211,5,5,0,1.0,2,2,0,1.0,1.0,shc-gpt-4o,medalign,nursing_note,PROMPT1_ICL_entailment
127,212,8,8,0,1.0,3,3,0,1.0,1.0,shc-gpt-4o,medalign,nursing_note,PROMPT1_ICL_entailment
128,213,16,16,0,1.0,8,8,0,1.0,1.0,shc-gpt-4o,medalign,nursing_note,PROMPT1_ICL_entailment
129,214,5,5,0,1.0,2,2,0,1.0,1.0,shc-gpt-4o,medalign,nursing_note,PROMPT1_ICL_entailment
130,215,3,3,0,1.0,1,1,0,1.0,1.0,shc-gpt-4o,medalign,nursing_note,PROMPT1_ICL_entailment
131,216,6,5,1,0.8333333333333334,3,3,0,1.0,0.9090909090909092,shc-gpt-4o,medalign,nursing_note,PROMPT1_ICL_entailment
132,217,16,14,2,0.875,11,8,3,0.7272727272727273,0.7943262411347517,shc-gpt-4o,medalign,nursing_note,PROMPT1_ICL_entailment
133,218,19,19,0,1.0,3,3,0,1.0,1.0,shc-gpt-4o,medalign,nursing_note,PROMPT1_ICL_entailment
134,219,9,8,1,0.8888888888888888,2,2,0,1.0,0.9411764705882352,shc-gpt-4o,medalign,nursing_note,PROMPT1_ICL_entailment
135,22,3,3,0,1.0,1,1,0,1.0,1.0,shc-gpt-4o,medalign,nursing_note,PROMPT1_ICL_entailment
136,220,11,9,2,0.8181818181818182,7,7,0,1.0,0.9,shc-gpt-4o,medalign,nursing_note,PROMPT1_ICL_entailment
137,221,32,30,2,0.9375,23,11,12,0.4782608695652174,0.6333973128598849,shc-gpt-4o,medalign,nursing_note,PROMPT1_ICL_entailment
138,222,6,6,0,1.0,4,4,0,1.0,1.0,shc-gpt-4o,medalign,nursing_note,PROMPT1_ICL_entailment
139,223,7,7,0,1.0,2,1,1,0.5,0.6666666666666666,shc-gpt-4o,medalign,nursing_note,PROMPT1_ICL_entailment
140,224,13,12,1,0.9230769230769232,4,3,1,0.75,0.8275862068965517,shc-gpt-4o,medalign,nursing_note,PROMPT1_ICL_entailment
141,225,10,10,0,1.0,2,2,0,1.0,1.0,shc-gpt-4o,medalign,nursing_note,PROMPT1_ICL_entailment
142,226,19,11,8,0.5789473684210527,5,4,1,0.8,0.6717557251908397,shc-gpt-4o,medalign,nursing_note,PROMPT1_ICL_entailment
143,227,4,3,1,0.75,1,1,0,1.0,0.8571428571428571,shc-gpt-4o,medalign,nursing_note,PROMPT1_ICL_entailment
144,228,31,29,2,0.935483870967742,18,15,3,0.8333333333333334,0.8814589665653495,shc-gpt-4o,medalign,nursing_note,PROMPT1_ICL_entailment
145,229,12,10,2,0.8333333333333334,7,6,1,0.8571428571428571,0.8450704225352113,shc-gpt-4o,medalign,nursing_note,PROMPT1_ICL_entailment
146,23,26,25,1,0.9615384615384616,21,12,9,0.5714285714285714,0.7168458781362007,shc-gpt-4o,medalign,nursing_note,PROMPT1_ICL_entailment
147,230,3,2,1,0.6666666666666666,1,1,0,1.0,0.8,shc-gpt-4o,medalign,nursing_note,PROMPT1_ICL_entailment
148,231,16,14,2,0.875,13,7,6,0.5384615384615384,0.6666666666666667,shc-gpt-4o,medalign,nursing_note,PROMPT1_ICL_entailment
149,232,13,12,1,0.9230769230769232,6,4,2,0.6666666666666666,0.7741935483870968,shc-gpt-4o,medalign,nursing_note,PROMPT1_ICL_entailment
150,233,6,3,3,0.5,4,1,3,0.25,0.3333333333333333,shc-gpt-4o,medalign,nursing_note,PROMPT1_ICL_entailment
151,234,9,9,0,1.0,2,2,0,1.0,1.0,shc-gpt-4o,medalign,nursing_note,PROMPT1_ICL_entailment
152,235,3,3,0,1.0,1,1,0,1.0,1.0,shc-gpt-4o,medalign,nursing_note,PROMPT1_ICL_entailment
153,236,16,16,0,1.0,14,12,2,0.8571428571428571,0.923076923076923,shc-gpt-4o,medalign,nursing_note,PROMPT1_ICL_entailment
154,237,12,11,1,0.9166666666666666,5,5,0,1.0,0.9565217391304348,shc-gpt-4o,medalign,nursing_note,PROMPT1_ICL_entailment
155,238,13,13,0,1.0,4,4,0,1.0,1.0,shc-gpt-4o,medalign,nursing_note,PROMPT1_ICL_entailment
156,239,12,12,0,1.0,4,4,0,1.0,1.0,shc-gpt-4o,medalign,nursing_note,PROMPT1_ICL_entailment
157,24,3,3,0,1.0,1,1,0,1.0,1.0,shc-gpt-4o,medalign,nursing_note,PROMPT1_ICL_entailment
158,240,4,2,2,0.5,2,1,1,0.5,0.5,shc-gpt-4o,medalign,nursing_note,PROMPT1_ICL_entailment
159,241,5,4,1,0.8,2,2,0,1.0,0.888888888888889,shc-gpt-4o,medalign,nursing_note,PROMPT1_ICL_entailment
160,242,23,20,3,0.8695652173913043,2,2,0,1.0,0.9302325581395348,shc-gpt-4o,medalign,nursing_note,PROMPT1_ICL_entailment
161,243,24,24,0,1.0,10,10,0,1.0,1.0,shc-gpt-4o,medalign,nursing_note,PROMPT1_ICL_entailment
162,244,4,4,0,1.0,1,1,0,1.0,1.0,shc-gpt-4o,medalign,nursing_note,PROMPT1_ICL_entailment
163,245,5,4,1,0.8,1,0,1,0.0,0.0,shc-gpt-4o,medalign,nursing_note,PROMPT1_ICL_entailment
164,246,5,5,0,1.0,1,1,0,1.0,1.0,shc-gpt-4o,medalign,nursing_note,PROMPT1_ICL_entailment
165,247,8,8,0,1.0,5,5,0,1.0,1.0,shc-gpt-4o,medalign,nursing_note,PROMPT1_ICL_entailment
166,248,3,3,0,1.0,1,1,0,1.0,1.0,shc-gpt-4o,medalign,nursing_note,PROMPT1_ICL_entailment
167,249,10,10,0,1.0,2,2,0,1.0,1.0,shc-gpt-4o,medalign,nursing_note,PROMPT1_ICL_entailment
168,25,64,59,5,0.921875,33,23,10,0.696969696969697,0.7937993565369992,shc-gpt-4o,medalign,nursing_note,PROMPT1_ICL_entailment
169,26,6,5,1,0.8333333333333334,1,1,0,1.0,0.9090909090909092,shc-gpt-4o,medalign,nursing_note,PROMPT1_ICL_entailment
170,27,15,15,0,1.0,2,2,0,1.0,1.0,shc-gpt-4o,medalign,nursing_note,PROMPT1_ICL_entailment
171,28,16,9,7,0.5625,4,4,0,1.0,0.72,shc-gpt-4o,medalign,nursing_note,PROMPT1_ICL_entailment
172,29,7,7,0,1.0,3,3,0,1.0,1.0,shc-gpt-4o,medalign,nursing_note,PROMPT1_ICL_entailment
173,3,6,6,0,1.0,2,2,0,1.0,1.0,shc-gpt-4o,medalign,nursing_note,PROMPT1_ICL_entailment
174,30,6,5,1,0.8333333333333334,1,1,0,1.0,0.9090909090909092,shc-gpt-4o,medalign,nursing_note,PROMPT1_ICL_entailment
175,31,2,1,1,0.5,1,1,0,1.0,0.6666666666666666,shc-gpt-4o,medalign,nursing_note,PROMPT1_ICL_entailment
176,32,5,5,0,1.0,2,2,0,1.0,1.0,shc-gpt-4o,medalign,nursing_note,PROMPT1_ICL_entailment
177,33,15,14,1,0.9333333333333332,5,5,0,1.0,0.9655172413793104,shc-gpt-4o,medalign,nursing_note,PROMPT1_ICL_entailment
178,34,16,14,2,0.875,4,2,2,0.5,0.6363636363636364,shc-gpt-4o,medalign,nursing_note,PROMPT1_ICL_entailment
179,35,9,9,0,1.0,4,3,1,0.75,0.8571428571428571,shc-gpt-4o,medalign,nursing_note,PROMPT1_ICL_entailment
180,36,24,17,7,0.7083333333333334,5,3,2,0.6,0.6496815286624203,shc-gpt-4o,medalign,nursing_note,PROMPT1_ICL_entailment
181,37,9,8,1,0.8888888888888888,3,3,0,1.0,0.9411764705882352,shc-gpt-4o,medalign,nursing_note,PROMPT1_ICL_entailment
182,38,20,19,1,0.95,5,2,3,0.4,0.5629629629629629,shc-gpt-4o,medalign,nursing_note,PROMPT1_ICL_entailment
183,39,4,4,0,1.0,1,1,0,1.0,1.0,shc-gpt-4o,medalign,nursing_note,PROMPT1_ICL_entailment
184,4,5,2,3,0.4,3,3,0,1.0,0.5714285714285715,shc-gpt-4o,medalign,nursing_note,PROMPT1_ICL_entailment
185,40,16,14,2,0.875,8,8,0,1.0,0.9333333333333332,shc-gpt-4o,medalign,nursing_note,PROMPT1_ICL_entailment
186,41,4,3,1,0.75,1,1,0,1.0,0.8571428571428571,shc-gpt-4o,medalign,nursing_note,PROMPT1_ICL_entailment
187,42,9,8,1,0.8888888888888888,8,5,3,0.625,0.7339449541284404,shc-gpt-4o,medalign,nursing_note,PROMPT1_ICL_entailment
188,43,5,5,0,1.0,2,2,0,1.0,1.0,shc-gpt-4o,medalign,nursing_note,PROMPT1_ICL_entailment
189,44,5,5,0,1.0,1,1,0,1.0,1.0,shc-gpt-4o,medalign,nursing_note,PROMPT1_ICL_entailment
190,45,2,1,1,0.5,1,1,0,1.0,0.6666666666666666,shc-gpt-4o,medalign,nursing_note,PROMPT1_ICL_entailment
191,46,10,10,0,1.0,5,4,1,0.8,0.888888888888889,shc-gpt-4o,medalign,nursing_note,PROMPT1_ICL_entailment
192,47,25,25,0,1.0,20,20,0,1.0,1.0,shc-gpt-4o,medalign,nursing_note,PROMPT1_ICL_entailment
193,48,6,6,0,1.0,2,2,0,1.0,1.0,shc-gpt-4o,medalign,nursing_note,PROMPT1_ICL_entailment
194,49,5,4,1,0.8,2,1,1,0.5,0.6153846153846154,shc-gpt-4o,medalign,nursing_note,PROMPT1_ICL_entailment
195,5,15,15,0,1.0,5,5,0,1.0,1.0,shc-gpt-4o,medalign,nursing_note,PROMPT1_ICL_entailment
196,50,4,4,0,1.0,1,1,0,1.0,1.0,shc-gpt-4o,medalign,nursing_note,PROMPT1_ICL_entailment
197,51,5,5,0,1.0,2,2,0,1.0,1.0,shc-gpt-4o,medalign,nursing_note,PROMPT1_ICL_entailment
198,52,7,7,0,1.0,4,4,0,1.0,1.0,shc-gpt-4o,medalign,nursing_note,PROMPT1_ICL_entailment
199,53,5,5,0,1.0,1,1,0,1.0,1.0,shc-gpt-4o,medalign,nursing_note,PROMPT1_ICL_entailment
200,54,10,9,1,0.9,7,6,1,0.8571428571428571,0.8780487804878048,shc-gpt-4o,medalign,nursing_note,PROMPT1_ICL_entailment
201,55,9,8,1,0.8888888888888888,2,1,1,0.5,0.64,shc-gpt-4o,medalign,nursing_note,PROMPT1_ICL_entailment
202,56,8,7,1,0.875,3,2,1,0.6666666666666666,0.7567567567567567,shc-gpt-4o,medalign,nursing_note,PROMPT1_ICL_entailment
203,57,13,6,7,0.4615384615384615,4,2,2,0.5,0.48,shc-gpt-4o,medalign,nursing_note,PROMPT1_ICL_entailment
204,58,5,5,0,1.0,1,1,0,1.0,1.0,shc-gpt-4o,medalign,nursing_note,PROMPT1_ICL_entailment
205,59,4,4,0,1.0,1,1,0,1.0,1.0,shc-gpt-4o,medalign,nursing_note,PROMPT1_ICL_entailment
206,6,7,6,1,0.8571428571428571,3,3,0,1.0,0.923076923076923,shc-gpt-4o,medalign,nursing_note,PROMPT1_ICL_entailment
207,60,11,10,1,0.9090909090909092,9,9,0,1.0,0.9523809523809524,shc-gpt-4o,medalign,nursing_note,PROMPT1_ICL_entailment
208,61,4,4,0,1.0,1,1,0,1.0,1.0,shc-gpt-4o,medalign,nursing_note,PROMPT1_ICL_entailment
209,62,23,23,0,1.0,5,5,0,1.0,1.0,shc-gpt-4o,medalign,nursing_note,PROMPT1_ICL_entailment
210,63,13,11,2,0.8461538461538461,7,5,2,0.7142857142857143,0.7746478873239436,shc-gpt-4o,medalign,nursing_note,PROMPT1_ICL_entailment
211,64,3,3,0,1.0,1,1,0,1.0,1.0,shc-gpt-4o,medalign,nursing_note,PROMPT1_ICL_entailment
212,65,8,7,1,0.875,2,2,0,1.0,0.9333333333333332,shc-gpt-4o,medalign,nursing_note,PROMPT1_ICL_entailment
213,66,7,7,0,1.0,4,4,0,1.0,1.0,shc-gpt-4o,medalign,nursing_note,PROMPT1_ICL_entailment
214,67,6,6,0,1.0,4,3,1,0.75,0.8571428571428571,shc-gpt-4o,medalign,nursing_note,PROMPT1_ICL_entailment
215,68,6,5,1,0.8333333333333334,1,1,0,1.0,0.9090909090909092,shc-gpt-4o,medalign,nursing_note,PROMPT1_ICL_entailment
216,69,11,11,0,1.0,2,2,0,1.0,1.0,shc-gpt-4o,medalign,nursing_note,PROMPT1_ICL_entailment
217,7,8,8,0,1.0,1,1,0,1.0,1.0,shc-gpt-4o,medalign,nursing_note,PROMPT1_ICL_entailment
218,70,11,11,0,1.0,1,1,0,1.0,1.0,shc-gpt-4o,medalign,nursing_note,PROMPT1_ICL_entailment
219,71,16,15,1,0.9375,1,1,0,1.0,0.967741935483871,shc-gpt-4o,medalign,nursing_note,PROMPT1_ICL_entailment
220,72,4,4,0,1.0,1,1,0,1.0,1.0,shc-gpt-4o,medalign,nursing_note,PROMPT1_ICL_entailment
221,73,5,5,0,1.0,2,2,0,1.0,1.0,shc-gpt-4o,medalign,nursing_note,PROMPT1_ICL_entailment
222,74,14,12,2,0.8571428571428571,5,4,1,0.8,0.8275862068965518,shc-gpt-4o,medalign,nursing_note,PROMPT1_ICL_entailment
223,75,2,1,1,0.5,1,1,0,1.0,0.6666666666666666,shc-gpt-4o,medalign,nursing_note,PROMPT1_ICL_entailment
224,76,14,13,1,0.9285714285714286,5,5,0,1.0,0.962962962962963,shc-gpt-4o,medalign,nursing_note,PROMPT1_ICL_entailment
225,77,7,7,0,1.0,3,3,0,1.0,1.0,shc-gpt-4o,medalign,nursing_note,PROMPT1_ICL_entailment
226,78,10,9,1,0.9,3,3,0,1.0,0.9473684210526316,shc-gpt-4o,medalign,nursing_note,PROMPT1_ICL_entailment
227,79,16,15,1,0.9375,8,8,0,1.0,0.967741935483871,shc-gpt-4o,medalign,nursing_note,PROMPT1_ICL_entailment
228,8,18,15,3,0.8333333333333334,8,7,1,0.875,0.8536585365853658,shc-gpt-4o,medalign,nursing_note,PROMPT1_ICL_entailment
229,80,12,10,2,0.8333333333333334,10,9,1,0.9,0.8653846153846153,shc-gpt-4o,medalign,nursing_note,PROMPT1_ICL_entailment
230,81,4,3,1,0.75,1,1,0,1.0,0.8571428571428571,shc-gpt-4o,medalign,nursing_note,PROMPT1_ICL_entailment
231,82,4,4,0,1.0,3,3,0,1.0,1.0,shc-gpt-4o,medalign,nursing_note,PROMPT1_ICL_entailment
232,83,7,6,1,0.8571428571428571,3,1,2,0.3333333333333333,0.48,shc-gpt-4o,medalign,nursing_note,PROMPT1_ICL_entailment
233,84,11,5,6,0.4545454545454545,2,1,1,0.5,0.4761904761904761,shc-gpt-4o,medalign,nursing_note,PROMPT1_ICL_entailment
234,85,15,15,0,1.0,8,8,0,1.0,1.0,shc-gpt-4o,medalign,nursing_note,PROMPT1_ICL_entailment
235,86,4,4,0,1.0,3,3,0,1.0,1.0,shc-gpt-4o,medalign,nursing_note,PROMPT1_ICL_entailment
236,87,5,4,1,0.8,2,2,0,1.0,0.888888888888889,shc-gpt-4o,medalign,nursing_note,PROMPT1_ICL_entailment
237,88,16,15,1,0.9375,7,7,0,1.0,0.967741935483871,shc-gpt-4o,medalign,nursing_note,PROMPT1_ICL_entailment
238,89,9,9,0,1.0,6,6,0,1.0,1.0,shc-gpt-4o,medalign,nursing_note,PROMPT1_ICL_entailment
239,9,8,8,0,1.0,2,2,0,1.0,1.0,shc-gpt-4o,medalign,nursing_note,PROMPT1_ICL_entailment
240,90,6,6,0,1.0,1,1,0,1.0,1.0,shc-gpt-4o,medalign,nursing_note,PROMPT1_ICL_entailment
241,91,5,5,0,1.0,1,1,0,1.0,1.0,shc-gpt-4o,medalign,nursing_note,PROMPT1_ICL_entailment
242,92,7,7,0,1.0,4,2,2,0.5,0.6666666666666666,shc-gpt-4o,medalign,nursing_note,PROMPT1_ICL_entailment
243,93,4,4,0,1.0,1,1,0,1.0,1.0,shc-gpt-4o,medalign,nursing_note,PROMPT1_ICL_entailment
244,94,4,4,0,1.0,2,1,1,0.5,0.6666666666666666,shc-gpt-4o,medalign,nursing_note,PROMPT1_ICL_entailment
245,95,3,3,0,1.0,1,1,0,1.0,1.0,shc-gpt-4o,medalign,nursing_note,PROMPT1_ICL_entailment
246,96,3,2,1,0.6666666666666666,1,1,0,1.0,0.8,shc-gpt-4o,medalign,nursing_note,PROMPT1_ICL_entailment
247,97,7,7,0,1.0,2,2,0,1.0,1.0,shc-gpt-4o,medalign,nursing_note,PROMPT1_ICL_entailment
248,98,13,12,1,0.9230769230769232,5,5,0,1.0,0.96,shc-gpt-4o,medalign,nursing_note,PROMPT1_ICL_entailment
249,99,14,14,0,1.0,7,4,3,0.5714285714285714,0.7272727272727273,shc-gpt-4o,medalign,nursing_note,PROMPT1_ICL_entailment
0,0,12,12,0,1.0,6,5,1,0.8333333333333334,0.9090909090909092,shc-gpt-4o,medalign,nursing_note,PROMPT2_ICL_entailment
1,1,13,13,0,1.0,1,1,0,1.0,1.0,shc-gpt-4o,medalign,nursing_note,PROMPT2_ICL_entailment
2,10,9,9,0,1.0,5,4,1,0.8,0.888888888888889,shc-gpt-4o,medalign,nursing_note,PROMPT2_ICL_entailment
3,100,14,13,1,0.9285714285714286,10,8,2,0.8,0.859504132231405,shc-gpt-4o,medalign,nursing_note,PROMPT2_ICL_entailment
4,101,7,7,0,1.0,1,1,0,1.0,1.0,shc-gpt-4o,medalign,nursing_note,PROMPT2_ICL_entailment
5,102,14,14,0,1.0,4,4,0,1.0,1.0,shc-gpt-4o,medalign,nursing_note,PROMPT2_ICL_entailment
6,103,4,4,0,1.0,2,2,0,1.0,1.0,shc-gpt-4o,medalign,nursing_note,PROMPT2_ICL_entailment
7,104,19,19,0,1.0,15,13,2,0.8666666666666667,0.9285714285714286,shc-gpt-4o,medalign,nursing_note,PROMPT2_ICL_entailment
8,105,3,2,1,0.6666666666666666,1,1,0,1.0,0.8,shc-gpt-4o,medalign,nursing_note,PROMPT2_ICL_entailment
9,106,6,6,0,1.0,1,1,0,1.0,1.0,shc-gpt-4o,medalign,nursing_note,PROMPT2_ICL_entailment
10,107,6,6,0,1.0,4,3,1,0.75,0.8571428571428571,shc-gpt-4o,medalign,nursing_note,PROMPT2_ICL_entailment
11,108,4,4,0,1.0,2,2,0,1.0,1.0,shc-gpt-4o,medalign,nursing_note,PROMPT2_ICL_entailment
12,109,13,12,1,0.9230769230769232,5,5,0,1.0,0.96,shc-gpt-4o,medalign,nursing_note,PROMPT2_ICL_entailment
13,11,2,2,0,1.0,1,1,0,1.0,1.0,shc-gpt-4o,medalign,nursing_note,PROMPT2_ICL_entailment
14,110,19,13,6,0.6842105263157895,6,4,2,0.6666666666666666,0.6753246753246753,shc-gpt-4o,medalign,nursing_note,PROMPT2_ICL_entailment
15,111,3,3,0,1.0,1,1,0,1.0,1.0,shc-gpt-4o,medalign,nursing_note,PROMPT2_ICL_entailment
16,112,9,9,0,1.0,2,2,0,1.0,1.0,shc-gpt-4o,medalign,nursing_note,PROMPT2_ICL_entailment
17,113,2,2,0,1.0,1,1,0,1.0,1.0,shc-gpt-4o,medalign,nursing_note,PROMPT2_ICL_entailment
18,114,4,4,0,1.0,1,1,0,1.0,1.0,shc-gpt-4o,medalign,nursing_note,PROMPT2_ICL_entailment
19,115,14,14,0,1.0,7,4,3,0.5714285714285714,0.7272727272727273,shc-gpt-4o,medalign,nursing_note,PROMPT2_ICL_entailment
20,116,9,8,1,0.8888888888888888,5,4,1,0.8,0.8421052631578948,shc-gpt-4o,medalign,nursing_note,PROMPT2_ICL_entailment
21,117,16,14,2,0.875,13,9,4,0.6923076923076923,0.7730061349693251,shc-gpt-4o,medalign,nursing_note,PROMPT2_ICL_entailment
22,118,5,5,0,1.0,2,2,0,1.0,1.0,shc-gpt-4o,medalign,nursing_note,PROMPT2_ICL_entailment
23,119,4,4,0,1.0,2,2,0,1.0,1.0,shc-gpt-4o,medalign,nursing_note,PROMPT2_ICL_entailment
24,12,3,3,0,1.0,1,1,0,1.0,1.0,shc-gpt-4o,medalign,nursing_note,PROMPT2_ICL_entailment
25,120,13,13,0,1.0,7,6,1,0.8571428571428571,0.923076923076923,shc-gpt-4o,medalign,nursing_note,PROMPT2_ICL_entailment
26,121,2,2,0,1.0,1,1,0,1.0,1.0,shc-gpt-4o,medalign,nursing_note,PROMPT2_ICL_entailment
27,122,2,2,0,1.0,1,1,0,1.0,1.0,shc-gpt-4o,medalign,nursing_note,PROMPT2_ICL_entailment
28,123,4,4,0,1.0,4,3,1,0.75,0.8571428571428571,shc-gpt-4o,medalign,nursing_note,PROMPT2_ICL_entailment
29,124,24,21,3,0.875,14,14,0,1.0,0.9333333333333332,shc-gpt-4o,medalign,nursing_note,PROMPT2_ICL_entailment
30,125,17,17,0,1.0,9,9,0,1.0,1.0,shc-gpt-4o,medalign,nursing_note,PROMPT2_ICL_entailment
31,126,4,3,1,0.75,2,2,0,1.0,0.8571428571428571,shc-gpt-4o,medalign,nursing_note,PROMPT2_ICL_entailment
32,127,2,2,0,1.0,1,1,0,1.0,1.0,shc-gpt-4o,medalign,nursing_note,PROMPT2_ICL_entailment
33,128,5,5,0,1.0,2,2,0,1.0,1.0,shc-gpt-4o,medalign,nursing_note,PROMPT2_ICL_entailment
34,129,36,33,3,0.9166666666666666,20,20,0,1.0,0.9565217391304348,shc-gpt-4o,medalign,nursing_note,PROMPT2_ICL_entailment
35,13,8,7,1,0.875,5,3,2,0.6,0.711864406779661,shc-gpt-4o,medalign,nursing_note,PROMPT2_ICL_entailment
36,130,6,6,0,1.0,2,2,0,1.0,1.0,shc-gpt-4o,medalign,nursing_note,PROMPT2_ICL_entailment
37,131,3,3,0,1.0,1,1,0,1.0,1.0,shc-gpt-4o,medalign,nursing_note,PROMPT2_ICL_entailment
38,132,7,7,0,1.0,2,2,0,1.0,1.0,shc-gpt-4o,medalign,nursing_note,PROMPT2_ICL_entailment
39,133,19,19,0,1.0,14,7,7,0.5,0.6666666666666666,shc-gpt-4o,medalign,nursing_note,PROMPT2_ICL_entailment
40,134,7,6,1,0.8571428571428571,3,3,0,1.0,0.923076923076923,shc-gpt-4o,medalign,nursing_note,PROMPT2_ICL_entailment
41,135,8,7,1,0.875,2,2,0,1.0,0.9333333333333332,shc-gpt-4o,medalign,nursing_note,PROMPT2_ICL_entailment
42,136,91,47,44,0.5164835164835165,51,40,11,0.7843137254901961,0.6228259069074044,shc-gpt-4o,medalign,nursing_note,PROMPT2_ICL_entailment
43,137,14,14,0,1.0,6,6,0,1.0,1.0,shc-gpt-4o,medalign,nursing_note,PROMPT2_ICL_entailment
44,138,2,1,1,0.5,1,1,0,1.0,0.6666666666666666,shc-gpt-4o,medalign,nursing_note,PROMPT2_ICL_entailment
45,139,4,4,0,1.0,1,1,0,1.0,1.0,shc-gpt-4o,medalign,nursing_note,PROMPT2_ICL_entailment
46,14,3,3,0,1.0,1,1,0,1.0,1.0,shc-gpt-4o,medalign,nursing_note,PROMPT2_ICL_entailment
47,140,5,5,0,1.0,3,3,0,1.0,1.0,shc-gpt-4o,medalign,nursing_note,PROMPT2_ICL_entailment
48,141,3,3,0,1.0,1,1,0,1.0,1.0,shc-gpt-4o,medalign,nursing_note,PROMPT2_ICL_entailment
49,142,3,3,0,1.0,1,1,0,1.0,1.0,shc-gpt-4o,medalign,nursing_note,PROMPT2_ICL_entailment
50,143,2,1,1,0.5,1,1,0,1.0,0.6666666666666666,shc-gpt-4o,medalign,nursing_note,PROMPT2_ICL_entailment
51,144,3,2,1,0.6666666666666666,1,1,0,1.0,0.8,shc-gpt-4o,medalign,nursing_note,PROMPT2_ICL_entailment
52,145,6,6,0,1.0,4,4,0,1.0,1.0,shc-gpt-4o,medalign,nursing_note,PROMPT2_ICL_entailment
53,146,23,22,1,0.9565217391304348,3,3,0,1.0,0.9777777777777776,shc-gpt-4o,medalign,nursing_note,PROMPT2_ICL_entailment
54,147,8,8,0,1.0,6,4,2,0.6666666666666666,0.8,shc-gpt-4o,medalign,nursing_note,PROMPT2_ICL_entailment
55,148,27,26,1,0.9629629629629628,7,7,0,1.0,0.981132075471698,shc-gpt-4o,medalign,nursing_note,PROMPT2_ICL_entailment
56,149,10,9,1,0.9,1,0,1,0.0,0.0,shc-gpt-4o,medalign,nursing_note,PROMPT2_ICL_entailment
57,15,5,5,0,1.0,1,1,0,1.0,1.0,shc-gpt-4o,medalign,nursing_note,PROMPT2_ICL_entailment
58,150,5,4,1,0.8,1,1,0,1.0,0.888888888888889,shc-gpt-4o,medalign,nursing_note,PROMPT2_ICL_entailment
59,151,16,16,0,1.0,8,8,0,1.0,1.0,shc-gpt-4o,medalign,nursing_note,PROMPT2_ICL_entailment
60,152,7,7,0,1.0,4,4,0,1.0,1.0,shc-gpt-4o,medalign,nursing_note,PROMPT2_ICL_entailment
61,153,15,15,0,1.0,14,10,4,0.7142857142857143,0.8333333333333333,shc-gpt-4o,medalign,nursing_note,PROMPT2_ICL_entailment
62,154,3,3,0,1.0,1,1,0,1.0,1.0,shc-gpt-4o,medalign,nursing_note,PROMPT2_ICL_entailment
63,155,29,29,0,1.0,14,11,3,0.7857142857142857,0.88,shc-gpt-4o,medalign,nursing_note,PROMPT2_ICL_entailment
64,156,10,10,0,1.0,1,0,1,0.0,0.0,shc-gpt-4o,medalign,nursing_note,PROMPT2_ICL_entailment
65,157,7,7,0,1.0,3,3,0,1.0,1.0,shc-gpt-4o,medalign,nursing_note,PROMPT2_ICL_entailment
66,158,10,10,0,1.0,1,1,0,1.0,1.0,shc-gpt-4o,medalign,nursing_note,PROMPT2_ICL_entailment
67,159,6,6,0,1.0,3,3,0,1.0,1.0,shc-gpt-4o,medalign,nursing_note,PROMPT2_ICL_entailment
68,16,17,17,0,1.0,3,2,1,0.6666666666666666,0.8,shc-gpt-4o,medalign,nursing_note,PROMPT2_ICL_entailment
69,160,4,4,0,1.0,1,1,0,1.0,1.0,shc-gpt-4o,medalign,nursing_note,PROMPT2_ICL_entailment
70,161,5,5,0,1.0,1,1,0,1.0,1.0,shc-gpt-4o,medalign,nursing_note,PROMPT2_ICL_entailment
71,162,12,11,1,0.9166666666666666,8,6,2,0.75,0.8250000000000001,shc-gpt-4o,medalign,nursing_note,PROMPT2_ICL_entailment
72,163,7,7,0,1.0,3,3,0,1.0,1.0,shc-gpt-4o,medalign,nursing_note,PROMPT2_ICL_entailment
73,164,9,9,0,1.0,2,2,0,1.0,1.0,shc-gpt-4o,medalign,nursing_note,PROMPT2_ICL_entailment
74,165,10,9,1,0.9,4,4,0,1.0,0.9473684210526316,shc-gpt-4o,medalign,nursing_note,PROMPT2_ICL_entailment
75,166,16,15,1,0.9375,5,5,0,1.0,0.967741935483871,shc-gpt-4o,medalign,nursing_note,PROMPT2_ICL_entailment
76,167,13,13,0,1.0,2,2,0,1.0,1.0,shc-gpt-4o,medalign,nursing_note,PROMPT2_ICL_entailment
77,168,8,8,0,1.0,3,3,0,1.0,1.0,shc-gpt-4o,medalign,nursing_note,PROMPT2_ICL_entailment
78,169,14,14,0,1.0,9,6,3,0.6666666666666666,0.8,shc-gpt-4o,medalign,nursing_note,PROMPT2_ICL_entailment
79,17,6,5,1,0.8333333333333334,1,1,0,1.0,0.9090909090909092,shc-gpt-4o,medalign,nursing_note,PROMPT2_ICL_entailment
80,170,5,5,0,1.0,1,0,1,0.0,0.0,shc-gpt-4o,medalign,nursing_note,PROMPT2_ICL_entailment
81,171,11,8,3,0.7272727272727273,7,4,3,0.5714285714285714,0.64,shc-gpt-4o,medalign,nursing_note,PROMPT2_ICL_entailment
82,172,13,11,2,0.8461538461538461,12,5,7,0.4166666666666667,0.5583756345177665,shc-gpt-4o,medalign,nursing_note,PROMPT2_ICL_entailment
83,173,11,11,0,1.0,1,1,0,1.0,1.0,shc-gpt-4o,medalign,nursing_note,PROMPT2_ICL_entailment
84,174,5,4,1,0.8,1,1,0,1.0,0.888888888888889,shc-gpt-4o,medalign,nursing_note,PROMPT2_ICL_entailment
85,175,2,2,0,1.0,2,2,0,1.0,1.0,shc-gpt-4o,medalign,nursing_note,PROMPT2_ICL_entailment
86,176,17,14,3,0.8235294117647058,3,3,0,1.0,0.9032258064516128,shc-gpt-4o,medalign,nursing_note,PROMPT2_ICL_entailment
87,177,10,10,0,1.0,8,5,3,0.625,0.7692307692307693,shc-gpt-4o,medalign,nursing_note,PROMPT2_ICL_entailment
88,178,12,11,1,0.9166666666666666,10,8,2,0.8,0.854368932038835,shc-gpt-4o,medalign,nursing_note,PROMPT2_ICL_entailment
89,179,13,13,0,1.0,2,2,0,1.0,1.0,shc-gpt-4o,medalign,nursing_note,PROMPT2_ICL_entailment
90,18,24,18,6,0.75,3,3,0,1.0,0.8571428571428571,shc-gpt-4o,medalign,nursing_note,PROMPT2_ICL_entailment
91,180,12,11,1,0.9166666666666666,4,3,1,0.75,0.8250000000000001,shc-gpt-4o,medalign,nursing_note,PROMPT2_ICL_entailment
92,181,11,11,0,1.0,7,7,0,1.0,1.0,shc-gpt-4o,medalign,nursing_note,PROMPT2_ICL_entailment
93,182,4,4,0,1.0,2,2,0,1.0,1.0,shc-gpt-4o,medalign,nursing_note,PROMPT2_ICL_entailment
94,183,9,9,0,1.0,6,6,0,1.0,1.0,shc-gpt-4o,medalign,nursing_note,PROMPT2_ICL_entailment
95,184,11,10,1,0.9090909090909092,11,10,1,0.9090909090909092,0.9090909090909092,shc-gpt-4o,medalign,nursing_note,PROMPT2_ICL_entailment
96,185,5,5,0,1.0,3,3,0,1.0,1.0,shc-gpt-4o,medalign,nursing_note,PROMPT2_ICL_entailment
97,186,7,6,1,0.8571428571428571,3,3,0,1.0,0.923076923076923,shc-gpt-4o,medalign,nursing_note,PROMPT2_ICL_entailment
98,187,3,2,1,0.6666666666666666,1,1,0,1.0,0.8,shc-gpt-4o,medalign,nursing_note,PROMPT2_ICL_entailment
99,188,4,4,0,1.0,3,3,0,1.0,1.0,shc-gpt-4o,medalign,nursing_note,PROMPT2_ICL_entailment
100,189,15,14,1,0.9333333333333332,10,6,4,0.6,0.7304347826086957,shc-gpt-4o,medalign,nursing_note,PROMPT2_ICL_entailment
101,19,17,17,0,1.0,7,7,0,1.0,1.0,shc-gpt-4o,medalign,nursing_note,PROMPT2_ICL_entailment
102,190,5,4,1,0.8,2,2,0,1.0,0.888888888888889,shc-gpt-4o,medalign,nursing_note,PROMPT2_ICL_entailment
103,191,17,17,0,1.0,5,3,2,0.6,0.7499999999999999,shc-gpt-4o,medalign,nursing_note,PROMPT2_ICL_entailment
104,192,4,4,0,1.0,1,1,0,1.0,1.0,shc-gpt-4o,medalign,nursing_note,PROMPT2_ICL_entailment
105,193,6,6,0,1.0,3,3,0,1.0,1.0,shc-gpt-4o,medalign,nursing_note,PROMPT2_ICL_entailment
106,194,4,4,0,1.0,2,1,1,0.5,0.6666666666666666,shc-gpt-4o,medalign,nursing_note,PROMPT2_ICL_entailment
107,195,14,10,4,0.7142857142857143,10,6,4,0.6,0.6521739130434783,shc-gpt-4o,medalign,nursing_note,PROMPT2_ICL_entailment
108,196,5,5,0,1.0,1,1,0,1.0,1.0,shc-gpt-4o,medalign,nursing_note,PROMPT2_ICL_entailment
109,197,3,3,0,1.0,1,0,1,0.0,0.0,shc-gpt-4o,medalign,nursing_note,PROMPT2_ICL_entailment
110,198,19,18,1,0.9473684210526316,8,5,3,0.625,0.7531380753138075,shc-gpt-4o,medalign,nursing_note,PROMPT2_ICL_entailment
111,199,21,17,4,0.8095238095238095,7,7,0,1.0,0.8947368421052632,shc-gpt-4o,medalign,nursing_note,PROMPT2_ICL_entailment
112,2,19,8,11,0.4210526315789473,5,5,0,1.0,0.5925925925925926,shc-gpt-4o,medalign,nursing_note,PROMPT2_ICL_entailment
113,20,7,5,2,0.7142857142857143,2,1,1,0.5,0.588235294117647,shc-gpt-4o,medalign,nursing_note,PROMPT2_ICL_entailment
114,200,4,4,0,1.0,3,3,0,1.0,1.0,shc-gpt-4o,medalign,nursing_note,PROMPT2_ICL_entailment
115,201,4,4,0,1.0,1,1,0,1.0,1.0,shc-gpt-4o,medalign,nursing_note,PROMPT2_ICL_entailment
116,202,7,6,1,0.8571428571428571,1,1,0,1.0,0.923076923076923,shc-gpt-4o,medalign,nursing_note,PROMPT2_ICL_entailment
117,203,5,5,0,1.0,1,1,0,1.0,1.0,shc-gpt-4o,medalign,nursing_note,PROMPT2_ICL_entailment
118,204,22,18,4,0.8181818181818182,9,7,2,0.7777777777777778,0.7974683544303799,shc-gpt-4o,medalign,nursing_note,PROMPT2_ICL_entailment
119,205,29,18,11,0.6206896551724138,8,4,4,0.5,0.5538461538461539,shc-gpt-4o,medalign,nursing_note,PROMPT2_ICL_entailment
120,206,8,7,1,0.875,4,4,0,1.0,0.9333333333333332,shc-gpt-4o,medalign,nursing_note,PROMPT2_ICL_entailment
121,207,15,14,1,0.9333333333333332,6,6,0,1.0,0.9655172413793104,shc-gpt-4o,medalign,nursing_note,PROMPT2_ICL_entailment
122,208,15,13,2,0.8666666666666667,10,7,3,0.7,0.774468085106383,shc-gpt-4o,medalign,nursing_note,PROMPT2_ICL_entailment
123,209,8,8,0,1.0,1,1,0,1.0,1.0,shc-gpt-4o,medalign,nursing_note,PROMPT2_ICL_entailment
124,21,5,5,0,1.0,1,1,0,1.0,1.0,shc-gpt-4o,medalign,nursing_note,PROMPT2_ICL_entailment
125,210,6,5,1,0.8333333333333334,2,1,1,0.5,0.625,shc-gpt-4o,medalign,nursing_note,PROMPT2_ICL_entailment
126,211,4,4,0,1.0,2,2,0,1.0,1.0,shc-gpt-4o,medalign,nursing_note,PROMPT2_ICL_entailment
127,212,7,7,0,1.0,3,3,0,1.0,1.0,shc-gpt-4o,medalign,nursing_note,PROMPT2_ICL_entailment
128,213,15,15,0,1.0,8,8,0,1.0,1.0,shc-gpt-4o,medalign,nursing_note,PROMPT2_ICL_entailment
129,214,5,5,0,1.0,2,2,0,1.0,1.0,shc-gpt-4o,medalign,nursing_note,PROMPT2_ICL_entailment
130,215,3,3,0,1.0,1,1,0,1.0,1.0,shc-gpt-4o,medalign,nursing_note,PROMPT2_ICL_entailment
131,216,6,6,0,1.0,3,3,0,1.0,1.0,shc-gpt-4o,medalign,nursing_note,PROMPT2_ICL_entailment
132,217,17,14,3,0.8235294117647058,11,7,4,0.6363636363636364,0.717948717948718,shc-gpt-4o,medalign,nursing_note,PROMPT2_ICL_entailment
133,218,23,23,0,1.0,3,3,0,1.0,1.0,shc-gpt-4o,medalign,nursing_note,PROMPT2_ICL_entailment
134,219,13,12,1,0.9230769230769232,2,2,0,1.0,0.96,shc-gpt-4o,medalign,nursing_note,PROMPT2_ICL_entailment
135,22,3,3,0,1.0,1,1,0,1.0,1.0,shc-gpt-4o,medalign,nursing_note,PROMPT2_ICL_entailment
136,220,10,9,1,0.9,7,7,0,1.0,0.9473684210526316,shc-gpt-4o,medalign,nursing_note,PROMPT2_ICL_entailment
137,221,31,30,1,0.967741935483871,23,14,9,0.6086956521739131,0.7473309608540926,shc-gpt-4o,medalign,nursing_note,PROMPT2_ICL_entailment
138,222,8,8,0,1.0,4,4,0,1.0,1.0,shc-gpt-4o,medalign,nursing_note,PROMPT2_ICL_entailment
139,223,6,6,0,1.0,2,1,1,0.5,0.6666666666666666,shc-gpt-4o,medalign,nursing_note,PROMPT2_ICL_entailment
140,224,16,13,3,0.8125,4,3,1,0.75,0.78,shc-gpt-4o,medalign,nursing_note,PROMPT2_ICL_entailment
141,225,9,9,0,1.0,2,2,0,1.0,1.0,shc-gpt-4o,medalign,nursing_note,PROMPT2_ICL_entailment
142,226,20,12,8,0.6,5,4,1,0.8,0.6857142857142857,shc-gpt-4o,medalign,nursing_note,PROMPT2_ICL_entailment
143,227,3,3,0,1.0,1,1,0,1.0,1.0,shc-gpt-4o,medalign,nursing_note,PROMPT2_ICL_entailment
144,228,38,36,2,0.9473684210526316,18,17,1,0.9444444444444444,0.945904173106646,shc-gpt-4o,medalign,nursing_note,PROMPT2_ICL_entailment
145,229,19,17,2,0.8947368421052632,7,6,1,0.8571428571428571,0.8755364806866952,shc-gpt-4o,medalign,nursing_note,PROMPT2_ICL_entailment
146,23,38,33,5,0.868421052631579,21,11,10,0.5238095238095238,0.6534653465346535,shc-gpt-4o,medalign,nursing_note,PROMPT2_ICL_entailment
147,230,2,2,0,1.0,1,1,0,1.0,1.0,shc-gpt-4o,medalign,nursing_note,PROMPT2_ICL_entailment
148,231,13,12,1,0.9230769230769232,13,8,5,0.6153846153846154,0.7384615384615384,shc-gpt-4o,medalign,nursing_note,PROMPT2_ICL_entailment
149,232,11,11,0,1.0,6,3,3,0.5,0.6666666666666666,shc-gpt-4o,medalign,nursing_note,PROMPT2_ICL_entailment
150,233,5,3,2,0.6,4,2,2,0.5,0.5454545454545454,shc-gpt-4o,medalign,nursing_note,PROMPT2_ICL_entailment
151,234,10,10,0,1.0,2,2,0,1.0,1.0,shc-gpt-4o,medalign,nursing_note,PROMPT2_ICL_entailment
152,235,4,4,0,1.0,1,1,0,1.0,1.0,shc-gpt-4o,medalign,nursing_note,PROMPT2_ICL_entailment
153,236,14,14,0,1.0,14,9,5,0.6428571428571429,0.782608695652174,shc-gpt-4o,medalign,nursing_note,PROMPT2_ICL_entailment
154,237,13,10,3,0.7692307692307693,5,4,1,0.8,0.7843137254901961,shc-gpt-4o,medalign,nursing_note,PROMPT2_ICL_entailment
155,238,9,9,0,1.0,4,4,0,1.0,1.0,shc-gpt-4o,medalign,nursing_note,PROMPT2_ICL_entailment
156,239,12,12,0,1.0,4,4,0,1.0,1.0,shc-gpt-4o,medalign,nursing_note,PROMPT2_ICL_entailment
157,24,4,4,0,1.0,1,1,0,1.0,1.0,shc-gpt-4o,medalign,nursing_note,PROMPT2_ICL_entailment
158,240,5,4,1,0.8,2,1,1,0.5,0.6153846153846154,shc-gpt-4o,medalign,nursing_note,PROMPT2_ICL_entailment
159,241,5,5,0,1.0,2,2,0,1.0,1.0,shc-gpt-4o,medalign,nursing_note,PROMPT2_ICL_entailment
160,242,22,19,3,0.8636363636363636,2,0,2,0.0,0.0,shc-gpt-4o,medalign,nursing_note,PROMPT2_ICL_entailment
161,243,25,25,0,1.0,10,10,0,1.0,1.0,shc-gpt-4o,medalign,nursing_note,PROMPT2_ICL_entailment
162,244,4,4,0,1.0,1,1,0,1.0,1.0,shc-gpt-4o,medalign,nursing_note,PROMPT2_ICL_entailment
163,245,6,5,1,0.8333333333333334,1,1,0,1.0,0.9090909090909092,shc-gpt-4o,medalign,nursing_note,PROMPT2_ICL_entailment
164,246,5,5,0,1.0,1,1,0,1.0,1.0,shc-gpt-4o,medalign,nursing_note,PROMPT2_ICL_entailment
165,247,8,8,0,1.0,5,5,0,1.0,1.0,shc-gpt-4o,medalign,nursing_note,PROMPT2_ICL_entailment
166,248,5,5,0,1.0,1,1,0,1.0,1.0,shc-gpt-4o,medalign,nursing_note,PROMPT2_ICL_entailment
167,249,19,19,0,1.0,2,2,0,1.0,1.0,shc-gpt-4o,medalign,nursing_note,PROMPT2_ICL_entailment
168,25,61,56,5,0.918032786885246,33,23,10,0.696969696969697,0.7923715779760074,shc-gpt-4o,medalign,nursing_note,PROMPT2_ICL_entailment
169,26,6,6,0,1.0,1,1,0,1.0,1.0,shc-gpt-4o,medalign,nursing_note,PROMPT2_ICL_entailment
170,27,14,14,0,1.0,2,2,0,1.0,1.0,shc-gpt-4o,medalign,nursing_note,PROMPT2_ICL_entailment
171,28,16,10,6,0.625,4,4,0,1.0,0.7692307692307693,shc-gpt-4o,medalign,nursing_note,PROMPT2_ICL_entailment
172,29,8,8,0,1.0,3,3,0,1.0,1.0,shc-gpt-4o,medalign,nursing_note,PROMPT2_ICL_entailment
173,3,7,7,0,1.0,2,2,0,1.0,1.0,shc-gpt-4o,medalign,nursing_note,PROMPT2_ICL_entailment
174,30,5,4,1,0.8,1,1,0,1.0,0.888888888888889,shc-gpt-4o,medalign,nursing_note,PROMPT2_ICL_entailment
175,31,1,1,0,1.0,1,1,0,1.0,1.0,shc-gpt-4o,medalign,nursing_note,PROMPT2_ICL_entailment
176,32,5,5,0,1.0,2,2,0,1.0,1.0,shc-gpt-4o,medalign,nursing_note,PROMPT2_ICL_entailment
177,33,14,13,1,0.9285714285714286,5,5,0,1.0,0.962962962962963,shc-gpt-4o,medalign,nursing_note,PROMPT2_ICL_entailment
178,34,12,12,0,1.0,4,1,3,0.25,0.4,shc-gpt-4o,medalign,nursing_note,PROMPT2_ICL_entailment
179,35,14,14,0,1.0,4,2,2,0.5,0.6666666666666666,shc-gpt-4o,medalign,nursing_note,PROMPT2_ICL_entailment
180,36,21,11,10,0.5238095238095238,5,3,2,0.6,0.559322033898305,shc-gpt-4o,medalign,nursing_note,PROMPT2_ICL_entailment
181,37,6,6,0,1.0,3,3,0,1.0,1.0,shc-gpt-4o,medalign,nursing_note,PROMPT2_ICL_entailment
182,38,19,16,3,0.8421052631578947,5,3,2,0.6,0.7007299270072991,shc-gpt-4o,medalign,nursing_note,PROMPT2_ICL_entailment
183,39,3,3,0,1.0,1,1,0,1.0,1.0,shc-gpt-4o,medalign,nursing_note,PROMPT2_ICL_entailment
184,4,5,5,0,1.0,3,3,0,1.0,1.0,shc-gpt-4o,medalign,nursing_note,PROMPT2_ICL_entailment
185,40,10,9,1,0.9,8,8,0,1.0,0.9473684210526316,shc-gpt-4o,medalign,nursing_note,PROMPT2_ICL_entailment
186,41,5,5,0,1.0,1,1,0,1.0,1.0,shc-gpt-4o,medalign,nursing_note,PROMPT2_ICL_entailment
187,42,14,14,0,1.0,8,7,1,0.875,0.9333333333333332,shc-gpt-4o,medalign,nursing_note,PROMPT2_ICL_entailment
188,43,5,5,0,1.0,2,2,0,1.0,1.0,shc-gpt-4o,medalign,nursing_note,PROMPT2_ICL_entailment
189,44,4,4,0,1.0,1,1,0,1.0,1.0,shc-gpt-4o,medalign,nursing_note,PROMPT2_ICL_entailment
190,45,2,1,1,0.5,1,1,0,1.0,0.6666666666666666,shc-gpt-4o,medalign,nursing_note,PROMPT2_ICL_entailment
191,46,11,11,0,1.0,5,5,0,1.0,1.0,shc-gpt-4o,medalign,nursing_note,PROMPT2_ICL_entailment
192,47,29,29,0,1.0,20,18,2,0.9,0.9473684210526316,shc-gpt-4o,medalign,nursing_note,PROMPT2_ICL_entailment
193,48,5,5,0,1.0,2,2,0,1.0,1.0,shc-gpt-4o,medalign,nursing_note,PROMPT2_ICL_entailment
194,49,7,4,3,0.5714285714285714,2,1,1,0.5,0.5333333333333333,shc-gpt-4o,medalign,nursing_note,PROMPT2_ICL_entailment
195,5,16,16,0,1.0,5,5,0,1.0,1.0,shc-gpt-4o,medalign,nursing_note,PROMPT2_ICL_entailment
196,50,4,4,0,1.0,1,1,0,1.0,1.0,shc-gpt-4o,medalign,nursing_note,PROMPT2_ICL_entailment
197,51,4,4,0,1.0,2,2,0,1.0,1.0,shc-gpt-4o,medalign,nursing_note,PROMPT2_ICL_entailment
198,52,8,7,1,0.875,4,3,1,0.75,0.8076923076923077,shc-gpt-4o,medalign,nursing_note,PROMPT2_ICL_entailment
199,53,4,4,0,1.0,1,1,0,1.0,1.0,shc-gpt-4o,medalign,nursing_note,PROMPT2_ICL_entailment
200,54,12,11,1,0.9166666666666666,7,4,3,0.5714285714285714,0.7039999999999998,shc-gpt-4o,medalign,nursing_note,PROMPT2_ICL_entailment
201,55,8,7,1,0.875,2,2,0,1.0,0.9333333333333332,shc-gpt-4o,medalign,nursing_note,PROMPT2_ICL_entailment
202,56,6,6,0,1.0,3,3,0,1.0,1.0,shc-gpt-4o,medalign,nursing_note,PROMPT2_ICL_entailment
203,57,9,4,5,0.4444444444444444,4,2,2,0.5,0.4705882352941176,shc-gpt-4o,medalign,nursing_note,PROMPT2_ICL_entailment
204,58,3,3,0,1.0,1,1,0,1.0,1.0,shc-gpt-4o,medalign,nursing_note,PROMPT2_ICL_entailment
205,59,3,3,0,1.0,1,1,0,1.0,1.0,shc-gpt-4o,medalign,nursing_note,PROMPT2_ICL_entailment
206,6,4,4,0,1.0,3,3,0,1.0,1.0,shc-gpt-4o,medalign,nursing_note,PROMPT2_ICL_entailment
207,60,10,9,1,0.9,9,6,3,0.6666666666666666,0.7659574468085106,shc-gpt-4o,medalign,nursing_note,PROMPT2_ICL_entailment
208,61,3,3,0,1.0,1,1,0,1.0,1.0,shc-gpt-4o,medalign,nursing_note,PROMPT2_ICL_entailment
209,62,14,13,1,0.9285714285714286,5,4,1,0.8,0.859504132231405,shc-gpt-4o,medalign,nursing_note,PROMPT2_ICL_entailment
210,63,11,9,2,0.8181818181818182,7,3,4,0.4285714285714285,0.5625,shc-gpt-4o,medalign,nursing_note,PROMPT2_ICL_entailment
211,64,4,4,0,1.0,1,1,0,1.0,1.0,shc-gpt-4o,medalign,nursing_note,PROMPT2_ICL_entailment
212,65,6,6,0,1.0,2,2,0,1.0,1.0,shc-gpt-4o,medalign,nursing_note,PROMPT2_ICL_entailment
213,66,6,6,0,1.0,4,4,0,1.0,1.0,shc-gpt-4o,medalign,nursing_note,PROMPT2_ICL_entailment
214,67,9,9,0,1.0,4,3,1,0.75,0.8571428571428571,shc-gpt-4o,medalign,nursing_note,PROMPT2_ICL_entailment
215,68,6,5,1,0.8333333333333334,1,1,0,1.0,0.9090909090909092,shc-gpt-4o,medalign,nursing_note,PROMPT2_ICL_entailment
216,69,12,12,0,1.0,2,2,0,1.0,1.0,shc-gpt-4o,medalign,nursing_note,PROMPT2_ICL_entailment
217,7,6,6,0,1.0,1,1,0,1.0,1.0,shc-gpt-4o,medalign,nursing_note,PROMPT2_ICL_entailment
218,70,11,11,0,1.0,1,1,0,1.0,1.0,shc-gpt-4o,medalign,nursing_note,PROMPT2_ICL_entailment
219,71,16,16,0,1.0,1,0,1,0.0,0.0,shc-gpt-4o,medalign,nursing_note,PROMPT2_ICL_entailment
220,72,3,3,0,1.0,1,1,0,1.0,1.0,shc-gpt-4o,medalign,nursing_note,PROMPT2_ICL_entailment
221,73,4,4,0,1.0,2,2,0,1.0,1.0,shc-gpt-4o,medalign,nursing_note,PROMPT2_ICL_entailment
222,74,12,8,4,0.6666666666666666,5,4,1,0.8,0.7272727272727272,shc-gpt-4o,medalign,nursing_note,PROMPT2_ICL_entailment
223,75,12,1,11,0.0833333333333333,1,1,0,1.0,0.1538461538461538,shc-gpt-4o,medalign,nursing_note,PROMPT2_ICL_entailment
224,76,14,14,0,1.0,5,4,1,0.8,0.888888888888889,shc-gpt-4o,medalign,nursing_note,PROMPT2_ICL_entailment
225,77,7,7,0,1.0,3,3,0,1.0,1.0,shc-gpt-4o,medalign,nursing_note,PROMPT2_ICL_entailment
226,78,8,8,0,1.0,3,3,0,1.0,1.0,shc-gpt-4o,medalign,nursing_note,PROMPT2_ICL_entailment
227,79,9,9,0,1.0,8,5,3,0.625,0.7692307692307693,shc-gpt-4o,medalign,nursing_note,PROMPT2_ICL_entailment
228,8,20,18,2,0.9,8,7,1,0.875,0.8873239436619719,shc-gpt-4o,medalign,nursing_note,PROMPT2_ICL_entailment
229,80,12,11,1,0.9166666666666666,10,8,2,0.8,0.854368932038835,shc-gpt-4o,medalign,nursing_note,PROMPT2_ICL_entailment
230,81,2,1,1,0.5,1,1,0,1.0,0.6666666666666666,shc-gpt-4o,medalign,nursing_note,PROMPT2_ICL_entailment
231,82,4,4,0,1.0,3,3,0,1.0,1.0,shc-gpt-4o,medalign,nursing_note,PROMPT2_ICL_entailment
232,83,10,9,1,0.9,3,1,2,0.3333333333333333,0.4864864864864864,shc-gpt-4o,medalign,nursing_note,PROMPT2_ICL_entailment
233,84,9,9,0,1.0,2,2,0,1.0,1.0,shc-gpt-4o,medalign,nursing_note,PROMPT2_ICL_entailment
234,85,16,16,0,1.0,8,6,2,0.75,0.8571428571428571,shc-gpt-4o,medalign,nursing_note,PROMPT2_ICL_entailment
235,86,3,3,0,1.0,3,3,0,1.0,1.0,shc-gpt-4o,medalign,nursing_note,PROMPT2_ICL_entailment
236,87,5,5,0,1.0,2,2,0,1.0,1.0,shc-gpt-4o,medalign,nursing_note,PROMPT2_ICL_entailment
237,88,15,14,1,0.9333333333333332,7,7,0,1.0,0.9655172413793104,shc-gpt-4o,medalign,nursing_note,PROMPT2_ICL_entailment
238,89,9,9,0,1.0,6,5,1,0.8333333333333334,0.9090909090909092,shc-gpt-4o,medalign,nursing_note,PROMPT2_ICL_entailment
239,9,7,7,0,1.0,2,2,0,1.0,1.0,shc-gpt-4o,medalign,nursing_note,PROMPT2_ICL_entailment
240,90,6,6,0,1.0,1,1,0,1.0,1.0,shc-gpt-4o,medalign,nursing_note,PROMPT2_ICL_entailment
241,91,3,3,0,1.0,1,0,1,0.0,0.0,shc-gpt-4o,medalign,nursing_note,PROMPT2_ICL_entailment
242,92,6,6,0,1.0,4,4,0,1.0,1.0,shc-gpt-4o,medalign,nursing_note,PROMPT2_ICL_entailment
243,93,4,4,0,1.0,1,1,0,1.0,1.0,shc-gpt-4o,medalign,nursing_note,PROMPT2_ICL_entailment
244,94,6,6,0,1.0,2,2,0,1.0,1.0,shc-gpt-4o,medalign,nursing_note,PROMPT2_ICL_entailment
245,95,3,3,0,1.0,1,1,0,1.0,1.0,shc-gpt-4o,medalign,nursing_note,PROMPT2_ICL_entailment
246,96,3,2,1,0.6666666666666666,1,1,0,1.0,0.8,shc-gpt-4o,medalign,nursing_note,PROMPT2_ICL_entailment
247,97,6,6,0,1.0,2,1,1,0.5,0.6666666666666666,shc-gpt-4o,medalign,nursing_note,PROMPT2_ICL_entailment
248,98,16,15,1,0.9375,5,5,0,1.0,0.967741935483871,shc-gpt-4o,medalign,nursing_note,PROMPT2_ICL_entailment
249,99,13,13,0,1.0,7,3,4,0.4285714285714285,0.6,shc-gpt-4o,medalign,nursing_note,PROMPT2_ICL_entailment
0,0,12,12,0,1.0,6,5,1,0.8333333333333334,0.9090909090909092,shc-gpt-4o,medalign,nursing_note,PROMPT2_entailment
1,1,6,6,0,1.0,1,1,0,1.0,1.0,shc-gpt-4o,medalign,nursing_note,PROMPT2_entailment
2,10,8,7,1,0.875,5,4,1,0.8,0.8358208955223881,shc-gpt-4o,medalign,nursing_note,PROMPT2_entailment
3,100,12,12,0,1.0,10,8,2,0.8,0.888888888888889,shc-gpt-4o,medalign,nursing_note,PROMPT2_entailment
4,101,6,6,0,1.0,1,1,0,1.0,1.0,shc-gpt-4o,medalign,nursing_note,PROMPT2_entailment
5,102,9,9,0,1.0,4,3,1,0.75,0.8571428571428571,shc-gpt-4o,medalign,nursing_note,PROMPT2_entailment
6,103,3,3,0,1.0,2,2,0,1.0,1.0,shc-gpt-4o,medalign,nursing_note,PROMPT2_entailment
7,104,15,14,1,0.9333333333333332,15,12,3,0.8,0.8615384615384616,shc-gpt-4o,medalign,nursing_note,PROMPT2_entailment
8,105,2,2,0,1.0,1,1,0,1.0,1.0,shc-gpt-4o,medalign,nursing_note,PROMPT2_entailment
9,106,1,1,0,1.0,1,1,0,1.0,1.0,shc-gpt-4o,medalign,nursing_note,PROMPT2_entailment
10,107,8,8,0,1.0,4,4,0,1.0,1.0,shc-gpt-4o,medalign,nursing_note,PROMPT2_entailment
11,108,2,2,0,1.0,2,2,0,1.0,1.0,shc-gpt-4o,medalign,nursing_note,PROMPT2_entailment
12,109,10,10,0,1.0,5,5,0,1.0,1.0,shc-gpt-4o,medalign,nursing_note,PROMPT2_entailment
13,11,1,1,0,1.0,1,1,0,1.0,1.0,shc-gpt-4o,medalign,nursing_note,PROMPT2_entailment
14,110,17,11,6,0.6470588235294118,6,4,2,0.6666666666666666,0.6567164179104478,shc-gpt-4o,medalign,nursing_note,PROMPT2_entailment
15,111,1,1,0,1.0,1,1,0,1.0,1.0,shc-gpt-4o,medalign,nursing_note,PROMPT2_entailment
16,112,4,4,0,1.0,2,2,0,1.0,1.0,shc-gpt-4o,medalign,nursing_note,PROMPT2_entailment
17,113,1,1,0,1.0,1,1,0,1.0,1.0,shc-gpt-4o,medalign,nursing_note,PROMPT2_entailment
18,114,3,3,0,1.0,1,1,0,1.0,1.0,shc-gpt-4o,medalign,nursing_note,PROMPT2_entailment
19,115,13,13,0,1.0,7,5,2,0.7142857142857143,0.8333333333333333,shc-gpt-4o,medalign,nursing_note,PROMPT2_entailment
20,116,8,6,2,0.75,5,4,1,0.8,0.7741935483870969,shc-gpt-4o,medalign,nursing_note,PROMPT2_entailment
21,117,16,14,2,0.875,13,9,4,0.6923076923076923,0.7730061349693251,shc-gpt-4o,medalign,nursing_note,PROMPT2_entailment
22,118,3,3,0,1.0,2,2,0,1.0,1.0,shc-gpt-4o,medalign,nursing_note,PROMPT2_entailment
23,119,4,4,0,1.0,2,2,0,1.0,1.0,shc-gpt-4o,medalign,nursing_note,PROMPT2_entailment
24,12,2,2,0,1.0,1,1,0,1.0,1.0,shc-gpt-4o,medalign,nursing_note,PROMPT2_entailment
25,120,9,9,0,1.0,7,5,2,0.7142857142857143,0.8333333333333333,shc-gpt-4o,medalign,nursing_note,PROMPT2_entailment
26,121,2,2,0,1.0,1,1,0,1.0,1.0,shc-gpt-4o,medalign,nursing_note,PROMPT2_entailment
27,122,2,2,0,1.0,1,1,0,1.0,1.0,shc-gpt-4o,medalign,nursing_note,PROMPT2_entailment
28,123,3,3,0,1.0,4,3,1,0.75,0.8571428571428571,shc-gpt-4o,medalign,nursing_note,PROMPT2_entailment
29,124,21,20,1,0.9523809523809524,14,14,0,1.0,0.975609756097561,shc-gpt-4o,medalign,nursing_note,PROMPT2_entailment
30,125,14,14,0,1.0,9,8,1,0.8888888888888888,0.9411764705882352,shc-gpt-4o,medalign,nursing_note,PROMPT2_entailment
31,126,2,2,0,1.0,2,2,0,1.0,1.0,shc-gpt-4o,medalign,nursing_note,PROMPT2_entailment
32,127,2,2,0,1.0,1,0,1,0.0,0.0,shc-gpt-4o,medalign,nursing_note,PROMPT2_entailment
33,128,4,4,0,1.0,2,2,0,1.0,1.0,shc-gpt-4o,medalign,nursing_note,PROMPT2_entailment
34,129,30,28,2,0.9333333333333332,20,19,1,0.95,0.9415929203539822,shc-gpt-4o,medalign,nursing_note,PROMPT2_entailment
35,13,6,6,0,1.0,5,5,0,1.0,1.0,shc-gpt-4o,medalign,nursing_note,PROMPT2_entailment
36,130,5,5,0,1.0,2,2,0,1.0,1.0,shc-gpt-4o,medalign,nursing_note,PROMPT2_entailment
37,131,3,3,0,1.0,1,1,0,1.0,1.0,shc-gpt-4o,medalign,nursing_note,PROMPT2_entailment
38,132,5,5,0,1.0,2,2,0,1.0,1.0,shc-gpt-4o,medalign,nursing_note,PROMPT2_entailment
39,133,16,15,1,0.9375,14,8,6,0.5714285714285714,0.7100591715976331,shc-gpt-4o,medalign,nursing_note,PROMPT2_entailment
40,134,5,5,0,1.0,3,2,1,0.6666666666666666,0.8,shc-gpt-4o,medalign,nursing_note,PROMPT2_entailment
41,135,5,5,0,1.0,2,2,0,1.0,1.0,shc-gpt-4o,medalign,nursing_note,PROMPT2_entailment
42,136,60,30,30,0.5,51,36,15,0.7058823529411765,0.5853658536585366,shc-gpt-4o,medalign,nursing_note,PROMPT2_entailment
43,137,14,14,0,1.0,6,6,0,1.0,1.0,shc-gpt-4o,medalign,nursing_note,PROMPT2_entailment
44,138,1,1,0,1.0,1,1,0,1.0,1.0,shc-gpt-4o,medalign,nursing_note,PROMPT2_entailment
45,139,3,3,0,1.0,1,1,0,1.0,1.0,shc-gpt-4o,medalign,nursing_note,PROMPT2_entailment
46,14,1,1,0,1.0,1,1,0,1.0,1.0,shc-gpt-4o,medalign,nursing_note,PROMPT2_entailment
47,140,5,5,0,1.0,3,3,0,1.0,1.0,shc-gpt-4o,medalign,nursing_note,PROMPT2_entailment
48,141,1,1,0,1.0,1,1,0,1.0,1.0,shc-gpt-4o,medalign,nursing_note,PROMPT2_entailment
49,142,2,2,0,1.0,1,1,0,1.0,1.0,shc-gpt-4o,medalign,nursing_note,PROMPT2_entailment
50,143,1,1,0,1.0,1,1,0,1.0,1.0,shc-gpt-4o,medalign,nursing_note,PROMPT2_entailment
51,144,1,1,0,1.0,1,1,0,1.0,1.0,shc-gpt-4o,medalign,nursing_note,PROMPT2_entailment
52,145,4,4,0,1.0,4,4,0,1.0,1.0,shc-gpt-4o,medalign,nursing_note,PROMPT2_entailment
53,146,8,8,0,1.0,3,2,1,0.6666666666666666,0.8,shc-gpt-4o,medalign,nursing_note,PROMPT2_entailment
54,147,7,7,0,1.0,6,4,2,0.6666666666666666,0.8,shc-gpt-4o,medalign,nursing_note,PROMPT2_entailment
55,148,24,23,1,0.9583333333333334,7,7,0,1.0,0.9787234042553192,shc-gpt-4o,medalign,nursing_note,PROMPT2_entailment
56,149,3,3,0,1.0,1,0,1,0.0,0.0,shc-gpt-4o,medalign,nursing_note,PROMPT2_entailment
57,15,7,6,1,0.8571428571428571,1,1,0,1.0,0.923076923076923,shc-gpt-4o,medalign,nursing_note,PROMPT2_entailment
58,150,3,3,0,1.0,1,1,0,1.0,1.0,shc-gpt-4o,medalign,nursing_note,PROMPT2_entailment
59,151,15,15,0,1.0,8,7,1,0.875,0.9333333333333332,shc-gpt-4o,medalign,nursing_note,PROMPT2_entailment
60,152,5,5,0,1.0,4,4,0,1.0,1.0,shc-gpt-4o,medalign,nursing_note,PROMPT2_entailment
61,153,13,13,0,1.0,14,11,3,0.7857142857142857,0.88,shc-gpt-4o,medalign,nursing_note,PROMPT2_entailment
62,154,3,3,0,1.0,1,1,0,1.0,1.0,shc-gpt-4o,medalign,nursing_note,PROMPT2_entailment
63,155,30,27,3,0.9,14,11,3,0.7857142857142857,0.8389830508474577,shc-gpt-4o,medalign,nursing_note,PROMPT2_entailment
64,156,9,9,0,1.0,1,1,0,1.0,1.0,shc-gpt-4o,medalign,nursing_note,PROMPT2_entailment
65,157,4,4,0,1.0,3,3,0,1.0,1.0,shc-gpt-4o,medalign,nursing_note,PROMPT2_entailment
66,158,11,11,0,1.0,1,1,0,1.0,1.0,shc-gpt-4o,medalign,nursing_note,PROMPT2_entailment
67,159,6,6,0,1.0,3,3,0,1.0,1.0,shc-gpt-4o,medalign,nursing_note,PROMPT2_entailment
68,16,14,14,0,1.0,3,2,1,0.6666666666666666,0.8,shc-gpt-4o,medalign,nursing_note,PROMPT2_entailment
69,160,3,3,0,1.0,1,1,0,1.0,1.0,shc-gpt-4o,medalign,nursing_note,PROMPT2_entailment
70,161,3,3,0,1.0,1,1,0,1.0,1.0,shc-gpt-4o,medalign,nursing_note,PROMPT2_entailment
71,162,10,10,0,1.0,8,6,2,0.75,0.8571428571428571,shc-gpt-4o,medalign,nursing_note,PROMPT2_entailment
72,163,6,6,0,1.0,3,3,0,1.0,1.0,shc-gpt-4o,medalign,nursing_note,PROMPT2_entailment
73,164,5,5,0,1.0,2,2,0,1.0,1.0,shc-gpt-4o,medalign,nursing_note,PROMPT2_entailment
74,165,8,8,0,1.0,4,3,1,0.75,0.8571428571428571,shc-gpt-4o,medalign,nursing_note,PROMPT2_entailment
75,166,12,12,0,1.0,5,5,0,1.0,1.0,shc-gpt-4o,medalign,nursing_note,PROMPT2_entailment
76,167,14,13,1,0.9285714285714286,2,1,1,0.5,0.65,shc-gpt-4o,medalign,nursing_note,PROMPT2_entailment
77,168,6,6,0,1.0,3,3,0,1.0,1.0,shc-gpt-4o,medalign,nursing_note,PROMPT2_entailment
78,169,12,11,1,0.9166666666666666,9,5,4,0.5555555555555556,0.6918238993710691,shc-gpt-4o,medalign,nursing_note,PROMPT2_entailment
79,17,3,3,0,1.0,1,0,1,0.0,0.0,shc-gpt-4o,medalign,nursing_note,PROMPT2_entailment
80,170,4,4,0,1.0,1,1,0,1.0,1.0,shc-gpt-4o,medalign,nursing_note,PROMPT2_entailment
81,171,11,9,2,0.8181818181818182,7,4,3,0.5714285714285714,0.6728971962616823,shc-gpt-4o,medalign,nursing_note,PROMPT2_entailment
82,172,15,14,1,0.9333333333333332,12,8,4,0.6666666666666666,0.7777777777777778,shc-gpt-4o,medalign,nursing_note,PROMPT2_entailment
83,173,8,8,0,1.0,1,1,0,1.0,1.0,shc-gpt-4o,medalign,nursing_note,PROMPT2_entailment
84,174,4,4,0,1.0,1,1,0,1.0,1.0,shc-gpt-4o,medalign,nursing_note,PROMPT2_entailment
85,175,2,2,0,1.0,2,2,0,1.0,1.0,shc-gpt-4o,medalign,nursing_note,PROMPT2_entailment
86,176,10,8,2,0.8,3,2,1,0.6666666666666666,0.7272727272727272,shc-gpt-4o,medalign,nursing_note,PROMPT2_entailment
87,177,8,7,1,0.875,8,7,1,0.875,0.875,shc-gpt-4o,medalign,nursing_note,PROMPT2_entailment
88,178,12,12,0,1.0,10,9,1,0.9,0.9473684210526316,shc-gpt-4o,medalign,nursing_note,PROMPT2_entailment
89,179,8,8,0,1.0,2,2,0,1.0,1.0,shc-gpt-4o,medalign,nursing_note,PROMPT2_entailment
90,18,14,13,1,0.9285714285714286,3,3,0,1.0,0.962962962962963,shc-gpt-4o,medalign,nursing_note,PROMPT2_entailment
91,180,7,6,1,0.8571428571428571,4,1,3,0.25,0.3870967741935483,shc-gpt-4o,medalign,nursing_note,PROMPT2_entailment
92,181,8,8,0,1.0,7,7,0,1.0,1.0,shc-gpt-4o,medalign,nursing_note,PROMPT2_entailment
93,182,3,3,0,1.0,2,1,1,0.5,0.6666666666666666,shc-gpt-4o,medalign,nursing_note,PROMPT2_entailment
94,183,7,7,0,1.0,6,6,0,1.0,1.0,shc-gpt-4o,medalign,nursing_note,PROMPT2_entailment
95,184,10,10,0,1.0,11,7,4,0.6363636363636364,0.7777777777777778,shc-gpt-4o,medalign,nursing_note,PROMPT2_entailment
96,185,3,3,0,1.0,3,3,0,1.0,1.0,shc-gpt-4o,medalign,nursing_note,PROMPT2_entailment
97,186,10,10,0,1.0,3,3,0,1.0,1.0,shc-gpt-4o,medalign,nursing_note,PROMPT2_entailment
98,187,1,1,0,1.0,1,1,0,1.0,1.0,shc-gpt-4o,medalign,nursing_note,PROMPT2_entailment
99,188,2,2,0,1.0,3,3,0,1.0,1.0,shc-gpt-4o,medalign,nursing_note,PROMPT2_entailment
100,189,14,13,1,0.9285714285714286,10,4,6,0.4,0.5591397849462365,shc-gpt-4o,medalign,nursing_note,PROMPT2_entailment
101,19,15,15,0,1.0,7,7,0,1.0,1.0,shc-gpt-4o,medalign,nursing_note,PROMPT2_entailment
102,190,4,4,0,1.0,2,2,0,1.0,1.0,shc-gpt-4o,medalign,nursing_note,PROMPT2_entailment
103,191,15,15,0,1.0,5,4,1,0.8,0.888888888888889,shc-gpt-4o,medalign,nursing_note,PROMPT2_entailment
104,192,3,3,0,1.0,1,1,0,1.0,1.0,shc-gpt-4o,medalign,nursing_note,PROMPT2_entailment
105,193,6,6,0,1.0,3,3,0,1.0,1.0,shc-gpt-4o,medalign,nursing_note,PROMPT2_entailment
106,194,3,2,1,0.6666666666666666,2,1,1,0.5,0.5714285714285715,shc-gpt-4o,medalign,nursing_note,PROMPT2_entailment
107,195,15,14,1,0.9333333333333332,10,7,3,0.7,0.8,shc-gpt-4o,medalign,nursing_note,PROMPT2_entailment
108,196,3,3,0,1.0,1,1,0,1.0,1.0,shc-gpt-4o,medalign,nursing_note,PROMPT2_entailment
109,197,1,1,0,1.0,1,1,0,1.0,1.0,shc-gpt-4o,medalign,nursing_note,PROMPT2_entailment
110,198,20,19,1,0.95,8,6,2,0.75,0.838235294117647,shc-gpt-4o,medalign,nursing_note,PROMPT2_entailment
111,199,16,14,2,0.875,7,6,1,0.8571428571428571,0.8659793814432989,shc-gpt-4o,medalign,nursing_note,PROMPT2_entailment
112,2,13,11,2,0.8461538461538461,5,4,1,0.8,0.8224299065420562,shc-gpt-4o,medalign,nursing_note,PROMPT2_entailment
113,20,6,5,1,0.8333333333333334,2,2,0,1.0,0.9090909090909092,shc-gpt-4o,medalign,nursing_note,PROMPT2_entailment
114,200,4,4,0,1.0,3,3,0,1.0,1.0,shc-gpt-4o,medalign,nursing_note,PROMPT2_entailment
115,201,3,3,0,1.0,1,1,0,1.0,1.0,shc-gpt-4o,medalign,nursing_note,PROMPT2_entailment
116,202,5,5,0,1.0,1,1,0,1.0,1.0,shc-gpt-4o,medalign,nursing_note,PROMPT2_entailment
117,203,3,3,0,1.0,1,1,0,1.0,1.0,shc-gpt-4o,medalign,nursing_note,PROMPT2_entailment
118,204,15,14,1,0.9333333333333332,9,8,1,0.8888888888888888,0.9105691056910568,shc-gpt-4o,medalign,nursing_note,PROMPT2_entailment
119,205,30,17,13,0.5666666666666667,8,3,5,0.375,0.4513274336283185,shc-gpt-4o,medalign,nursing_note,PROMPT2_entailment
120,206,4,4,0,1.0,4,4,0,1.0,1.0,shc-gpt-4o,medalign,nursing_note,PROMPT2_entailment
121,207,9,9,0,1.0,6,6,0,1.0,1.0,shc-gpt-4o,medalign,nursing_note,PROMPT2_entailment
122,208,10,9,1,0.9,10,8,2,0.8,0.8470588235294118,shc-gpt-4o,medalign,nursing_note,PROMPT2_entailment
123,209,4,4,0,1.0,1,0,1,0.0,0.0,shc-gpt-4o,medalign,nursing_note,PROMPT2_entailment
124,21,4,4,0,1.0,1,1,0,1.0,1.0,shc-gpt-4o,medalign,nursing_note,PROMPT2_entailment
125,210,6,5,1,0.8333333333333334,2,1,1,0.5,0.625,shc-gpt-4o,medalign,nursing_note,PROMPT2_entailment
126,211,4,4,0,1.0,2,2,0,1.0,1.0,shc-gpt-4o,medalign,nursing_note,PROMPT2_entailment
127,212,7,7,0,1.0,3,3,0,1.0,1.0,shc-gpt-4o,medalign,nursing_note,PROMPT2_entailment
128,213,14,14,0,1.0,8,8,0,1.0,1.0,shc-gpt-4o,medalign,nursing_note,PROMPT2_entailment
129,214,3,3,0,1.0,2,2,0,1.0,1.0,shc-gpt-4o,medalign,nursing_note,PROMPT2_entailment
130,215,2,2,0,1.0,1,1,0,1.0,1.0,shc-gpt-4o,medalign,nursing_note,PROMPT2_entailment
131,216,6,6,0,1.0,3,3,0,1.0,1.0,shc-gpt-4o,medalign,nursing_note,PROMPT2_entailment
132,217,10,7,3,0.7,11,6,5,0.5454545454545454,0.6131386861313869,shc-gpt-4o,medalign,nursing_note,PROMPT2_entailment
133,218,20,16,4,0.8,3,2,1,0.6666666666666666,0.7272727272727272,shc-gpt-4o,medalign,nursing_note,PROMPT2_entailment
134,219,5,5,0,1.0,2,2,0,1.0,1.0,shc-gpt-4o,medalign,nursing_note,PROMPT2_entailment
135,22,2,2,0,1.0,1,1,0,1.0,1.0,shc-gpt-4o,medalign,nursing_note,PROMPT2_entailment
136,220,8,6,2,0.75,7,5,2,0.7142857142857143,0.7317073170731706,shc-gpt-4o,medalign,nursing_note,PROMPT2_entailment
137,221,5,5,0,1.0,23,5,18,0.217391304347826,0.3571428571428571,shc-gpt-4o,medalign,nursing_note,PROMPT2_entailment
138,222,7,7,0,1.0,4,4,0,1.0,1.0,shc-gpt-4o,medalign,nursing_note,PROMPT2_entailment
139,223,5,5,0,1.0,2,1,1,0.5,0.6666666666666666,shc-gpt-4o,medalign,nursing_note,PROMPT2_entailment
140,224,11,10,1,0.9090909090909092,4,2,2,0.5,0.6451612903225806,shc-gpt-4o,medalign,nursing_note,PROMPT2_entailment
141,225,5,5,0,1.0,2,2,0,1.0,1.0,shc-gpt-4o,medalign,nursing_note,PROMPT2_entailment
142,226,15,11,4,0.7333333333333333,5,4,1,0.8,0.7652173913043478,shc-gpt-4o,medalign,nursing_note,PROMPT2_entailment
143,227,1,1,0,1.0,1,1,0,1.0,1.0,shc-gpt-4o,medalign,nursing_note,PROMPT2_entailment
144,228,31,29,2,0.935483870967742,18,16,2,0.8888888888888888,0.911591355599214,shc-gpt-4o,medalign,nursing_note,PROMPT2_entailment
145,229,13,11,2,0.8461538461538461,7,6,1,0.8571428571428571,0.8516129032258064,shc-gpt-4o,medalign,nursing_note,PROMPT2_entailment
146,23,27,24,3,0.8888888888888888,21,12,9,0.5714285714285714,0.6956521739130435,shc-gpt-4o,medalign,nursing_note,PROMPT2_entailment
147,230,2,2,0,1.0,1,1,0,1.0,1.0,shc-gpt-4o,medalign,nursing_note,PROMPT2_entailment
148,231,13,12,1,0.9230769230769232,13,7,6,0.5384615384615384,0.6801619433198379,shc-gpt-4o,medalign,nursing_note,PROMPT2_entailment
149,232,9,9,0,1.0,6,3,3,0.5,0.6666666666666666,shc-gpt-4o,medalign,nursing_note,PROMPT2_entailment
150,233,5,4,1,0.8,4,1,3,0.25,0.3809523809523809,shc-gpt-4o,medalign,nursing_note,PROMPT2_entailment
151,234,9,9,0,1.0,2,2,0,1.0,1.0,shc-gpt-4o,medalign,nursing_note,PROMPT2_entailment
152,235,1,1,0,1.0,1,1,0,1.0,1.0,shc-gpt-4o,medalign,nursing_note,PROMPT2_entailment
153,236,10,10,0,1.0,14,10,4,0.7142857142857143,0.8333333333333333,shc-gpt-4o,medalign,nursing_note,PROMPT2_entailment
154,237,15,11,4,0.7333333333333333,5,4,1,0.8,0.7652173913043478,shc-gpt-4o,medalign,nursing_note,PROMPT2_entailment
155,238,9,9,0,1.0,4,4,0,1.0,1.0,shc-gpt-4o,medalign,nursing_note,PROMPT2_entailment
156,239,11,11,0,1.0,4,4,0,1.0,1.0,shc-gpt-4o,medalign,nursing_note,PROMPT2_entailment
157,24,2,2,0,1.0,1,1,0,1.0,1.0,shc-gpt-4o,medalign,nursing_note,PROMPT2_entailment
158,240,2,2,0,1.0,2,2,0,1.0,1.0,shc-gpt-4o,medalign,nursing_note,PROMPT2_entailment
159,241,5,5,0,1.0,2,2,0,1.0,1.0,shc-gpt-4o,medalign,nursing_note,PROMPT2_entailment
160,242,13,12,1,0.9230769230769232,2,1,1,0.5,0.6486486486486487,shc-gpt-4o,medalign,nursing_note,PROMPT2_entailment
161,243,22,22,0,1.0,10,10,0,1.0,1.0,shc-gpt-4o,medalign,nursing_note,PROMPT2_entailment
162,244,3,3,0,1.0,1,1,0,1.0,1.0,shc-gpt-4o,medalign,nursing_note,PROMPT2_entailment
163,245,3,3,0,1.0,1,1,0,1.0,1.0,shc-gpt-4o,medalign,nursing_note,PROMPT2_entailment
164,246,2,2,0,1.0,1,1,0,1.0,1.0,shc-gpt-4o,medalign,nursing_note,PROMPT2_entailment
165,247,7,7,0,1.0,5,5,0,1.0,1.0,shc-gpt-4o,medalign,nursing_note,PROMPT2_entailment
166,248,3,3,0,1.0,1,1,0,1.0,1.0,shc-gpt-4o,medalign,nursing_note,PROMPT2_entailment
167,249,8,8,0,1.0,2,2,0,1.0,1.0,shc-gpt-4o,medalign,nursing_note,PROMPT2_entailment
168,25,68,58,10,0.8529411764705882,33,24,9,0.7272727272727273,0.7851099830795263,shc-gpt-4o,medalign,nursing_note,PROMPT2_entailment
169,26,6,6,0,1.0,1,1,0,1.0,1.0,shc-gpt-4o,medalign,nursing_note,PROMPT2_entailment
170,27,9,9,0,1.0,2,2,0,1.0,1.0,shc-gpt-4o,medalign,nursing_note,PROMPT2_entailment
171,28,12,8,4,0.6666666666666666,4,3,1,0.75,0.7058823529411765,shc-gpt-4o,medalign,nursing_note,PROMPT2_entailment
172,29,7,7,0,1.0,3,3,0,1.0,1.0,shc-gpt-4o,medalign,nursing_note,PROMPT2_entailment
173,3,5,5,0,1.0,2,2,0,1.0,1.0,shc-gpt-4o,medalign,nursing_note,PROMPT2_entailment
174,30,3,3,0,1.0,1,1,0,1.0,1.0,shc-gpt-4o,medalign,nursing_note,PROMPT2_entailment
175,31,1,1,0,1.0,1,1,0,1.0,1.0,shc-gpt-4o,medalign,nursing_note,PROMPT2_entailment
176,32,4,4,0,1.0,2,2,0,1.0,1.0,shc-gpt-4o,medalign,nursing_note,PROMPT2_entailment
177,33,8,8,0,1.0,5,4,1,0.8,0.888888888888889,shc-gpt-4o,medalign,nursing_note,PROMPT2_entailment
178,34,9,9,0,1.0,4,2,2,0.5,0.6666666666666666,shc-gpt-4o,medalign,nursing_note,PROMPT2_entailment
179,35,7,7,0,1.0,4,2,2,0.5,0.6666666666666666,shc-gpt-4o,medalign,nursing_note,PROMPT2_entailment
180,36,14,12,2,0.8571428571428571,5,3,2,0.6,0.7058823529411764,shc-gpt-4o,medalign,nursing_note,PROMPT2_entailment
181,37,5,5,0,1.0,3,2,1,0.6666666666666666,0.8,shc-gpt-4o,medalign,nursing_note,PROMPT2_entailment
182,38,14,13,1,0.9285714285714286,5,3,2,0.6,0.7289719626168225,shc-gpt-4o,medalign,nursing_note,PROMPT2_entailment
183,39,3,3,0,1.0,1,1,0,1.0,1.0,shc-gpt-4o,medalign,nursing_note,PROMPT2_entailment
184,4,3,3,0,1.0,3,2,1,0.6666666666666666,0.8,shc-gpt-4o,medalign,nursing_note,PROMPT2_entailment
185,40,9,9,0,1.0,8,6,2,0.75,0.8571428571428571,shc-gpt-4o,medalign,nursing_note,PROMPT2_entailment
186,41,2,2,0,1.0,1,1,0,1.0,1.0,shc-gpt-4o,medalign,nursing_note,PROMPT2_entailment
187,42,10,10,0,1.0,8,6,2,0.75,0.8571428571428571,shc-gpt-4o,medalign,nursing_note,PROMPT2_entailment
188,43,6,4,2,0.6666666666666666,2,2,0,1.0,0.8,shc-gpt-4o,medalign,nursing_note,PROMPT2_entailment
189,44,4,4,0,1.0,1,1,0,1.0,1.0,shc-gpt-4o,medalign,nursing_note,PROMPT2_entailment
190,45,19,1,18,0.0526315789473684,1,1,0,1.0,0.1,shc-gpt-4o,medalign,nursing_note,PROMPT2_entailment
191,46,8,8,0,1.0,5,5,0,1.0,1.0,shc-gpt-4o,medalign,nursing_note,PROMPT2_entailment
192,47,26,26,0,1.0,20,19,1,0.95,0.9743589743589745,shc-gpt-4o,medalign,nursing_note,PROMPT2_entailment
193,48,4,4,0,1.0,2,2,0,1.0,1.0,shc-gpt-4o,medalign,nursing_note,PROMPT2_entailment
194,49,3,3,0,1.0,2,1,1,0.5,0.6666666666666666,shc-gpt-4o,medalign,nursing_note,PROMPT2_entailment
195,5,15,15,0,1.0,5,5,0,1.0,1.0,shc-gpt-4o,medalign,nursing_note,PROMPT2_entailment
196,50,2,1,1,0.5,1,0,1,0.0,0.0,shc-gpt-4o,medalign,nursing_note,PROMPT2_entailment
197,51,3,3,0,1.0,2,2,0,1.0,1.0,shc-gpt-4o,medalign,nursing_note,PROMPT2_entailment
198,52,5,5,0,1.0,4,4,0,1.0,1.0,shc-gpt-4o,medalign,nursing_note,PROMPT2_entailment
199,53,3,3,0,1.0,1,1,0,1.0,1.0,shc-gpt-4o,medalign,nursing_note,PROMPT2_entailment
200,54,10,10,0,1.0,7,5,2,0.7142857142857143,0.8333333333333333,shc-gpt-4o,medalign,nursing_note,PROMPT2_entailment
201,55,5,5,0,1.0,2,2,0,1.0,1.0,shc-gpt-4o,medalign,nursing_note,PROMPT2_entailment
202,56,6,6,0,1.0,3,3,0,1.0,1.0,shc-gpt-4o,medalign,nursing_note,PROMPT2_entailment
203,57,9,5,4,0.5555555555555556,4,3,1,0.75,0.6382978723404256,shc-gpt-4o,medalign,nursing_note,PROMPT2_entailment
204,58,3,3,0,1.0,1,1,0,1.0,1.0,shc-gpt-4o,medalign,nursing_note,PROMPT2_entailment
205,59,2,2,0,1.0,1,1,0,1.0,1.0,shc-gpt-4o,medalign,nursing_note,PROMPT2_entailment
206,6,4,4,0,1.0,3,3,0,1.0,1.0,shc-gpt-4o,medalign,nursing_note,PROMPT2_entailment
207,60,10,10,0,1.0,9,8,1,0.8888888888888888,0.9411764705882352,shc-gpt-4o,medalign,nursing_note,PROMPT2_entailment
208,61,3,3,0,1.0,1,1,0,1.0,1.0,shc-gpt-4o,medalign,nursing_note,PROMPT2_entailment
209,62,12,12,0,1.0,5,5,0,1.0,1.0,shc-gpt-4o,medalign,nursing_note,PROMPT2_entailment
210,63,8,7,1,0.875,7,4,3,0.5714285714285714,0.691358024691358,shc-gpt-4o,medalign,nursing_note,PROMPT2_entailment
211,64,2,2,0,1.0,1,1,0,1.0,1.0,shc-gpt-4o,medalign,nursing_note,PROMPT2_entailment
212,65,7,7,0,1.0,2,2,0,1.0,1.0,shc-gpt-4o,medalign,nursing_note,PROMPT2_entailment
213,66,5,5,0,1.0,4,4,0,1.0,1.0,shc-gpt-4o,medalign,nursing_note,PROMPT2_entailment
214,67,6,6,0,1.0,4,3,1,0.75,0.8571428571428571,shc-gpt-4o,medalign,nursing_note,PROMPT2_entailment
215,68,5,5,0,1.0,1,1,0,1.0,1.0,shc-gpt-4o,medalign,nursing_note,PROMPT2_entailment
216,69,10,9,1,0.9,2,2,0,1.0,0.9473684210526316,shc-gpt-4o,medalign,nursing_note,PROMPT2_entailment
217,7,3,3,0,1.0,1,0,1,0.0,0.0,shc-gpt-4o,medalign,nursing_note,PROMPT2_entailment
218,70,8,8,0,1.0,1,1,0,1.0,1.0,shc-gpt-4o,medalign,nursing_note,PROMPT2_entailment
219,71,12,12,0,1.0,1,1,0,1.0,1.0,shc-gpt-4o,medalign,nursing_note,PROMPT2_entailment
220,72,1,1,0,1.0,1,1,0,1.0,1.0,shc-gpt-4o,medalign,nursing_note,PROMPT2_entailment
221,73,4,4,0,1.0,2,2,0,1.0,1.0,shc-gpt-4o,medalign,nursing_note,PROMPT2_entailment
222,74,12,9,3,0.75,5,4,1,0.8,0.7741935483870969,shc-gpt-4o,medalign,nursing_note,PROMPT2_entailment
223,75,1,1,0,1.0,1,1,0,1.0,1.0,shc-gpt-4o,medalign,nursing_note,PROMPT2_entailment
224,76,10,10,0,1.0,5,4,1,0.8,0.888888888888889,shc-gpt-4o,medalign,nursing_note,PROMPT2_entailment
225,77,6,6,0,1.0,3,3,0,1.0,1.0,shc-gpt-4o,medalign,nursing_note,PROMPT2_entailment
226,78,5,5,0,1.0,3,2,1,0.6666666666666666,0.8,shc-gpt-4o,medalign,nursing_note,PROMPT2_entailment
227,79,8,8,0,1.0,8,5,3,0.625,0.7692307692307693,shc-gpt-4o,medalign,nursing_note,PROMPT2_entailment
228,8,15,15,0,1.0,6,4,2,0.6666666666666666,0.8,shc-gpt-4o,medalign,nursing_note,PROMPT2_entailment
229,80,10,9,1,0.9,10,8,2,0.8,0.8470588235294118,shc-gpt-4o,medalign,nursing_note,PROMPT2_entailment
230,81,1,1,0,1.0,1,1,0,1.0,1.0,shc-gpt-4o,medalign,nursing_note,PROMPT2_entailment
231,82,3,3,0,1.0,3,3,0,1.0,1.0,shc-gpt-4o,medalign,nursing_note,PROMPT2_entailment
232,83,5,5,0,1.0,3,1,2,0.3333333333333333,0.5,shc-gpt-4o,medalign,nursing_note,PROMPT2_entailment
233,84,10,10,0,1.0,2,1,1,0.5,0.6666666666666666,shc-gpt-4o,medalign,nursing_note,PROMPT2_entailment
234,85,11,11,0,1.0,8,7,1,0.875,0.9333333333333332,shc-gpt-4o,medalign,nursing_note,PROMPT2_entailment
235,86,3,3,0,1.0,3,3,0,1.0,1.0,shc-gpt-4o,medalign,nursing_note,PROMPT2_entailment
236,87,4,4,0,1.0,2,2,0,1.0,1.0,shc-gpt-4o,medalign,nursing_note,PROMPT2_entailment
237,88,15,15,0,1.0,7,6,1,0.8571428571428571,0.923076923076923,shc-gpt-4o,medalign,nursing_note,PROMPT2_entailment
238,89,11,11,0,1.0,6,5,1,0.8333333333333334,0.9090909090909092,shc-gpt-4o,medalign,nursing_note,PROMPT2_entailment
239,9,4,4,0,1.0,2,2,0,1.0,1.0,shc-gpt-4o,medalign,nursing_note,PROMPT2_entailment
240,90,6,6,0,1.0,1,1,0,1.0,1.0,shc-gpt-4o,medalign,nursing_note,PROMPT2_entailment
241,91,2,2,0,1.0,1,0,1,0.0,0.0,shc-gpt-4o,medalign,nursing_note,PROMPT2_entailment
242,92,6,6,0,1.0,4,2,2,0.5,0.6666666666666666,shc-gpt-4o,medalign,nursing_note,PROMPT2_entailment
243,93,2,2,0,1.0,1,1,0,1.0,1.0,shc-gpt-4o,medalign,nursing_note,PROMPT2_entailment
244,94,2,2,0,1.0,2,1,1,0.5,0.6666666666666666,shc-gpt-4o,medalign,nursing_note,PROMPT2_entailment
245,95,1,1,0,1.0,1,1,0,1.0,1.0,shc-gpt-4o,medalign,nursing_note,PROMPT2_entailment
246,96,2,2,0,1.0,1,1,0,1.0,1.0,shc-gpt-4o,medalign,nursing_note,PROMPT2_entailment
247,97,6,6,0,1.0,2,2,0,1.0,1.0,shc-gpt-4o,medalign,nursing_note,PROMPT2_entailment
248,98,9,9,0,1.0,5,4,1,0.8,0.888888888888889,shc-gpt-4o,medalign,nursing_note,PROMPT2_entailment
249,99,12,12,0,1.0,7,5,2,0.7142857142857143,0.8333333333333333,shc-gpt-4o,medalign,nursing_note,PROMPT2_entailment
0,0,31,29,2,0.935483870967742,71,53,18,0.7464788732394366,0.8303619665045922,shc-gpt-4o,medalign,progress_note,PROMPT1_entailment
1,1,42,40,2,0.9523809523809524,47,40,7,0.851063829787234,0.898876404494382,shc-gpt-4o,medalign,progress_note,PROMPT1_entailment
2,10,40,30,10,0.75,48,38,10,0.7916666666666666,0.7702702702702704,shc-gpt-4o,medalign,progress_note,PROMPT1_entailment
3,100,69,67,2,0.9710144927536232,43,38,5,0.8837209302325582,0.9253134653825186,shc-gpt-4o,medalign,progress_note,PROMPT1_entailment
4,101,61,59,2,0.9672131147540984,73,57,16,0.7808219178082192,0.8640801644398767,shc-gpt-4o,medalign,progress_note,PROMPT1_entailment
5,102,24,22,2,0.9166666666666666,13,13,0,1.0,0.9565217391304348,shc-gpt-4o,medalign,progress_note,PROMPT1_entailment
6,11,24,22,2,0.9166666666666666,38,32,6,0.8421052631578947,0.8778054862842893,shc-gpt-4o,medalign,progress_note,PROMPT1_entailment
7,12,60,54,6,0.9,46,42,4,0.9130434782608696,0.9064748201438848,shc-gpt-4o,medalign,progress_note,PROMPT1_entailment
8,13,13,13,0,1.0,68,61,7,0.8970588235294118,0.9457364341085271,shc-gpt-4o,medalign,progress_note,PROMPT1_entailment
9,14,13,13,0,1.0,13,9,4,0.6923076923076923,0.8181818181818181,shc-gpt-4o,medalign,progress_note,PROMPT1_entailment
10,15,26,24,2,0.9230769230769232,19,19,0,1.0,0.96,shc-gpt-4o,medalign,progress_note,PROMPT1_entailment
11,16,16,14,2,0.875,78,58,20,0.7435897435897436,0.803960396039604,shc-gpt-4o,medalign,progress_note,PROMPT1_entailment
12,17,34,34,0,1.0,33,30,3,0.9090909090909092,0.9523809523809524,shc-gpt-4o,medalign,progress_note,PROMPT1_entailment
13,18,60,59,1,0.9833333333333332,59,54,5,0.9152542372881356,0.9480732033923523,shc-gpt-4o,medalign,progress_note,PROMPT1_entailment
14,19,63,61,2,0.9682539682539684,57,46,11,0.8070175438596491,0.880313725490196,shc-gpt-4o,medalign,progress_note,PROMPT1_entailment
15,2,50,39,11,0.78,54,41,13,0.7592592592592593,0.7694898941289703,shc-gpt-4o,medalign,progress_note,PROMPT1_entailment
16,20,33,33,0,1.0,31,31,0,1.0,1.0,shc-gpt-4o,medalign,progress_note,PROMPT1_entailment
17,21,42,37,5,0.8809523809523809,31,26,5,0.8387096774193549,0.8593121929432782,shc-gpt-4o,medalign,progress_note,PROMPT1_entailment
18,22,47,36,11,0.7659574468085106,63,46,17,0.7301587301587301,0.7476297968397292,shc-gpt-4o,medalign,progress_note,PROMPT1_entailment
19,23,28,26,2,0.9285714285714286,35,25,10,0.7142857142857143,0.8074534161490684,shc-gpt-4o,medalign,progress_note,PROMPT1_entailment
20,24,45,43,2,0.9555555555555556,42,35,7,0.8333333333333334,0.8902691511387164,shc-gpt-4o,medalign,progress_note,PROMPT1_entailment
21,25,40,38,2,0.95,26,23,3,0.8846153846153846,0.9161425576519916,shc-gpt-4o,medalign,progress_note,PROMPT1_entailment
22,26,38,37,1,0.9736842105263158,24,22,2,0.9166666666666666,0.9443155452436194,shc-gpt-4o,medalign,progress_note,PROMPT1_entailment
23,27,77,73,4,0.948051948051948,81,64,17,0.7901234567901234,0.861913107646896,shc-gpt-4o,medalign,progress_note,PROMPT1_entailment
24,28,42,40,2,0.9523809523809524,38,28,10,0.7368421052631579,0.8308605341246291,shc-gpt-4o,medalign,progress_note,PROMPT1_entailment
25,29,104,104,0,1.0,99,59,40,0.5959595959595959,0.7468354430379746,shc-gpt-4o,medalign,progress_note,PROMPT1_entailment
26,3,37,36,1,0.972972972972973,56,47,9,0.8392857142857143,0.9011984021304928,shc-gpt-4o,medalign,progress_note,PROMPT1_entailment
27,30,23,20,3,0.8695652173913043,54,46,8,0.8518518518518519,0.8606173994387277,shc-gpt-4o,medalign,progress_note,PROMPT1_entailment
28,31,43,42,1,0.9767441860465116,38,33,5,0.868421052631579,0.9194029850746268,shc-gpt-4o,medalign,progress_note,PROMPT1_entailment
29,32,48,47,1,0.9791666666666666,45,39,6,0.8666666666666667,0.9194883370955608,shc-gpt-4o,medalign,progress_note,PROMPT1_entailment
30,33,19,19,0,1.0,33,32,1,0.9696969696969696,0.9846153846153848,shc-gpt-4o,medalign,progress_note,PROMPT1_entailment
31,34,35,35,0,1.0,30,25,5,0.8333333333333334,0.9090909090909092,shc-gpt-4o,medalign,progress_note,PROMPT1_entailment
32,35,49,48,1,0.979591836734694,57,51,6,0.8947368421052632,0.935243553008596,shc-gpt-4o,medalign,progress_note,PROMPT1_entailment
33,36,29,25,4,0.8620689655172413,29,25,4,0.8620689655172413,0.8620689655172413,shc-gpt-4o,medalign,progress_note,PROMPT1_entailment
34,37,24,18,6,0.75,19,10,9,0.5263157894736842,0.6185567010309279,shc-gpt-4o,medalign,progress_note,PROMPT1_entailment
35,38,46,43,3,0.9347826086956522,63,49,14,0.7777777777777778,0.849083215796897,shc-gpt-4o,medalign,progress_note,PROMPT1_entailment
36,39,20,19,1,0.95,43,38,5,0.8837209302325582,0.9156626506024096,shc-gpt-4o,medalign,progress_note,PROMPT1_entailment
37,4,60,60,0,1.0,65,57,8,0.8769230769230769,0.9344262295081968,shc-gpt-4o,medalign,progress_note,PROMPT1_entailment
38,40,44,40,4,0.9090909090909092,31,25,6,0.8064516129032258,0.8547008547008547,shc-gpt-4o,medalign,progress_note,PROMPT1_entailment
39,41,50,46,4,0.92,69,60,9,0.8695652173913043,0.8940719144800778,shc-gpt-4o,medalign,progress_note,PROMPT1_entailment
40,42,30,29,1,0.9666666666666668,32,27,5,0.84375,0.901035673187572,shc-gpt-4o,medalign,progress_note,PROMPT1_entailment
41,43,15,12,3,0.8,23,20,3,0.8695652173913043,0.8333333333333333,shc-gpt-4o,medalign,progress_note,PROMPT1_entailment
42,44,34,34,0,1.0,92,50,42,0.5434782608695652,0.704225352112676,shc-gpt-4o,medalign,progress_note,PROMPT1_entailment
43,45,24,24,0,1.0,15,13,2,0.8666666666666667,0.9285714285714286,shc-gpt-4o,medalign,progress_note,PROMPT1_entailment
44,46,22,22,0,1.0,50,43,7,0.86,0.924731182795699,shc-gpt-4o,medalign,progress_note,PROMPT1_entailment
45,47,29,27,2,0.9310344827586208,42,36,6,0.8571428571428571,0.8925619834710743,shc-gpt-4o,medalign,progress_note,PROMPT1_entailment
46,48,46,44,2,0.9565217391304348,56,47,9,0.8392857142857143,0.8940769563337657,shc-gpt-4o,medalign,progress_note,PROMPT1_entailment
47,49,50,46,4,0.92,58,50,8,0.8620689655172413,0.8900928792569659,shc-gpt-4o,medalign,progress_note,PROMPT1_entailment
48,5,68,52,16,0.7647058823529411,69,43,26,0.6231884057971014,0.6867321867321866,shc-gpt-4o,medalign,progress_note,PROMPT1_entailment
49,50,16,15,1,0.9375,68,59,9,0.8676470588235294,0.9012219959266804,shc-gpt-4o,medalign,progress_note,PROMPT1_entailment
50,51,23,23,0,1.0,47,42,5,0.8936170212765957,0.9438202247191012,shc-gpt-4o,medalign,progress_note,PROMPT1_entailment
51,52,28,26,2,0.9285714285714286,19,16,3,0.8421052631578947,0.8832271762208067,shc-gpt-4o,medalign,progress_note,PROMPT1_entailment
52,53,24,23,1,0.9583333333333334,54,46,8,0.8518518518518519,0.9019607843137256,shc-gpt-4o,medalign,progress_note,PROMPT1_entailment
53,54,28,24,4,0.8571428571428571,24,20,4,0.8333333333333334,0.8450704225352113,shc-gpt-4o,medalign,progress_note,PROMPT1_entailment
54,55,26,24,2,0.9230769230769232,23,23,0,1.0,0.96,shc-gpt-4o,medalign,progress_note,PROMPT1_entailment
55,56,25,24,1,0.96,25,22,3,0.88,0.9182608695652176,shc-gpt-4o,medalign,progress_note,PROMPT1_entailment
56,57,6,6,0,1.0,4,3,1,0.75,0.8571428571428571,shc-gpt-4o,medalign,progress_note,PROMPT1_entailment
57,58,21,20,1,0.9523809523809524,13,12,1,0.9230769230769232,0.9375,shc-gpt-4o,medalign,progress_note,PROMPT1_entailment
58,59,41,38,3,0.926829268292683,35,32,3,0.9142857142857144,0.9205147615442848,shc-gpt-4o,medalign,progress_note,PROMPT1_entailment
59,6,35,34,1,0.9714285714285714,59,53,6,0.8983050847457628,0.9334369334369336,shc-gpt-4o,medalign,progress_note,PROMPT1_entailment
60,60,53,48,5,0.9056603773584906,56,46,10,0.8214285714285714,0.8614904408895825,shc-gpt-4o,medalign,progress_note,PROMPT1_entailment
61,61,26,24,2,0.9230769230769232,25,22,3,0.88,0.9010238907849828,shc-gpt-4o,medalign,progress_note,PROMPT1_entailment
62,62,37,35,2,0.945945945945946,32,26,6,0.8125,0.8741594620557156,shc-gpt-4o,medalign,progress_note,PROMPT1_entailment
63,63,15,14,1,0.9333333333333332,10,9,1,0.9,0.9163636363636364,shc-gpt-4o,medalign,progress_note,PROMPT1_entailment
64,64,37,31,6,0.8378378378378378,69,46,23,0.6666666666666666,0.7425149700598802,shc-gpt-4o,medalign,progress_note,PROMPT1_entailment
65,65,76,58,18,0.7631578947368421,104,78,26,0.75,0.7565217391304349,shc-gpt-4o,medalign,progress_note,PROMPT1_entailment
66,66,68,65,3,0.9558823529411764,87,71,16,0.8160919540229885,0.8804731469999046,shc-gpt-4o,medalign,progress_note,PROMPT1_entailment
67,67,30,28,2,0.9333333333333332,18,16,2,0.8888888888888888,0.9105691056910568,shc-gpt-4o,medalign,progress_note,PROMPT1_entailment
68,68,18,18,0,1.0,11,10,1,0.9090909090909092,0.9523809523809524,shc-gpt-4o,medalign,progress_note,PROMPT1_entailment
69,69,54,49,5,0.9074074074074074,68,63,5,0.9264705882352942,0.9168399168399168,shc-gpt-4o,medalign,progress_note,PROMPT1_entailment
70,7,46,40,6,0.8695652173913043,37,30,7,0.8108108108108109,0.8391608391608392,shc-gpt-4o,medalign,progress_note,PROMPT1_entailment
71,70,45,37,8,0.8222222222222222,69,49,20,0.7101449275362319,0.7620849096258933,shc-gpt-4o,medalign,progress_note,PROMPT1_entailment
72,71,72,68,4,0.9444444444444444,48,43,5,0.8958333333333334,0.919496855345912,shc-gpt-4o,medalign,progress_note,PROMPT1_entailment
73,72,57,56,1,0.9824561403508772,69,60,9,0.8695652173913043,0.9225700164744646,shc-gpt-4o,medalign,progress_note,PROMPT1_entailment
74,73,61,55,6,0.9016393442622952,90,70,20,0.7777777777777778,0.8351409978308026,shc-gpt-4o,medalign,progress_note,PROMPT1_entailment
75,74,6,6,0,1.0,22,21,1,0.9545454545454546,0.9767441860465116,shc-gpt-4o,medalign,progress_note,PROMPT1_entailment
76,75,44,43,1,0.9772727272727272,49,42,7,0.8571428571428571,0.913274336283186,shc-gpt-4o,medalign,progress_note,PROMPT1_entailment
77,76,30,29,1,0.9666666666666668,77,54,23,0.7012987012987013,0.8128730859070853,shc-gpt-4o,medalign,progress_note,PROMPT1_entailment
78,77,24,24,0,1.0,38,32,6,0.8421052631578947,0.9142857142857144,shc-gpt-4o,medalign,progress_note,PROMPT1_entailment
79,78,49,49,0,1.0,54,45,9,0.8333333333333334,0.9090909090909092,shc-gpt-4o,medalign,progress_note,PROMPT1_entailment
80,79,24,21,3,0.875,64,39,25,0.609375,0.718421052631579,shc-gpt-4o,medalign,progress_note,PROMPT1_entailment
81,8,55,52,3,0.9454545454545454,31,28,3,0.9032258064516128,0.9238578680203046,shc-gpt-4o,medalign,progress_note,PROMPT1_entailment
82,80,51,46,5,0.9019607843137256,66,40,26,0.6060606060606061,0.7249802994483846,shc-gpt-4o,medalign,progress_note,PROMPT1_entailment
83,81,16,14,2,0.875,12,10,2,0.8333333333333334,0.8536585365853658,shc-gpt-4o,medalign,progress_note,PROMPT1_entailment
84,82,19,17,2,0.8947368421052632,13,12,1,0.9230769230769232,0.9086859688195992,shc-gpt-4o,medalign,progress_note,PROMPT1_entailment
85,83,14,14,0,1.0,8,8,0,1.0,1.0,shc-gpt-4o,medalign,progress_note,PROMPT1_entailment
86,84,19,13,6,0.6842105263157895,23,21,2,0.9130434782608696,0.7822349570200573,shc-gpt-4o,medalign,progress_note,PROMPT1_entailment
87,85,42,35,7,0.8333333333333334,63,49,14,0.7777777777777778,0.8045977011494253,shc-gpt-4o,medalign,progress_note,PROMPT1_entailment
88,86,64,58,6,0.90625,75,57,18,0.76,0.8267066766691673,shc-gpt-4o,medalign,progress_note,PROMPT1_entailment
89,87,88,82,6,0.9318181818181818,87,67,20,0.7701149425287356,0.8432847275518034,shc-gpt-4o,medalign,progress_note,PROMPT1_entailment
90,88,27,21,6,0.7777777777777778,84,68,16,0.8095238095238095,0.7933333333333333,shc-gpt-4o,medalign,progress_note,PROMPT1_entailment
91,89,25,24,1,0.96,41,38,3,0.926829268292683,0.9431230610134436,shc-gpt-4o,medalign,progress_note,PROMPT1_entailment
92,9,39,37,2,0.9487179487179488,68,49,19,0.7205882352941176,0.8190648294556134,shc-gpt-4o,medalign,progress_note,PROMPT1_entailment
93,90,25,23,2,0.92,24,21,3,0.875,0.8969359331476324,shc-gpt-4o,medalign,progress_note,PROMPT1_entailment
94,91,41,41,0,1.0,45,37,8,0.8222222222222222,0.902439024390244,shc-gpt-4o,medalign,progress_note,PROMPT1_entailment
95,92,16,15,1,0.9375,17,16,1,0.9411764705882352,0.9393346379647748,shc-gpt-4o,medalign,progress_note,PROMPT1_entailment
96,93,31,30,1,0.967741935483871,25,22,3,0.88,0.9217877094972068,shc-gpt-4o,medalign,progress_note,PROMPT1_entailment
97,94,39,38,1,0.9743589743589745,33,31,2,0.9393939393939394,0.9565570442549736,shc-gpt-4o,medalign,progress_note,PROMPT1_entailment
98,95,40,35,5,0.875,41,36,5,0.8780487804878049,0.8765217391304349,shc-gpt-4o,medalign,progress_note,PROMPT1_entailment
99,96,51,49,2,0.9607843137254902,48,43,5,0.8958333333333334,0.9271727172717272,shc-gpt-4o,medalign,progress_note,PROMPT1_entailment
100,97,10,7,3,0.7,37,34,3,0.918918918918919,0.7946577629382303,shc-gpt-4o,medalign,progress_note,PROMPT1_entailment
101,98,59,48,11,0.8135593220338984,55,48,7,0.8727272727272727,0.8421052631578948,shc-gpt-4o,medalign,progress_note,PROMPT1_entailment
102,99,17,14,3,0.8235294117647058,73,57,16,0.7808219178082192,0.801607232546459,shc-gpt-4o,medalign,progress_note,PROMPT1_entailment
0,0,149,115,34,0.7718120805369127,71,66,5,0.9295774647887324,0.8433801877882104,shc-gpt-4o,medalign,progress_note,PROMPT1_ICL_entailment
1,1,78,73,5,0.935897435897436,47,40,7,0.851063829787234,0.8914669516104411,shc-gpt-4o,medalign,progress_note,PROMPT1_ICL_entailment
2,10,130,108,22,0.8307692307692308,48,32,16,0.6666666666666666,0.7397260273972603,shc-gpt-4o,medalign,progress_note,PROMPT1_ICL_entailment
3,100,96,95,1,0.9895833333333334,43,37,6,0.8604651162790697,0.9205185282178868,shc-gpt-4o,medalign,progress_note,PROMPT1_ICL_entailment
4,101,124,115,9,0.9274193548387096,73,62,11,0.8493150684931506,0.8866505005285084,shc-gpt-4o,medalign,progress_note,PROMPT1_ICL_entailment
5,102,24,23,1,0.9583333333333334,13,10,3,0.7692307692307693,0.8534322820037106,shc-gpt-4o,medalign,progress_note,PROMPT1_ICL_entailment
6,11,54,53,1,0.9814814814814816,38,27,11,0.7105263157894737,0.8243087557603687,shc-gpt-4o,medalign,progress_note,PROMPT1_ICL_entailment
7,12,94,91,3,0.9680851063829788,46,42,4,0.9130434782608696,0.9397590361445782,shc-gpt-4o,medalign,progress_note,PROMPT1_ICL_entailment
8,13,115,106,9,0.9217391304347826,68,49,19,0.7205882352941176,0.8088452853694619,shc-gpt-4o,medalign,progress_note,PROMPT1_ICL_entailment
9,14,27,26,1,0.9629629629629628,13,12,1,0.9230769230769232,0.9425981873111782,shc-gpt-4o,medalign,progress_note,PROMPT1_ICL_entailment
10,15,31,29,2,0.935483870967742,19,19,0,1.0,0.9666666666666666,shc-gpt-4o,medalign,progress_note,PROMPT1_ICL_entailment
11,16,150,131,19,0.8733333333333333,78,61,17,0.782051282051282,0.8251755472945063,shc-gpt-4o,medalign,progress_note,PROMPT1_ICL_entailment
12,17,60,59,1,0.9833333333333332,33,26,7,0.7878787878787878,0.8748217850014257,shc-gpt-4o,medalign,progress_note,PROMPT1_ICL_entailment
13,18,93,92,1,0.989247311827957,59,57,2,0.9661016949152542,0.9775375151458664,shc-gpt-4o,medalign,progress_note,PROMPT1_ICL_entailment
14,19,100,91,9,0.91,57,47,10,0.8245614035087719,0.8651764943865683,shc-gpt-4o,medalign,progress_note,PROMPT1_ICL_entailment
15,2,160,129,31,0.80625,54,46,8,0.8518518518518519,0.828423844757783,shc-gpt-4o,medalign,progress_note,PROMPT1_ICL_entailment
16,20,35,35,0,1.0,31,31,0,1.0,1.0,shc-gpt-4o,medalign,progress_note,PROMPT1_ICL_entailment
17,21,51,48,3,0.9411764705882352,31,25,6,0.8064516129032258,0.8686210640608034,shc-gpt-4o,medalign,progress_note,PROMPT1_ICL_entailment
18,22,107,98,9,0.9158878504672896,63,49,14,0.7777777777777778,0.8412017167381974,shc-gpt-4o,medalign,progress_note,PROMPT1_ICL_entailment
19,23,89,83,6,0.9325842696629212,35,28,7,0.8,0.861219195849546,shc-gpt-4o,medalign,progress_note,PROMPT1_ICL_entailment
20,24,80,77,3,0.9625,42,35,7,0.8333333333333334,0.8932714617169374,shc-gpt-4o,medalign,progress_note,PROMPT1_ICL_entailment
21,25,48,45,3,0.9375,26,23,3,0.8846153846153846,0.9102902374670184,shc-gpt-4o,medalign,progress_note,PROMPT1_ICL_entailment
22,26,53,53,0,1.0,24,20,4,0.8333333333333334,0.9090909090909092,shc-gpt-4o,medalign,progress_note,PROMPT1_ICL_entailment
23,27,121,114,7,0.9421487603305784,81,65,16,0.8024691358024691,0.8667173518919234,shc-gpt-4o,medalign,progress_note,PROMPT1_ICL_entailment
24,28,65,60,5,0.9230769230769232,38,29,9,0.7631578947368421,0.8355342136854742,shc-gpt-4o,medalign,progress_note,PROMPT1_ICL_entailment
25,29,197,189,8,0.9593908629441624,99,59,40,0.5959595959595959,0.7352146106678974,shc-gpt-4o,medalign,progress_note,PROMPT1_ICL_entailment
26,3,86,83,3,0.9651162790697676,56,49,7,0.875,0.9178515007898896,shc-gpt-4o,medalign,progress_note,PROMPT1_ICL_entailment
27,30,109,97,12,0.8899082568807339,54,45,9,0.8333333333333334,0.8606921029281278,shc-gpt-4o,medalign,progress_note,PROMPT1_ICL_entailment
28,31,64,59,5,0.921875,38,35,3,0.9210526315789472,0.9214636323070058,shc-gpt-4o,medalign,progress_note,PROMPT1_ICL_entailment
29,32,134,123,11,0.917910447761194,45,39,6,0.8666666666666667,0.8915528296626709,shc-gpt-4o,medalign,progress_note,PROMPT1_ICL_entailment
30,33,37,36,1,0.972972972972973,33,27,6,0.8181818181818182,0.8888888888888891,shc-gpt-4o,medalign,progress_note,PROMPT1_ICL_entailment
31,34,42,42,0,1.0,30,26,4,0.8666666666666667,0.9285714285714286,shc-gpt-4o,medalign,progress_note,PROMPT1_ICL_entailment
32,35,66,64,2,0.9696969696969696,57,48,9,0.8421052631578947,0.9014084507042254,shc-gpt-4o,medalign,progress_note,PROMPT1_ICL_entailment
33,36,61,57,4,0.9344262295081968,29,21,8,0.7241379310344828,0.8159509202453987,shc-gpt-4o,medalign,progress_note,PROMPT1_ICL_entailment
34,37,68,43,25,0.6323529411764706,19,13,6,0.6842105263157895,0.6572604350382129,shc-gpt-4o,medalign,progress_note,PROMPT1_ICL_entailment
35,38,134,121,13,0.9029850746268656,63,53,10,0.8412698412698413,0.8710356536502546,shc-gpt-4o,medalign,progress_note,PROMPT1_ICL_entailment
36,39,81,76,5,0.9382716049382716,43,36,7,0.8372093023255814,0.8848641655886159,shc-gpt-4o,medalign,progress_note,PROMPT1_ICL_entailment
37,4,107,103,4,0.9626168224299064,65,48,17,0.7384615384615385,0.8357704336066266,shc-gpt-4o,medalign,progress_note,PROMPT1_ICL_entailment
38,40,64,60,4,0.9375,31,25,6,0.8064516129032258,0.8670520231213872,shc-gpt-4o,medalign,progress_note,PROMPT1_ICL_entailment
39,41,133,127,6,0.9548872180451128,69,60,9,0.8695652173913043,0.910231141372514,shc-gpt-4o,medalign,progress_note,PROMPT1_ICL_entailment
40,42,49,45,4,0.9183673469387756,32,23,9,0.71875,0.8063887806778341,shc-gpt-4o,medalign,progress_note,PROMPT1_ICL_entailment
41,43,34,32,2,0.9411764705882352,23,19,4,0.8260869565217391,0.8798842257597684,shc-gpt-4o,medalign,progress_note,PROMPT1_ICL_entailment
42,44,130,125,5,0.9615384615384616,92,57,35,0.6195652173913043,0.7535695399259651,shc-gpt-4o,medalign,progress_note,PROMPT1_ICL_entailment
43,45,25,23,2,0.92,15,13,2,0.8666666666666667,0.8925373134328359,shc-gpt-4o,medalign,progress_note,PROMPT1_ICL_entailment
44,46,86,86,0,1.0,50,40,10,0.8,0.888888888888889,shc-gpt-4o,medalign,progress_note,PROMPT1_ICL_entailment
45,47,105,92,13,0.8761904761904762,42,28,14,0.6666666666666666,0.757201646090535,shc-gpt-4o,medalign,progress_note,PROMPT1_ICL_entailment
46,48,63,59,4,0.9365079365079364,56,51,5,0.9107142857142856,0.9234310265459568,shc-gpt-4o,medalign,progress_note,PROMPT1_ICL_entailment
47,49,151,131,20,0.8675496688741722,58,42,16,0.7241379310344828,0.7893830703012912,shc-gpt-4o,medalign,progress_note,PROMPT1_ICL_entailment
48,5,127,112,15,0.8818897637795275,69,60,9,0.8695652173913043,0.8756841282251758,shc-gpt-4o,medalign,progress_note,PROMPT1_ICL_entailment
49,50,110,105,5,0.9545454545454546,68,61,7,0.8970588235294118,0.9249097472924188,shc-gpt-4o,medalign,progress_note,PROMPT1_ICL_entailment
50,51,110,106,4,0.9636363636363636,47,45,2,0.9574468085106383,0.9605316149818768,shc-gpt-4o,medalign,progress_note,PROMPT1_ICL_entailment
51,52,25,24,1,0.96,19,15,4,0.7894736842105263,0.8664259927797834,shc-gpt-4o,medalign,progress_note,PROMPT1_ICL_entailment
52,53,87,84,3,0.9655172413793104,54,47,7,0.8703703703703703,0.9154782608695652,shc-gpt-4o,medalign,progress_note,PROMPT1_ICL_entailment
53,54,39,36,3,0.9230769230769232,24,18,6,0.75,0.8275862068965517,shc-gpt-4o,medalign,progress_note,PROMPT1_ICL_entailment
54,55,35,34,1,0.9714285714285714,23,21,2,0.9130434782608696,0.9413315754779168,shc-gpt-4o,medalign,progress_note,PROMPT1_ICL_entailment
55,56,42,41,1,0.9761904761904762,25,20,5,0.8,0.8793565683646113,shc-gpt-4o,medalign,progress_note,PROMPT1_ICL_entailment
56,57,12,12,0,1.0,4,4,0,1.0,1.0,shc-gpt-4o,medalign,progress_note,PROMPT1_ICL_entailment
57,58,18,18,0,1.0,13,7,6,0.5384615384615384,0.7000000000000001,shc-gpt-4o,medalign,progress_note,PROMPT1_ICL_entailment
58,59,46,45,1,0.9782608695652174,35,29,6,0.8285714285714286,0.8972155379855621,shc-gpt-4o,medalign,progress_note,PROMPT1_ICL_entailment
59,6,98,96,2,0.979591836734694,59,51,8,0.864406779661017,0.9184018007878446,shc-gpt-4o,medalign,progress_note,PROMPT1_ICL_entailment
60,60,83,73,10,0.8795180722891566,56,41,15,0.7321428571428571,0.7990922440261647,shc-gpt-4o,medalign,progress_note,PROMPT1_ICL_entailment
61,61,33,33,0,1.0,25,22,3,0.88,0.9361702127659576,shc-gpt-4o,medalign,progress_note,PROMPT1_ICL_entailment
62,62,53,49,4,0.9245283018867924,32,25,7,0.78125,0.8468717594192879,shc-gpt-4o,medalign,progress_note,PROMPT1_ICL_entailment
63,63,19,18,1,0.9473684210526316,10,9,1,0.9,0.9230769230769232,shc-gpt-4o,medalign,progress_note,PROMPT1_ICL_entailment
64,64,132,107,25,0.8106060606060606,69,50,19,0.7246376811594203,0.7652149038117714,shc-gpt-4o,medalign,progress_note,PROMPT1_ICL_entailment
65,65,205,153,52,0.7463414634146341,104,36,68,0.3461538461538461,0.472952086553323,shc-gpt-4o,medalign,progress_note,PROMPT1_ICL_entailment
66,66,110,106,4,0.9636363636363636,87,80,7,0.9195402298850576,0.9410720230828988,shc-gpt-4o,medalign,progress_note,PROMPT1_ICL_entailment
67,67,40,37,3,0.925,18,13,5,0.7222222222222222,0.8111298482293424,shc-gpt-4o,medalign,progress_note,PROMPT1_ICL_entailment
68,68,17,17,0,1.0,11,7,4,0.6363636363636364,0.7777777777777778,shc-gpt-4o,medalign,progress_note,PROMPT1_ICL_entailment
69,69,112,105,7,0.9375,68,56,12,0.8235294117647058,0.8768267223382046,shc-gpt-4o,medalign,progress_note,PROMPT1_ICL_entailment
70,7,76,64,12,0.8421052631578947,37,33,4,0.8918918918918919,0.8662838392124692,shc-gpt-4o,medalign,progress_note,PROMPT1_ICL_entailment
71,70,133,106,27,0.7969924812030075,69,50,19,0.7246376811594203,0.7590948152391864,shc-gpt-4o,medalign,progress_note,PROMPT1_ICL_entailment
72,71,105,98,7,0.9333333333333332,48,43,5,0.8958333333333334,0.9141989369779804,shc-gpt-4o,medalign,progress_note,PROMPT1_ICL_entailment
73,72,121,110,11,0.9090909090909092,69,63,6,0.9130434782608696,0.9110629067245118,shc-gpt-4o,medalign,progress_note,PROMPT1_ICL_entailment
74,73,121,102,19,0.8429752066115702,90,72,18,0.8,0.8209255533199196,shc-gpt-4o,medalign,progress_note,PROMPT1_ICL_entailment
75,74,29,28,1,0.9655172413793104,22,21,1,0.9545454545454546,0.96,shc-gpt-4o,medalign,progress_note,PROMPT1_ICL_entailment
76,75,84,83,1,0.988095238095238,49,40,9,0.8163265306122449,0.8940352766931466,shc-gpt-4o,medalign,progress_note,PROMPT1_ICL_entailment
77,76,162,141,21,0.8703703703703703,77,62,15,0.8051948051948052,0.8365149992823311,shc-gpt-4o,medalign,progress_note,PROMPT1_ICL_entailment
78,77,103,100,3,0.970873786407767,38,32,6,0.8421052631578947,0.9019165727170236,shc-gpt-4o,medalign,progress_note,PROMPT1_ICL_entailment
79,78,90,88,2,0.9777777777777776,54,51,3,0.9444444444444444,0.9608220937700708,shc-gpt-4o,medalign,progress_note,PROMPT1_ICL_entailment
80,79,103,76,27,0.7378640776699029,64,45,19,0.703125,0.7200757974523634,shc-gpt-4o,medalign,progress_note,PROMPT1_ICL_entailment
81,8,71,69,2,0.971830985915493,31,26,5,0.8387096774193549,0.9003764115432873,shc-gpt-4o,medalign,progress_note,PROMPT1_ICL_entailment
82,80,82,73,9,0.8902439024390244,66,37,29,0.5606060606060606,0.6879775853285787,shc-gpt-4o,medalign,progress_note,PROMPT1_ICL_entailment
83,81,19,19,0,1.0,12,7,5,0.5833333333333334,0.7368421052631579,shc-gpt-4o,medalign,progress_note,PROMPT1_ICL_entailment
84,82,28,27,1,0.9642857142857144,13,12,1,0.9230769230769232,0.943231441048035,shc-gpt-4o,medalign,progress_note,PROMPT1_ICL_entailment
85,83,16,14,2,0.875,8,8,0,1.0,0.9333333333333332,shc-gpt-4o,medalign,progress_note,PROMPT1_ICL_entailment
86,84,43,32,11,0.7441860465116279,23,20,3,0.8695652173913043,0.8020050125313284,shc-gpt-4o,medalign,progress_note,PROMPT1_ICL_entailment
87,85,126,119,7,0.9444444444444444,63,41,22,0.6507936507936508,0.7705914870093975,shc-gpt-4o,medalign,progress_note,PROMPT1_ICL_entailment
88,86,142,128,14,0.9014084507042254,75,43,32,0.5733333333333334,0.7008786451037821,shc-gpt-4o,medalign,progress_note,PROMPT1_ICL_entailment
89,87,131,117,14,0.8931297709923665,87,65,22,0.7471264367816092,0.8136300417246175,shc-gpt-4o,medalign,progress_note,PROMPT1_ICL_entailment
90,88,155,125,30,0.8064516129032258,84,68,16,0.8095238095238095,0.8079847908745248,shc-gpt-4o,medalign,progress_note,PROMPT1_ICL_entailment
91,89,70,68,2,0.9714285714285714,41,39,2,0.951219512195122,0.9612178325480246,shc-gpt-4o,medalign,progress_note,PROMPT1_ICL_entailment
92,9,94,92,2,0.9787234042553192,68,53,15,0.7794117647058824,0.8677700658480156,shc-gpt-4o,medalign,progress_note,PROMPT1_ICL_entailment
93,90,35,33,2,0.9428571428571428,24,21,3,0.875,0.9076620825147348,shc-gpt-4o,medalign,progress_note,PROMPT1_ICL_entailment
94,91,86,83,3,0.9651162790697676,45,40,5,0.8888888888888888,0.9254355400696864,shc-gpt-4o,medalign,progress_note,PROMPT1_ICL_entailment
95,92,26,25,1,0.9615384615384616,17,17,0,1.0,0.9803921568627452,shc-gpt-4o,medalign,progress_note,PROMPT1_ICL_entailment
96,93,31,31,0,1.0,25,22,3,0.88,0.9361702127659576,shc-gpt-4o,medalign,progress_note,PROMPT1_ICL_entailment
97,94,74,71,3,0.9594594594594594,33,26,7,0.7878787878787878,0.8652449027419733,shc-gpt-4o,medalign,progress_note,PROMPT1_ICL_entailment
98,95,84,75,9,0.8928571428571429,41,35,6,0.8536585365853658,0.8728179551122195,shc-gpt-4o,medalign,progress_note,PROMPT1_ICL_entailment
99,96,116,115,1,0.9913793103448276,48,44,4,0.9166666666666666,0.9525602409638554,shc-gpt-4o,medalign,progress_note,PROMPT1_ICL_entailment
100,97,83,78,5,0.9397590361445785,37,33,4,0.8918918918918919,0.9152,shc-gpt-4o,medalign,progress_note,PROMPT1_ICL_entailment
101,98,127,86,41,0.6771653543307087,55,51,4,0.9272727272727272,0.7827250825376996,shc-gpt-4o,medalign,progress_note,PROMPT1_ICL_entailment
102,99,164,148,16,0.902439024390244,73,56,17,0.7671232876712328,0.8292975785471283,shc-gpt-4o,medalign,progress_note,PROMPT1_ICL_entailment
0,0,168,126,42,0.75,71,61,10,0.8591549295774648,0.8008752735229758,shc-gpt-4o,medalign,progress_note,PROMPT2_ICL_entailment
1,1,97,87,10,0.8969072164948454,47,32,15,0.6808510638297872,0.7740859168636174,shc-gpt-4o,medalign,progress_note,PROMPT2_ICL_entailment
2,10,158,125,33,0.7911392405063291,48,35,13,0.7291666666666666,0.7588898525585429,shc-gpt-4o,medalign,progress_note,PROMPT2_ICL_entailment
3,100,104,101,3,0.971153846153846,43,40,3,0.9302325581395348,0.9502528519346114,shc-gpt-4o,medalign,progress_note,PROMPT2_ICL_entailment
4,101,111,105,6,0.945945945945946,73,57,16,0.7808219178082192,0.8554888507718696,shc-gpt-4o,medalign,progress_note,PROMPT2_ICL_entailment
5,102,23,23,0,1.0,13,10,3,0.7692307692307693,0.8695652173913044,shc-gpt-4o,medalign,progress_note,PROMPT2_ICL_entailment
6,11,67,67,0,1.0,38,28,10,0.7368421052631579,0.8484848484848484,shc-gpt-4o,medalign,progress_note,PROMPT2_ICL_entailment
7,12,89,87,2,0.9775280898876404,46,37,9,0.8043478260869565,0.8825222755311857,shc-gpt-4o,medalign,progress_note,PROMPT2_ICL_entailment
8,13,131,125,6,0.9541984732824428,68,54,14,0.7941176470588235,0.8668293309361756,shc-gpt-4o,medalign,progress_note,PROMPT2_ICL_entailment
9,14,19,18,1,0.9473684210526316,13,8,5,0.6153846153846154,0.7461139896373057,shc-gpt-4o,medalign,progress_note,PROMPT2_ICL_entailment
10,15,32,27,5,0.84375,19,16,3,0.8421052631578947,0.8429268292682927,shc-gpt-4o,medalign,progress_note,PROMPT2_ICL_entailment
11,16,150,133,17,0.8866666666666667,78,65,13,0.8333333333333334,0.859173126614987,shc-gpt-4o,medalign,progress_note,PROMPT2_ICL_entailment
12,17,69,66,3,0.9565217391304348,33,30,3,0.9090909090909092,0.9322033898305084,shc-gpt-4o,medalign,progress_note,PROMPT2_ICL_entailment
13,18,91,88,3,0.967032967032967,59,45,14,0.7627118644067796,0.8528049962312911,shc-gpt-4o,medalign,progress_note,PROMPT2_ICL_entailment
14,19,127,117,10,0.9212598425196852,57,47,10,0.8245614035087719,0.8702326317455293,shc-gpt-4o,medalign,progress_note,PROMPT2_ICL_entailment
15,2,162,123,39,0.7592592592592593,54,47,7,0.8703703703703703,0.811026936026936,shc-gpt-4o,medalign,progress_note,PROMPT2_ICL_entailment
16,20,49,49,0,1.0,31,27,4,0.8709677419354839,0.9310344827586208,shc-gpt-4o,medalign,progress_note,PROMPT2_ICL_entailment
17,21,61,58,3,0.9508196721311476,31,24,7,0.7741935483870968,0.8534641324340895,shc-gpt-4o,medalign,progress_note,PROMPT2_ICL_entailment
18,22,82,81,1,0.9878048780487804,63,36,27,0.5714285714285714,0.724022346368715,shc-gpt-4o,medalign,progress_note,PROMPT2_ICL_entailment
19,23,95,89,6,0.936842105263158,35,24,11,0.6857142857142857,0.7918443002780352,shc-gpt-4o,medalign,progress_note,PROMPT2_ICL_entailment
20,24,88,87,1,0.9886363636363636,42,33,9,0.7857142857142857,0.8755718206770357,shc-gpt-4o,medalign,progress_note,PROMPT2_ICL_entailment
21,25,45,44,1,0.9777777777777776,26,23,3,0.8846153846153846,0.9288664525011472,shc-gpt-4o,medalign,progress_note,PROMPT2_ICL_entailment
22,26,51,51,0,1.0,24,22,2,0.9166666666666666,0.9565217391304348,shc-gpt-4o,medalign,progress_note,PROMPT2_ICL_entailment
23,27,167,150,17,0.8982035928143712,81,65,16,0.8024691358024691,0.8476418169963051,shc-gpt-4o,medalign,progress_note,PROMPT2_ICL_entailment
24,28,70,66,4,0.9428571428571428,38,30,8,0.7894736842105263,0.859375,shc-gpt-4o,medalign,progress_note,PROMPT2_ICL_entailment
25,29,208,195,13,0.9375,99,54,45,0.5454545454545454,0.6896551724137931,shc-gpt-4o,medalign,progress_note,PROMPT2_ICL_entailment
26,3,98,97,1,0.9897959183673468,56,48,8,0.8571428571428571,0.9187056037884768,shc-gpt-4o,medalign,progress_note,PROMPT2_ICL_entailment
27,30,122,113,9,0.9262295081967212,54,37,17,0.6851851851851852,0.7876789751318765,shc-gpt-4o,medalign,progress_note,PROMPT2_ICL_entailment
28,31,75,68,7,0.9066666666666666,38,34,4,0.8947368421052632,0.9006622516556291,shc-gpt-4o,medalign,progress_note,PROMPT2_ICL_entailment
29,32,130,123,7,0.946153846153846,45,43,2,0.9555555555555556,0.9508314606741574,shc-gpt-4o,medalign,progress_note,PROMPT2_ICL_entailment
30,33,46,45,1,0.9782608695652174,33,26,7,0.7878787878787878,0.8728086534875046,shc-gpt-4o,medalign,progress_note,PROMPT2_ICL_entailment
31,34,47,47,0,1.0,30,23,7,0.7666666666666667,0.8679245283018869,shc-gpt-4o,medalign,progress_note,PROMPT2_ICL_entailment
32,35,80,78,2,0.975,57,47,10,0.8245614035087719,0.8934925664148184,shc-gpt-4o,medalign,progress_note,PROMPT2_ICL_entailment
33,36,54,52,2,0.9629629629629628,29,19,10,0.6551724137931034,0.7797947908445145,shc-gpt-4o,medalign,progress_note,PROMPT2_ICL_entailment
34,37,48,33,15,0.6875,19,14,5,0.7368421052631579,0.7113163972286374,shc-gpt-4o,medalign,progress_note,PROMPT2_ICL_entailment
35,38,145,128,17,0.8827586206896552,63,45,18,0.7142857142857143,0.7896360271437384,shc-gpt-4o,medalign,progress_note,PROMPT2_ICL_entailment
36,39,96,84,12,0.875,43,34,9,0.7906976744186046,0.8307155322862129,shc-gpt-4o,medalign,progress_note,PROMPT2_ICL_entailment
37,4,127,126,1,0.9921259842519684,65,46,19,0.7076923076923077,0.8261117445838084,shc-gpt-4o,medalign,progress_note,PROMPT2_ICL_entailment
38,40,70,65,5,0.9285714285714286,31,27,4,0.8709677419354839,0.8988476312419975,shc-gpt-4o,medalign,progress_note,PROMPT2_ICL_entailment
39,41,155,146,9,0.9419354838709676,69,59,10,0.855072463768116,0.8964045996149644,shc-gpt-4o,medalign,progress_note,PROMPT2_ICL_entailment
40,42,50,48,2,0.96,32,26,6,0.8125,0.8801128349788435,shc-gpt-4o,medalign,progress_note,PROMPT2_ICL_entailment
41,43,39,38,1,0.9743589743589745,23,18,5,0.782608695652174,0.868020304568528,shc-gpt-4o,medalign,progress_note,PROMPT2_ICL_entailment
42,44,142,138,4,0.971830985915493,92,60,32,0.6521739130434783,0.7805429864253394,shc-gpt-4o,medalign,progress_note,PROMPT2_ICL_entailment
43,45,26,25,1,0.9615384615384616,15,11,4,0.7333333333333333,0.832072617246596,shc-gpt-4o,medalign,progress_note,PROMPT2_ICL_entailment
44,46,98,97,1,0.9897959183673468,50,37,13,0.74,0.8468617272298254,shc-gpt-4o,medalign,progress_note,PROMPT2_ICL_entailment
45,47,97,91,6,0.9381443298969072,42,35,7,0.8333333333333334,0.8826382153249273,shc-gpt-4o,medalign,progress_note,PROMPT2_ICL_entailment
46,48,94,87,7,0.925531914893617,56,45,11,0.8035714285714286,0.8602504943968359,shc-gpt-4o,medalign,progress_note,PROMPT2_ICL_entailment
47,49,172,162,10,0.9418604651162792,58,31,27,0.5344827586206896,0.6819663226507332,shc-gpt-4o,medalign,progress_note,PROMPT2_ICL_entailment
48,5,163,146,17,0.8957055214723927,69,50,19,0.7246376811594203,0.8011413520632134,shc-gpt-4o,medalign,progress_note,PROMPT2_ICL_entailment
49,50,152,142,10,0.9342105263157896,68,48,20,0.7058823529411765,0.8041529023124115,shc-gpt-4o,medalign,progress_note,PROMPT2_ICL_entailment
50,51,104,102,2,0.9807692307692308,47,42,5,0.8936170212765957,0.9351669941060904,shc-gpt-4o,medalign,progress_note,PROMPT2_ICL_entailment
51,52,28,28,0,1.0,19,12,7,0.631578947368421,0.7741935483870968,shc-gpt-4o,medalign,progress_note,PROMPT2_ICL_entailment
52,53,94,90,4,0.9574468085106383,54,38,16,0.7037037037037037,0.8111954459203036,shc-gpt-4o,medalign,progress_note,PROMPT2_ICL_entailment
53,54,35,22,13,0.6285714285714286,24,16,8,0.6666666666666666,0.6470588235294118,shc-gpt-4o,medalign,progress_note,PROMPT2_ICL_entailment
54,55,34,33,1,0.9705882352941176,23,21,2,0.9130434782608696,0.9409368635437882,shc-gpt-4o,medalign,progress_note,PROMPT2_ICL_entailment
55,56,50,49,1,0.98,25,16,9,0.64,0.7743209876543209,shc-gpt-4o,medalign,progress_note,PROMPT2_ICL_entailment
56,57,13,13,0,1.0,4,3,1,0.75,0.8571428571428571,shc-gpt-4o,medalign,progress_note,PROMPT2_ICL_entailment
57,58,19,19,0,1.0,13,7,6,0.5384615384615384,0.7000000000000001,shc-gpt-4o,medalign,progress_note,PROMPT2_ICL_entailment
58,59,83,80,3,0.963855421686747,35,27,8,0.7714285714285715,0.8569728228526087,shc-gpt-4o,medalign,progress_note,PROMPT2_ICL_entailment
59,6,98,96,2,0.979591836734694,59,44,15,0.7457627118644068,0.846832397754611,shc-gpt-4o,medalign,progress_note,PROMPT2_ICL_entailment
60,60,100,78,22,0.78,56,34,22,0.6071428571428571,0.6828012358393409,shc-gpt-4o,medalign,progress_note,PROMPT2_ICL_entailment
61,61,41,36,5,0.8780487804878049,25,20,5,0.8,0.8372093023255814,shc-gpt-4o,medalign,progress_note,PROMPT2_ICL_entailment
62,62,50,47,3,0.94,32,22,10,0.6875,0.794162826420891,shc-gpt-4o,medalign,progress_note,PROMPT2_ICL_entailment
63,63,37,36,1,0.972972972972973,10,10,0,1.0,0.9863013698630138,shc-gpt-4o,medalign,progress_note,PROMPT2_ICL_entailment
64,64,159,130,29,0.8176100628930818,69,49,20,0.7101449275362319,0.7600978461905615,shc-gpt-4o,medalign,progress_note,PROMPT2_ICL_entailment
65,65,215,143,72,0.6651162790697674,104,47,57,0.4519230769230769,0.5381751211114225,shc-gpt-4o,medalign,progress_note,PROMPT2_ICL_entailment
66,66,155,140,15,0.9032258064516128,87,62,25,0.7126436781609196,0.7966957319871502,shc-gpt-4o,medalign,progress_note,PROMPT2_ICL_entailment
67,67,38,37,1,0.9736842105263158,18,13,5,0.7222222222222222,0.8293103448275863,shc-gpt-4o,medalign,progress_note,PROMPT2_ICL_entailment
68,68,13,13,0,1.0,11,7,4,0.6363636363636364,0.7777777777777778,shc-gpt-4o,medalign,progress_note,PROMPT2_ICL_entailment
69,69,117,112,5,0.9572649572649572,68,52,16,0.7647058823529411,0.8502189781021897,shc-gpt-4o,medalign,progress_note,PROMPT2_ICL_entailment
70,7,74,58,16,0.7837837837837838,37,32,5,0.8648648648648649,0.82233052724856,shc-gpt-4o,medalign,progress_note,PROMPT2_ICL_entailment
71,70,87,78,9,0.896551724137931,69,46,23,0.6666666666666666,0.7647058823529411,shc-gpt-4o,medalign,progress_note,PROMPT2_ICL_entailment
72,71,104,101,3,0.971153846153846,48,39,9,0.8125,0.8847708894878705,shc-gpt-4o,medalign,progress_note,PROMPT2_ICL_entailment
73,72,141,131,10,0.9290780141843972,69,55,14,0.7971014492753623,0.8580445397165655,shc-gpt-4o,medalign,progress_note,PROMPT2_ICL_entailment
74,73,171,132,39,0.7719298245614035,90,49,41,0.5444444444444444,0.6385310232489263,shc-gpt-4o,medalign,progress_note,PROMPT2_ICL_entailment
75,74,38,37,1,0.9736842105263158,22,20,2,0.9090909090909092,0.940279542566709,shc-gpt-4o,medalign,progress_note,PROMPT2_ICL_entailment
76,75,111,109,2,0.981981981981982,49,35,14,0.7142857142857143,0.82701062215478,shc-gpt-4o,medalign,progress_note,PROMPT2_ICL_entailment
77,76,171,158,13,0.9239766081871345,77,50,27,0.6493506493506493,0.762695501061981,shc-gpt-4o,medalign,progress_note,PROMPT2_ICL_entailment
78,77,106,102,4,0.9622641509433962,38,33,5,0.868421052631579,0.9129373474369404,shc-gpt-4o,medalign,progress_note,PROMPT2_ICL_entailment
79,78,101,96,5,0.9504950495049505,54,40,14,0.7407407407407407,0.8326105810928014,shc-gpt-4o,medalign,progress_note,PROMPT2_ICL_entailment
80,79,135,86,49,0.6370370370370371,64,55,9,0.859375,0.7316884523164978,shc-gpt-4o,medalign,progress_note,PROMPT2_ICL_entailment
81,8,67,66,1,0.9850746268656716,31,22,9,0.7096774193548387,0.8250000000000001,shc-gpt-4o,medalign,progress_note,PROMPT2_ICL_entailment
82,80,126,114,12,0.9047619047619048,66,35,31,0.5303030303030303,0.668677727501257,shc-gpt-4o,medalign,progress_note,PROMPT2_ICL_entailment
83,81,14,13,1,0.9285714285714286,12,6,6,0.5,0.65,shc-gpt-4o,medalign,progress_note,PROMPT2_ICL_entailment
84,82,14,14,0,1.0,13,6,7,0.4615384615384615,0.631578947368421,shc-gpt-4o,medalign,progress_note,PROMPT2_ICL_entailment
85,83,15,15,0,1.0,8,8,0,1.0,1.0,shc-gpt-4o,medalign,progress_note,PROMPT2_ICL_entailment
86,84,35,32,3,0.9142857142857144,23,18,5,0.782608695652174,0.8433382137628112,shc-gpt-4o,medalign,progress_note,PROMPT2_ICL_entailment
87,85,123,118,5,0.959349593495935,63,38,25,0.6031746031746031,0.7406673273868516,shc-gpt-4o,medalign,progress_note,PROMPT2_ICL_entailment
88,86,152,139,13,0.9144736842105264,75,60,15,0.8,0.8534151957022257,shc-gpt-4o,medalign,progress_note,PROMPT2_ICL_entailment
89,87,165,151,14,0.9151515151515152,87,54,33,0.6206896551724138,0.7396924751666895,shc-gpt-4o,medalign,progress_note,PROMPT2_ICL_entailment
90,88,161,154,7,0.9565217391304348,84,63,21,0.75,0.8407643312101911,shc-gpt-4o,medalign,progress_note,PROMPT2_ICL_entailment
91,89,68,66,2,0.9705882352941176,41,35,6,0.8536585365853658,0.9083759339362956,shc-gpt-4o,medalign,progress_note,PROMPT2_ICL_entailment
92,9,110,107,3,0.9727272727272728,68,56,12,0.8235294117647058,0.8919321226555521,shc-gpt-4o,medalign,progress_note,PROMPT2_ICL_entailment
93,90,27,24,3,0.8888888888888888,24,17,7,0.7083333333333334,0.7884057971014492,shc-gpt-4o,medalign,progress_note,PROMPT2_ICL_entailment
94,91,77,77,0,1.0,45,34,11,0.7555555555555555,0.8607594936708861,shc-gpt-4o,medalign,progress_note,PROMPT2_ICL_entailment
95,92,30,29,1,0.9666666666666668,17,15,2,0.8823529411764706,0.9225874867444326,shc-gpt-4o,medalign,progress_note,PROMPT2_ICL_entailment
96,93,39,37,2,0.9487179487179488,25,23,2,0.92,0.9341383095499451,shc-gpt-4o,medalign,progress_note,PROMPT2_ICL_entailment
97,94,70,68,2,0.9714285714285714,33,26,7,0.7878787878787878,0.8700787401574804,shc-gpt-4o,medalign,progress_note,PROMPT2_ICL_entailment
98,95,83,74,9,0.891566265060241,41,33,8,0.8048780487804879,0.8460072752468387,shc-gpt-4o,medalign,progress_note,PROMPT2_ICL_entailment
99,96,128,125,3,0.9765625,48,42,6,0.875,0.9229957805907172,shc-gpt-4o,medalign,progress_note,PROMPT2_ICL_entailment
100,97,91,84,7,0.9230769230769232,37,32,5,0.8648648648648649,0.8930232558139535,shc-gpt-4o,medalign,progress_note,PROMPT2_ICL_entailment
101,98,122,79,43,0.6475409836065574,55,42,13,0.7636363636363637,0.7008131798500371,shc-gpt-4o,medalign,progress_note,PROMPT2_ICL_entailment
102,99,196,167,29,0.8520408163265306,73,57,16,0.7808219178082192,0.8148782262551899,shc-gpt-4o,medalign,progress_note,PROMPT2_ICL_entailment
0,0,108,91,17,0.8425925925925926,71,50,21,0.704225352112676,0.7672203018295254,shc-gpt-4o,medalign,progress_note,PROMPT2_entailment
1,1,65,63,2,0.9692307692307692,47,38,9,0.8085106382978723,0.8816055974958571,shc-gpt-4o,medalign,progress_note,PROMPT2_entailment
2,10,106,97,9,0.9150943396226416,48,35,13,0.7291666666666666,0.811618455653837,shc-gpt-4o,medalign,progress_note,PROMPT2_entailment
3,100,66,65,1,0.9848484848484848,43,35,8,0.813953488372093,0.8912830558276199,shc-gpt-4o,medalign,progress_note,PROMPT2_entailment
4,101,100,85,15,0.85,73,46,27,0.6301369863013698,0.7237390097177232,shc-gpt-4o,medalign,progress_note,PROMPT2_entailment
5,102,18,18,0,1.0,13,10,3,0.7692307692307693,0.8695652173913044,shc-gpt-4o,medalign,progress_note,PROMPT2_entailment
6,11,46,46,0,1.0,38,24,14,0.631578947368421,0.7741935483870968,shc-gpt-4o,medalign,progress_note,PROMPT2_entailment
7,12,73,70,3,0.958904109589041,46,34,12,0.7391304347826086,0.8347948088390038,shc-gpt-4o,medalign,progress_note,PROMPT2_entailment
8,13,104,98,6,0.9423076923076924,68,53,15,0.7794117647058824,0.8531537450722733,shc-gpt-4o,medalign,progress_note,PROMPT2_entailment
9,14,15,15,0,1.0,13,7,6,0.5384615384615384,0.7000000000000001,shc-gpt-4o,medalign,progress_note,PROMPT2_entailment
10,15,23,21,2,0.9130434782608696,19,12,7,0.631578947368421,0.7466666666666667,shc-gpt-4o,medalign,progress_note,PROMPT2_entailment
11,16,128,118,10,0.921875,78,64,14,0.8205128205128205,0.8682455736951024,shc-gpt-4o,medalign,progress_note,PROMPT2_entailment
12,17,57,54,3,0.9473684210526316,33,29,4,0.8787878787878788,0.9117903930131004,shc-gpt-4o,medalign,progress_note,PROMPT2_entailment
13,18,66,63,3,0.9545454545454546,59,50,9,0.847457627118644,0.8978195810175288,shc-gpt-4o,medalign,progress_note,PROMPT2_entailment
14,19,103,94,9,0.912621359223301,57,42,15,0.7368421052631579,0.815365551425031,shc-gpt-4o,medalign,progress_note,PROMPT2_entailment
15,2,153,139,14,0.9084967320261438,54,43,11,0.7962962962962963,0.8487042953496627,shc-gpt-4o,medalign,progress_note,PROMPT2_entailment
16,20,43,42,1,0.9767441860465116,31,29,2,0.935483870967742,0.9556688897606904,shc-gpt-4o,medalign,progress_note,PROMPT2_entailment
17,21,51,48,3,0.9411764705882352,31,21,10,0.6774193548387096,0.7878077373974208,shc-gpt-4o,medalign,progress_note,PROMPT2_entailment
18,22,69,66,3,0.9565217391304348,63,36,27,0.5714285714285714,0.7154471544715447,shc-gpt-4o,medalign,progress_note,PROMPT2_entailment
19,23,77,67,10,0.8701298701298701,35,30,5,0.8571428571428571,0.8635875402792695,shc-gpt-4o,medalign,progress_note,PROMPT2_entailment
20,24,66,66,0,1.0,42,37,5,0.8809523809523809,0.9367088607594936,shc-gpt-4o,medalign,progress_note,PROMPT2_entailment
21,25,39,38,1,0.9743589743589745,26,23,3,0.8846153846153846,0.9273209549071616,shc-gpt-4o,medalign,progress_note,PROMPT2_entailment
22,26,48,48,0,1.0,24,21,3,0.875,0.9333333333333332,shc-gpt-4o,medalign,progress_note,PROMPT2_entailment
23,27,110,95,15,0.8636363636363636,81,57,24,0.7037037037037037,0.7755102040816326,shc-gpt-4o,medalign,progress_note,PROMPT2_entailment
24,28,56,52,4,0.9285714285714286,38,27,11,0.7105263157894737,0.805045871559633,shc-gpt-4o,medalign,progress_note,PROMPT2_entailment
25,29,135,129,6,0.9555555555555556,99,60,39,0.6060606060606061,0.7416990081931867,shc-gpt-4o,medalign,progress_note,PROMPT2_entailment
26,3,82,81,1,0.9878048780487804,56,49,7,0.875,0.9279869067103108,shc-gpt-4o,medalign,progress_note,PROMPT2_entailment
27,30,85,81,4,0.9529411764705882,54,42,12,0.7777777777777778,0.8564954682779455,shc-gpt-4o,medalign,progress_note,PROMPT2_entailment
28,31,68,63,5,0.9264705882352942,38,32,6,0.8421052631578947,0.8822757111597375,shc-gpt-4o,medalign,progress_note,PROMPT2_entailment
29,32,110,109,1,0.990909090909091,45,39,6,0.8666666666666667,0.9246329526916804,shc-gpt-4o,medalign,progress_note,PROMPT2_entailment
30,33,37,36,1,0.972972972972973,33,25,8,0.7575757575757576,0.8518693800283956,shc-gpt-4o,medalign,progress_note,PROMPT2_entailment
31,34,38,38,0,1.0,30,23,7,0.7666666666666667,0.8679245283018869,shc-gpt-4o,medalign,progress_note,PROMPT2_entailment
32,35,72,71,1,0.9861111111111112,57,46,11,0.8070175438596491,0.887620600625085,shc-gpt-4o,medalign,progress_note,PROMPT2_entailment
33,36,51,51,0,1.0,29,21,8,0.7241379310344828,0.8400000000000001,shc-gpt-4o,medalign,progress_note,PROMPT2_entailment
34,37,46,31,15,0.6739130434782609,19,9,10,0.4736842105263157,0.5563310069790628,shc-gpt-4o,medalign,progress_note,PROMPT2_entailment
35,38,121,95,26,0.7851239669421488,63,46,17,0.7301587301587301,0.7566444463682798,shc-gpt-4o,medalign,progress_note,PROMPT2_entailment
36,39,89,72,17,0.8089887640449438,43,37,6,0.8604651162790697,0.8339333228987321,shc-gpt-4o,medalign,progress_note,PROMPT2_entailment
37,4,92,90,2,0.9782608695652174,65,47,18,0.7230769230769231,0.8315313544328681,shc-gpt-4o,medalign,progress_note,PROMPT2_entailment
38,40,50,47,3,0.94,31,21,10,0.6774193548387096,0.7873952931790985,shc-gpt-4o,medalign,progress_note,PROMPT2_entailment
39,41,99,97,2,0.9797979797979798,69,56,13,0.8115942028985508,0.8877992972133694,shc-gpt-4o,medalign,progress_note,PROMPT2_entailment
40,42,42,42,0,1.0,32,25,7,0.78125,0.8771929824561403,shc-gpt-4o,medalign,progress_note,PROMPT2_entailment
41,43,29,28,1,0.9655172413793104,23,18,5,0.782608695652174,0.8644939965694683,shc-gpt-4o,medalign,progress_note,PROMPT2_entailment
42,44,128,102,26,0.796875,92,54,38,0.5869565217391305,0.6759941089837999,shc-gpt-4o,medalign,progress_note,PROMPT2_entailment
43,45,28,28,0,1.0,15,15,0,1.0,1.0,shc-gpt-4o,medalign,progress_note,PROMPT2_entailment
44,46,89,88,1,0.9887640449438202,50,42,8,0.84,0.9083312853280904,shc-gpt-4o,medalign,progress_note,PROMPT2_entailment
45,47,85,80,5,0.9411764705882352,42,34,8,0.8095238095238095,0.8704,shc-gpt-4o,medalign,progress_note,PROMPT2_entailment
46,48,65,63,2,0.9692307692307692,56,37,19,0.6607142857142857,0.7857744817124557,shc-gpt-4o,medalign,progress_note,PROMPT2_entailment
47,49,152,138,14,0.9078947368421052,58,40,18,0.6896551724137931,0.7838682192558932,shc-gpt-4o,medalign,progress_note,PROMPT2_entailment
48,5,125,112,13,0.896,69,56,13,0.8115942028985508,0.8517110266159696,shc-gpt-4o,medalign,progress_note,PROMPT2_entailment
49,50,131,120,11,0.916030534351145,68,58,10,0.8529411764705882,0.8833608325929687,shc-gpt-4o,medalign,progress_note,PROMPT2_entailment
50,51,89,84,5,0.9438202247191012,47,42,5,0.8936170212765957,0.918032786885246,shc-gpt-4o,medalign,progress_note,PROMPT2_entailment
51,52,22,21,1,0.9545454545454546,19,14,5,0.7368421052631579,0.8316831683168316,shc-gpt-4o,medalign,progress_note,PROMPT2_entailment
52,53,82,79,3,0.9634146341463414,54,41,13,0.7592592592592593,0.8492396434189827,shc-gpt-4o,medalign,progress_note,PROMPT2_entailment
53,54,30,30,0,1.0,24,16,8,0.6666666666666666,0.8,shc-gpt-4o,medalign,progress_note,PROMPT2_entailment
54,55,32,31,1,0.96875,23,20,3,0.8695652173913043,0.9164818920916482,shc-gpt-4o,medalign,progress_note,PROMPT2_entailment
55,56,35,34,1,0.9714285714285714,25,16,9,0.64,0.771631205673759,shc-gpt-4o,medalign,progress_note,PROMPT2_entailment
56,57,11,11,0,1.0,4,4,0,1.0,1.0,shc-gpt-4o,medalign,progress_note,PROMPT2_entailment
57,58,16,16,0,1.0,13,8,5,0.6153846153846154,0.761904761904762,shc-gpt-4o,medalign,progress_note,PROMPT2_entailment
58,59,71,66,5,0.9295774647887324,35,24,11,0.6857142857142857,0.789237668161435,shc-gpt-4o,medalign,progress_note,PROMPT2_entailment
59,6,86,86,0,1.0,59,46,13,0.7796610169491526,0.8761904761904762,shc-gpt-4o,medalign,progress_note,PROMPT2_entailment
60,60,77,67,10,0.8701298701298701,56,37,19,0.6607142857142857,0.7510983184366004,shc-gpt-4o,medalign,progress_note,PROMPT2_entailment
61,61,26,26,0,1.0,25,19,6,0.76,0.8636363636363636,shc-gpt-4o,medalign,progress_note,PROMPT2_entailment
62,62,38,36,2,0.9473684210526316,32,23,9,0.71875,0.8173741362290227,shc-gpt-4o,medalign,progress_note,PROMPT2_entailment
63,63,21,21,0,1.0,10,9,1,0.9,0.9473684210526316,shc-gpt-4o,medalign,progress_note,PROMPT2_entailment
64,64,106,80,26,0.7547169811320755,69,54,15,0.782608695652174,0.768409818569904,shc-gpt-4o,medalign,progress_note,PROMPT2_entailment
65,65,150,106,44,0.7066666666666667,104,58,46,0.5576923076923077,0.6234029608598661,shc-gpt-4o,medalign,progress_note,PROMPT2_entailment
66,66,113,99,14,0.8761061946902655,87,60,27,0.6896551724137931,0.7717793802377705,shc-gpt-4o,medalign,progress_note,PROMPT2_entailment
67,67,29,27,2,0.9310344827586208,18,14,4,0.7777777777777778,0.8475336322869955,shc-gpt-4o,medalign,progress_note,PROMPT2_entailment
68,68,15,15,0,1.0,11,10,1,0.9090909090909092,0.9523809523809524,shc-gpt-4o,medalign,progress_note,PROMPT2_entailment
69,69,83,79,4,0.9518072289156626,68,54,14,0.7941176470588235,0.8658412827278262,shc-gpt-4o,medalign,progress_note,PROMPT2_entailment
70,7,58,49,9,0.8448275862068966,37,28,9,0.7567567567567568,0.7983706720977598,shc-gpt-4o,medalign,progress_note,PROMPT2_entailment
71,70,98,87,11,0.8877551020408163,69,42,27,0.6086956521739131,0.7222057515564779,shc-gpt-4o,medalign,progress_note,PROMPT2_entailment
72,71,107,100,7,0.9345794392523364,48,39,9,0.8125,0.8692744901370778,shc-gpt-4o,medalign,progress_note,PROMPT2_entailment
73,72,85,80,5,0.9411764705882352,69,63,6,0.9130434782608696,0.926896551724138,shc-gpt-4o,medalign,progress_note,PROMPT2_entailment
74,73,129,115,14,0.8914728682170543,90,62,28,0.6888888888888889,0.7771964246784391,shc-gpt-4o,medalign,progress_note,PROMPT2_entailment
75,74,31,31,0,1.0,22,19,3,0.8636363636363636,0.9268292682926828,shc-gpt-4o,medalign,progress_note,PROMPT2_entailment
76,75,81,79,2,0.9753086419753086,49,39,10,0.7959183673469388,0.8765291607396869,shc-gpt-4o,medalign,progress_note,PROMPT2_entailment
77,76,108,97,11,0.8981481481481481,77,71,6,0.922077922077922,0.9099557375966176,shc-gpt-4o,medalign,progress_note,PROMPT2_entailment
78,77,84,80,4,0.9523809523809524,38,34,4,0.8947368421052632,0.9226594301221168,shc-gpt-4o,medalign,progress_note,PROMPT2_entailment
79,78,87,85,2,0.9770114942528736,54,44,10,0.8148148148148148,0.8885721073889286,shc-gpt-4o,medalign,progress_note,PROMPT2_entailment
80,79,127,75,52,0.5905511811023622,64,44,20,0.6875,0.6353484790142472,shc-gpt-4o,medalign,progress_note,PROMPT2_entailment
81,8,50,48,2,0.96,31,23,8,0.7419354838709677,0.8369977255496589,shc-gpt-4o,medalign,progress_note,PROMPT2_entailment
82,80,105,78,27,0.7428571428571429,66,44,22,0.6666666666666666,0.7027027027027027,shc-gpt-4o,medalign,progress_note,PROMPT2_entailment
83,81,17,16,1,0.9411764705882352,12,7,5,0.5833333333333334,0.7202572347266882,shc-gpt-4o,medalign,progress_note,PROMPT2_entailment
84,82,22,22,0,1.0,13,8,5,0.6153846153846154,0.761904761904762,shc-gpt-4o,medalign,progress_note,PROMPT2_entailment
85,83,12,12,0,1.0,8,8,0,1.0,1.0,shc-gpt-4o,medalign,progress_note,PROMPT2_entailment
86,84,27,25,2,0.925925925925926,23,17,6,0.7391304347826086,0.8220502901353965,shc-gpt-4o,medalign,progress_note,PROMPT2_entailment
87,85,81,79,2,0.9753086419753086,63,39,24,0.6190476190476191,0.7573746312684367,shc-gpt-4o,medalign,progress_note,PROMPT2_entailment
88,86,129,116,13,0.8992248062015504,75,44,31,0.5866666666666667,0.7100723427935449,shc-gpt-4o,medalign,progress_note,PROMPT2_entailment
89,87,86,83,3,0.9651162790697676,87,60,27,0.6896551724137931,0.8044584443905987,shc-gpt-4o,medalign,progress_note,PROMPT2_entailment
90,88,111,91,20,0.8198198198198198,84,70,14,0.8333333333333334,0.8265213442325159,shc-gpt-4o,medalign,progress_note,PROMPT2_entailment
91,89,56,54,2,0.9642857142857144,41,37,4,0.902439024390244,0.9323378441437238,shc-gpt-4o,medalign,progress_note,PROMPT2_entailment
92,9,84,82,2,0.9761904761904762,68,48,20,0.7058823529411765,0.8193172356369691,shc-gpt-4o,medalign,progress_note,PROMPT2_entailment
93,90,22,21,1,0.9545454545454546,24,16,8,0.6666666666666666,0.7850467289719627,shc-gpt-4o,medalign,progress_note,PROMPT2_entailment
94,91,60,59,1,0.9833333333333332,45,35,10,0.7777777777777778,0.868559411146162,shc-gpt-4o,medalign,progress_note,PROMPT2_entailment
95,92,25,23,2,0.92,17,16,1,0.9411764705882352,0.9304677623261696,shc-gpt-4o,medalign,progress_note,PROMPT2_entailment
96,93,27,26,1,0.9629629629629628,25,22,3,0.88,0.919614147909968,shc-gpt-4o,medalign,progress_note,PROMPT2_entailment
97,94,57,55,2,0.9649122807017544,33,20,13,0.6060606060606061,0.7445008460236886,shc-gpt-4o,medalign,progress_note,PROMPT2_entailment
98,95,61,55,6,0.9016393442622952,41,35,6,0.8536585365853658,0.8769931662870158,shc-gpt-4o,medalign,progress_note,PROMPT2_entailment
99,96,111,107,4,0.963963963963964,48,36,12,0.75,0.8436268068331144,shc-gpt-4o,medalign,progress_note,PROMPT2_entailment
100,97,70,66,4,0.9428571428571428,37,33,4,0.8918918918918919,0.9166666666666669,shc-gpt-4o,medalign,progress_note,PROMPT2_entailment
101,98,84,60,24,0.7142857142857143,55,38,17,0.6909090909090909,0.7024029574861367,shc-gpt-4o,medalign,progress_note,PROMPT2_entailment
102,99,148,127,21,0.8581081081081081,73,65,8,0.8904109589041096,0.8739611455190303,shc-gpt-4o,medalign,progress_note,PROMPT2_entailment
